20141226.2059,2866,174,174,2018782,2865,10,2866,28,1
20141226.21,2865,14,188,6,2865,3,2866,30,0
20141226.210001,2865,122,310,26,2863,6,2865,148,0
20141226.210001,2865,68,378,-4,2863,8,2865,149,0
20141226.210001,2865,220,598,70,2863,51,2865,83,0
20141226.210002,2863,22,620,0,2863,50,2864,69,0
20141226.210002,2864,14,634,8,2863,110,2864,64,1
20141226.210003,2865,36,670,4,2864,190,2865,164,1
20141226.210003,2865,28,698,-28,2864,190,2865,151,1
20141226.210004,2864,82,780,68,2864,150,2865,151,0
20141226.210004,2865,6,786,4,2864,149,2865,150,1
20141226.210005,2865,296,1082,30,2864,1,2865,28,1
20141226.210005,2865,4,1086,2,2864,6,2865,33,1
20141226.210006,2865,22,1108,2,2864,6,2865,22,1
20141226.210007,2865,2,1110,0,2864,9,2865,21,1
20141226.210008,2866,52,1162,2,2864,9,2866,44,1
20141226.210008,2865,2,1164,-2,2864,18,2866,21,0
20141226.210009,2865,14,1178,6,2864,38,2866,21,0
20141226.21001,2865,2,1180,2,2864,85,2866,22,0
20141226.21001,2865,6,1186,2,2864,166,2866,21,0
20141226.210011,2865,2,1188,2,2865,62,2866,26,0
20141226.210012,2865,2,1190,0,2865,67,2866,34,0
20141226.210013,2866,30,1220,20,2865,53,2866,19,1
20141226.210013,2866,4,1224,4,2865,52,2866,16,1
20141226.210014,2865,14,1238,0,2865,47,2866,23,0
20141226.210014,2865,2,1240,2,2865,46,2866,26,0
20141226.210015,2866,20,1260,4,2865,46,2866,18,1
20141226.210015,2866,88,1348,30,2864,68,2866,6,1
20141226.210016,2865,10,1358,-10,2865,34,2866,28,0
20141226.210017,2866,34,1392,2,2865,34,2866,11,1
20141226.210018,2866,8,1400,-4,2865,31,2866,10,1
20141226.210019,2865,118,1518,-12,2865,7,2866,38,0
20141226.21002,2866,4,1522,2,2865,7,2866,70,1
20141226.210021,2866,10,1532,-4,2865,47,2866,66,1
20141226.210021,2865,44,1576,8,2865,6,2866,58,0
20141226.210022,2866,12,1588,-12,2865,6,2866,52,1
20141226.210022,2865,4,1592,0,2865,7,2866,61,0
20141226.210023,2865,62,1654,52,2864,48,2866,61,0
20141226.210023,2865,4,1658,0,2865,5,2866,60,0
20141226.210024,2865,12,1670,-6,2864,207,2865,45,0
20141226.210028,2864,4,1674,-4,2864,218,2865,55,0
20141226.210028,2865,32,1706,-20,2864,208,2865,51,1
20141226.210028,2865,2,1708,0,2864,208,2865,55,1
20141226.21003,2864,2,1710,-2,2864,204,2865,70,0
20141226.21003,2865,2,1712,0,2864,204,2865,69,1
20141226.210031,2865,2,1714,0,2864,202,2865,68,1
20141226.210032,2865,16,1730,-8,2864,188,2865,91,1
20141226.210033,2864,20,1750,-8,2864,178,2865,91,0
20141226.210034,2864,20,1770,-10,2864,181,2865,99,0
20141226.210035,2865,202,1972,28,2865,199,2866,76,1
20141226.210035,2865,4,1976,0,2865,197,2866,76,1
20141226.210035,2865,2,1978,0,2865,196,2866,76,1
20141226.210036,2865,22,2000,0,2865,185,2866,46,1
20141226.210037,2865,12,2012,6,2865,179,2866,46,1
20141226.210039,2865,2,2014,2,2865,235,2866,48,1
20141226.210039,2865,4,2018,0,2865,213,2866,48,1
20141226.210041,2865,4,2022,2,2865,176,2866,58,1
20141226.210041,2865,4,2026,2,2865,174,2866,58,1
20141226.210044,2865,2,2028,2,2865,173,2866,137,1
20141226.210045,2865,18,2046,8,2865,167,2866,136,1
20141226.210047,2865,34,2080,-10,2865,172,2866,139,1
20141226.210047,2865,204,2284,200,2865,70,2866,141,1
20141226.210049,2866,10,2294,0,2865,76,2866,146,1
20141226.210049,2865,4,2298,2,2865,74,2866,146,0
20141226.21005,2865,6,2304,0,2865,71,2866,146,0
20141226.21005,2866,8,2312,0,2865,70,2866,143,1
20141226.210051,2866,12,2324,-4,2865,68,2866,155,1
20141226.210052,2866,22,2346,16,2865,72,2866,146,1
20141226.210052,2866,2,2348,-2,2865,75,2866,145,1
20141226.210053,2866,4,2352,4,2865,76,2866,143,1
20141226.210054,2865,2,2354,0,2865,75,2866,143,0
20141226.210055,2866,8,2362,0,2865,76,2866,139,1
20141226.210056,2865,62,2424,2,2865,45,2866,139,0
20141226.210056,2865,4,2428,4,2865,163,2866,139,0
20141226.210057,2865,10,2438,0,2865,158,2866,142,0
20141226.210059,2866,2,2440,2,2865,162,2866,142,1
20141226.210059,2865,2,2442,2,2865,41,2866,145,0
20141226.2101,2866,4,2446,2,2865,41,2866,143,1
20141226.2101,2866,16,2462,14,2865,41,2866,150,1
20141226.210101,2866,2,2464,0,2865,41,2866,151,1
20141226.210102,2866,6,2470,6,2865,44,2866,155,1
20141226.210103,2866,8,2478,8,2865,42,2866,153,1
20141226.210104,2865,12,2490,2,2865,37,2866,152,0
20141226.210105,2865,12,2502,2,2865,61,2866,153,0
20141226.210106,2865,40,2542,-16,2865,42,2866,155,0
20141226.210107,2866,46,2588,-40,2865,11,2866,170,1
20141226.210107,2865,22,2610,0,2864,70,2865,20,0
20141226.210108,2865,4,2614,0,2864,74,2865,30,0
20141226.210109,2865,2,2616,0,2864,74,2865,39,0
20141226.21011,2865,2,2618,2,2864,77,2865,38,0
20141226.21011,2864,2,2620,-2,2864,77,2865,40,0
20141226.210111,2865,130,2750,-50,2865,122,2866,177,1
20141226.210112,2865,142,2892,-80,2865,53,2866,177,1
20141226.210113,2865,12,2904,0,2865,48,2866,178,1
20141226.210115,2865,4,2908,-2,2865,46,2866,196,1
20141226.210117,2865,66,2974,-2,2865,14,2866,214,1
20141226.210118,2865,2,2976,0,2865,13,2866,244,1
20141226.210118,2864,40,3016,6,2864,81,2865,80,0
20141226.210119,2864,40,3056,20,2864,69,2865,90,0
20141226.21012,2864,2,3058,2,2864,69,2865,91,0
20141226.210122,2864,2,3060,2,2864,63,2865,91,0
20141226.210123,2864,2,3062,2,2864,62,2865,94,0
20141226.210124,2864,10,3072,10,2864,56,2865,96,0
20141226.210125,2865,214,3286,196,2865,3,2866,249,1
20141226.210126,2864,10,3296,-10,2864,62,2865,6,0
20141226.210128,2864,6,3302,-6,2864,60,2865,64,0
20141226.21013,2864,6,3308,-6,2864,59,2865,116,0
20141226.21013,2865,4,3312,4,2864,60,2865,112,1
20141226.210131,2864,24,3336,-20,2864,48,2865,113,0
20141226.210134,2864,66,3402,22,2864,22,2865,156,0
20141226.210135,2864,10,3412,-4,2864,18,2865,160,0
20141226.210136,2864,2,3414,0,2864,17,2865,161,0
20141226.210137,2864,12,3426,10,2864,11,2865,162,0
20141226.210137,2864,2,3428,0,2864,10,2865,173,0
20141226.210138,2864,4,3432,0,2864,9,2865,174,0
20141226.210139,2864,14,3446,0,2864,2,2865,174,0
20141226.21014,2864,4,3450,0,2863,120,2865,175,0
20141226.210141,2864,4,3454,0,2864,1,2865,185,0
20141226.210142,2863,4,3458,4,2864,1,2865,186,0
20141226.210142,2863,2,3460,-2,2863,119,2865,187,0
20141226.210143,2863,14,3474,0,2863,113,2865,187,0
20141226.210144,2863,6,3480,0,2863,110,2864,12,0
20141226.210146,2864,2,3482,0,2863,101,2864,11,1
20141226.210147,2864,2,3484,2,2863,102,2864,21,1
20141226.21015,2864,2,3486,2,2863,100,2864,88,1
20141226.210152,2863,20,3506,20,2863,90,2864,88,0
20141226.210154,2864,12,3518,12,2863,90,2864,87,1
20141226.210155,2863,2,3520,2,2863,91,2864,119,0
20141226.210156,2863,2,3522,2,2863,93,2864,119,0
20141226.210157,2863,8,3530,2,2863,89,2864,119,0
20141226.210157,2863,22,3552,20,2863,88,2864,109,0
20141226.210158,2863,12,3564,-12,2863,82,2864,109,0
20141226.210159,2864,2,3566,2,2863,82,2864,108,1
20141226.2102,2863,6,3572,0,2863,79,2864,106,0
20141226.2102,2863,4,3576,2,2863,77,2864,112,0
20141226.210201,2864,36,3612,-2,2863,77,2864,94,1
20141226.210201,2863,10,3622,4,2863,82,2864,104,0
20141226.210205,2863,2,3624,0,2863,104,2864,110,0
20141226.210205,2864,136,3760,-28,2863,53,2864,140,1
20141226.210205,2863,14,3774,0,2863,51,2864,135,0
20141226.210206,2864,2,3776,-2,2863,51,2864,134,1
20141226.210206,2864,2,3778,0,2863,53,2864,144,1
20141226.210207,2863,22,3800,-12,2863,43,2864,143,0
20141226.210208,2863,62,3862,-22,2863,13,2864,113,0
20141226.210209,2863,2,3864,2,2863,13,2864,113,0
20141226.210212,2863,4,3868,0,2863,37,2864,125,0
20141226.210213,2863,2,3870,0,2863,36,2864,125,0
20141226.210216,2863,20,3890,12,2863,28,2864,134,0
20141226.210218,2863,2,3892,0,2863,28,2864,131,0
20141226.21022,2863,22,3914,2,2863,18,2864,132,0
20141226.21022,2863,10,3924,0,2863,13,2864,132,0
20141226.210221,2864,2,3926,0,2863,14,2864,130,1
20141226.210222,2863,2,3928,0,2863,13,2864,130,0
20141226.210222,2863,30,3958,-8,2863,6,2864,130,0
20141226.210224,2863,8,3966,6,2863,63,2864,133,0
20141226.210224,2863,2,3968,2,2863,62,2864,133,0
20141226.210225,2863,4,3972,4,2863,61,2864,133,0
20141226.210226,2863,2,3974,0,2863,62,2864,133,0
20141226.210228,2863,2,3976,0,2863,64,2864,133,0
20141226.210229,2863,18,3994,-6,2863,56,2864,134,0
20141226.21023,2864,4,3998,0,2863,56,2864,132,1
20141226.21023,2863,20,4018,0,2863,46,2864,132,0
20141226.210231,2864,2,4020,-2,2863,46,2864,138,1
20141226.210232,2863,2,4022,-2,2863,45,2864,138,0
20141226.210234,2863,2,4024,0,2863,47,2864,139,0
20141226.210234,2863,2,4026,0,2863,47,2864,139,0
20141226.210234,2863,10,4036,0,2863,42,2864,139,0
20141226.210235,2863,2,4038,0,2863,41,2864,139,0
20141226.210236,2864,12,4050,0,2863,40,2864,133,1
20141226.210241,2863,4,4054,0,2863,59,2864,356,0
20141226.210242,2863,4,4058,-4,2863,57,2864,356,0
20141226.210244,2863,2,4060,0,2863,56,2864,356,0
20141226.210245,2863,12,4072,-12,2863,50,2864,356,0
20141226.210246,2863,42,4114,2,2863,29,2864,356,0
20141226.210248,2863,4,4118,0,2863,28,2864,358,0
20141226.210248,2863,4,4122,0,2863,26,2864,358,0
20141226.210249,2863,52,4174,-42,2862,221,2863,6,0
20141226.21025,2863,2,4176,0,2862,221,2863,6,0
20141226.210252,2862,2,4178,0,2862,221,2863,49,0
20141226.210257,2862,2,4180,2,2862,217,2863,68,0
20141226.210258,2862,12,4192,12,2862,213,2863,68,0
20141226.210258,2862,60,4252,0,2862,183,2863,68,0
20141226.2103,2863,2,4254,0,2862,163,2863,85,1
20141226.210303,2862,14,4268,0,2862,155,2863,97,0
20141226.210306,2862,10,4278,10,2862,150,2863,102,0
20141226.210307,2862,6,4284,4,2862,139,2863,116,0
20141226.210308,2863,2,4286,-2,2862,139,2863,140,1
20141226.21031,2863,22,4308,2,2862,137,2863,131,1
20141226.210311,2862,20,4328,20,2862,127,2863,152,0
20141226.210312,2863,2,4330,0,2862,129,2863,151,1
20141226.210315,2862,24,4354,-4,2862,122,2863,149,0
20141226.210317,2863,8,4362,0,2862,123,2863,145,1
20141226.210318,2862,6,4368,2,2862,123,2863,144,0
20141226.210319,2863,2,4370,-2,2862,126,2863,142,1
20141226.21032,2863,4,4374,-4,2862,126,2863,140,1
20141226.21032,2863,4,4378,0,2862,127,2863,138,1
20141226.210321,2863,100,4478,26,2862,135,2863,88,1
20141226.210322,2862,4,4482,4,2862,134,2863,90,0
20141226.210323,2863,4,4486,0,2862,133,2863,90,1
20141226.210324,2863,42,4528,-8,2862,118,2863,85,1
20141226.210324,2862,4,4532,0,2862,116,2863,85,0
20141226.210325,2863,6,4538,2,2862,114,2863,84,1
20141226.210326,2862,102,4640,-20,2862,114,2863,34,0
20141226.210327,2863,8,4648,8,2862,114,2863,31,1
20141226.210328,2862,2,4650,2,2862,163,2863,32,0
20141226.210331,2862,2,4652,2,2862,167,2863,38,0
20141226.210333,2863,2,4654,0,2862,169,2863,61,1
20141226.210334,2862,42,4696,-8,2862,149,2863,61,0
20141226.210334,2863,4,4700,-4,2862,149,2863,59,1
20141226.210336,2863,42,4742,-16,2862,131,2863,59,1
20141226.210336,2863,20,4762,0,2862,131,2863,50,1
20141226.210343,2862,18,4780,0,2862,129,2863,80,0
20141226.210347,2863,24,4804,4,2862,129,2863,77,1
20141226.210348,2863,2,4806,2,2862,129,2863,81,1
20141226.210352,2862,2,4808,0,2862,155,2863,93,0
20141226.210352,2863,2,4810,2,2862,155,2863,92,1
20141226.210354,2862,2,4812,0,2862,154,2863,317,0
20141226.210358,2862,4,4816,0,2862,152,2863,351,0
20141226.2104,2862,6,4822,2,2862,154,2863,344,0
20141226.210401,2862,2,4824,0,2862,153,2863,344,0
20141226.210401,2862,56,4880,-22,2862,138,2863,316,0
20141226.210402,2862,98,4978,-22,2862,84,2863,321,0
20141226.210403,2862,42,5020,2,2862,73,2863,321,0
20141226.210403,2862,48,5068,46,2862,49,2863,319,0
20141226.210403,2862,32,5100,-26,2862,33,2863,319,0
20141226.210404,2862,6,5106,-4,2862,32,2863,315,0
20141226.210404,2862,24,5130,10,2862,20,2863,315,0
20141226.210405,2862,6,5136,2,2862,19,2863,313,0
20141226.210405,2862,6,5142,2,2862,24,2863,308,0
20141226.210406,2862,22,5164,2,2861,148,2863,310,0
20141226.210407,2863,28,5192,-18,2861,148,2863,296,1
20141226.210408,2862,18,5210,2,2861,150,2862,15,0
20141226.21041,2861,2,5212,-2,2861,157,2862,89,0
20141226.210411,2861,8,5220,0,2861,137,2862,90,0
20141226.210412,2861,212,5432,-6,2861,110,2862,90,0
20141226.210414,2861,4,5436,-4,2861,108,2862,90,0
20141226.210416,2861,2,5438,-2,2861,108,2862,91,0
20141226.210417,2861,24,5462,-12,2861,97,2862,62,0
20141226.210419,2862,4,5466,0,2861,96,2862,62,1
20141226.21042,2862,2,5468,2,2861,96,2862,62,1
20141226.210421,2862,100,5568,-50,2861,96,2862,12,1
20141226.210421,2861,10,5578,0,2861,101,2862,12,0
20141226.210423,2862,2,5580,2,2861,101,2862,17,1
20141226.210423,2861,40,5620,0,2861,83,2862,17,0
20141226.210425,2862,24,5644,20,2861,113,2862,75,1
20141226.210426,2862,36,5680,20,2861,113,2862,59,1
20141226.210427,2862,4,5684,4,2861,113,2862,60,1
20141226.210428,2862,66,5750,6,2861,112,2862,37,1
20141226.210429,2862,10,5760,0,2861,112,2862,34,1
20141226.210429,2862,2,5762,2,2861,114,2862,33,1
20141226.210429,2861,2,5764,2,2861,113,2862,33,0
20141226.210431,2861,12,5776,0,2861,109,2862,33,0
20141226.210431,2861,2,5778,2,2861,108,2862,34,0
20141226.210432,2862,2,5780,0,2861,108,2862,34,1
20141226.210433,2861,12,5792,12,2861,106,2862,29,0
20141226.210433,2862,2,5794,2,2861,106,2862,30,1
20141226.210436,2862,2,5796,0,2861,107,2862,34,1
20141226.210438,2862,2,5798,0,2861,107,2862,34,1
20141226.210439,2862,76,5874,56,2862,73,2863,317,1
20141226.21044,2862,4,5878,2,2862,71,2863,317,1
20141226.210441,2862,22,5900,18,2862,70,2863,317,1
20141226.210441,2862,200,6100,-2,2862,46,2863,293,1
20141226.210442,2862,2,6102,0,2862,50,2863,293,1
20141226.210443,2862,4,6106,4,2862,72,2863,313,1
20141226.210443,2862,2,6108,2,2862,71,2863,308,1
20141226.210444,2862,14,6122,14,2862,64,2863,300,1
20141226.210444,2863,8,6130,-2,2862,64,2863,296,1
20141226.210446,2862,2,6132,2,2862,75,2863,294,0
20141226.21045,2862,2,6134,0,2862,86,2863,294,0
20141226.21045,2863,18,6152,18,2862,88,2863,285,1
20141226.210451,2862,86,6238,-20,2862,87,2863,343,0
20141226.210451,2863,8,6246,8,2862,87,2863,340,1
20141226.210452,2862,2,6248,2,2862,86,2863,340,0
20141226.210453,2862,116,6364,-84,2862,28,2863,346,0
20141226.210454,2863,104,6468,0,2862,19,2863,230,1
20141226.210456,2862,218,6686,-42,2862,3,2863,244,0
20141226.210457,2862,10,6696,-8,2861,104,2863,254,0
20141226.210458,2862,2,6698,2,2861,104,2862,10,0
20141226.210459,2862,22,6720,0,2862,40,2863,253,0
20141226.210501,2862,2,6722,-2,2862,40,2863,254,0
20141226.210501,2862,6,6728,-6,2862,37,2863,255,0
20141226.210503,2862,10,6738,-10,2862,34,2863,258,0
20141226.210504,2862,2,6740,-2,2862,33,2863,257,0
20141226.210504,2863,6,6746,6,2862,34,2863,254,1
20141226.210505,2862,2,6748,-2,2862,34,2863,255,0
20141226.210505,2862,8,6756,-8,2862,30,2863,255,0
20141226.210506,2863,6,6762,2,2862,29,2863,248,1
20141226.210508,2862,2,6764,0,2862,28,2863,249,0
20141226.210508,2862,2,6766,0,2862,47,2863,249,0
20141226.210509,2862,2,6768,-2,2862,49,2863,248,0
20141226.210509,2862,10,6778,-10,2862,44,2863,333,0
20141226.210512,2862,2,6780,0,2862,54,2863,373,0
20141226.210513,2862,200,6980,-52,2861,145,2863,319,0
20141226.210513,2862,2,6982,2,2862,1,2863,324,0
20141226.210515,2862,2,6984,0,2861,148,2862,25,0
20141226.210517,2862,4,6988,0,2861,176,2862,18,0
20141226.210518,2862,10,6998,10,2861,186,2862,13,0
20141226.210519,2861,2,7000,2,2861,189,2862,13,0
20141226.21052,2862,28,7028,-16,2862,25,2863,334,1
20141226.21052,2862,2,7030,-2,2862,25,2863,334,1
20141226.210522,2863,20,7050,20,2862,25,2863,324,1
20141226.210523,2862,2,7052,0,2862,24,2863,325,0
20141226.210524,2862,4,7056,0,2862,24,2863,329,0
20141226.210524,2862,40,7096,-40,2862,4,2863,330,0
20141226.210525,2863,10,7106,-4,2862,3,2863,326,1
20141226.210526,2862,2,7108,2,2862,2,2863,326,0
20141226.210529,2863,2,7110,2,2862,7,2863,326,1
20141226.210529,2863,34,7144,0,2862,8,2863,309,1
20141226.210531,2862,200,7344,-16,2861,186,2863,279,0
20141226.210532,2863,52,7396,0,2862,1,2863,257,1
20141226.210537,2862,4,7400,4,2862,67,2863,274,0
20141226.210538,2862,4,7404,4,2862,76,2863,274,0
20141226.21054,2863,114,7518,34,2862,57,2863,240,1
20141226.210543,2863,2,7520,2,2862,104,2863,239,1
20141226.210543,2863,2,7522,2,2862,106,2863,236,1
20141226.210545,2863,4,7526,2,2862,106,2863,225,1
20141226.210546,2862,114,7640,-86,2862,70,2863,271,0
20141226.210547,2862,120,7760,30,2862,10,2863,263,0
20141226.210548,2862,24,7784,-4,2861,157,2862,38,0
20141226.210549,2862,10,7794,0,2861,158,2862,44,0
20141226.210549,2862,4,7798,-2,2861,157,2862,42,0
20141226.210551,2862,2,7800,-2,2861,157,2862,41,0
20141226.210551,2862,116,7916,30,2862,72,2863,240,0
20141226.210552,2862,30,7946,0,2862,57,2863,241,0
20141226.210553,2862,2,7948,2,2862,57,2863,241,0
20141226.210553,2862,44,7992,0,2862,36,2863,222,0
20141226.210555,2862,2,7994,2,2862,40,2863,223,0
20141226.210557,2862,4,7998,4,2862,88,2863,224,0
20141226.2106,2862,8,8006,0,2862,85,2863,242,0
20141226.2106,2862,20,8026,-20,2862,85,2863,235,0
20141226.210601,2863,2,8028,2,2862,85,2863,236,1
20141226.210602,2862,52,8080,-18,2862,59,2863,235,0
20141226.210603,2863,18,8098,-8,2862,51,2863,245,1
20141226.210605,2863,2,8100,2,2862,71,2863,237,1
20141226.210606,2862,10,8110,0,2862,66,2863,237,0
20141226.210608,2862,2,8112,0,2862,65,2863,234,0
20141226.210608,2862,2,8114,-2,2862,64,2863,234,0
20141226.210611,2862,4,8118,-4,2862,63,2863,251,0
20141226.210611,2862,4,8122,-2,2862,61,2863,251,0
20141226.210614,2862,20,8142,0,2862,53,2863,253,0
20141226.210617,2862,22,8164,-22,2862,55,2863,258,0
20141226.210618,2863,22,8186,0,2862,45,2863,263,1
20141226.210622,2862,4,8190,0,2862,60,2863,264,0
20141226.210623,2862,6,8196,-6,2862,70,2863,264,0
20141226.210627,2862,6,8202,0,2862,75,2863,267,0
20141226.210629,2863,2,8204,2,2862,75,2863,266,1
20141226.210632,2862,4,8208,2,2862,73,2863,274,0
20141226.210635,2862,2,8210,0,2862,73,2863,274,0
20141226.210636,2863,4,8214,4,2862,73,2863,272,1
20141226.210639,2863,4,8218,2,2862,93,2863,271,1
20141226.210639,2863,2,8220,0,2862,94,2863,270,1
20141226.210643,2862,40,8260,0,2862,85,2863,267,0
20141226.210645,2862,4,8264,0,2862,83,2863,271,0
20141226.210646,2862,2,8266,2,2862,82,2863,256,0
20141226.210648,2863,10,8276,10,2862,83,2863,255,1
20141226.210648,2862,64,8340,-4,2862,51,2863,354,0
20141226.210649,2862,2,8342,2,2862,50,2863,355,0
20141226.210649,2863,4,8346,2,2862,49,2863,354,1
20141226.21065,2863,20,8366,20,2862,49,2863,344,1
20141226.21065,2862,10,8376,8,2862,44,2863,344,0
20141226.210651,2862,10,8386,0,2862,39,2863,344,0
20141226.210653,2862,8,8394,8,2862,48,2863,342,0
20141226.210654,2862,6,8400,4,2862,52,2863,343,0
20141226.210655,2863,6,8406,2,2862,52,2863,340,1
20141226.210656,2862,2,8408,0,2862,51,2863,339,0
20141226.210657,2862,10,8418,8,2862,46,2863,340,0
20141226.210659,2862,30,8448,0,2862,118,2863,338,0
20141226.2107,2862,2,8450,2,2862,117,2863,336,0
20141226.210701,2862,2,8452,2,2862,116,2863,331,0
20141226.210701,2862,4,8456,2,2862,119,2863,331,0
20141226.210702,2862,66,8522,48,2862,87,2863,333,0
20141226.210703,2862,8,8530,0,2862,83,2863,341,0
20141226.210703,2862,2,8532,0,2862,82,2863,352,0
20141226.210704,2862,2,8534,0,2862,81,2863,352,0
20141226.210705,2862,2,8536,0,2862,80,2863,352,0
20141226.210708,2862,160,8696,-154,2861,185,2863,238,0
20141226.210711,2861,4,8700,0,2861,183,2862,140,0
20141226.210712,2861,4,8704,4,2861,182,2862,160,0
20141226.210716,2861,2,8706,2,2861,182,2862,178,0
20141226.210719,2861,4,8710,4,2861,179,2862,175,0
20141226.21072,2861,64,8774,-44,2861,147,2862,177,0
20141226.210721,2861,10,8784,10,2861,142,2862,178,0
20141226.210721,2861,2,8786,2,2861,132,2862,177,0
20141226.210723,2861,124,8910,44,2861,70,2862,171,0
20141226.210723,2861,4,8914,-4,2861,68,2862,176,0
20141226.210724,2861,136,9050,50,2860,155,2861,75,0
20141226.210725,2860,2,9052,2,2860,154,2861,91,0
20141226.210726,2860,20,9072,4,2860,145,2861,86,0
20141226.210727,2861,68,9140,-8,2860,146,2861,55,1
20141226.210728,2860,2,9142,2,2860,143,2861,55,0
20141226.210728,2861,2,9144,2,2860,143,2861,55,1
20141226.210729,2860,4,9148,2,2860,141,2861,51,0
20141226.21073,2860,20,9168,0,2860,131,2861,62,0
20141226.210731,2861,4,9172,-4,2860,133,2861,64,1
20141226.210733,2860,36,9208,-16,2860,115,2861,69,0
20141226.210734,2860,20,9228,0,2860,105,2861,79,0
20141226.210735,2860,2,9230,-2,2860,107,2861,85,0
20141226.210737,2860,2,9232,0,2860,119,2861,83,0
20141226.210738,2860,2,9234,0,2860,121,2861,85,0
20141226.210739,2860,6,9240,-2,2860,115,2861,90,0
20141226.21074,2860,4,9244,0,2860,113,2861,100,0
20141226.210742,2860,12,9256,-2,2860,107,2861,105,0
20141226.210742,2860,2,9258,0,2860,119,2861,106,0
20141226.210743,2861,6,9264,-6,2860,117,2861,105,1
20141226.210744,2860,4,9268,0,2860,115,2861,121,0
20141226.210746,2860,14,9282,-10,2860,111,2861,121,0
20141226.210747,2860,2,9284,2,2860,110,2861,120,0
20141226.210748,2860,4,9288,0,2860,106,2861,120,0
20141226.210748,2861,4,9292,2,2860,103,2861,120,1
20141226.210749,2861,16,9308,2,2860,97,2861,120,1
20141226.210749,2860,20,9328,10,2860,87,2861,120,0
20141226.21075,2860,4,9332,0,2860,85,2861,135,0
20141226.21075,2860,52,9384,-26,2860,60,2861,135,0
20141226.210751,2861,2,9386,-2,2860,60,2861,101,1
20141226.210751,2860,60,9446,-16,2860,30,2861,101,0
20141226.210752,2860,2,9448,0,2860,28,2861,97,0
20141226.210753,2861,8,9456,0,2860,22,2861,98,1
20141226.210753,2860,32,9488,-14,2860,91,2861,98,0
20141226.210754,2860,6,9494,4,2860,100,2861,96,0
20141226.210755,2860,12,9506,-4,2860,95,2861,96,0
20141226.210756,2861,42,9548,18,2860,93,2861,76,1
20141226.210757,2860,2,9550,-2,2860,94,2861,76,0
20141226.210758,2860,184,9734,-180,2859,281,2860,8,0
20141226.210758,2860,4,9738,0,2859,281,2860,28,0
20141226.210759,2860,4,9742,-2,2859,281,2860,27,0
20141226.210759,2860,8,9750,-4,2859,281,2860,24,0
20141226.2108,2859,10,9760,0,2859,276,2860,154,0
20141226.2108,2859,22,9782,-22,2859,265,2860,154,0
20141226.210801,2860,14,9796,-10,2859,263,2860,152,1
20141226.210801,2859,84,9880,4,2859,251,2860,126,0
20141226.210803,2860,280,10160,34,2860,860,2861,101,1
20141226.210804,2860,4,10164,4,2860,878,2861,98,1
20141226.210804,2860,12,10176,0,2860,872,2861,99,1
20141226.210805,2860,20,10196,20,2860,862,2861,96,1
20141226.210805,2860,204,10400,90,2860,858,2862,130,1
20141226.210806,2860,2,10402,2,2860,857,2862,203,1
20141226.210807,2861,2,10404,0,2861,44,2862,263,1
20141226.210807,2861,2,10406,2,2861,43,2862,263,1
20141226.210808,2861,6,10412,6,2861,50,2862,267,1
20141226.210809,2861,4,10416,0,2861,49,2862,303,1
20141226.21081,2861,2,10418,0,2861,98,2862,304,1
20141226.21081,2861,10,10428,0,2861,108,2862,346,1
20141226.210811,2861,4,10432,4,2861,136,2862,347,1
20141226.210812,2861,4,10436,4,2861,134,2862,356,1
20141226.210812,2861,12,10448,2,2861,128,2862,357,1
20141226.210813,2861,20,10468,0,2861,127,2862,295,1
20141226.210814,2861,2,10470,0,2861,130,2862,293,1
20141226.210814,2861,2,10472,2,2861,129,2862,296,1
20141226.210815,2861,28,10500,0,2861,115,2862,296,1
20141226.210816,2861,4,10504,2,2861,114,2862,296,1
20141226.210817,2861,2,10506,2,2861,113,2862,355,1
20141226.210818,2861,2,10508,0,2861,127,2862,355,1
20141226.210818,2861,28,10536,-2,2861,113,2862,355,1
20141226.210819,2861,226,10762,62,2860,925,2861,87,1
20141226.21082,2861,164,10926,0,2860,1013,2861,7,1
20141226.210821,2861,16,10942,-2,2860,1013,2861,10,1
20141226.210822,2861,20,10962,-18,2860,1013,2862,356,1
20141226.210823,2862,4,10966,0,2861,15,2862,372,1
20141226.210823,2861,4,10970,0,2861,24,2862,373,0
20141226.210825,2861,58,11028,0,2860,1009,2861,31,0
20141226.210826,2861,2,11030,-2,2860,1009,2861,30,0
20141226.210828,2861,102,11132,0,2860,1009,2862,384,0
20141226.210829,2861,8,11140,0,2860,1009,2861,16,0
20141226.210829,2861,32,11172,0,2860,1009,2861,7,0
20141226.210829,2861,14,11186,0,2861,33,2862,384,0
20141226.21083,2861,2,11188,0,2861,37,2862,397,0
20141226.210831,2861,2,11190,0,2861,52,2862,398,0
20141226.210832,2861,2,11192,2,2861,66,2862,399,0
20141226.210833,2861,2,11194,2,2861,65,2862,399,0
20141226.210835,2861,154,11348,130,2860,1022,2861,322,0
20141226.210838,2861,6,11354,4,2860,1022,2861,384,0
20141226.210838,2861,272,11626,72,2860,1022,2861,248,0
20141226.210839,2861,2,11628,2,2860,1027,2861,248,0
20141226.210842,2861,2,11630,2,2860,1025,2861,255,0
20141226.210844,2861,20,11650,0,2860,1025,2861,245,0
20141226.210845,2860,2,11652,0,2860,1025,2861,246,0
20141226.210846,2860,4,11656,0,2860,1023,2861,246,0
20141226.210847,2861,16,11672,0,2860,1032,2861,248,1
20141226.210848,2861,400,12072,-74,2860,1030,2861,48,1
20141226.210848,2861,2,12074,0,2860,1048,2861,47,1
20141226.21085,2861,12,12086,-2,2860,1044,2861,41,1
20141226.210851,2861,20,12106,2,2860,958,2861,32,1
20141226.210853,2861,26,12132,12,2860,958,2861,29,1
20141226.210854,2861,30,12162,26,2860,958,2861,47,1
20141226.210855,2861,2,12164,2,2860,948,2861,46,1
20141226.210856,2861,6,12170,6,2860,950,2861,43,1
20141226.210858,2861,6,12176,0,2860,953,2861,40,1
20141226.210858,2861,6,12182,0,2860,953,2861,37,1
20141226.210859,2861,2,12184,2,2860,953,2861,33,1
20141226.210859,2860,4,12188,0,2860,942,2861,32,0
20141226.210902,2860,2,12190,2,2860,929,2861,169,0
20141226.210905,2860,4,12194,4,2860,926,2861,170,0
20141226.210905,2861,16,12210,-14,2860,926,2861,162,1
20141226.210907,2861,2,12212,0,2860,917,2861,162,1
20141226.210909,2860,8,12220,-4,2860,917,2861,160,0
20141226.21091,2861,12,12232,0,2860,916,2861,154,1
20141226.210911,2860,2,12234,2,2860,915,2861,156,0
20141226.210913,2861,2,12236,0,2860,915,2861,161,1
20141226.210914,2860,4,12240,0,2860,913,2861,363,0
20141226.210914,2860,2,12242,2,2860,915,2861,363,0
20141226.210915,2860,4,12246,4,2860,913,2861,363,0
20141226.210915,2861,2,12248,0,2860,913,2861,363,1
20141226.210916,2860,342,12590,6,2860,742,2861,453,0
20141226.210917,2860,20,12610,0,2860,724,2861,468,0
20141226.21092,2860,4,12614,4,2860,722,2861,468,0
20141226.210921,2860,2,12616,2,2860,722,2861,472,0
20141226.210923,2860,6,12622,6,2860,748,2861,568,0
20141226.210926,2860,10,12632,10,2860,743,2861,600,0
20141226.210928,2861,10,12642,-10,2860,745,2861,595,1
20141226.210928,2861,4,12646,0,2860,745,2861,595,1
20141226.210929,2860,4,12650,4,2860,743,2861,596,0
20141226.21093,2860,32,12682,4,2860,707,2861,599,0
20141226.21093,2860,2,12684,2,2860,707,2861,598,0
20141226.210932,2860,2,12686,2,2860,701,2861,598,0
20141226.210938,2860,4,12690,4,2860,702,2861,901,0
20141226.210939,2860,2,12692,0,2860,716,2861,906,0
20141226.210939,2861,40,12732,30,2860,716,2861,886,1
20141226.21094,2861,2,12734,2,2860,716,2861,885,1
20141226.21094,2860,2,12736,0,2860,715,2861,885,0
20141226.210943,2860,10,12746,0,2860,713,2861,886,0
20141226.210945,2860,2,12748,2,2860,712,2861,892,0
20141226.210945,2860,2,12750,2,2860,711,2861,892,0
20141226.210946,2860,6,12756,2,2860,708,2861,892,0
20141226.210948,2860,2,12758,2,2860,708,2861,892,0
20141226.210949,2861,48,12806,40,2860,708,2861,868,1
20141226.21095,2860,24,12830,0,2860,697,2861,868,0
20141226.210951,2860,1018,13848,310,2860,188,2861,868,0
20141226.210951,2860,376,14224,258,2859,1209,2860,64,0
20141226.210952,2859,2,14226,-2,2859,1208,2860,106,0
20141226.210953,2860,6,14232,0,2859,1211,2860,108,1
20141226.210954,2859,2,14234,0,2859,1210,2860,109,0
20141226.210954,2860,20,14254,2,2859,1219,2860,101,1
20141226.210955,2860,2,14256,2,2859,1219,2860,136,1
20141226.210956,2860,4,14260,-2,2859,1233,2860,157,1
20141226.210957,2860,34,14294,-22,2859,1198,2860,153,1
20141226.210958,2859,6,14300,-6,2859,1195,2860,158,0
20141226.210958,2859,2,14302,-2,2859,1194,2860,163,0
20141226.210959,2859,2,14304,-2,2859,1196,2860,163,0
20141226.211,2860,2,14306,0,2859,1197,2860,183,1
20141226.211001,2859,4,14310,-2,2859,1195,2860,183,0
20141226.211001,2859,2,14312,0,2859,1195,2860,185,0
20141226.211002,2859,2,14314,-2,2859,1192,2860,190,0
20141226.211004,2859,2,14316,0,2859,1191,2860,190,0
20141226.211004,2859,2,14318,0,2859,1190,2860,192,0
20141226.211005,2859,42,14360,-18,2859,1170,2860,193,0
20141226.211005,2859,6,14366,0,2859,1167,2860,193,0
20141226.211006,2860,2,14368,0,2859,1167,2860,198,1
20141226.211007,2860,420,14788,-94,2859,1168,2861,902,1
20141226.211009,2860,8,14796,0,2860,62,2861,899,1
20141226.211009,2860,2,14798,-2,2860,61,2861,899,1
20141226.21101,2860,6,14804,0,2860,58,2861,899,1
20141226.211011,2860,10,14814,-10,2860,53,2861,899,1
20141226.211011,2860,4,14818,-4,2860,51,2861,900,1
20141226.211012,2860,18,14836,-12,2860,42,2861,900,1
20141226.211012,2860,24,14860,-4,2860,32,2861,904,1
20141226.211013,2860,12,14872,0,2860,26,2861,904,1
20141226.211013,2860,54,14926,-12,2859,1168,2860,41,1
20141226.211014,2860,20,14946,0,2859,1168,2860,31,1
20141226.211014,2860,62,15008,-18,2860,1,2861,905,1
20141226.211015,2860,22,15030,-2,2859,1169,2861,905,1
20141226.211016,2860,56,15086,0,2859,1167,2860,35,1
20141226.211016,2860,70,15156,-20,2859,1167,2861,907,1
20141226.211017,2860,2,15158,2,2859,1167,2861,907,1
20141226.211018,2860,4,15162,4,2860,10,2861,907,1
20141226.211018,2860,10,15172,0,2860,6,2861,907,1
20141226.211019,2860,12,15184,12,2859,1167,2861,909,1
20141226.21102,2860,22,15206,-20,2859,1167,2861,909,1
20141226.211021,2861,4,15210,0,2859,1168,2861,906,1
20141226.211021,2860,8,15218,6,2860,7,2861,906,0
20141226.211023,2860,2,15220,2,2860,99,2861,907,0
20141226.211023,2860,2,15222,2,2860,98,2861,907,0
20141226.211023,2860,4,15226,4,2860,96,2861,907,0
20141226.211024,2861,2,15228,2,2860,97,2861,906,1
20141226.211025,2860,420,15648,-184,2859,1229,2861,907,0
20141226.211028,2860,60,15708,22,2859,1215,2860,25,0
20141226.211029,2860,12,15720,-12,2859,1217,2860,19,0
20141226.211029,2860,4,15724,-2,2859,1217,2860,29,0
20141226.21103,2859,6,15730,-6,2859,1214,2860,42,0
20141226.211031,2860,4,15734,-2,2859,1215,2860,40,1
20141226.211031,2860,2,15736,-2,2859,1207,2860,62,1
20141226.211033,2860,8,15744,0,2859,1207,2860,87,1
20141226.211034,2860,24,15768,2,2859,1207,2860,79,1
20141226.211035,2860,2,15770,2,2859,1207,2860,80,1
20141226.211036,2860,4,15774,4,2859,1208,2860,78,1
20141226.211036,2860,2,15776,2,2859,1208,2860,77,1
20141226.211037,2860,4,15780,4,2859,1208,2860,75,1
20141226.211037,2860,2,15782,2,2859,1208,2860,99,1
20141226.211038,2860,22,15804,2,2859,1208,2860,113,1
20141226.211039,2860,10,15814,10,2859,1208,2860,108,1
20141226.21104,2860,6,15820,0,2859,1206,2860,107,1
20141226.21104,2860,20,15840,20,2859,1206,2860,97,1
20141226.211041,2859,4,15844,0,2859,1204,2860,169,0
20141226.211042,2860,4,15848,2,2859,1206,2860,170,1
20141226.211043,2859,2,15850,0,2859,1205,2860,169,0
20141226.211044,2860,20,15870,0,2859,1205,2860,184,1
20141226.211045,2859,240,16110,-156,2859,1109,2860,165,0
20141226.211046,2860,2,16112,2,2859,1109,2860,164,1
20141226.211051,2860,2,16114,2,2859,1106,2860,257,1
20141226.211052,2860,2,16116,2,2859,1106,2860,257,1
20141226.211054,2859,2,16118,-2,2859,1105,2860,258,0
20141226.211054,2860,418,16536,-94,2859,1105,2860,49,1
20141226.211056,2860,4,16540,4,2859,1128,2860,48,1
20141226.211059,2860,2,16542,2,2859,1128,2860,97,1
20141226.211059,2859,6,16548,-2,2859,1126,2860,146,0
20141226.211101,2860,8,16556,2,2859,1124,2860,145,1
20141226.211103,2860,10,16566,10,2859,1144,2860,140,1
20141226.211103,2859,2,16568,0,2859,1143,2860,146,0
20141226.211104,2860,200,16768,194,2859,1123,2860,46,1
20141226.211105,2860,16,16784,2,2860,319,2861,1038,1
20141226.211107,2860,2,16786,-2,2860,329,2861,1038,1
20141226.211107,2861,2,16788,2,2860,339,2861,1037,1
20141226.211108,2860,4,16792,0,2860,343,2861,1037,0
20141226.21111,2860,4,16796,0,2860,342,2861,1047,0
20141226.211111,2860,2,16798,0,2860,363,2861,1027,0
20141226.211114,2860,10,16808,0,2860,371,2861,1030,0
20141226.211114,2860,2,16810,0,2860,370,2861,1032,0
20141226.211114,2860,4,16814,0,2860,368,2861,1032,0
20141226.211117,2861,2,16816,0,2860,373,2861,1036,1
20141226.211118,2860,2,16818,0,2860,374,2861,1036,0
20141226.211119,2860,10,16828,-10,2860,369,2861,1036,0
20141226.211121,2860,2,16830,0,2860,374,2861,1036,0
20141226.211123,2860,2,16832,-2,2860,374,2861,1036,0
20141226.211125,2861,20,16852,0,2860,418,2861,1026,1
20141226.211127,2860,40,16892,-40,2860,398,2861,1026,0
20141226.211134,2861,2010,18902,-420,2860,420,2862,226,1
20141226.211135,2861,4,18906,0,2860,442,2861,8,1
20141226.211136,2861,16,18922,16,2860,442,2862,198,1
20141226.211137,2861,4,18926,0,2861,102,2862,206,1
20141226.211137,2861,10,18936,10,2861,97,2862,205,1
20141226.211138,2861,100,19036,100,2861,66,2862,174,1
20141226.211138,2861,32,19068,-4,2861,65,2862,159,1
20141226.211141,2861,6,19074,6,2861,62,2862,191,1
20141226.211143,2862,4,19078,2,2861,87,2862,209,1
20141226.211144,2861,2,19080,2,2861,87,2862,209,0
20141226.211147,2862,2,19082,2,2861,105,2862,247,1
20141226.211147,2861,4,19086,4,2861,103,2862,227,0
20141226.211149,2861,2,19088,0,2861,104,2862,237,0
20141226.21115,2861,2,19090,2,2861,105,2862,237,0
20141226.211151,2861,2,19092,2,2861,104,2862,237,0
20141226.211152,2861,6,19098,6,2861,103,2862,248,0
20141226.211153,2862,2,19100,-2,2861,103,2862,267,1
20141226.211156,2861,10,19110,0,2861,96,2862,272,0
20141226.211157,2861,6,19116,6,2861,94,2862,274,0
20141226.211158,2861,2,19118,2,2861,95,2862,275,0
20141226.211159,2861,2,19120,2,2861,95,2862,275,0
20141226.2112,2862,2,19122,0,2861,95,2862,275,1
20141226.211201,2862,4,19126,0,2861,105,2862,278,1
20141226.211201,2861,12,19138,0,2861,101,2862,277,0
20141226.211203,2861,4,19142,4,2861,100,2862,285,0
20141226.211203,2861,2,19144,2,2861,100,2862,285,0
20141226.211206,2862,554,19698,-202,2862,224,2863,212,1
20141226.211206,2862,20,19718,-20,2862,214,2863,212,1
20141226.211207,2862,10,19728,0,2862,209,2863,212,1
20141226.211208,2862,24,19752,-24,2862,207,2863,212,1
20141226.211209,2862,2,19754,-2,2862,216,2863,213,1
20141226.21121,2862,16,19770,-14,2862,208,2863,258,1
20141226.211212,2863,2,19772,2,2862,208,2863,208,1
20141226.211213,2862,2,19774,-2,2862,207,2863,208,0
20141226.211216,2863,2,19776,2,2862,228,2863,229,1
20141226.211216,2862,476,20252,22,2861,114,2862,72,0
20141226.211219,2862,2,20254,2,2861,104,2862,132,0
20141226.21122,2862,2,20256,0,2861,104,2862,132,0
20141226.211221,2862,12,20268,0,2861,104,2862,126,0
20141226.211222,2862,14,20282,14,2861,105,2862,120,0
20141226.211223,2862,2,20284,2,2861,106,2862,119,0
20141226.211227,2862,18,20302,18,2861,117,2862,122,0
20141226.211227,2862,2,20304,2,2861,117,2862,122,0
20141226.211228,2862,10,20314,10,2861,117,2862,117,0
20141226.21123,2862,254,20568,-146,2862,373,2863,182,0
20141226.21123,2863,2,20570,0,2862,373,2863,181,1
20141226.211231,2863,4,20574,-2,2862,372,2863,181,1
20141226.211232,2863,10,20584,-2,2862,372,2863,177,1
20141226.211233,2862,750,21334,-100,2861,116,2863,174,0
20141226.211234,2861,4,21338,0,2861,114,2863,174,0
20141226.211234,2863,20,21358,-16,2861,116,2863,164,1
20141226.211235,2862,12,21370,-12,2861,122,2863,165,0
20141226.211238,2863,2,21372,-2,2862,17,2863,177,1
20141226.211239,2863,14,21386,-2,2862,17,2863,171,1
20141226.211239,2862,2,21388,0,2862,16,2863,171,0
20141226.21124,2862,6,21394,0,2861,125,2863,171,0
20141226.21124,2862,2,21396,0,2861,125,2863,171,0
20141226.211241,2862,2,21398,0,2861,125,2863,171,0
20141226.211241,2863,2,21400,0,2862,10,2863,170,1
20141226.211242,2863,6,21406,-4,2862,10,2863,222,1
20141226.211243,2862,6,21412,6,2862,30,2863,230,0
20141226.211244,2861,100,21512,60,2861,108,2863,230,0
20141226.211244,2863,2,21514,2,2861,108,2863,230,1
20141226.211248,2862,66,21580,-44,2862,228,2863,244,0
20141226.211251,2862,4,21584,-4,2862,254,2863,243,0
20141226.211253,2862,4,21588,0,2862,253,2863,246,0
20141226.211254,2863,400,21988,266,2862,253,2864,171,1
20141226.211255,2863,22,22010,2,2862,261,2864,171,1
20141226.211257,2863,30,22040,-30,2862,271,2864,211,1
20141226.211259,2863,12,22052,-12,2862,279,2864,211,1
20141226.2113,2863,10,22062,-10,2862,290,2864,212,1
20141226.211301,2863,2,22064,0,2862,289,2864,225,1
20141226.211305,2863,20,22084,0,2862,295,2864,263,1
20141226.211306,2863,2,22086,0,2863,10,2864,268,1
20141226.211306,2863,24,22110,-4,2862,294,2864,268,1
20141226.211307,2863,6,22116,0,2862,296,2863,1,1
20141226.211307,2863,4,22120,-2,2863,19,2864,268,1
20141226.211308,2863,2,22122,-2,2863,18,2864,278,1
20141226.211308,2863,4,22126,-4,2863,46,2864,307,1
20141226.211309,2863,4,22130,-4,2863,44,2864,308,1
20141226.211309,2863,2,22132,-2,2863,52,2864,310,1
20141226.211311,2863,2,22134,-2,2863,51,2864,312,1
20141226.211311,2863,4,22138,0,2863,49,2864,313,1
20141226.211312,2864,2,22140,0,2863,150,2864,333,1
20141226.211313,2864,4,22144,-2,2863,158,2864,331,1
20141226.211313,2864,244,22388,-14,2863,63,2864,366,1
20141226.211313,2863,2,22390,2,2863,62,2864,366,0
20141226.211315,2863,2,22392,2,2863,61,2864,369,0
20141226.211315,2864,2,22394,-2,2863,63,2864,623,1
20141226.211316,2863,126,22520,84,2862,292,2864,286,0
20141226.211316,2863,6,22526,0,2863,5,2864,639,0
20141226.211316,2863,10,22536,0,2862,292,2863,5,0
20141226.211319,2863,6,22542,0,2862,296,2863,368,0
20141226.211319,2863,12,22554,4,2862,296,2863,362,0
20141226.21132,2863,2,22556,-2,2862,296,2863,361,0
20141226.21132,2863,2,22558,0,2862,296,2863,360,0
20141226.211321,2863,2,22560,0,2862,296,2863,549,0
20141226.211322,2862,592,23152,-470,2861,174,2863,276,0
20141226.211322,2862,2,23154,0,2861,174,2863,277,0
20141226.211323,2862,2,23156,0,2861,174,2863,278,0
20141226.211324,2862,316,23472,-248,2862,92,2863,417,0
20141226.211324,2862,2,23474,-2,2862,96,2863,416,0
20141226.211325,2862,106,23580,-106,2862,56,2863,364,0
20141226.211325,2862,42,23622,-40,2862,36,2863,364,0
20141226.211326,2862,72,23694,10,2861,174,2862,13,0
20141226.211327,2862,32,23726,-16,2862,268,2863,391,0
20141226.211327,2862,2,23728,0,2862,267,2863,391,0
20141226.211331,2863,500,24228,-44,2862,269,2863,161,1
20141226.211332,2863,328,24556,-110,2863,97,2864,464,1
20141226.211332,2863,212,24768,2,2862,271,2863,10,1
20141226.211333,2863,10,24778,0,2862,271,2863,5,1
20141226.211333,2864,26,24804,-26,2863,9,2864,456,1
20141226.211334,2863,10,24814,8,2863,4,2864,450,0
20141226.211334,2863,2,24816,2,2863,42,2864,450,0
20141226.211335,2863,90,24906,12,2862,299,2863,163,0
20141226.211335,2863,2,24908,2,2862,339,2863,162,0
20141226.211336,2863,20,24928,0,2862,339,2863,152,0
20141226.211337,2863,2,24930,2,2862,342,2863,151,0
20141226.211337,2863,318,25248,-26,2862,342,2864,491,0
20141226.211338,2863,4,25252,0,2862,342,2864,490,0
20141226.21134,2863,6,25258,2,2863,6,2864,499,0
20141226.211341,2863,4,25262,0,2863,24,2864,500,0
20141226.211341,2864,10,25272,0,2863,24,2864,495,1
20141226.211342,2863,4,25276,4,2863,27,2864,485,0
20141226.211343,2863,2,25278,2,2863,32,2864,485,0
20141226.211344,2863,12,25290,12,2863,57,2864,485,0
20141226.211345,2863,2,25292,0,2863,56,2864,485,0
20141226.211345,2863,74,25366,-12,2863,23,2864,486,0
20141226.211346,2863,46,25412,-36,2862,352,2864,282,0
20141226.211348,2863,2,25414,2,2862,352,2863,45,0
20141226.21135,2863,4,25418,0,2862,352,2863,108,0
20141226.211351,2863,4,25422,0,2862,362,2863,209,0
20141226.211353,2863,418,25840,-342,2863,51,2864,495,0
20141226.211354,2863,2,25842,0,2863,50,2864,495,0
20141226.211355,2863,58,25900,-2,2863,22,2864,479,0
20141226.211356,2863,2,25902,-2,2863,21,2864,479,0
20141226.211357,2863,2,25904,-2,2863,20,2864,479,0
20141226.211358,2863,6,25910,0,2863,19,2864,477,0
20141226.2114,2863,4,25914,0,2863,28,2864,477,0
20141226.211403,2863,2,25916,0,2863,35,2864,529,0
20141226.211404,2863,42,25958,34,2863,14,2864,508,0
20141226.211404,2863,2,25960,2,2863,13,2864,508,0
20141226.211405,2863,2,25962,2,2863,12,2864,508,0
20141226.211405,2863,24,25986,6,2862,408,2863,53,0
20141226.211406,2862,2,25988,0,2862,407,2863,54,0
20141226.211407,2863,10,25998,4,2862,404,2863,74,1
20141226.211408,2862,34,26032,-34,2862,387,2863,59,0
20141226.211409,2863,118,26150,-28,2863,192,2864,507,1
20141226.21141,2863,2,26152,0,2863,192,2864,507,1
20141226.211411,2863,4,26156,0,2863,294,2864,472,1
20141226.211413,2864,500,26656,-160,2863,305,2864,224,1
20141226.211413,2863,548,27204,-394,2863,285,2865,540,0
20141226.211414,2864,40,27244,-6,2864,34,2865,539,1
20141226.211415,2864,8,27252,2,2863,274,2865,539,1
20141226.211416,2863,4,27256,-4,2863,280,2864,30,0
20141226.211418,2864,2,27258,2,2863,282,2864,65,1
20141226.211419,2864,8,27266,2,2863,292,2864,71,1
20141226.21142,2864,2,27268,2,2863,292,2864,81,1
20141226.21142,2864,22,27290,-2,2863,303,2864,70,1
20141226.211421,2864,140,27430,30,2863,303,2865,206,1
20141226.211421,2864,2,27432,0,2863,303,2865,206,1
20141226.211422,2864,46,27478,-22,2863,312,2864,89,1
20141226.211423,2864,8,27486,6,2863,312,2864,95,1
20141226.211424,2864,22,27508,22,2863,314,2864,88,1
20141226.211424,2864,132,27640,132,2863,314,2864,27,1
20141226.211425,2863,8,27648,-8,2863,310,2864,27,0
20141226.211425,2864,4,27652,4,2863,311,2864,26,1
20141226.211426,2864,4,27656,4,2863,313,2864,24,1
20141226.211429,2864,4,27660,4,2863,315,2864,21,1
20141226.211429,2864,8,27668,2,2863,316,2864,17,1
20141226.21143,2864,2,27670,2,2863,232,2864,16,1
20141226.21143,2864,6,27676,2,2863,232,2864,48,1
20141226.211431,2864,24,27700,4,2863,233,2864,38,1
20141226.211431,2863,4,27704,0,2863,234,2864,40,0
20141226.211432,2864,2,27706,2,2863,234,2864,39,1
20141226.211432,2864,2,27708,2,2863,234,2864,38,1
20141226.211433,2864,6,27714,0,2863,234,2864,50,1
20141226.211433,2863,4,27718,0,2863,233,2864,49,0
20141226.211435,2863,24,27742,4,2863,223,2864,38,0
20141226.211435,2864,2,27744,2,2863,223,2864,37,1
20141226.211437,2864,2,27746,2,2863,228,2864,90,1
20141226.211438,2863,2,27748,-2,2863,227,2864,123,0
20141226.211438,2864,4,27752,0,2863,229,2864,121,1
20141226.211441,2863,10,27762,0,2863,222,2864,118,0
20141226.211441,2864,12,27774,12,2863,222,2864,113,1
20141226.211442,2864,2,27776,2,2863,222,2864,113,1
20141226.211442,2864,4,27780,0,2863,222,2864,116,1
20141226.211444,2863,2,27782,0,2863,227,2864,116,0
20141226.211447,2864,6,27788,-4,2863,225,2864,146,1
20141226.211448,2863,60,27848,-60,2863,197,2864,147,0
20141226.211448,2864,2,27850,0,2863,197,2864,146,1
20141226.211449,2864,8,27858,8,2863,197,2864,142,1
20141226.211449,2864,2,27860,2,2863,217,2864,141,1
20141226.211451,2864,2,27862,2,2863,217,2864,145,1
20141226.211451,2864,2,27864,2,2863,218,2864,154,1
20141226.211456,2863,2,27866,-2,2863,220,2864,159,0
20141226.211457,2863,8,27874,-6,2863,215,2864,164,0
20141226.211458,2863,2,27876,0,2863,234,2864,194,0
20141226.211458,2863,2,27878,-2,2863,233,2864,196,0
20141226.211459,2864,8,27886,8,2863,234,2864,192,1
20141226.211503,2864,20,27906,12,2863,232,2864,184,1
20141226.211505,2864,6,27912,-2,2863,236,2864,553,1
20141226.211507,2863,4,27916,-4,2863,236,2864,554,0
20141226.211508,2864,16,27932,0,2863,236,2864,546,1
20141226.211508,2864,50,27982,-30,2863,236,2864,531,1
20141226.21151,2864,502,28484,-408,2863,246,2865,234,1
20141226.211511,2864,414,28898,-408,2864,53,2865,569,1
20141226.211511,2864,2,28900,-2,2864,82,2865,568,1
20141226.211512,2864,4,28904,0,2864,80,2865,567,1
20141226.211512,2864,2,28906,-2,2864,84,2865,572,1
20141226.211513,2864,2,28908,0,2864,95,2865,571,1
20141226.211514,2864,6,28914,-2,2864,92,2865,571,1
20141226.211514,2865,2,28916,2,2864,96,2865,570,1
20141226.211515,2864,4,28920,-2,2864,94,2865,560,0
20141226.211515,2864,2,28922,0,2864,93,2865,560,0
20141226.211516,2864,8,28930,-2,2864,90,2865,559,0
20141226.211517,2864,6,28936,-2,2864,87,2865,561,0
20141226.211517,2864,2,28938,0,2864,86,2865,561,0
20141226.211518,2864,4,28942,-4,2864,84,2865,561,0
20141226.211518,2864,2,28944,-2,2864,83,2865,562,0
20141226.211519,2864,4,28948,-2,2864,81,2865,562,0
20141226.21152,2864,18,28966,0,2864,76,2865,560,0
20141226.211521,2864,2,28968,0,2864,75,2865,560,0
20141226.211522,2865,160,29128,-102,2863,249,2865,656,1
20141226.211523,2864,2,29130,-2,2863,246,2865,657,0
20141226.211524,2864,6,29136,-6,2863,247,2865,661,0
20141226.211525,2864,20,29156,18,2863,249,2864,1,0
20141226.211526,2864,4,29160,0,2863,249,2865,662,0
20141226.211528,2865,26,29186,0,2863,249,2865,324,1
20141226.21153,2864,4,29190,0,2863,249,2865,328,0
20141226.211531,2864,2,29192,-2,2863,248,2865,328,0
20141226.211532,2864,2,29194,0,2863,248,2865,329,0
20141226.211532,2864,4,29198,0,2864,4,2865,650,0
20141226.211533,2864,28,29226,-20,2863,249,2865,658,0
20141226.211534,2864,2,29228,0,2863,249,2865,665,0
20141226.211534,2865,2,29230,2,2863,249,2865,680,1
20141226.211535,2864,6,29236,0,2863,249,2865,680,0
20141226.211538,2863,98,29334,20,2863,217,2865,683,0
20141226.211539,2864,2,29336,0,2863,217,2864,1,1
20141226.21154,2864,40,29376,-40,2864,11,2865,684,1
20141226.21154,2864,22,29398,-20,2863,217,2864,11,1
20141226.211541,2864,2,29400,0,2863,221,2864,11,1
20141226.211542,2864,2,29402,2,2863,241,2864,15,1
20141226.211542,2864,10,29412,0,2863,241,2864,10,1
20141226.211544,2864,2,29414,2,2863,251,2864,19,1
20141226.211545,2864,4,29418,4,2863,250,2864,24,1
20141226.211546,2864,12,29430,4,2863,250,2864,18,1
20141226.211547,2864,2,29432,0,2863,250,2864,17,1
20141226.211548,2863,4,29436,-2,2863,248,2864,19,0
20141226.211548,2863,16,29452,-10,2863,210,2864,19,0
20141226.211549,2863,6,29458,-4,2863,208,2864,19,0
20141226.211549,2863,2,29460,0,2863,207,2864,20,0
20141226.21155,2864,26,29486,-16,2863,207,2864,7,1
20141226.211551,2863,2,29488,0,2863,206,2864,8,0
20141226.211551,2863,2,29490,0,2863,205,2864,18,0
20141226.211553,2863,2,29492,2,2863,204,2864,19,0
20141226.211553,2864,2,29494,2,2863,226,2864,21,1
20141226.211555,2863,4,29498,0,2863,225,2864,37,0
20141226.211556,2864,4,29502,-2,2863,228,2864,36,1
20141226.211557,2864,2,29504,2,2863,228,2864,38,1
20141226.211604,2864,22,29526,-18,2863,227,2864,58,1
20141226.211607,2864,2,29528,0,2863,229,2864,61,1
20141226.211608,2864,2,29530,2,2863,231,2864,67,1
20141226.211609,2864,4,29534,-4,2863,232,2864,65,1
20141226.21161,2864,14,29548,-8,2863,228,2864,62,1
20141226.211611,2863,4,29552,-4,2863,226,2864,98,0
20141226.211614,2863,2,29554,-2,2863,225,2864,98,0
20141226.211619,2863,2,29556,0,2863,228,2864,127,0
20141226.21162,2863,10,29566,-10,2863,223,2864,127,0
20141226.211621,2864,4,29570,-4,2863,232,2864,122,1
20141226.211621,2864,4,29574,0,2863,232,2864,146,1
20141226.211635,2863,2,29576,0,2863,240,2864,157,0
20141226.211639,2863,2,29578,-2,2863,229,2864,185,0
20141226.211642,2863,2,29580,0,2863,228,2864,191,0
20141226.211645,2863,2,29582,0,2863,226,2864,203,0
20141226.211648,2863,2,29584,0,2863,225,2864,203,0
20141226.211654,2863,2,29586,-2,2863,272,2864,312,0
20141226.211658,2864,630,30216,-94,2864,186,2865,799,1
20141226.211658,2864,2,30218,-2,2864,195,2865,839,1
20141226.211659,2865,8,30226,0,2864,195,2865,835,1
20141226.2117,2865,8,30234,8,2864,10,2865,831,1
20141226.2117,2864,2,30236,-2,2864,9,2865,831,0
20141226.211701,2865,40,30276,30,2864,9,2865,811,1
20141226.211701,2864,10,30286,0,2864,14,2865,811,0
20141226.211702,2864,28,30314,-20,2863,284,2864,17,0
20141226.211704,2864,2,30316,2,2863,287,2864,20,0
20141226.211706,2864,48,30364,40,2864,36,2865,812,0
20141226.211706,2864,12,30376,12,2864,30,2865,812,0
20141226.211707,2864,6,30382,0,2864,27,2865,812,0
20141226.211709,2864,68,30450,48,2864,1,2865,812,0
20141226.211709,2864,2,30452,0,2863,290,2865,812,0
20141226.211709,2863,2,30454,-2,2863,289,2865,812,0
20141226.211712,2865,50,30504,24,2864,86,2865,811,1
20141226.211712,2864,2,30506,0,2864,85,2865,811,0
20141226.211714,2864,36,30542,0,2864,67,2865,811,0
20141226.211714,2864,2,30544,0,2864,66,2865,811,0
20141226.211715,2864,10,30554,10,2864,61,2865,811,0
20141226.211715,2864,122,30676,102,2863,293,2865,812,0
20141226.211716,2863,2,30678,0,2863,292,2865,815,0
20141226.211718,2864,8,30686,8,2863,297,2864,7,1
20141226.211719,2864,2,30688,0,2863,297,2864,36,1
20141226.21172,2864,4,30692,0,2863,296,2864,36,1
20141226.211722,2864,4,30696,0,2863,296,2864,40,1
20141226.211723,2864,26,30722,0,2863,328,2864,24,1
20141226.211724,2864,40,30762,40,2863,328,2864,4,1
20141226.211725,2863,2,30764,0,2863,327,2864,14,0
20141226.211725,2863,2,30766,0,2863,326,2864,14,0
20141226.211726,2864,4,30770,0,2863,336,2864,12,1
20141226.211728,2863,2,30772,-2,2863,338,2864,40,0
20141226.211732,2864,2,30774,2,2863,336,2864,46,1
20141226.211735,2863,20,30794,2,2863,329,2864,57,0
20141226.211736,2864,2,30796,-2,2863,328,2864,57,1
20141226.211736,2863,2,30798,-2,2863,327,2864,57,0
20141226.211737,2864,2,30800,0,2863,327,2864,106,1
20141226.211739,2864,4,30804,0,2863,327,2864,114,1
20141226.211741,2864,100,30904,24,2863,329,2864,72,1
20141226.211742,2863,4,30908,0,2863,334,2864,92,0
20141226.211745,2864,100,31008,90,2863,334,2864,108,1
20141226.211745,2863,2,31010,0,2863,333,2864,109,0
20141226.211747,2864,100,31110,52,2863,333,2864,59,1
20141226.211748,2863,4,31114,0,2863,340,2864,59,0
20141226.211749,2864,10,31124,10,2863,340,2864,54,1
20141226.21175,2864,100,31224,96,2863,311,2864,619,1
20141226.21175,2864,6,31230,0,2863,311,2864,616,1
20141226.211754,2864,1022,32252,-988,2864,240,2865,657,1
20141226.211756,2864,2,32254,-2,2864,249,2865,657,1
20141226.211757,2865,2,32256,2,2864,249,2865,664,1
20141226.211758,2865,100,32356,56,2864,250,2865,616,1
20141226.211758,2865,8,32364,6,2864,249,2865,613,1
20141226.211759,2864,10,32374,0,2864,246,2865,615,0
20141226.2118,2865,2,32376,2,2864,246,2865,614,1
20141226.211801,2865,2,32378,2,2864,248,2865,614,1
20141226.211803,2865,100,32478,74,2864,251,2865,565,1
20141226.211804,2865,1000,33478,-528,2864,252,2866,174,1
20141226.211806,2865,2,33480,-2,2864,262,2866,174,1
20141226.211806,2865,90,33570,0,2864,262,2866,174,1
20141226.211808,2865,112,33682,-106,2864,326,2866,296,1
20141226.211809,2866,84,33766,-46,2865,143,2866,253,1
20141226.211809,2866,10,33776,-10,2865,180,2866,248,1
20141226.211809,2866,78,33854,-58,2865,183,2866,210,1
20141226.21181,2866,84,33938,50,2865,269,2866,157,1
20141226.211811,2866,202,34140,70,2866,209,2867,295,1
20141226.211811,2867,14,34154,2,2866,216,2867,289,1
20141226.211812,2867,232,34386,-58,2866,217,2867,178,1
20141226.211812,2867,292,34678,26,2866,226,2868,144,1
20141226.211813,2866,20,34698,14,2866,252,2868,502,0
20141226.211813,2866,40,34738,40,2866,62,2868,502,0
20141226.211814,2867,24,34762,0,2867,11,2868,507,1
20141226.211814,2867,40,34802,-4,2866,63,2867,8,1
20141226.211815,2868,1034,35836,-792,2868,483,2869,974,1
20141226.211815,2868,102,35938,-24,2868,439,2869,973,1
20141226.211816,2868,116,36054,-36,2868,405,2869,970,1
20141226.211816,2868,22,36076,-16,2868,397,2869,968,1
20141226.211817,2868,8,36084,-8,2868,393,2869,970,1
20141226.211817,2869,16,36100,-14,2868,391,2869,966,1
20141226.211818,2869,2,36102,-2,2868,391,2869,1005,1
20141226.211818,2869,162,36264,-52,2868,388,2869,928,1
20141226.211819,2869,150,36414,-14,2868,397,2869,853,1
20141226.211819,2869,1232,37646,474,2868,393,2870,339,1
20141226.21182,2869,4,37650,-2,2868,393,2870,339,1
20141226.21182,2869,8,37658,-4,2868,391,2870,340,1
20141226.211821,2868,8,37666,-4,2868,395,2869,233,0
20141226.211821,2869,10,37676,-8,2868,395,2869,228,1
20141226.211822,2868,22,37698,-2,2868,394,2869,219,0
20141226.211823,2869,28,37726,-12,2868,394,2869,206,1
20141226.211823,2869,32,37758,-2,2868,394,2869,190,1
20141226.211824,2869,38,37796,-26,2868,394,2869,173,1
20141226.211824,2869,4,37800,0,2868,394,2869,395,1
20141226.211825,2869,14,37814,0,2868,394,2869,388,1
20141226.211825,2869,6,37820,-4,2868,394,2869,426,1
20141226.211826,2868,240,38060,-240,2868,274,2869,308,0
20141226.211826,2868,496,38556,-234,2868,29,2869,277,0
20141226.211827,2868,100,38656,18,2867,45,2868,25,0
20141226.211827,2868,38,38694,8,2867,53,2869,152,0
20141226.211828,2867,12,38706,10,2867,52,2869,151,0
20141226.211829,2869,30,38736,26,2868,7,2869,204,1
20141226.211829,2868,4,38740,2,2868,7,2869,223,0
20141226.21183,2868,158,38898,46,2868,105,2869,147,0
20141226.211831,2868,2,38900,2,2868,112,2869,169,0
20141226.211831,2868,10,38910,10,2868,107,2869,171,0
20141226.211832,2869,12,38922,6,2868,105,2869,168,1
20141226.211832,2868,26,38948,26,2868,100,2869,207,0
20141226.211833,2869,22,38970,22,2868,99,2869,198,1
20141226.211833,2869,6,38976,2,2868,101,2869,198,1
20141226.211834,2868,64,39040,50,2868,84,2869,175,0
20141226.211834,2869,66,39106,52,2868,84,2869,143,1
20141226.211835,2869,2,39108,0,2868,126,2869,145,1
20141226.211835,2868,4,39112,0,2868,129,2869,145,0
20141226.211836,2869,8,39120,4,2868,130,2869,465,1
20141226.211837,2869,50,39170,10,2868,118,2869,490,1
20141226.211838,2869,4,39174,2,2868,117,2869,491,1
20141226.211838,2869,30,39204,24,2868,118,2869,478,1
20141226.211839,2869,4,39208,4,2868,119,2869,512,1
20141226.211839,2868,14,39222,6,2868,122,2869,507,0
20141226.21184,2868,14,39236,2,2868,120,2869,507,0
20141226.21184,2869,10,39246,6,2868,119,2869,506,1
20141226.21184,2869,4,39250,0,2868,120,2869,504,1
20141226.211841,2868,8,39258,8,2868,125,2869,501,0
20141226.211842,2868,10,39268,4,2868,124,2869,535,0
20141226.211842,2869,30,39298,28,2868,124,2869,521,1
20141226.211843,2869,62,39360,52,2868,178,2869,499,1
20141226.211843,2868,22,39382,0,2868,167,2869,498,0
20141226.211844,2868,12,39394,12,2868,161,2869,498,0
20141226.211844,2869,10,39404,10,2868,161,2869,493,1
20141226.211845,2869,2,39406,0,2868,161,2869,492,1
20141226.211845,2868,10,39416,0,2868,156,2869,730,0
20141226.211846,2868,106,39522,-44,2868,109,2869,737,0
20141226.211846,2869,220,39742,64,2867,444,2869,662,1
20141226.211847,2868,4,39746,2,2867,444,2869,663,0
20141226.211847,2868,8,39754,0,2868,1,2869,661,0
20141226.211848,2868,22,39776,-2,2868,53,2869,714,0
20141226.211849,2868,144,39920,-72,2868,14,2869,716,0
20141226.211849,2869,28,39948,4,2868,14,2869,703,1
20141226.21185,2868,24,39972,18,2868,12,2869,693,0
20141226.211851,2868,16,39988,-16,2868,12,2869,701,0
20141226.211851,2868,30,40018,-6,2867,445,2868,168,0
20141226.211852,2867,10,40028,-8,2867,442,2868,170,0
20141226.211852,2868,2,40030,-2,2867,443,2868,170,1
20141226.211853,2867,6,40036,-6,2867,440,2868,183,0
20141226.211854,2867,40,40076,0,2867,420,2868,185,0
20141226.211855,2868,12,40088,0,2867,421,2868,216,1
20141226.211855,2867,4,40092,-2,2867,420,2868,215,0
20141226.211856,2868,96,40188,74,2867,421,2868,177,1
20141226.211856,2868,2,40190,2,2867,421,2868,181,1
20141226.211857,2867,14,40204,10,2867,421,2868,175,0
20141226.211857,2868,124,40328,22,2867,426,2869,591,1
20141226.211858,2868,4,40332,0,2867,428,2868,124,1
20141226.211858,2868,26,40358,20,2867,428,2868,115,1
20141226.211859,2868,2,40360,2,2867,428,2868,114,1
20141226.211859,2868,228,40588,-224,2867,428,2869,673,1
20141226.2119,2868,18,40606,0,2868,74,2869,687,1
20141226.211901,2869,2,40608,2,2868,378,2869,692,1
20141226.211902,2868,12,40620,2,2868,378,2869,609,0
20141226.211902,2868,8,40628,-8,2868,375,2869,610,0
20141226.211902,2868,66,40694,-22,2868,350,2869,608,0
20141226.211903,2868,2,40696,0,2868,353,2869,608,0
20141226.211904,2868,40,40736,26,2868,345,2869,610,0
20141226.211904,2869,2,40738,2,2868,349,2869,609,1
20141226.211906,2869,104,40842,104,2868,355,2869,560,1
20141226.211906,2869,114,40956,114,2868,350,2869,510,1
20141226.211907,2868,24,40980,20,2868,347,2869,521,0
20141226.211908,2868,26,41006,2,2868,351,2869,515,0
20141226.211909,2868,2,41008,0,2868,353,2869,514,0
20141226.211909,2869,2,41010,0,2868,353,2869,513,1
20141226.21191,2869,16,41026,8,2868,350,2869,709,1
20141226.21191,2869,8,41034,6,2868,348,2869,703,1
20141226.211911,2869,6,41040,6,2868,350,2869,705,1
20141226.211912,2869,8,41048,8,2868,347,2869,712,1
20141226.211912,2869,12,41060,12,2868,339,2869,709,1
20141226.211913,2868,82,41142,80,2868,299,2869,714,0
20141226.211914,2869,4,41146,0,2868,299,2869,713,1
20141226.211915,2869,2,41148,2,2868,313,2869,714,1
20141226.211915,2868,4,41152,2,2868,319,2869,713,0
20141226.211916,2869,6,41158,4,2868,440,2869,713,1
20141226.211917,2869,10,41168,10,2868,441,2869,710,1
20141226.211918,2868,10,41178,10,2868,447,2869,712,0
20141226.211918,2868,4,41182,4,2868,446,2869,712,0
20141226.21192,2869,18,41200,6,2868,445,2869,708,1
20141226.21192,2868,2,41202,0,2868,445,2869,708,0
20141226.211921,2869,2,41204,0,2868,445,2869,708,1
20141226.211921,2868,100,41304,0,2868,397,2869,719,0
20141226.211922,2868,8,41312,8,2868,394,2869,719,0
20141226.211922,2869,2,41314,0,2868,394,2869,718,1
20141226.211923,2869,8,41322,-4,2868,394,2869,714,1
20141226.211923,2869,2,41324,0,2868,394,2869,714,1
20141226.211924,2868,2,41326,2,2868,393,2869,766,0
20141226.211924,2868,24,41350,2,2868,391,2869,775,0
20141226.211925,2868,2,41352,2,2868,390,2869,775,0
20141226.211926,2869,10,41362,-8,2868,391,2869,770,1
20141226.211926,2868,14,41376,-8,2868,388,2869,763,0
20141226.211927,2868,4,41380,0,2868,394,2869,764,0
20141226.211928,2868,2,41382,2,2868,393,2869,800,0
20141226.211929,2868,6,41388,6,2868,390,2869,801,0
20141226.21193,2868,2,41390,2,2868,410,2869,806,0
20141226.21193,2868,2,41392,2,2868,409,2869,806,0
20141226.211931,2868,2,41394,2,2868,407,2869,809,0
20141226.211932,2868,2,41396,0,2868,416,2869,809,0
20141226.211932,2868,6,41402,6,2868,413,2869,809,0
20141226.211932,2868,4,41406,0,2868,411,2869,829,0
20141226.211933,2869,10,41416,0,2868,409,2869,827,1
20141226.211933,2868,2,41418,2,2868,408,2869,829,0
20141226.211934,2868,2,41420,2,2868,412,2869,829,0
20141226.211935,2868,2,41422,2,2868,420,2869,829,0
20141226.211935,2868,2,41424,2,2868,419,2869,829,0
20141226.211936,2869,4,41428,0,2868,419,2869,823,1
20141226.211937,2869,24,41452,12,2868,415,2869,818,1
20141226.211938,2868,14,41466,12,2868,397,2869,823,0
20141226.211939,2869,22,41488,6,2868,396,2869,812,1
20141226.21194,2868,20,41508,20,2868,417,2869,825,0
20141226.211941,2868,58,41566,16,2868,389,2869,825,0
20141226.211941,2869,8,41574,0,2868,387,2869,827,1
20141226.211942,2869,4,41578,0,2868,386,2869,830,1
20141226.211942,2869,2,41580,0,2868,385,2869,831,1
20141226.211943,2869,2,41582,0,2868,385,2869,830,1
20141226.211944,2868,20,41602,6,2868,392,2869,835,0
20141226.211945,2869,2,41604,0,2868,393,2869,842,1
20141226.211946,2868,6,41610,0,2868,392,2869,842,0
20141226.211947,2868,12,41622,2,2868,386,2869,842,0
20141226.211948,2868,6,41628,2,2868,383,2869,844,0
20141226.211948,2869,90,41718,2,2868,383,2869,799,1
20141226.211949,2868,28,41746,-12,2868,380,2869,789,0
20141226.21195,2869,22,41768,6,2868,388,2869,780,1
20141226.21195,2869,20,41788,-14,2868,388,2869,771,1
20141226.211951,2868,2,41790,0,2868,408,2869,794,0
20141226.211952,2868,8,41798,0,2868,406,2869,790,0
20141226.211952,2869,2,41800,0,2868,407,2869,791,1
20141226.211953,2868,2,41802,0,2868,406,2869,791,0
20141226.211954,2869,6,41808,6,2868,401,2869,721,1
20141226.211955,2868,8,41816,8,2868,400,2869,715,0
20141226.211955,2868,2,41818,2,2868,400,2869,714,0
20141226.211956,2868,66,41884,66,2868,368,2869,715,0
20141226.211956,2869,2,41886,2,2868,368,2869,726,1
20141226.211957,2869,20,41906,20,2868,362,2869,722,1
20141226.211957,2869,4,41910,4,2868,362,2869,721,1
20141226.211958,2869,8,41918,8,2868,373,2869,721,1
20141226.211958,2869,2,41920,2,2868,383,2869,720,1
20141226.211959,2869,6,41926,6,2868,411,2869,718,1
20141226.211959,2868,4,41930,0,2868,410,2869,718,0
20141226.212,2869,4,41934,0,2868,410,2869,716,1
20141226.212,2869,2,41936,0,2868,410,2869,715,1
20141226.212001,2869,20,41956,2,2868,410,2869,705,1
20141226.212001,2868,10,41966,4,2868,408,2869,703,0
20141226.212002,2868,202,42168,162,2868,307,2869,703,0
20141226.212002,2869,4,42172,2,2868,306,2869,736,1
20141226.212003,2868,10,42182,6,2868,301,2869,737,0
20141226.212004,2868,4,42186,4,2868,270,2869,736,0
20141226.212004,2869,216,42402,110,2868,263,2869,631,1
20141226.212005,2868,4,42406,0,2868,264,2869,630,0
20141226.212006,2869,8,42414,8,2868,269,2869,626,1
20141226.212006,2868,6,42420,4,2868,267,2869,647,0
20141226.212007,2868,28,42448,28,2868,254,2869,650,0
20141226.212008,2868,2,42450,2,2868,253,2869,650,0
20141226.212008,2868,40,42490,40,2868,233,2869,650,0
20141226.212009,2869,2,42492,2,2868,233,2869,652,1
20141226.212011,2869,2,42494,2,2868,239,2869,667,1
20141226.212011,2869,10,42504,8,2868,239,2869,662,1
20141226.212012,2868,4,42508,4,2868,237,2869,663,0
20141226.212012,2868,2,42510,0,2868,237,2869,664,0
20141226.212013,2868,12,42522,2,2868,231,2869,672,0
20141226.212013,2868,16,42538,16,2868,224,2869,677,0
20141226.212013,2868,4,42542,4,2868,222,2869,688,0
20141226.212014,2869,8,42550,0,2868,224,2869,684,1
20141226.212014,2868,22,42572,22,2868,223,2869,674,0
20141226.212015,2868,6,42578,-2,2868,320,2869,674,0
20141226.212016,2869,84,42662,-18,2868,323,2869,642,1
20141226.212016,2868,22,42684,4,2868,313,2869,653,0
20141226.212017,2869,1306,43990,-808,2869,347,2870,962,1
20141226.212018,2869,12,44002,-12,2869,369,2870,759,1
20141226.212019,2869,4,44006,-4,2869,377,2870,728,1
20141226.212019,2869,4,44010,-2,2869,376,2870,677,1
20141226.21202,2870,20,44030,-20,2869,375,2870,669,1
20141226.21202,2870,46,44076,-34,2869,375,2870,597,1
20141226.212021,2870,22,44098,-8,2869,374,2870,584,1
20141226.212021,2870,6,44104,-2,2869,372,2870,551,1
20141226.212022,2869,746,44850,76,2868,228,2869,629,0
20141226.212022,2869,8,44858,8,2868,228,2869,625,0
20141226.212023,2869,32,44890,32,2868,228,2869,636,0
20141226.212023,2869,2,44892,2,2868,228,2869,935,0
20141226.212024,2869,2,44894,0,2868,228,2869,934,0
20141226.212024,2869,412,45306,412,2868,231,2869,728,0
20141226.212025,2869,4,45310,2,2868,236,2869,726,0
20141226.212026,2869,6,45316,4,2868,236,2869,726,0
20141226.212026,2869,2,45318,0,2868,236,2869,726,0
20141226.212027,2869,2,45320,2,2868,236,2869,726,0
20141226.212027,2869,2,45322,0,2868,237,2869,749,0
20141226.212028,2869,30,45352,0,2868,242,2869,735,0
20141226.212029,2869,2,45354,2,2868,245,2869,734,0
20141226.21203,2869,4,45358,0,2868,233,2869,737,0
20141226.212031,2869,10,45368,10,2868,239,2869,733,0
20141226.212033,2868,6,45374,0,2868,241,2869,839,0
20141226.212034,2869,40,45414,40,2868,241,2869,830,1
20141226.212035,2868,8,45422,2,2868,234,2869,828,0
20141226.212036,2869,20,45442,20,2868,236,2869,818,1
20141226.212036,2869,6,45448,0,2868,237,2869,815,1
20141226.212037,2869,24,45472,24,2868,237,2869,807,1
20141226.212038,2868,2,45474,0,2868,236,2869,818,0
20141226.212038,2869,6,45480,4,2868,236,2869,817,1
20141226.21204,2869,10,45490,10,2868,236,2869,844,1
20141226.212042,2869,2,45492,0,2868,244,2869,874,1
20141226.212044,2868,2,45494,0,2868,336,2869,901,0
20141226.212046,2869,8,45502,2,2868,352,2869,899,1
20141226.21205,2868,6,45508,2,2868,352,2869,972,0
20141226.212051,2869,50,45558,22,2868,337,2869,963,1
20141226.212051,2868,20,45578,0,2868,342,2869,964,0
20141226.212052,2869,48,45626,0,2868,342,2869,944,1
20141226.212053,2868,4,45630,2,2868,341,2869,961,0
20141226.212054,2868,2,45632,0,2868,340,2869,961,0
20141226.212055,2868,2,45634,0,2868,339,2869,965,0
20141226.212055,2868,2,45636,-2,2868,344,2869,966,0
20141226.212057,2869,22,45658,10,2868,346,2869,969,1
20141226.212058,2868,2,45660,0,2868,345,2869,972,0
20141226.2121,2868,40,45700,38,2868,326,2869,977,0
20141226.212101,2868,2,45702,2,2868,325,2869,977,0
20141226.212102,2868,4,45706,4,2868,329,2869,977,0
20141226.212103,2869,42,45748,2,2868,329,2869,963,1
20141226.212104,2868,2,45750,2,2868,328,2869,973,0
20141226.212106,2868,2,45752,0,2868,338,2869,882,0
20141226.212107,2869,2,45754,2,2868,333,2869,891,1
20141226.21211,2869,2,45756,2,2868,333,2869,897,1
20141226.212111,2868,82,45838,82,2868,331,2869,855,0
20141226.212113,2868,2,45840,0,2868,332,2869,902,0
20141226.212113,2868,2,45842,2,2868,331,2869,902,0
20141226.212114,2868,2,45844,2,2868,330,2869,902,0
20141226.212114,2868,4,45848,0,2868,328,2869,903,0
20141226.212115,2868,2,45850,0,2868,327,2869,902,0
20141226.212118,2868,2,45852,0,2868,314,2869,1099,0
20141226.212119,2869,6,45858,6,2868,314,2869,1099,1
20141226.21212,2868,4,45862,2,2868,313,2869,1098,0
20141226.21212,2868,76,45938,-22,2868,275,2869,1060,0
20141226.212121,2868,12,45950,8,2868,269,2869,1061,0
20141226.212121,2868,144,46094,26,2868,197,2869,1032,0
20141226.212122,2868,6,46100,0,2868,194,2869,1031,0
20141226.212122,2868,428,46528,364,2867,463,2868,64,0
20141226.212124,2867,102,46630,102,2867,412,2868,97,0
20141226.212124,2868,14,46644,6,2867,414,2868,163,1
20141226.212125,2867,60,46704,60,2867,384,2868,163,0
20141226.212126,2867,8,46712,0,2867,382,2868,165,0
20141226.212127,2867,4,46716,0,2867,380,2868,167,0
20141226.212127,2868,36,46752,34,2867,380,2868,151,1
20141226.212128,2868,2,46754,2,2867,380,2868,150,1
20141226.212128,2867,2,46756,2,2867,379,2868,147,0
20141226.21213,2867,2,46758,0,2867,417,2868,106,0
20141226.212131,2868,12,46770,2,2867,413,2868,151,1
20141226.212131,2867,2,46772,2,2867,413,2868,179,0
20141226.212133,2867,2,46774,0,2867,402,2868,187,0
20141226.212134,2867,4,46778,0,2867,395,2868,222,0
20141226.212135,2867,2,46780,2,2867,394,2868,224,0
20141226.212135,2868,26,46806,6,2867,384,2868,221,1
20141226.212136,2867,40,46846,40,2867,364,2868,221,0
20141226.212137,2867,6,46852,0,2867,360,2868,222,0
20141226.212141,2867,2,46854,0,2867,360,2868,246,0
20141226.212141,2868,2,46856,2,2867,360,2868,245,1
20141226.212142,2867,2,46858,2,2867,359,2868,246,0
20141226.212143,2868,10,46868,0,2867,394,2868,245,1
20141226.212144,2868,20,46888,20,2867,394,2868,259,1
20141226.212144,2868,44,46932,44,2867,374,2868,256,1
20141226.212146,2867,4,46936,4,2867,375,2868,292,0
20141226.212147,2867,4,46940,2,2867,370,2868,307,0
20141226.212148,2867,10,46950,8,2867,370,2868,296,0
20141226.21215,2867,26,46976,26,2867,361,2868,296,0
20141226.212152,2867,10,46986,-4,2867,358,2868,305,0
20141226.212155,2867,16,47002,8,2867,356,2868,359,0
20141226.212157,2867,4,47006,2,2867,355,2868,410,0
20141226.212158,2867,2,47008,0,2867,354,2868,410,0
20141226.212159,2868,20,47028,-4,2867,364,2868,400,1
20141226.2122,2867,8,47036,4,2867,366,2868,388,0
20141226.212202,2868,2,47038,0,2867,367,2868,402,1
20141226.212202,2867,4,47042,4,2867,365,2868,410,0
20141226.212203,2867,24,47066,24,2867,353,2868,415,0
20141226.212204,2867,2,47068,2,2867,352,2868,415,0
20141226.212204,2867,2,47070,2,2867,351,2868,418,0
20141226.212205,2867,200,47270,200,2867,251,2868,460,0
20141226.212206,2867,8,47278,2,2867,249,2868,467,0
20141226.212206,2867,30,47308,26,2867,234,2868,468,0
20141226.212207,2867,60,47368,50,2867,204,2868,468,0
20141226.212207,2867,2,47370,2,2867,203,2868,487,0
20141226.212208,2867,4,47374,0,2867,201,2868,428,0
20141226.212209,2867,2,47376,0,2867,210,2868,428,0
20141226.21221,2867,4,47380,0,2867,208,2868,430,0
20141226.212211,2868,2,47382,0,2867,209,2868,430,1
20141226.212212,2867,8,47390,0,2867,236,2868,434,0
20141226.212213,2867,2,47392,-2,2867,235,2868,434,0
20141226.212213,2867,2,47394,0,2867,235,2868,434,0
20141226.212214,2867,4,47398,0,2867,234,2868,424,0
20141226.212215,2867,20,47418,-20,2867,224,2868,423,0
20141226.212216,2867,2,47420,0,2867,223,2868,432,0
20141226.212217,2867,4,47424,0,2867,222,2868,432,0
20141226.212218,2867,100,47524,36,2867,172,2868,383,0
20141226.212219,2867,4,47528,0,2867,170,2868,343,0
20141226.212221,2867,6,47534,2,2867,167,2868,337,0
20141226.212221,2867,4,47538,-2,2867,165,2868,335,0
20141226.212222,2867,2,47540,2,2867,166,2868,335,0
20141226.212223,2867,2,47542,0,2867,233,2868,335,0
20141226.212223,2867,396,47938,-298,2867,202,2868,426,0
20141226.212223,2867,2,47940,-2,2867,201,2868,427,0
20141226.212224,2868,2,47942,0,2867,201,2868,427,1
20141226.212225,2867,8,47950,-8,2867,197,2868,424,0
20141226.212226,2867,18,47968,-6,2867,188,2868,418,0
20141226.212228,2868,100,48068,-28,2867,188,2868,373,1
20141226.212229,2867,4,48072,4,2867,186,2868,379,0
20141226.212231,2868,8,48080,0,2867,187,2868,375,1
20141226.212232,2867,2,48082,2,2867,187,2868,376,0
20141226.212233,2867,4,48086,2,2867,186,2868,416,0
20141226.212234,2867,12,48098,8,2867,183,2868,418,0
20141226.212235,2867,6,48104,6,2867,180,2868,417,0
20141226.212236,2867,2,48106,0,2867,179,2868,417,0
20141226.212236,2867,6,48112,-6,2867,177,2868,417,0
20141226.212237,2867,2,48114,0,2867,176,2868,417,0
20141226.212237,2867,14,48128,-12,2867,169,2868,411,0
20141226.212239,2868,4,48132,0,2867,176,2868,459,1
20141226.212242,2867,2,48134,0,2867,176,2868,494,0
20141226.212243,2867,4,48138,0,2867,173,2868,495,0
20141226.212243,2867,24,48162,-20,2867,161,2868,506,0
20141226.212245,2867,18,48180,-18,2867,153,2868,532,0
20141226.212246,2867,2,48182,-2,2867,152,2868,532,0
20141226.212247,2867,2,48184,-2,2867,153,2868,533,0
20141226.212249,2868,2,48186,-2,2867,154,2868,532,1
20141226.212249,2868,4,48190,2,2867,153,2868,531,1
20141226.21225,2867,2,48192,0,2867,157,2868,530,0
20141226.21225,2867,2,48194,0,2867,162,2868,540,0
20141226.212253,2868,20,48214,-20,2867,162,2868,480,1
20141226.212253,2867,2,48216,0,2867,161,2868,480,0
20141226.212256,2867,2,48218,0,2867,162,2868,493,0
20141226.212257,2868,4,48222,0,2867,161,2868,492,1
20141226.212258,2867,28,48250,2,2867,147,2868,482,0
20141226.212258,2867,102,48352,-92,2867,96,2868,482,0
20141226.212259,2867,192,48544,-148,2866,255,2868,472,0
20141226.2123,2867,10,48554,0,2867,25,2868,474,0
20141226.212302,2867,4,48558,4,2867,36,2868,483,0
20141226.212303,2867,22,48580,16,2867,25,2868,481,0
20141226.212303,2867,32,48612,32,2867,9,2868,479,0
20141226.212303,2867,10,48622,4,2867,4,2868,479,0
20141226.212304,2867,12,48634,12,2866,255,2867,176,0
20141226.212305,2866,2,48636,0,2866,262,2867,218,0
20141226.212308,2867,42,48678,0,2866,254,2867,201,1
20141226.212309,2867,2,48680,2,2866,255,2867,200,1
20141226.212309,2867,4,48684,4,2866,256,2867,198,1
20141226.21231,2866,2,48686,-2,2866,255,2867,196,0
20141226.212315,2867,2,48688,2,2866,286,2867,134,1
20141226.212316,2866,4,48692,4,2866,305,2867,133,0
20141226.212317,2866,2,48694,2,2866,311,2867,133,0
20141226.212317,2866,4,48698,0,2866,314,2867,133,0
20141226.212318,2867,4,48702,0,2866,314,2867,132,1
20141226.212319,2866,22,48724,-2,2866,303,2867,132,0
20141226.21232,2866,2,48726,2,2866,302,2867,135,0
20141226.21232,2866,4,48730,0,2866,300,2867,135,0
20141226.212322,2866,2,48732,0,2866,330,2867,146,0
20141226.212323,2866,2,48734,2,2866,531,2867,152,0
20141226.212326,2867,2,48736,0,2866,334,2867,151,1
20141226.212327,2867,22,48758,2,2866,437,2867,195,1
20141226.212329,2866,2,48760,0,2866,436,2867,196,0
20141226.212331,2867,2,48762,2,2866,442,2867,190,1
20141226.212333,2867,2,48764,0,2866,446,2867,195,1
20141226.212333,2867,10,48774,2,2866,447,2867,190,1
20141226.212335,2866,2,48776,2,2866,346,2867,192,0
20141226.212336,2866,10,48786,10,2866,343,2867,196,0
20141226.212336,2866,2,48788,0,2866,342,2867,245,0
20141226.212337,2866,2,48790,2,2866,341,2867,246,0
20141226.212338,2866,10,48800,2,2866,337,2867,345,0
20141226.212338,2866,2,48802,2,2866,339,2867,343,0
20141226.212339,2867,2,48804,2,2866,339,2867,353,1
20141226.21234,2866,8,48812,2,2866,333,2867,399,0
20141226.212341,2866,12,48824,12,2866,327,2867,399,0
20141226.212345,2867,4,48828,0,2866,331,2867,401,1
20141226.212348,2866,2,48830,2,2866,341,2867,403,0
20141226.212354,2866,2,48832,0,2866,323,2867,429,0
20141226.212355,2867,20,48852,0,2866,324,2867,418,1
20141226.212359,2866,30,48882,30,2866,433,2867,418,0
20141226.2124,2866,4,48886,4,2866,432,2867,418,0
20141226.212401,2866,4,48890,4,2866,432,2867,418,0
20141226.212401,2866,2,48892,2,2866,431,2867,419,0
20141226.212402,2866,12,48904,4,2866,425,2867,429,0
20141226.212402,2866,4,48908,4,2866,425,2867,430,0
20141226.212403,2866,2,48910,2,2866,424,2867,429,0
20141226.212403,2866,2,48912,2,2866,423,2867,430,0
20141226.212404,2866,2,48914,2,2866,422,2867,430,0
20141226.212404,2866,2,48916,2,2866,421,2867,431,0
20141226.212405,2866,60,48976,-28,2866,391,2867,431,0
20141226.212405,2866,2,48978,0,2866,390,2867,450,0
20141226.212406,2866,4,48982,0,2866,389,2867,449,0
20141226.212407,2866,8,48990,2,2866,389,2867,449,0
20141226.212407,2866,2,48992,0,2866,388,2867,449,0
20141226.212408,2866,24,49016,0,2866,376,2867,449,0
20141226.212408,2866,2,49018,0,2866,375,2867,449,0
20141226.212409,2866,2,49020,-2,2866,374,2867,449,0
20141226.212409,2866,2,49022,0,2866,373,2867,450,0
20141226.21241,2866,6,49028,0,2866,370,2867,452,0
20141226.212412,2866,2,49030,0,2866,369,2867,451,0
20141226.212414,2866,2,49032,0,2866,369,2867,459,0
20141226.212415,2867,2,49034,2,2866,369,2867,458,1
20141226.212416,2866,2,49036,0,2866,368,2867,459,0
20141226.212417,2866,2,49038,0,2866,368,2867,460,0
20141226.212417,2866,2,49040,0,2866,367,2867,460,0
20141226.21242,2866,2,49042,0,2866,377,2867,460,0
20141226.21242,2866,8,49050,-8,2866,373,2867,460,0
20141226.212421,2867,4,49054,0,2866,373,2867,458,1
20141226.212422,2866,4,49058,-4,2866,371,2867,457,0
20141226.212422,2866,4,49062,-2,2866,330,2867,458,0
20141226.212424,2867,4,49066,0,2866,330,2867,459,1
20141226.212425,2866,8,49074,8,2866,326,2867,459,0
20141226.212427,2867,6,49080,4,2866,325,2867,465,1
20141226.212428,2866,42,49122,20,2866,324,2867,444,0
20141226.212431,2867,2,49124,2,2866,324,2867,442,1
20141226.212431,2866,6,49130,-2,2866,321,2867,442,0
20141226.212432,2867,4,49134,4,2866,321,2867,441,1
20141226.212433,2866,2,49136,-2,2866,320,2867,472,0
20141226.212435,2867,2,49138,0,2866,320,2867,475,1
20141226.212447,2867,2,49140,0,2866,324,2867,514,1
20141226.212447,2867,100,49240,-50,2866,284,2867,506,1
20141226.21245,2866,2,49242,-2,2866,289,2867,568,0
20141226.21245,2867,28,49270,0,2866,289,2867,554,1
20141226.212451,2866,6,49276,0,2866,287,2867,553,0
20141226.212456,2866,2,49278,-2,2866,296,2867,551,0
20141226.212459,2867,40,49318,-16,2866,299,2867,553,1
20141226.212501,2866,10,49328,0,2866,295,2867,551,0
20141226.212502,2867,22,49350,-14,2866,296,2867,542,1
20141226.212503,2866,4,49354,0,2866,295,2867,539,0
20141226.212505,2867,22,49376,8,2866,297,2867,528,1
20141226.212506,2866,28,49404,-20,2866,287,2867,524,0
20141226.212508,2866,2,49406,0,2866,287,2867,535,0
20141226.21251,2866,6,49412,-6,2866,284,2867,535,0
20141226.212512,2867,20,49432,0,2866,284,2867,535,1
20141226.212514,2866,4,49436,-4,2866,284,2867,534,0
20141226.21252,2866,2,49438,-2,2866,303,2867,547,0
20141226.212521,2866,2,49440,0,2866,302,2867,547,0
20141226.212521,2866,40,49480,-40,2866,283,2867,527,0
20141226.212521,2866,14,49494,-6,2866,276,2867,527,0
20141226.212523,2866,102,49596,-62,2866,231,2867,479,0
20141226.212523,2866,2,49598,0,2866,230,2867,479,0
20141226.212524,2866,2,49600,2,2866,230,2867,479,0
20141226.212526,2866,22,49622,20,2866,223,2867,477,0
20141226.212529,2866,2,49624,2,2866,222,2867,481,0
20141226.212532,2866,2,49626,2,2866,221,2867,473,0
20141226.212533,2867,20,49646,-20,2866,221,2867,462,1
20141226.212533,2866,100,49746,96,2866,171,2867,462,0
20141226.212534,2866,2,49748,2,2866,170,2867,523,0
20141226.212535,2866,20,49768,0,2866,160,2867,523,0
20141226.212535,2866,2,49770,0,2866,159,2867,524,0
20141226.212536,2866,8,49778,0,2866,157,2867,523,0
20141226.212537,2866,46,49824,44,2866,134,2867,523,0
20141226.212537,2866,2,49826,2,2866,133,2867,523,0
20141226.212538,2866,40,49866,40,2866,113,2867,523,0
20141226.212538,2866,44,49910,40,2866,91,2867,523,0
20141226.212539,2866,40,49950,20,2866,71,2867,524,0
20141226.212539,2866,42,49992,14,2866,50,2867,524,0
20141226.21254,2866,48,50040,10,2866,36,2867,524,0
20141226.21254,2866,2,50042,0,2866,35,2867,525,0
20141226.212541,2866,8,50050,-2,2866,31,2867,525,0
20141226.212541,2866,6,50056,-4,2866,28,2867,525,0
20141226.212542,2866,60,50116,22,2865,509,2866,7,0
20141226.212542,2866,36,50152,0,2865,509,2867,525,0
20141226.212543,2866,10,50162,0,2865,509,2867,526,0
20141226.212544,2865,2,50164,0,2866,11,2867,526,0
20141226.212544,2866,4,50168,-2,2866,9,2867,527,1
20141226.212545,2866,18,50186,-18,2865,517,2866,10,1
20141226.212546,2866,42,50228,2,2865,522,2867,533,1
20141226.212548,2866,20,50248,0,2865,522,2867,536,1
20141226.212552,2865,24,50272,0,2865,513,2867,536,0
20141226.212553,2866,2,50274,2,2866,10,2867,534,1
20141226.212554,2865,22,50296,-10,2865,512,2866,94,0
20141226.212554,2865,62,50358,-22,2865,482,2866,103,0
20141226.212554,2865,4,50362,-4,2865,480,2866,103,0
20141226.212555,2865,6,50368,-4,2865,504,2866,103,0
20141226.212558,2866,6,50374,-6,2865,496,2866,115,1
20141226.212559,2866,2,50376,0,2865,496,2866,114,1
20141226.2126,2865,4,50380,-4,2865,494,2866,116,0
20141226.212601,2865,6,50386,0,2865,494,2866,126,0
20141226.212601,2866,20,50406,0,2865,465,2866,126,1
20141226.212602,2865,12,50418,-12,2865,459,2866,126,0
20141226.212603,2866,2,50420,0,2865,467,2866,128,1
20141226.212603,2866,2,50422,-2,2865,468,2866,127,1
20141226.212604,2866,2,50424,-2,2865,468,2866,126,1
20141226.212607,2866,4,50428,-4,2865,469,2866,127,1
20141226.212609,2866,10,50438,-10,2865,470,2866,122,1
20141226.21261,2866,6,50444,-6,2865,481,2866,120,1
20141226.212614,2866,20,50464,0,2865,483,2866,112,1
20141226.212618,2866,2,50466,-2,2865,487,2866,112,1
20141226.212618,2866,2,50468,0,2865,487,2866,113,1
20141226.212621,2865,4,50472,-4,2865,492,2866,121,0
20141226.212621,2866,4,50476,-4,2865,492,2866,119,1
20141226.212626,2865,20,50496,0,2865,494,2866,120,0
20141226.212626,2866,4,50500,-2,2865,501,2866,120,1
20141226.212629,2865,2,50502,0,2865,500,2866,122,0
20141226.212636,2866,2,50504,-2,2865,475,2866,236,1
20141226.212636,2865,2,50506,-2,2865,475,2866,236,0
20141226.212638,2866,2,50508,0,2865,474,2866,238,1
20141226.21264,2865,10,50518,0,2865,469,2866,239,0
20141226.21264,2865,60,50578,-42,2865,439,2866,239,0
20141226.212641,2866,2,50580,0,2865,439,2866,238,1
20141226.212647,2865,2,50582,-2,2865,435,2866,249,0
20141226.21265,2865,2,50584,-2,2865,433,2866,243,0
20141226.212652,2866,2,50586,0,2865,434,2866,246,1
20141226.212652,2865,12,50598,-4,2865,427,2866,246,0
20141226.212654,2865,6,50604,4,2865,423,2866,261,0
20141226.212655,2866,522,51126,-398,2866,739,2867,386,1
20141226.212655,2866,2,51128,-2,2866,738,2867,366,1
20141226.212657,2866,2,51130,-2,2866,737,2867,367,1
20141226.212701,2867,26,51156,0,2866,742,2867,363,1
20141226.212702,2867,4,51160,0,2866,741,2867,363,1
20141226.212703,2867,2,51162,0,2866,741,2867,363,1
20141226.212705,2867,8,51170,-6,2866,741,2867,399,1
20141226.212706,2867,70,51240,26,2866,742,2867,370,1
20141226.212706,2867,2,51242,2,2866,742,2867,369,1
20141226.212708,2867,2,51244,2,2866,743,2867,369,1
20141226.21271,2866,122,51366,-34,2866,747,2867,310,0
20141226.212711,2867,6,51372,-2,2866,755,2867,299,1
20141226.212712,2867,4,51376,0,2866,755,2867,257,1
20141226.212713,2867,60,51436,44,2866,750,2867,227,1
20141226.212713,2867,298,51734,114,2866,750,2868,215,1
20141226.212714,2868,176,51910,-8,2866,749,2868,411,1
20141226.212714,2867,6,51916,-6,2866,749,2867,97,0
20141226.212715,2867,2,51918,0,2866,749,2867,202,0
20141226.212716,2867,2,51920,0,2866,759,2867,101,0
20141226.212716,2867,14,51934,-12,2866,765,2867,94,0
20141226.212717,2867,20,51954,-20,2866,765,2867,84,0
20141226.212717,2867,4,51958,0,2866,765,2867,82,0
20141226.212718,2867,8,51966,0,2866,765,2867,79,0
20141226.212719,2867,100,52066,-100,2866,784,2867,24,0
20141226.21272,2866,60,52126,-60,2866,754,2867,25,0
20141226.21272,2867,2,52128,0,2866,754,2867,24,1
20141226.21272,2867,2,52130,0,2866,756,2867,23,1
20141226.212721,2867,62,52192,-40,2867,9,2868,557,1
20141226.212723,2867,4,52196,-2,2867,40,2868,564,1
20141226.212724,2868,2,52198,0,2867,45,2868,563,1
20141226.212724,2867,4,52202,0,2867,48,2868,563,0
20141226.212727,2867,10,52212,0,2867,51,2868,372,0
20141226.212727,2867,6,52218,6,2867,48,2868,372,0
20141226.212728,2868,6,52224,4,2867,50,2868,469,1
20141226.212729,2867,6,52230,6,2867,47,2868,468,0
20141226.212729,2867,2,52232,2,2867,46,2868,493,0
20141226.21273,2867,4,52236,0,2867,45,2868,493,0
20141226.21273,2867,2,52238,2,2867,44,2868,506,0
20141226.212731,2867,4,52242,4,2867,92,2868,506,0
20141226.212731,2867,2,52244,2,2867,89,2868,507,0
20141226.212732,2867,4,52248,4,2867,87,2868,507,0
20141226.212732,2867,14,52262,12,2867,151,2868,507,0
20141226.212733,2867,22,52284,22,2867,140,2868,507,0
20141226.212733,2867,6,52290,6,2867,138,2868,507,0
20141226.212735,2868,10,52300,6,2867,139,2868,505,1
20141226.212735,2867,2,52302,2,2867,167,2868,547,0
20141226.212736,2867,2,52304,2,2867,196,2868,547,0
20141226.212737,2868,20,52324,-16,2867,196,2868,538,1
20141226.212741,2867,6,52330,4,2867,197,2868,548,0
20141226.212741,2867,8,52338,0,2867,196,2868,546,0
20141226.212742,2867,8,52346,2,2867,193,2868,545,0
20141226.212742,2867,2,52348,2,2867,192,2868,551,0
20141226.212743,2867,4,52352,4,2867,190,2868,551,0
20141226.212743,2868,42,52394,-30,2867,209,2868,538,1
20141226.212744,2867,6,52400,2,2867,207,2868,539,0
20141226.212744,2867,222,52622,118,2867,206,2868,390,0
20141226.212745,2868,2,52624,2,2867,222,2868,387,1
20141226.212746,2868,774,53398,-432,2868,263,2869,756,1
20141226.212746,2868,4,53402,0,2868,261,2869,756,1
20141226.212747,2869,6,53408,0,2868,260,2869,754,1
20141226.212747,2869,8,53416,0,2868,260,2869,750,1
20141226.212748,2869,4,53420,4,2868,260,2869,748,1
20141226.212749,2868,4,53424,0,2868,259,2869,744,0
20141226.21275,2868,2,53426,0,2868,258,2869,746,0
20141226.21275,2868,2,53428,0,2868,257,2869,746,0
20141226.212751,2869,8,53436,8,2868,258,2869,742,1
20141226.212752,2869,120,53556,-100,2868,208,2869,682,1
20141226.212752,2868,12,53568,4,2868,206,2869,678,0
20141226.212753,2869,2,53570,2,2868,206,2869,678,1
20141226.212753,2869,18,53588,16,2868,206,2869,669,1
20141226.212754,2868,2,53590,0,2868,205,2869,669,0
20141226.212755,2868,166,53756,-84,2868,124,2869,586,0
20141226.212755,2868,22,53778,-18,2868,114,2869,585,0
20141226.212756,2868,60,53838,-60,2868,85,2869,585,0
20141226.212756,2868,22,53860,0,2868,80,2869,585,0
20141226.212757,2868,2,53862,-2,2868,79,2869,587,0
20141226.212757,2868,158,54020,8,2868,2,2869,592,0
20141226.212758,2868,14,54034,-4,2867,233,2869,592,0
20141226.212758,2869,2,54036,2,2868,1,2869,591,1
20141226.212759,2868,4,54040,2,2868,21,2869,598,0
20141226.212759,2868,60,54100,60,2867,285,2868,40,0
20141226.2128,2868,42,54142,42,2867,285,2868,20,0
20141226.2128,2868,2,54144,0,2867,246,2868,19,0
20141226.212801,2867,2,54146,0,2867,245,2868,29,0
20141226.212802,2868,10,54156,10,2867,242,2868,55,1
20141226.212802,2867,2,54158,0,2867,240,2868,55,0
20141226.212804,2868,2,54160,2,2867,271,2868,55,1
20141226.212804,2868,2,54162,2,2867,271,2868,54,1
20141226.212805,2868,2,54164,2,2867,272,2868,53,1
20141226.212805,2868,8,54172,6,2867,262,2868,93,1
20141226.212806,2868,40,54212,-28,2867,262,2868,76,1
20141226.212807,2868,20,54232,-20,2867,264,2868,67,1
20141226.212808,2868,80,54312,-72,2867,266,2868,28,1
20141226.212809,2868,32,54344,22,2867,266,2868,25,1
20141226.21281,2868,10,54354,-8,2867,265,2869,557,1
20141226.212812,2868,4,54358,0,2867,265,2868,29,1
20141226.212813,2868,24,54382,14,2867,265,2868,23,1
20141226.212815,2868,2,54384,2,2867,272,2868,24,1
20141226.212816,2868,40,54424,-36,2867,272,2869,560,1
20141226.212816,2868,2,54426,2,2867,277,2869,560,1
20141226.212817,2868,2,54428,-2,2867,263,2868,1,1
20141226.212818,2869,202,54630,200,2867,263,2869,465,1
20141226.212819,2869,10,54640,0,2867,262,2869,471,1
20141226.212819,2868,52,54692,-52,2867,262,2868,74,0
20141226.21282,2868,6,54698,2,2867,260,2868,82,0
20141226.212821,2868,12,54710,-12,2867,261,2868,78,0
20141226.212821,2868,2,54712,0,2867,262,2868,78,0
20141226.212822,2868,2,54714,0,2867,262,2868,80,0
20141226.212823,2868,8,54722,-4,2867,257,2868,79,0
20141226.212824,2868,104,54826,0,2867,256,2868,28,0
20141226.212826,2868,70,54896,44,2868,116,2869,531,0
20141226.212827,2869,2,54898,2,2868,150,2869,490,1
20141226.212827,2869,2,54900,2,2868,150,2869,491,1
20141226.212828,2869,2,54902,0,2868,169,2869,492,1
20141226.21283,2869,26,54928,26,2868,170,2869,484,1
20141226.212831,2868,22,54950,0,2868,159,2869,484,0
20141226.212832,2868,2,54952,0,2868,161,2869,488,0
20141226.212833,2868,6,54958,0,2868,168,2869,489,0
20141226.212835,2868,2,54960,2,2868,168,2869,485,0
20141226.212835,2869,2,54962,2,2868,188,2869,484,1
20141226.212836,2868,4,54966,4,2868,186,2869,484,0
20141226.212837,2868,4,54970,0,2868,185,2869,491,0
20141226.212837,2869,6,54976,6,2868,183,2869,491,1
20141226.212841,2868,20,54996,20,2868,174,2869,493,0
20141226.212841,2869,14,55010,4,2868,169,2869,491,1
20141226.212841,2868,2,55012,2,2868,168,2869,491,0
20141226.212842,2869,8,55020,8,2868,168,2869,488,1
20141226.212843,2868,2,55022,2,2868,167,2869,488,0
20141226.212844,2869,4,55026,4,2868,172,2869,486,1
20141226.212844,2868,4,55030,2,2868,170,2869,486,0
20141226.212845,2869,90,55120,-14,2868,271,2869,443,1
20141226.212846,2868,6,55126,6,2868,281,2869,441,0
20141226.212848,2869,100,55226,8,2868,281,2869,403,1
20141226.212848,2869,2,55228,0,2868,281,2869,402,1
20141226.212849,2869,4,55232,2,2868,283,2869,400,1
20141226.212849,2869,602,55834,-112,2868,284,2869,76,1
20141226.21285,2869,154,55988,98,2869,233,2870,1093,1
20141226.21285,2869,4,55992,0,2869,232,2870,1093,1
20141226.212851,2870,4,55996,0,2869,232,2870,1092,1
20141226.212851,2869,2,55998,0,2869,232,2870,1099,0
20141226.212852,2869,2,56000,0,2869,231,2870,1099,0
20141226.212852,2869,322,56322,98,2869,71,2870,1139,0
20141226.212853,2869,36,56358,2,2869,44,2870,1138,0
20141226.212853,2869,2,56360,2,2869,43,2870,1153,0
20141226.212854,2869,24,56384,2,2868,289,2870,699,0
20141226.212854,2869,18,56402,0,2868,309,2870,700,0
20141226.212855,2869,56,56458,-30,2868,358,2870,1155,0
20141226.212856,2870,20,56478,0,2868,358,2870,1145,1
20141226.212857,2870,4,56482,-2,2869,21,2870,1144,1
20141226.212858,2869,2,56484,-2,2869,30,2870,1144,0
20141226.212858,2869,60,56544,-22,2868,366,2870,1155,0
20141226.212858,2870,4,56548,0,2868,368,2870,1165,1
20141226.212859,2869,2,56550,0,2868,378,2869,11,0
20141226.212859,2869,32,56582,-2,2868,379,2870,1170,0
20141226.2129,2869,72,56654,0,2868,379,2869,73,0
20141226.212901,2869,2,56656,0,2868,380,2869,73,0
20141226.212902,2869,4,56660,0,2868,361,2869,72,0
20141226.212903,2868,10,56670,0,2868,255,2869,77,0
20141226.212904,2868,544,57214,-166,2867,330,2868,128,0
20141226.212904,2868,8,57222,-6,2867,329,2868,124,0
20141226.212905,2868,214,57436,-192,2867,329,2868,17,0
20141226.212905,2868,10,57446,0,2867,329,2868,51,0
20141226.212906,2868,10,57456,0,2867,428,2868,46,0
20141226.212906,2868,120,57576,0,2867,428,2868,8,0
20141226.212907,2868,2,57578,0,2867,430,2868,7,0
20141226.212907,2868,14,57592,0,2868,14,2869,220,0
20141226.212908,2868,2,57594,2,2868,87,2869,231,0
20141226.21291,2868,2,57596,2,2868,98,2869,231,0
20141226.212913,2868,2,57598,0,2868,136,2869,202,0
20141226.212916,2868,2,57600,2,2868,157,2869,208,0
20141226.212918,2869,4,57604,0,2868,161,2869,206,1
20141226.212919,2868,62,57666,38,2868,143,2869,207,0
20141226.212919,2868,4,57670,4,2868,141,2869,207,0
20141226.21292,2868,22,57692,2,2868,131,2869,210,0
20141226.21292,2868,4,57696,4,2868,129,2869,210,0
20141226.212921,2868,8,57704,8,2868,135,2869,222,0
20141226.212922,2868,4,57708,2,2868,134,2869,222,0
20141226.212924,2868,2,57710,2,2868,137,2869,240,0
20141226.212924,2868,10,57720,10,2868,132,2869,240,0
20141226.212925,2868,2,57722,2,2868,131,2869,247,0
20141226.212926,2868,2,57724,2,2868,130,2869,248,0
20141226.212926,2869,4,57728,2,2868,129,2869,248,1
20141226.212927,2868,8,57736,8,2868,128,2869,248,0
20141226.212928,2868,2,57738,2,2868,132,2869,249,0
20141226.212928,2868,6,57744,2,2868,130,2869,253,0
20141226.212933,2869,82,57826,0,2868,212,2869,224,1
20141226.212934,2869,4,57830,0,2868,220,2869,223,1
20141226.212936,2869,2,57832,0,2868,244,2869,222,1
20141226.212936,2869,4,57836,-4,2868,242,2869,220,1
20141226.212938,2869,26,57862,0,2868,240,2869,209,1
20141226.212938,2869,8,57870,-8,2868,237,2869,205,1
20141226.21294,2868,4,57874,4,2868,236,2869,206,0
20141226.21294,2869,10,57884,6,2868,238,2869,201,1
20141226.212941,2869,12,57896,6,2868,243,2869,206,1
20141226.212942,2869,2,57898,0,2868,243,2869,205,1
20141226.212942,2868,2,57900,2,2868,242,2869,205,0
20141226.212943,2869,8,57908,-2,2868,206,2869,203,1
20141226.212944,2868,20,57928,20,2868,196,2869,209,0
20141226.212945,2869,14,57942,4,2868,196,2869,203,1
20141226.212946,2869,200,58142,84,2868,196,2869,104,1
20141226.212947,2869,2,58144,-2,2868,196,2869,103,1
20141226.212949,2868,2,58146,2,2868,200,2869,122,0
20141226.212951,2869,42,58188,-16,2868,231,2869,110,1
20141226.212956,2869,2,58190,0,2868,235,2869,134,1
20141226.212956,2868,4,58194,4,2868,234,2869,133,0
20141226.212957,2869,2,58196,0,2868,234,2869,132,1
20141226.212958,2868,16,58212,0,2868,232,2869,127,0
20141226.212959,2869,2,58214,0,2868,232,2869,131,1
20141226.212959,2869,6,58220,0,2868,230,2869,131,1
20141226.213,2868,20,58240,10,2868,222,2869,136,0
20141226.213,2868,116,58356,-26,2868,217,2869,83,0
20141226.213001,2869,20,58376,2,2868,222,2869,73,1
20141226.213001,2869,8,58384,6,2868,222,2869,81,1
20141226.213002,2869,16,58400,16,2868,222,2869,82,1
20141226.213002,2869,240,58640,72,2869,18,2870,1142,1
20141226.213003,2869,36,58676,-36,2868,222,2870,1142,1
20141226.213004,2869,8,58684,-6,2868,258,2870,1141,1
20141226.213005,2869,70,58754,70,2868,264,2870,1139,1
20141226.213006,2869,2,58756,0,2868,265,2870,1139,1
20141226.213007,2869,6,58762,6,2869,2,2870,1130,1
20141226.213007,2869,8,58770,4,2868,265,2870,1131,1
20141226.213008,2868,2,58772,0,2868,274,2870,1131,0
20141226.213009,2869,4,58776,0,2868,274,2869,22,1
20141226.213009,2869,6,58782,0,2868,274,2869,36,1
20141226.21301,2869,2,58784,-2,2868,274,2869,35,1
20141226.213011,2868,6,58790,-2,2868,273,2869,32,0
20141226.213011,2869,6,58796,0,2868,273,2869,29,1
20141226.213012,2869,22,58818,22,2868,276,2869,44,1
20141226.213013,2868,4,58822,0,2868,279,2869,49,0
20141226.213014,2869,2,58824,0,2868,282,2869,59,1
20141226.213018,2869,4,58828,4,2868,286,2869,75,1
20141226.213019,2869,2,58830,2,2868,286,2869,84,1
20141226.213021,2868,6,58836,2,2868,295,2869,88,0
20141226.213022,2869,10,58846,0,2868,247,2869,85,1
20141226.213024,2869,2,58848,0,2868,246,2869,107,1
20141226.213025,2869,2,58850,2,2868,246,2869,109,1
20141226.213025,2869,10,58860,2,2868,246,2869,104,1
20141226.213026,2869,4,58864,-2,2868,245,2869,104,1
20141226.21303,2868,4,58868,0,2868,249,2869,166,0
20141226.213034,2868,2,58870,0,2868,255,2869,172,0
20141226.213036,2869,2,58872,0,2868,255,2869,173,1
20141226.213039,2869,50,58922,-36,2868,260,2869,151,1
20141226.21304,2868,54,58976,42,2868,233,2869,155,0
20141226.21304,2869,6,58982,0,2868,233,2869,152,1
20141226.213044,2868,2,58984,2,2868,251,2869,160,0
20141226.213045,2868,2,58986,0,2868,250,2869,160,0
20141226.213046,2869,2,58988,0,2868,250,2869,164,1
20141226.213047,2868,10,58998,0,2868,265,2869,161,0
20141226.213051,2869,100,59098,70,2868,266,2869,98,1
20141226.213052,2868,10,59108,8,2868,263,2869,98,0
20141226.213052,2869,6,59114,6,2868,263,2869,96,1
20141226.213053,2869,12,59126,2,2868,266,2869,90,1
20141226.213057,2869,100,59226,86,2868,265,2869,39,1
20141226.213058,2869,10,59236,8,2868,264,2869,34,1
20141226.213059,2869,100,59336,82,2869,10,2870,1208,1
20141226.2131,2869,20,59356,-20,2868,268,2870,1208,1
20141226.213101,2868,914,60270,-164,2867,501,2868,43,0
20141226.213103,2868,2,60272,-2,2867,510,2868,52,0
20141226.213103,2868,58,60330,-58,2867,510,2868,23,0
20141226.213104,2868,2,60332,0,2867,511,2868,22,0
20141226.213105,2868,6,60338,0,2867,512,2868,19,0
20141226.213105,2868,2,60340,0,2867,512,2868,18,0
20141226.213106,2868,2,60342,0,2867,513,2868,17,0
20141226.213107,2868,2,60344,0,2867,514,2868,16,0
20141226.213107,2868,6,60350,0,2867,515,2868,13,0
20141226.213108,2868,22,60372,20,2867,505,2868,12,0
20141226.213108,2868,6,60378,0,2867,507,2868,9,0
20141226.213109,2868,18,60396,0,2868,34,2869,156,0
20141226.213114,2868,2,60398,0,2868,47,2869,166,0
20141226.213115,2868,10,60408,0,2868,43,2869,166,0
20141226.213119,2868,102,60510,38,2867,508,2869,166,0
20141226.213121,2868,2,60512,-2,2867,510,2868,6,0
20141226.213122,2868,2,60514,-2,2867,510,2868,5,0
20141226.213123,2868,2,60516,0,2867,510,2868,4,0
20141226.213126,2868,2,60518,0,2867,521,2868,103,0
20141226.213127,2868,40,60558,-6,2867,521,2868,87,0
20141226.213128,2868,6,60564,6,2867,521,2868,85,0
20141226.213131,2868,4,60568,-4,2867,515,2868,87,0
20141226.213133,2867,2,60570,0,2867,514,2868,87,0
20141226.213137,2868,2,60572,0,2867,519,2868,123,1
20141226.213138,2868,4,60576,4,2867,519,2868,121,1
20141226.213138,2867,4,60580,4,2867,518,2868,121,0
20141226.213139,2868,4,60584,4,2867,518,2868,121,1
20141226.21314,2868,120,60704,120,2867,506,2868,65,1
20141226.213142,2868,2,60706,0,2867,506,2868,71,1
20141226.213143,2867,16,60722,0,2867,498,2868,71,0
20141226.213144,2868,2,60724,2,2867,504,2868,71,1
20141226.213147,2869,400,61124,122,2868,8,2869,337,1
20141226.21315,2868,18,61142,-14,2867,505,2868,4,0
20141226.21315,2868,12,61154,4,2867,505,2868,5,0
20141226.213151,2868,8,61162,4,2867,503,2868,1,0
20141226.213152,2868,2,61164,2,2867,503,2869,348,0
20141226.213154,2869,6,61170,0,2868,48,2869,346,1
20141226.213156,2868,12,61182,0,2868,44,2869,341,0
20141226.213157,2868,2,61184,2,2868,48,2869,339,0
20141226.2132,2868,2,61186,0,2868,49,2869,339,0
20141226.2132,2868,2,61188,2,2868,49,2869,338,0
20141226.213201,2868,2,61190,0,2868,49,2869,338,0
20141226.213201,2868,4,61194,2,2868,51,2869,337,0
20141226.213202,2868,6,61200,0,2868,48,2869,388,0
20141226.213203,2868,4,61204,4,2868,46,2869,428,0
20141226.213204,2868,2,61206,2,2868,45,2869,428,0
20141226.213204,2868,4,61210,2,2868,44,2869,430,0
20141226.213206,2869,2,61212,0,2868,44,2869,428,1
20141226.213206,2869,2,61214,0,2868,44,2869,433,1
20141226.213207,2868,2,61216,2,2868,68,2869,434,0
20141226.213209,2868,2,61218,2,2868,67,2869,433,0
20141226.213212,2868,54,61272,52,2868,40,2869,433,0
20141226.213212,2869,2,61274,0,2868,40,2869,432,1
20141226.213216,2869,2,61276,0,2868,40,2869,466,1
20141226.213217,2868,82,61358,-22,2867,512,2868,160,0
20141226.213217,2868,2,61360,0,2867,509,2868,159,0
20141226.21322,2868,4,61364,0,2867,510,2868,191,0
20141226.213221,2868,2,61366,0,2867,514,2868,191,0
20141226.213227,2868,2,61368,0,2867,411,2868,193,0
20141226.213228,2868,2,61370,0,2867,413,2868,192,0
20141226.213229,2868,4,61374,0,2867,413,2868,190,0
20141226.213231,2868,2,61376,0,2867,414,2868,189,0
20141226.213237,2868,4,61380,-2,2867,413,2868,204,0
20141226.213247,2868,2,61382,0,2867,416,2868,222,0
20141226.213247,2867,4,61386,0,2867,415,2868,221,0
20141226.213248,2868,18,61404,0,2867,415,2868,212,1
20141226.21325,2867,2,61406,0,2867,414,2868,213,0
20141226.213251,2867,2,61408,0,2867,413,2868,213,0
20141226.213252,2868,2,61410,0,2867,413,2868,213,1
20141226.213255,2867,2,61412,2,2867,411,2868,214,0
20141226.213256,2868,2,61414,-2,2867,425,2868,213,1
20141226.213259,2868,6,61420,-6,2867,424,2868,221,1
20141226.213259,2868,2,61422,0,2867,424,2868,220,1
20141226.213302,2868,4,61426,0,2867,424,2868,259,1
20141226.213304,2867,2,61428,2,2867,425,2868,262,0
20141226.213306,2867,4,61432,4,2867,418,2868,317,0
20141226.213307,2867,20,61452,0,2867,409,2868,318,0
20141226.21331,2867,2,61454,2,2867,409,2868,308,0
20141226.213313,2868,4,61458,0,2867,409,2868,310,1
20141226.213314,2867,2,61460,2,2867,412,2868,312,0
20141226.213317,2868,2,61462,0,2867,411,2868,311,1
20141226.213317,2867,2,61464,2,2867,410,2868,311,0
20141226.213318,2867,2,61466,2,2867,408,2868,311,0
20141226.213321,2867,2,61468,2,2867,407,2868,319,0
20141226.213322,2867,2,61470,2,2867,406,2868,319,0
20141226.213323,2867,4,61474,4,2867,404,2868,319,0
20141226.213326,2867,4,61478,0,2867,403,2868,321,0
20141226.21333,2867,4,61482,0,2867,402,2868,331,0
20141226.213332,2867,120,61602,120,2867,338,2868,352,0
20141226.213333,2867,6,61608,-2,2867,336,2868,352,0
20141226.213334,2867,2,61610,0,2867,335,2868,353,0
20141226.213334,2867,2,61612,-2,2867,334,2868,624,0
20141226.213335,2867,12,61624,-10,2867,328,2868,624,0
20141226.213336,2867,8,61632,-6,2867,324,2868,626,0
20141226.213336,2867,12,61644,-12,2867,318,2868,626,0
20141226.213338,2867,2,61646,0,2867,316,2868,626,0
20141226.213338,2867,4,61650,-4,2867,314,2868,626,0
20141226.213339,2867,6,61656,0,2867,310,2868,626,0
20141226.213339,2867,2,61658,0,2867,311,2868,626,0
20141226.213341,2867,22,61680,-12,2867,262,2868,601,0
20141226.213342,2867,2,61682,0,2867,261,2868,601,0
20141226.213343,2867,4,61686,4,2867,259,2868,606,0
20141226.213343,2867,6,61692,4,2867,256,2868,607,0
20141226.213344,2867,512,62204,-166,2866,904,2867,254,0
20141226.213344,2867,4,62208,0,2866,904,2867,253,0
20141226.213345,2867,4,62212,-4,2866,912,2867,252,0
20141226.213345,2866,2,62214,-2,2866,891,2867,252,0
20141226.213347,2866,4,62218,-4,2866,926,2867,307,0
20141226.213347,2866,2,62220,-2,2866,927,2867,308,0
20141226.213348,2867,22,62242,0,2866,918,2867,297,1
20141226.213351,2867,8,62250,-6,2866,921,2867,298,1
20141226.213354,2867,4,62254,0,2866,924,2867,310,1
20141226.213358,2867,30,62284,0,2866,926,2867,317,1
20141226.213401,2867,10,62294,0,2866,930,2867,314,1
20141226.213402,2866,18,62312,-18,2866,929,2867,310,0
20141226.213402,2867,4,62316,-2,2866,930,2867,308,1
20141226.213403,2867,20,62336,0,2866,930,2867,298,1
20141226.213404,2867,20,62356,0,2866,935,2867,286,1
20141226.213406,2866,8,62364,-8,2866,931,2867,286,0
20141226.213407,2867,2,62366,0,2866,931,2867,285,1
20141226.213408,2867,20,62386,-20,2866,930,2867,275,1
20141226.21341,2867,2,62388,-2,2866,930,2867,269,1
20141226.213411,2867,2,62390,-2,2866,931,2867,268,1
20141226.213412,2867,4,62394,0,2866,931,2867,266,1
20141226.213413,2866,10,62404,-8,2866,927,2867,265,0
20141226.213413,2867,4,62408,0,2866,926,2867,232,1
20141226.213414,2867,2,62410,0,2866,926,2867,231,1
20141226.213414,2867,4,62414,0,2866,926,2867,230,1
20141226.213415,2866,2,62416,0,2866,925,2867,231,0
20141226.213417,2866,4,62420,-4,2866,923,2867,230,0
20141226.213419,2867,2,62422,-2,2866,935,2867,232,1
20141226.213422,2866,2,62424,-2,2866,938,2867,235,0
20141226.213429,2867,2,62426,-2,2866,945,2867,262,1
20141226.213432,2866,4,62430,0,2866,948,2867,267,0
20141226.213434,2867,2,62432,0,2866,947,2867,265,1
20141226.213435,2866,4,62436,0,2866,949,2867,270,0
20141226.213436,2866,12,62448,0,2866,943,2867,274,0
20141226.213437,2867,2,62450,-2,2866,945,2867,273,1
20141226.213439,2866,80,62530,-80,2866,908,2867,273,0
20141226.21344,2866,80,62610,0,2866,868,2867,273,0
20141226.213441,2866,12,62622,0,2866,863,2867,273,0
20141226.213442,2866,262,62884,-254,2866,732,2867,273,0
20141226.213443,2866,10,62894,0,2866,728,2867,270,0
20141226.213446,2866,2,62896,-2,2866,717,2867,322,0
20141226.213448,2866,10,62906,-10,2866,714,2867,323,0
20141226.213449,2866,16,62922,-16,2866,706,2867,329,0
20141226.21345,2866,16,62938,0,2866,699,2867,331,0
20141226.213451,2866,2,62940,-2,2866,698,2867,331,0
20141226.213451,2867,40,62980,0,2866,698,2867,311,1
20141226.213452,2866,4,62984,0,2866,697,2867,318,0
20141226.213452,2866,400,63384,0,2866,497,2867,318,0
20141226.213454,2866,994,64378,-690,2865,557,2866,155,0
20141226.213456,2866,20,64398,0,2865,543,2866,188,0
20141226.213457,2866,2,64400,-2,2865,544,2866,187,0
20141226.213457,2866,2,64402,-2,2865,544,2866,186,0
20141226.213458,2866,2,64404,0,2865,544,2866,185,0
20141226.213458,2866,26,64430,-24,2865,544,2866,173,0
20141226.213459,2865,2,64432,2,2865,538,2866,174,0
20141226.213459,2865,2,64434,0,2865,537,2866,174,0
20141226.2135,2865,4,64438,0,2865,535,2866,174,0
20141226.213501,2865,16,64454,-6,2865,530,2866,171,0
20141226.213503,2865,2,64456,2,2865,526,2866,171,0
20141226.213505,2866,204,64660,-200,2865,530,2866,72,1
20141226.213505,2866,2,64662,-2,2865,533,2866,70,1
20141226.213506,2866,12,64674,-12,2865,532,2866,64,1
20141226.213506,2865,26,64700,0,2865,525,2866,64,0
20141226.213507,2866,8,64708,-8,2865,527,2866,60,1
20141226.213508,2866,8,64716,-8,2865,532,2866,86,1
20141226.213508,2865,16,64732,0,2865,530,2866,83,0
20141226.213509,2866,4,64736,4,2865,540,2866,81,1
20141226.213511,2866,4,64740,0,2865,553,2866,81,1
20141226.213511,2866,2,64742,0,2865,556,2866,47,1
20141226.213513,2866,402,65144,158,2865,362,2866,107,1
20141226.213513,2865,20,65164,8,2865,356,2866,111,0
20141226.213514,2866,2,65166,0,2865,320,2866,111,1
20141226.213514,2866,32,65198,-6,2865,312,2866,109,1
20141226.213515,2866,16,65214,16,2865,313,2866,101,1
20141226.213516,2866,2,65216,2,2865,308,2866,102,1
20141226.213518,2866,2,65218,2,2865,311,2866,108,1
20141226.213518,2866,4,65222,4,2865,312,2866,109,1
20141226.213519,2866,2,65224,2,2865,317,2866,108,1
20141226.213521,2866,6,65230,6,2865,313,2866,105,1
20141226.213526,2865,2,65232,0,2865,307,2866,129,0
20141226.213527,2866,404,65636,60,2865,91,2866,126,1
20141226.213528,2865,8,65644,-8,2865,88,2866,123,0
20141226.213528,2866,16,65660,0,2865,87,2866,115,1
20141226.213529,2865,18,65678,8,2865,88,2866,107,0
20141226.213529,2865,4,65682,-4,2865,110,2866,107,0
20141226.21353,2865,2,65684,2,2865,109,2866,77,0
20141226.21353,2865,62,65746,-22,2865,119,2866,77,0
20141226.213532,2866,2,65748,0,2865,155,2866,85,1
20141226.213534,2865,2,65750,2,2865,158,2866,86,0
20141226.213534,2866,4,65754,-2,2865,159,2866,84,1
20141226.213535,2866,4,65758,0,2865,190,2866,76,1
20141226.213538,2866,2,65760,0,2865,190,2866,79,1
20141226.21354,2866,14,65774,2,2865,190,2866,79,1
20141226.213543,2866,32,65806,-16,2865,192,2866,54,1
20141226.213545,2866,4,65810,0,2865,243,2866,53,1
20141226.213547,2866,10,65820,-8,2865,257,2866,48,1
20141226.213547,2866,2,65822,0,2865,257,2866,47,1
20141226.213548,2866,2,65824,0,2865,258,2866,46,1
20141226.213548,2866,14,65838,2,2865,259,2866,39,1
20141226.213549,2866,22,65860,10,2865,268,2866,29,1
20141226.21355,2865,4,65864,0,2865,265,2866,29,0
20141226.213551,2866,4,65868,-4,2865,265,2866,30,1
20141226.213552,2866,30,65898,12,2865,266,2866,18,1
20141226.213553,2865,2,65900,-2,2865,265,2866,288,0
20141226.213553,2866,4,65904,-2,2865,272,2866,304,1
20141226.213555,2865,42,65946,8,2865,253,2866,307,0
20141226.213557,2866,2,65948,0,2865,172,2866,414,1
20141226.213558,2865,66,66014,-54,2865,141,2866,413,0
20141226.213558,2866,18,66032,-8,2865,140,2866,404,1
20141226.213559,2866,16,66048,6,2865,142,2866,404,1
20141226.2136,2866,2,66050,0,2865,142,2866,418,1
20141226.213602,2865,12,66062,-2,2865,142,2866,430,0
20141226.213602,2865,2,66064,0,2865,141,2866,430,0
20141226.213603,2865,10,66074,10,2865,140,2866,430,0
20141226.213603,2865,2,66076,2,2865,139,2866,430,0
20141226.213606,2866,6,66082,2,2865,142,2866,490,1
20141226.213606,2865,2,66084,2,2865,142,2866,490,0
20141226.21361,2865,2,66086,0,2865,139,2866,497,0
20141226.213611,2865,12,66098,12,2865,135,2866,497,0
20141226.213613,2865,2,66100,2,2865,133,2866,523,0
20141226.213613,2866,16,66116,-16,2865,139,2866,515,1
20141226.213614,2865,18,66134,2,2865,138,2866,507,0
20141226.213614,2865,12,66146,0,2865,132,2866,506,0
20141226.213615,2865,218,66364,-160,2865,24,2866,546,0
20141226.213616,2865,26,66390,-4,2865,11,2866,546,0
20141226.213616,2865,22,66412,4,2864,668,2865,21,0
20141226.213617,2865,8,66420,8,2864,671,2865,25,0
20141226.213617,2865,8,66428,4,2864,670,2865,22,0
20141226.213618,2864,4,66432,2,2864,669,2865,23,0
20141226.213618,2864,12,66444,-12,2864,663,2865,23,0
20141226.213619,2864,18,66462,-18,2864,658,2865,23,0
20141226.213619,2865,20,66482,20,2864,658,2865,47,1
20141226.21362,2865,6,66488,0,2864,658,2865,44,1
20141226.21362,2865,2,66490,2,2864,659,2865,43,1
20141226.213621,2865,4,66494,0,2864,658,2865,43,1
20141226.213623,2864,10,66504,-10,2864,653,2865,43,0
20141226.213624,2865,4,66508,-2,2864,655,2865,55,1
20141226.213626,2865,2,66510,-2,2864,658,2865,63,1
20141226.213627,2865,4,66514,0,2864,659,2865,62,1
20141226.213627,2865,10,66524,0,2864,656,2865,60,1
20141226.213627,2865,4,66528,-2,2864,656,2865,59,1
20141226.213628,2865,2,66530,0,2864,660,2865,59,1
20141226.213628,2865,22,66552,0,2864,651,2865,57,1
20141226.213629,2865,10,66562,0,2864,654,2865,52,1
20141226.21363,2865,2,66564,-2,2864,656,2865,51,1
20141226.213631,2865,6,66570,-6,2864,656,2865,48,1
20141226.213632,2865,2,66572,-2,2864,659,2865,57,1
20141226.213633,2865,2,66574,0,2864,659,2865,56,1
20141226.213634,2865,20,66594,-20,2864,659,2865,112,1
20141226.213637,2865,4,66598,0,2864,675,2865,110,1
20141226.213637,2864,2,66600,-2,2864,674,2865,121,0
20141226.213638,2864,2,66602,-2,2864,674,2865,122,0
20141226.213639,2865,4,66606,0,2864,674,2865,120,1
20141226.213639,2864,6,66612,-4,2864,671,2865,120,0
20141226.21364,2864,6,66618,0,2864,668,2865,120,0
20141226.213641,2864,2,66620,0,2864,668,2865,119,0
20141226.213643,2865,8,66628,-8,2864,667,2865,115,1
20141226.213644,2864,22,66650,-22,2864,656,2865,115,0
20141226.213645,2864,6,66656,0,2864,653,2865,116,0
20141226.213646,2864,2,66658,0,2864,652,2865,116,0
20141226.213647,2864,2,66660,0,2864,652,2865,118,0
20141226.213647,2865,2,66662,0,2864,651,2865,117,1
20141226.213648,2864,2,66664,0,2864,569,2865,118,0
20141226.213649,2865,6,66670,-6,2864,570,2865,115,1
20141226.21365,2864,20,66690,0,2864,560,2865,115,0
20141226.213653,2865,6,66696,-6,2864,1599,2865,116,1
20141226.213654,2865,2,66698,-2,2864,1600,2865,115,1
20141226.213654,2865,2,66700,-2,2864,1600,2865,121,1
20141226.213656,2865,2,66702,-2,2864,1593,2865,152,1
20141226.213657,2865,6,66708,0,2864,1593,2865,150,1
20141226.213657,2864,4,66712,0,2864,1589,2865,149,0
20141226.213658,2865,2,66714,0,2864,1589,2865,148,1
20141226.213658,2864,1014,67728,-760,2864,1046,2865,152,0
20141226.213659,2865,2,67730,0,2864,1046,2865,144,1
20141226.213659,2865,2,67732,0,2864,1045,2865,148,1
20141226.2137,2865,540,68272,-484,2865,230,2866,538,1
20141226.213702,2865,2,68274,-2,2865,237,2866,534,1
20141226.213703,2865,2,68276,0,2865,237,2866,534,1
20141226.213703,2865,2,68278,0,2865,253,2866,534,1
20141226.213704,2865,4,68282,-2,2865,257,2866,535,1
20141226.213705,2865,22,68304,0,2865,246,2866,536,1
20141226.213707,2865,2,68306,0,2865,246,2866,536,1
20141226.21371,2866,4,68310,-2,2865,290,2866,542,1
20141226.213712,2865,2,68312,0,2865,298,2866,542,0
20141226.213712,2866,2,68314,-2,2865,303,2866,542,1
20141226.213713,2866,6,68320,0,2865,306,2866,538,1
20141226.213714,2866,114,68434,-112,2865,251,2866,536,1
20141226.213715,2866,2,68436,-2,2865,255,2866,535,1
20141226.213717,2865,2,68438,0,2865,257,2866,535,0
20141226.213717,2865,8,68446,0,2865,253,2866,537,0
20141226.213721,2865,2,68448,0,2865,249,2866,537,0
20141226.213722,2866,2,68450,-2,2865,249,2866,535,1
20141226.213723,2865,2,68452,-2,2865,249,2866,543,0
20141226.213727,2866,2,68454,0,2865,252,2866,551,1
20141226.213727,2866,40,68494,0,2865,252,2866,531,1
20141226.213727,2866,2,68496,0,2865,252,2866,530,1
20141226.213729,2866,2,68498,0,2865,268,2866,528,1
20141226.213733,2865,2,68500,0,2865,392,2866,521,0
20141226.213737,2865,2,68502,0,2865,404,2866,520,0
20141226.213738,2865,2,68504,0,2865,384,2866,529,0
20141226.213743,2865,8,68512,-8,2865,382,2866,530,0
20141226.213746,2866,20,68532,-20,2865,383,2866,521,1
20141226.213748,2865,2,68534,-2,2865,397,2866,505,0
20141226.213749,2866,2,68536,0,2865,397,2866,504,1
20141226.21375,2866,20,68556,-20,2865,414,2866,496,1
20141226.213751,2866,60,68616,0,2865,426,2866,457,1
20141226.213752,2866,6,68622,-6,2865,416,2866,440,1
20141226.213752,2866,18,68640,0,2865,416,2866,431,1
20141226.213753,2866,4,68644,0,2865,418,2866,429,1
20141226.213753,2866,4,68648,-4,2865,318,2866,426,1
20141226.213754,2866,6,68654,-6,2865,320,2866,423,1
20141226.213755,2866,2,68656,0,2865,320,2866,422,1
20141226.213756,2866,4,68660,0,2865,342,2866,420,1
20141226.213756,2866,14,68674,-14,2865,350,2866,413,1
20141226.213757,2866,2,68676,0,2865,351,2866,412,1
20141226.213757,2866,2,68678,0,2865,361,2866,411,1
20141226.213759,2866,52,68730,0,2865,347,2866,405,1
20141226.2138,2866,30,68760,0,2865,342,2866,421,1
20141226.213801,2866,44,68804,0,2865,347,2866,399,1
20141226.213802,2866,124,68928,-120,2865,343,2866,337,1
20141226.213803,2866,20,68948,0,2865,343,2866,327,1
20141226.213804,2866,4,68952,0,2865,342,2866,308,1
20141226.213805,2866,8,68960,-4,2865,341,2866,305,1
20141226.213806,2866,2,68962,-2,2865,341,2866,303,1
20141226.213807,2865,4,68966,-2,2865,340,2866,302,0
20141226.213807,2865,6,68972,-6,2865,337,2866,302,0
20141226.213808,2865,6,68978,-6,2865,337,2866,302,0
20141226.213808,2865,16,68994,-12,2865,331,2866,312,0
20141226.213808,2866,2,68996,-2,2865,331,2866,311,1
20141226.21381,2866,10,69006,-10,2865,332,2866,306,1
20141226.213811,2866,456,69462,120,2865,372,2866,81,1
20141226.213812,2866,162,69624,54,2866,52,2867,340,1
20141226.213813,2867,4,69628,0,2866,84,2867,347,1
20141226.213814,2867,20,69648,-20,2866,85,2867,339,1
20141226.213814,2867,8,69656,-8,2866,85,2867,335,1
20141226.213815,2866,4,69660,-2,2866,114,2867,334,0
20141226.213818,2867,40,69700,-40,2866,241,2867,315,1
20141226.213819,2867,2,69702,-2,2866,241,2867,314,1
20141226.213821,2867,4,69706,0,2866,241,2867,312,1
20141226.213822,2867,2,69708,0,2866,241,2867,309,1
20141226.213823,2866,2,69710,2,2866,240,2867,310,0
20141226.213827,2866,30,69740,0,2866,291,2867,319,0
20141226.213828,2866,2,69742,0,2866,295,2867,319,0
20141226.213828,2866,10,69752,0,2866,291,2867,319,0
20141226.213829,2866,2,69754,0,2866,293,2867,320,0
20141226.213829,2866,20,69774,0,2866,307,2867,320,0
20141226.213831,2867,12,69786,2,2866,308,2867,316,1
20141226.213836,2867,2,69788,0,2866,378,2867,316,1
20141226.213837,2867,2,69790,-2,2866,379,2867,315,1
20141226.213838,2867,4,69794,0,2866,382,2867,313,1
20141226.213839,2867,120,69914,-120,2866,383,2867,253,1
20141226.21384,2867,4,69918,0,2866,387,2867,243,1
20141226.213841,2867,2,69920,0,2866,405,2867,239,1
20141226.213841,2867,2,69922,0,2866,405,2867,238,1
20141226.213842,2867,2,69924,-2,2866,405,2867,237,1
20141226.213842,2867,2,69926,-2,2866,405,2867,237,1
20141226.213843,2867,20,69946,0,2866,401,2867,227,1
20141226.213844,2867,2,69948,-2,2866,405,2867,226,1
20141226.213844,2867,2,69950,0,2866,407,2867,245,1
20141226.213845,2867,2,69952,0,2866,409,2867,244,1
20141226.213846,2867,12,69964,0,2866,409,2867,238,1
20141226.213846,2866,2,69966,2,2866,407,2867,238,0
20141226.213847,2867,2,69968,2,2866,408,2867,237,1
20141226.213848,2867,2,69970,2,2866,406,2867,236,1
20141226.213849,2867,2,69972,2,2866,406,2867,236,1
20141226.213849,2867,14,69986,12,2866,406,2867,229,1
20141226.21385,2867,100,70086,-86,2866,405,2867,179,1
20141226.213851,2867,2,70088,0,2866,406,2867,178,1
20141226.213851,2867,80,70168,44,2866,406,2867,138,1
20141226.213852,2867,2,70170,0,2866,406,2867,169,1
20141226.213853,2867,348,70518,128,2867,62,2868,363,1
20141226.213855,2867,2,70520,0,2867,73,2868,355,1
20141226.213856,2867,20,70540,0,2867,66,2868,356,1
20141226.213856,2867,2,70542,2,2867,65,2868,354,1
20141226.213857,2868,2,70544,2,2867,65,2868,353,1
20141226.2139,2867,2,70546,2,2867,113,2868,355,0
20141226.213901,2867,2,70548,2,2867,116,2868,350,0
20141226.213902,2867,2,70550,0,2867,117,2868,350,0
20141226.213902,2868,2,70552,2,2867,118,2868,351,1
20141226.213904,2868,2,70554,0,2867,120,2868,350,1
20141226.213904,2867,2,70556,2,2867,119,2868,351,0
20141226.213907,2868,6,70562,6,2867,121,2868,352,1
20141226.213907,2868,4,70566,0,2867,121,2868,349,1
20141226.213909,2868,2,70568,0,2867,122,2868,370,1
20141226.213911,2867,2,70570,2,2867,118,2868,620,0
20141226.213911,2868,2,70572,-2,2867,119,2868,659,1
20141226.213912,2867,2,70574,0,2867,120,2868,658,0
20141226.213912,2867,2,70576,0,2867,122,2868,657,0
20141226.213913,2868,2,70578,0,2867,123,2868,656,1
20141226.213914,2867,2,70580,2,2867,124,2868,656,0
20141226.213914,2868,2,70582,-2,2867,124,2868,652,1
20141226.213915,2867,4,70586,4,2867,122,2868,652,0
20141226.213916,2867,8,70594,6,2867,124,2868,641,0
20141226.213919,2867,2,70596,2,2867,123,2868,644,0
20141226.21392,2868,2,70598,0,2867,124,2868,644,1
20141226.21392,2867,20,70618,0,2867,114,2868,644,0
20141226.213921,2867,6,70624,0,2867,111,2868,645,0
20141226.213921,2867,222,70846,104,2866,313,2867,29,0
20141226.213922,2867,2,70848,0,2866,312,2867,52,0
20141226.213924,2867,4,70852,4,2866,325,2867,50,0
20141226.213925,2867,10,70862,0,2866,325,2867,56,0
20141226.213927,2867,20,70882,2,2866,326,2867,52,0
20141226.213928,2867,2,70884,2,2866,307,2867,56,0
20141226.213929,2867,116,71000,34,2867,14,2868,657,0
20141226.213929,2867,28,71028,0,2866,332,2867,17,0
20141226.213932,2867,2,71030,0,2866,332,2867,51,0
20141226.213933,2867,2,71032,0,2866,332,2867,51,0
20141226.213934,2867,2,71034,0,2866,332,2867,50,0
20141226.213935,2867,54,71088,-14,2866,332,2867,24,0
20141226.213936,2867,2,71090,2,2866,333,2867,23,0
20141226.213942,2867,4,71094,0,2866,346,2867,53,0
20141226.213942,2867,2,71096,2,2866,346,2867,52,0
20141226.213947,2867,2,71098,0,2866,346,2867,54,0
20141226.213948,2867,2,71100,2,2866,345,2867,53,0
20141226.213949,2867,10,71110,10,2866,346,2867,48,0
20141226.213951,2866,10,71120,8,2866,342,2867,48,0
20141226.213951,2866,2,71122,-2,2866,341,2867,51,0
20141226.213953,2867,4,71126,4,2866,341,2867,51,1
20141226.213958,2867,2,71128,0,2866,341,2867,56,1
20141226.213959,2866,10,71138,-10,2866,336,2867,56,0
20141226.214,2867,2,71140,2,2866,356,2867,55,1
20141226.214002,2867,6,71146,-2,2866,358,2867,87,1
20141226.214003,2867,14,71160,-10,2866,358,2867,81,1
20141226.214004,2867,2,71162,0,2866,359,2867,80,1
20141226.214004,2866,8,71170,-8,2866,355,2867,80,0
20141226.214008,2867,2,71172,2,2866,358,2867,80,1
20141226.214008,2866,2,71174,0,2866,357,2867,80,0
20141226.21401,2866,2,71176,-2,2866,356,2867,80,0
20141226.21401,2867,2,71178,0,2866,356,2867,79,1
20141226.214011,2867,2,71180,2,2866,356,2867,77,1
20141226.214013,2866,10,71190,0,2866,349,2867,77,0
20141226.214015,2867,8,71198,0,2866,351,2867,74,1
20141226.214016,2867,40,71238,0,2866,351,2867,54,1
20141226.214016,2867,10,71248,10,2866,355,2867,49,1
20141226.214018,2866,8,71256,-2,2866,352,2867,54,0
20141226.214019,2866,102,71358,0,2866,302,2867,54,0
20141226.214019,2867,8,71366,-6,2866,302,2867,50,1
20141226.21402,2867,10,71376,4,2866,303,2867,45,1
20141226.214021,2867,2,71378,0,2866,302,2867,44,1
20141226.214026,2867,20,71398,-2,2866,308,2867,36,1
20141226.21403,2867,2,71400,2,2866,297,2867,39,1
20141226.21403,2867,2,71402,2,2866,297,2867,38,1
20141226.214034,2867,2,71404,0,2866,327,2867,90,1
20141226.214038,2867,8,71412,4,2866,324,2867,92,1
20141226.214045,2867,2,71414,0,2866,324,2867,104,1
20141226.214047,2867,12,71426,0,2866,324,2867,139,1
20141226.214048,2867,2,71428,2,2866,324,2867,138,1
20141226.21405,2867,2,71430,2,2866,324,2867,137,1
20141226.214058,2866,4,71434,-4,2866,321,2867,137,0
20141226.214104,2867,4,71438,0,2866,343,2867,137,1
20141226.214105,2867,4,71442,4,2866,343,2867,135,1
20141226.214106,2866,2,71444,0,2866,342,2867,135,0
20141226.214107,2867,4,71448,2,2866,340,2867,134,1
20141226.214109,2866,2,71450,2,2866,339,2867,134,0
20141226.214112,2867,2,71452,0,2866,335,2867,134,1
20141226.214117,2866,2,71454,2,2866,328,2867,137,0
20141226.214122,2867,4,71458,0,2866,328,2867,139,1
20141226.214128,2867,2,71460,-2,2866,331,2867,138,1
20141226.214131,2867,20,71480,-2,2866,331,2867,128,1
20141226.214141,2867,2,71482,2,2866,333,2867,129,1
20141226.214144,2867,8,71490,6,2866,333,2867,127,1
20141226.214201,2867,20,71510,20,2866,332,2867,366,1
20141226.214204,2867,2,71512,0,2866,332,2867,365,1
20141226.21421,2866,40,71552,40,2866,315,2867,378,0
20141226.21421,2867,2,71554,2,2866,315,2867,377,1
20141226.214216,2866,4,71558,0,2866,317,2867,378,0
20141226.214216,2866,4,71562,4,2866,316,2867,378,0
20141226.214218,2866,2,71564,0,2866,316,2867,379,0
20141226.214221,2866,20,71584,2,2866,304,2867,386,0
20141226.214223,2866,26,71610,26,2866,261,2867,383,0
20141226.214226,2867,20,71630,2,2866,261,2867,372,1
20141226.214228,2867,32,71662,-32,2866,261,2867,366,1
20141226.21423,2866,2,71664,0,2866,260,2867,367,0
20141226.214231,2866,2,71666,2,2866,259,2867,367,0
20141226.214233,2866,6,71672,6,2866,256,2867,369,0
20141226.214237,2866,6,71678,0,2866,252,2867,376,0
20141226.214238,2866,2,71680,2,2866,251,2867,376,0
20141226.214239,2866,20,71700,0,2866,241,2867,370,0
20141226.214241,2866,2,71702,2,2866,239,2867,372,0
20141226.21425,2867,20,71722,-16,2866,245,2867,362,1
20141226.214252,2866,2,71724,2,2866,244,2867,363,0
20141226.214253,2867,2,71726,0,2866,244,2867,363,1
20141226.214255,2866,2,71728,0,2866,237,2867,365,0
20141226.214257,2866,240,71968,118,2866,117,2867,374,0
20141226.214257,2866,234,72202,-60,2865,388,2866,263,0
20141226.214258,2866,4,72206,0,2865,388,2866,261,0
20141226.214259,2865,4,72210,-2,2865,386,2866,263,0
20141226.214259,2865,2,72212,0,2865,398,2866,266,0
20141226.214303,2866,2,72214,0,2865,398,2866,267,1
20141226.214303,2866,2,72216,0,2865,398,2866,266,1
20141226.214316,2865,22,72238,-22,2865,373,2866,381,0
20141226.214321,2865,2,72240,0,2865,374,2866,384,0
20141226.214322,2866,4,72244,-2,2865,373,2866,385,1
20141226.214324,2865,4,72248,-4,2865,375,2866,385,0
20141226.214327,2865,2,72250,0,2865,386,2866,385,0
20141226.214328,2866,2,72252,-2,2865,386,2866,384,1
20141226.214331,2865,2,72254,-2,2865,387,2866,384,0
20141226.214335,2865,2,72256,-2,2865,366,2866,387,0
20141226.214335,2865,2,72258,0,2865,365,2866,387,0
20141226.214338,2865,2,72260,-2,2865,364,2866,387,0
20141226.214341,2866,2,72262,0,2865,364,2866,406,1
20141226.214342,2865,2,72264,-2,2865,363,2866,406,0
20141226.214345,2866,10,72274,0,2865,368,2866,401,1
20141226.214346,2865,42,72316,-42,2865,356,2866,404,0
20141226.214349,2866,8,72324,0,2865,368,2866,509,1
20141226.214353,2866,40,72364,0,2865,370,2866,490,1
20141226.214354,2865,10,72374,0,2865,365,2866,491,0
20141226.214355,2865,2,72376,-2,2865,364,2866,491,0
20141226.214359,2865,2,72378,0,2865,364,2866,490,0
20141226.2144,2865,12,72390,-12,2865,358,2866,490,0
20141226.214403,2865,4,72394,-4,2865,356,2866,490,0
20141226.214403,2865,2,72396,-2,2865,355,2866,490,0
20141226.214413,2866,8,72404,0,2865,355,2866,485,1
20141226.214418,2866,2,72406,0,2865,355,2866,483,1
20141226.214419,2865,2,72408,0,2865,354,2866,483,0
20141226.214423,2865,20,72428,0,2865,341,2866,482,0
20141226.214427,2865,2,72430,-2,2865,342,2866,482,0
20141226.214427,2865,2,72432,0,2865,341,2866,483,0
20141226.214428,2865,2,72434,0,2865,340,2866,483,0
20141226.214429,2866,2,72436,0,2865,341,2866,482,1
20141226.214431,2866,2,72438,0,2865,341,2866,481,1
20141226.214435,2866,20,72458,-20,2865,352,2866,472,1
20141226.214439,2866,2,72460,0,2865,371,2866,470,1
20141226.21444,2866,2,72462,0,2865,372,2866,468,1
20141226.214444,2866,2,72464,0,2865,383,2866,472,1
20141226.214447,2865,48,72512,-48,2865,359,2866,477,0
20141226.214449,2865,2,72514,-2,2865,358,2866,477,0
20141226.214451,2865,2,72516,-2,2865,370,2866,477,0
20141226.214452,2865,2,72518,0,2865,372,2866,477,0
20141226.214453,2865,8,72526,-8,2865,368,2866,477,0
20141226.214455,2865,2,72528,0,2865,366,2866,477,0
20141226.214459,2866,32,72560,0,2865,351,2866,257,1
20141226.214459,2866,8,72568,8,2865,350,2866,256,1
20141226.214502,2865,2,72570,-2,2865,349,2866,257,0
20141226.214503,2866,2,72572,2,2865,350,2866,255,1
20141226.214504,2866,470,73042,36,2865,348,2867,161,1
20141226.214505,2866,52,73094,8,2866,29,2867,357,1
20141226.214505,2867,38,73132,2,2866,79,2867,340,1
20141226.214506,2867,4,73136,-4,2866,79,2867,338,1
20141226.214509,2866,2,73138,0,2866,79,2867,334,0
20141226.21451,2866,2,73140,0,2866,78,2867,334,0
20141226.214511,2866,4,73144,0,2866,88,2867,334,0
20141226.214513,2867,8,73152,0,2866,54,2867,291,1
20141226.214513,2867,2,73154,0,2866,54,2867,290,1
20141226.214514,2867,2,73156,0,2866,54,2867,288,1
20141226.214515,2866,10,73166,0,2866,62,2867,285,0
20141226.214518,2867,2,73168,0,2866,98,2867,284,1
20141226.214523,2866,12,73180,-12,2866,141,2867,285,0
20141226.214527,2867,2,73182,-2,2866,141,2867,283,1
20141226.214529,2867,2,73184,-2,2866,141,2867,282,1
20141226.214529,2866,14,73198,-8,2866,135,2867,281,0
20141226.21453,2866,2,73200,-2,2866,135,2867,281,0
20141226.21453,2866,2,73202,0,2866,134,2867,281,0
20141226.214534,2867,6,73208,0,2866,141,2867,289,1
20141226.214536,2867,2,73210,0,2866,141,2867,284,1
20141226.214537,2866,2,73212,-2,2866,140,2867,276,0
20141226.214538,2866,6,73218,-6,2866,137,2867,276,0
20141226.214538,2867,2,73220,0,2866,137,2867,275,1
20141226.214539,2866,2,73222,-2,2866,136,2867,276,0
20141226.214541,2866,4,73226,-2,2866,135,2867,278,0
20141226.214549,2866,10,73236,-10,2866,198,2867,301,0
20141226.21455,2867,2,73238,-2,2866,198,2867,302,1
20141226.214551,2866,4,73242,0,2866,195,2867,303,0
20141226.214553,2867,20,73262,-20,2866,125,2867,330,1
20141226.214556,2867,2,73264,0,2866,185,2867,329,1
20141226.214557,2866,2,73266,-2,2866,184,2867,329,0
20141226.214557,2867,4,73270,0,2866,184,2867,327,1
20141226.214558,2866,2,73272,0,2866,183,2867,327,0
20141226.214559,2866,4,73276,0,2866,182,2867,325,0
20141226.214559,2867,20,73296,2,2866,183,2867,275,1
20141226.214601,2867,4,73300,2,2866,187,2867,275,1
20141226.214607,2867,2,73302,0,2866,189,2867,277,1
20141226.214609,2867,2,73304,0,2866,250,2867,276,1
20141226.214611,2867,20,73324,-4,2866,250,2867,271,1
20141226.214612,2867,20,73344,18,2866,250,2867,261,1
20141226.214614,2867,2,73346,0,2866,250,2867,259,1
20141226.214615,2867,18,73364,0,2866,258,2867,250,1
20141226.214617,2866,10,73374,0,2866,254,2867,251,0
20141226.21462,2867,20,73394,-12,2866,255,2867,242,1
20141226.214622,2867,2,73396,2,2866,257,2867,243,1
20141226.214624,2867,2,73398,-2,2866,262,2867,244,1
20141226.214625,2866,4,73402,4,2866,260,2867,245,0
20141226.21463,2867,2,73404,0,2866,265,2867,244,1
20141226.214631,2867,20,73424,12,2866,265,2867,234,1
20141226.21464,2867,2,73426,2,2866,268,2867,234,1
20141226.214643,2867,2,73428,2,2866,268,2867,233,1
20141226.214647,2867,200,73628,22,2866,270,2868,420,1
20141226.214648,2867,60,73688,-60,2866,270,2868,882,1
20141226.21465,2867,2,73690,2,2866,282,2867,26,1
20141226.214655,2867,120,73810,120,2866,322,2867,27,1
20141226.214655,2866,14,73824,12,2866,319,2867,24,0
20141226.214656,2866,2,73826,-2,2866,318,2867,24,0
20141226.214702,2866,2,73828,2,2866,288,2867,38,0
20141226.214703,2867,20,73848,20,2866,308,2867,29,1
20141226.214705,2867,2,73850,0,2866,309,2867,28,1
20141226.214705,2867,2,73852,2,2866,320,2867,29,1
20141226.214706,2867,6,73858,4,2866,320,2867,26,1
20141226.214707,2867,2,73860,2,2866,320,2867,25,1
20141226.214708,2867,6,73866,4,2866,320,2867,24,1
20141226.214709,2867,2,73868,2,2866,320,2867,123,1
20141226.214711,2867,2,73870,2,2866,315,2867,123,1
20141226.214714,2866,6,73876,-6,2866,313,2867,168,0
20141226.21472,2867,2,73878,2,2866,317,2867,170,1
20141226.214723,2867,4,73882,2,2866,317,2867,169,1
20141226.214734,2867,2,73884,0,2866,331,2867,169,1
20141226.214746,2866,14,73898,0,2866,346,2867,207,0
20141226.214756,2866,2,73900,0,2866,346,2867,239,0
20141226.214804,2866,2,73902,-2,2866,345,2867,238,0
20141226.214806,2867,50,73952,22,2866,345,2867,214,1
20141226.214808,2866,6,73958,-2,2866,342,2867,214,0
20141226.214812,2867,2,73960,0,2866,343,2867,213,1
20141226.214817,2867,2,73962,0,2866,343,2867,212,1
20141226.214818,2866,6,73968,-2,2866,340,2867,213,0
20141226.214819,2867,2,73970,0,2866,340,2867,212,1
20141226.214819,2867,2,73972,0,2866,341,2867,211,1
20141226.214825,2867,24,73996,-24,2866,350,2867,209,1
20141226.214839,2866,2,73998,0,2866,356,2867,223,0
20141226.214841,2867,10,74008,-10,2866,369,2867,218,1
20141226.214842,2866,50,74058,-34,2866,349,2867,218,0
20141226.214853,2866,2,74060,-2,2866,431,2867,217,0
20141226.2149,2866,10,74070,-10,2866,426,2867,217,0
20141226.214901,2867,2,74072,0,2866,426,2867,216,1
20141226.214902,2866,2,74074,-2,2866,425,2867,216,0
20141226.214904,2867,4,74078,0,2866,427,2867,214,1
20141226.214914,2867,4,74082,-4,2866,454,2867,213,1
20141226.214916,2866,2,74084,0,2866,453,2867,213,0
20141226.214921,2867,16,74100,0,2866,461,2867,203,1
20141226.21493,2866,2,74102,0,2866,468,2867,207,0
20141226.214936,2866,28,74130,-28,2866,454,2867,208,0
20141226.214942,2866,2,74132,0,2866,453,2867,211,0
20141226.214948,2867,2,74134,0,2866,454,2867,209,1
20141226.214949,2867,20,74154,-20,2866,454,2867,199,1
20141226.214952,2867,270,74424,142,2866,454,2867,64,1
20141226.214953,2867,4,74428,0,2866,454,2867,62,1
20141226.214954,2867,2,74430,0,2866,454,2867,62,1
20141226.214954,2867,12,74442,-10,2866,454,2867,96,1
20141226.214955,2866,2,74444,-2,2866,475,2867,176,0
20141226.215001,2866,12,74456,-12,2866,469,2867,181,0
20141226.215004,2866,6,74462,0,2866,495,2867,181,0
20141226.215007,2866,2,74464,0,2866,496,2867,203,0
20141226.215009,2867,10,74474,0,2866,496,2867,200,1
20141226.215011,2866,4,74478,0,2866,495,2867,199,0
20141226.215016,2866,20,74498,-20,2866,587,2867,250,0
20141226.215018,2867,8,74506,-8,2866,587,2867,247,1
20141226.21502,2866,12,74518,-12,2866,580,2867,248,0
20141226.215021,2866,2,74520,0,2866,579,2867,248,0
20141226.215022,2867,100,74620,34,2866,579,2867,198,1
20141226.215026,2867,100,74720,0,2866,579,2867,152,1
20141226.215028,2867,2,74722,-2,2866,579,2867,151,1
20141226.215029,2867,2,74724,-2,2866,579,2867,216,1
20141226.215034,2867,2,74726,0,2866,578,2867,219,1
20141226.215036,2867,2,74728,0,2866,578,2867,218,1
20141226.21504,2867,100,74828,0,2866,579,2867,169,1
20141226.215041,2867,2,74830,0,2866,579,2867,168,1
20141226.215043,2867,2,74832,0,2866,580,2867,171,1
20141226.215046,2867,4,74836,0,2866,578,2867,170,1
20141226.215048,2867,2,74838,0,2866,578,2867,169,1
20141226.215056,2867,2,74840,0,2866,591,2867,165,1
20141226.215059,2867,2,74842,0,2866,591,2867,164,1
20141226.2151,2867,2,74844,0,2866,591,2867,163,1
20141226.2151,2866,10,74854,-6,2866,586,2867,163,0
20141226.215106,2866,2,74856,0,2866,487,2867,163,0
20141226.21511,2867,2,74858,0,2866,508,2867,165,1
20141226.215114,2867,2,74860,-2,2866,530,2867,173,1
20141226.215116,2867,4,74864,0,2866,530,2867,171,1
20141226.215125,2867,198,75062,182,2866,531,2867,74,1
20141226.215126,2867,84,75146,-68,2866,521,2868,475,1
20141226.215128,2866,26,75172,-20,2866,508,2868,475,0
20141226.215129,2867,66,75238,0,2867,12,2868,871,1
20141226.21513,2867,4,75242,0,2867,10,2868,871,1
20141226.21513,2867,2,75244,-2,2867,51,2868,871,1
20141226.215138,2867,2,75246,-2,2867,152,2868,870,1
20141226.215142,2868,4,75250,0,2867,155,2868,861,1
20141226.215143,2867,2,75252,0,2867,154,2868,862,0
20141226.215146,2867,10,75262,-10,2867,164,2868,856,0
20141226.215147,2867,2,75264,0,2867,178,2868,856,0
20141226.215148,2867,8,75272,-2,2867,189,2868,856,0
20141226.215153,2868,2,75274,0,2867,214,2868,854,1
20141226.215157,2867,2,75276,2,2867,214,2868,855,0
20141226.215158,2867,2,75278,2,2867,213,2868,855,0
20141226.215159,2868,2,75280,0,2867,215,2868,856,1
20141226.2152,2868,2,75282,0,2867,217,2868,855,1
20141226.215203,2868,2,75284,0,2867,217,2868,854,1
20141226.215203,2867,2,75286,2,2867,216,2868,854,0
20141226.215205,2868,10,75296,0,2867,219,2868,849,1
20141226.215213,2867,2,75298,0,2867,254,2868,853,0
20141226.215213,2868,6,75304,4,2867,254,2868,851,1
20141226.215215,2867,138,75442,-32,2866,234,2867,370,0
20141226.215215,2867,12,75454,-12,2866,234,2867,406,0
20141226.215216,2867,2,75456,0,2866,234,2867,405,0
20141226.215219,2866,2,75458,0,2866,233,2867,405,0
20141226.215226,2867,2,75460,0,2866,472,2867,406,1
20141226.215241,2867,2,75462,0,2866,599,2867,409,1
20141226.215247,2866,2,75464,0,2866,606,2867,409,0
20141226.215249,2867,2,75466,0,2866,606,2867,408,1
20141226.215259,2867,2,75468,0,2866,668,2867,409,1
20141226.215301,2867,2,75470,0,2866,668,2867,408,1
20141226.215304,2866,26,75496,-26,2866,665,2867,428,0
20141226.215304,2866,2,75498,0,2866,664,2867,428,0
20141226.215307,2866,2,75500,0,2866,663,2867,428,0
20141226.215311,2867,2,75502,-2,2866,662,2867,427,1
20141226.215315,2866,2,75504,-2,2866,663,2867,427,0
20141226.215318,2866,4,75508,-4,2866,662,2867,427,0
20141226.215319,2866,4,75512,-4,2866,660,2867,427,0
20141226.21532,2866,2,75514,0,2866,659,2867,427,0
20141226.215323,2867,20,75534,0,2866,689,2867,423,1
20141226.215326,2866,2,75536,-2,2866,688,2867,423,0
20141226.215329,2867,2,75538,0,2866,726,2867,422,1
20141226.21533,2867,44,75582,-44,2866,726,2867,400,1
20141226.215335,2866,2,75584,-2,2866,750,2867,399,0
20141226.215339,2867,2,75586,0,2866,749,2867,399,1
20141226.21534,2866,2,75588,0,2866,752,2867,399,0
20141226.215341,2867,2,75590,0,2866,767,2867,398,1
20141226.215345,2867,2,75592,0,2866,772,2867,397,1
20141226.215352,2867,4,75596,0,2866,772,2867,376,1
20141226.215355,2867,2,75598,0,2866,773,2867,375,1
20141226.215356,2866,2,75600,0,2866,787,2867,375,0
20141226.2154,2867,6,75606,0,2866,787,2867,385,1
20141226.215404,2867,2,75608,0,2866,787,2867,386,1
20141226.215407,2866,4,75612,-4,2866,796,2867,387,0
20141226.215418,2866,30,75642,0,2866,781,2867,395,0
20141226.215418,2866,12,75654,-12,2866,775,2867,395,0
20141226.215419,2866,10,75664,2,2866,776,2867,395,0
20141226.21542,2867,4,75668,0,2866,776,2867,393,1
20141226.215427,2866,4,75672,-4,2866,764,2867,394,0
20141226.215431,2866,6,75678,2,2866,758,2867,394,0
20141226.215431,2866,8,75686,8,2866,754,2867,395,0
20141226.215432,2866,2,75688,2,2866,753,2867,395,0
20141226.215433,2866,10,75698,-4,2866,748,2867,395,0
20141226.215434,2867,26,75724,6,2866,745,2867,385,1
20141226.215439,2867,2,75726,-2,2866,748,2867,392,1
20141226.21545,2866,2,75728,0,2866,764,2867,508,0
20141226.215503,2866,2,75730,0,2866,774,2867,208,0
20141226.215509,2866,2,75732,2,2866,772,2867,247,0
20141226.215511,2866,36,75768,-34,2866,771,2867,231,0
20141226.215513,2866,2,75770,0,2866,773,2867,232,0
20141226.215514,2867,34,75804,0,2866,773,2867,215,1
20141226.215518,2866,16,75820,-2,2866,809,2867,215,0
20141226.215528,2866,2,75822,0,2866,808,2867,382,0
20141226.21553,2867,2,75824,0,2866,808,2867,380,1
20141226.215532,2866,2,75826,2,2866,807,2867,380,0
20141226.215553,2867,2,75828,0,2866,769,2867,383,1
20141226.215554,2867,2,75830,-2,2866,769,2867,387,1
20141226.2156,2866,456,76286,-216,2865,1047,2866,73,0
20141226.2156,2866,10,76296,0,2865,1055,2866,68,0
20141226.215601,2866,136,76432,-126,2865,1055,2867,398,0
20141226.215606,2866,2,76434,0,2866,10,2867,399,0
20141226.215606,2866,40,76474,0,2865,1048,2867,399,0
20141226.21561,2866,68,76542,2,2866,9,2867,407,0
20141226.21561,2866,18,76560,0,2865,1049,2867,407,0
20141226.215616,2866,2,76562,-2,2865,1057,2866,14,0
20141226.215618,2865,18,76580,-4,2865,1048,2866,14,0
20141226.215619,2866,6,76586,2,2865,911,2866,145,1
20141226.215619,2865,4,76590,0,2865,909,2866,145,0
20141226.215623,2865,2,76592,2,2865,844,2866,150,0
20141226.215629,2865,30,76622,-16,2865,837,2866,191,0
20141226.215629,2866,2,76624,0,2865,837,2866,211,1
20141226.215631,2866,4,76628,-4,2865,837,2866,231,1
20141226.215638,2866,4,76632,-4,2865,837,2866,236,1
20141226.215651,2866,2,76634,-2,2865,836,2866,285,1
20141226.215651,2865,2,76636,0,2865,830,2866,290,0
20141226.215652,2865,2,76638,2,2865,829,2866,291,0
20141226.215654,2866,40,76678,-8,2865,834,2866,281,1
20141226.2157,2865,202,76880,32,2865,733,2866,303,0
20141226.215702,2865,2,76882,-2,2865,732,2866,303,0
20141226.215709,2865,30,76912,-18,2865,717,2866,311,0
20141226.21571,2865,16,76928,0,2865,710,2866,312,0
20141226.215715,2865,8,76936,0,2865,702,2866,324,0
20141226.215716,2865,2,76938,0,2865,702,2866,325,0
20141226.215718,2865,4,76942,-2,2865,701,2866,328,0
20141226.215719,2865,18,76960,-8,2865,692,2866,328,0
20141226.215724,2865,6,76966,6,2865,710,2866,338,0
20141226.215727,2865,2,76968,2,2865,709,2866,331,0
20141226.215728,2865,2,76970,0,2865,701,2866,330,0
20141226.215728,2865,2,76972,0,2865,700,2866,329,0
20141226.215733,2865,266,77238,36,2865,567,2866,335,0
20141226.215734,2865,266,77504,0,2865,426,2866,344,0
20141226.215735,2865,134,77638,-2,2865,359,2866,344,0
20141226.215735,2865,320,77958,-80,2865,199,2866,351,0
20141226.215736,2865,182,78140,-152,2865,108,2866,392,0
20141226.215736,2865,16,78156,8,2865,100,2866,392,0
20141226.215737,2865,4,78160,2,2865,98,2866,393,0
20141226.215737,2865,106,78266,56,2865,45,2866,393,0
20141226.215738,2865,10,78276,4,2865,40,2866,393,0
20141226.215739,2865,2,78278,2,2865,39,2866,426,0
20141226.21574,2865,4,78282,0,2865,37,2866,426,0
20141226.215741,2865,6,78288,2,2865,34,2866,426,0
20141226.215741,2865,2,78290,0,2865,33,2866,426,0
20141226.215742,2865,596,78886,-312,2864,1118,2866,362,0
20141226.215742,2865,2,78888,0,2864,1118,2865,4,0
20141226.215743,2865,8,78896,-8,2864,1126,2866,737,0
20141226.215744,2865,12,78908,6,2864,1127,2866,736,0
20141226.215745,2865,2,78910,2,2864,1132,2866,695,0
20141226.215747,2864,14,78924,0,2864,1126,2865,1,0
20141226.215748,2864,12,78936,0,2864,1120,2865,1,0
20141226.215748,2864,10,78946,0,2864,1115,2865,2,0
20141226.215751,2865,8,78954,-6,2865,11,2866,653,1
20141226.215752,2865,24,78978,0,2864,1125,2866,662,1
20141226.215752,2866,2,78980,2,2864,1125,2866,680,1
20141226.215753,2865,2,78982,2,2864,1125,2865,11,0
20141226.215754,2865,6,78988,0,2864,1125,2865,8,0
20141226.215754,2864,2,78990,2,2864,1123,2865,8,0
20141226.215757,2865,30,79020,14,2864,1123,2865,75,1
20141226.215758,2865,6,79026,6,2864,1128,2865,93,1
20141226.215759,2864,4,79030,2,2864,1126,2865,94,0
20141226.215802,2865,2,79032,2,2864,1128,2865,111,1
20141226.215804,2864,2,79034,2,2864,1128,2865,125,0
20141226.215805,2864,2,79036,2,2864,1128,2865,126,0
20141226.215805,2864,2,79038,2,2864,1127,2865,126,0
20141226.215806,2865,4,79042,2,2864,1126,2865,130,1
20141226.215807,2865,2,79044,2,2864,1129,2865,134,1
20141226.215808,2864,2,79046,0,2864,1128,2865,154,0
20141226.215808,2864,14,79060,4,2864,1121,2865,154,0
20141226.215809,2864,2,79062,2,2864,1124,2865,165,0
20141226.215815,2865,10,79072,10,2864,1124,2865,162,1
20141226.215817,2865,2,79074,2,2864,1123,2865,167,1
20141226.215817,2864,2,79076,2,2864,1123,2865,167,0
20141226.215818,2864,20,79096,0,2864,1113,2865,175,0
20141226.215818,2864,4,79100,4,2864,1111,2865,175,0
20141226.215819,2865,160,79260,-16,2864,1111,2865,95,1
20141226.215819,2865,180,79440,-80,2865,1,2866,556,1
20141226.21582,2865,22,79462,8,2865,2,2866,566,1
20141226.21582,2865,4,79466,-4,2864,1113,2866,566,1
20141226.215823,2865,38,79504,0,2864,1112,2866,565,1
20141226.215823,2865,8,79512,0,2864,1110,2865,1,1
20141226.215824,2865,4,79516,0,2864,1111,2866,564,1
20141226.215825,2864,12,79528,0,2864,1105,2865,10,0
20141226.215827,2864,4,79532,2,2864,1107,2865,19,0
20141226.215828,2865,40,79572,0,2864,1116,2865,24,1
20141226.215828,2865,48,79620,0,2864,1118,2866,557,1
20141226.215829,2864,44,79664,-2,2864,1098,2866,557,0
20141226.215829,2864,2,79666,2,2864,1097,2866,562,0
20141226.21583,2864,2,79668,2,2864,1097,2865,1,0
20141226.21583,2866,6,79674,2,2864,1097,2866,561,1
20141226.215834,2865,10,79684,10,2865,6,2866,563,0
20141226.215836,2865,12,79696,2,2865,2,2866,563,0
20141226.215836,2865,4,79700,4,2864,1102,2865,6,0
20141226.215837,2865,2,79702,2,2864,1102,2865,5,0
20141226.215838,2865,2,79704,2,2864,1102,2865,5,0
20141226.21584,2865,24,79728,8,2865,94,2866,574,0
20141226.215843,2865,20,79748,0,2865,91,2866,571,0
20141226.215844,2865,20,79768,0,2865,82,2866,571,0
20141226.215845,2865,166,79934,146,2864,1097,2865,27,0
20141226.215846,2865,58,79992,36,2865,25,2866,572,0
20141226.215847,2865,20,80012,-20,2865,17,2866,572,0
20141226.215849,2865,60,80072,-36,2864,1099,2865,10,0
20141226.21585,2865,100,80172,0,2864,1099,2866,573,0
20141226.215852,2865,2,80174,0,2864,1124,2866,574,0
20141226.215856,2865,22,80196,0,2864,1130,2866,583,0
20141226.215857,2865,4,80200,4,2864,1131,2866,584,0
20141226.215901,2865,20,80220,-10,2864,1130,2866,591,0
20141226.215901,2864,2,80222,0,2864,1129,2866,593,0
20141226.215902,2864,2,80224,2,2864,1129,2866,593,0
20141226.215902,2866,2,80226,0,2864,1129,2866,594,1
20141226.215907,2865,2,80228,2,2864,1132,2866,595,0
20141226.215909,2865,8,80236,6,2864,1132,2866,593,0
20141226.215909,2865,2,80238,0,2864,1132,2865,3,0
20141226.215911,2865,6,80244,6,2865,2,2866,563,0
20141226.215911,2866,104,80348,-10,2864,1132,2866,514,1
20141226.215914,2864,2,80350,2,2864,1131,2866,514,0
20141226.215915,2864,2,80352,0,2864,1136,2866,514,0
20141226.215916,2865,2,80354,0,2864,1136,2866,514,1
20141226.215917,2865,2,80356,2,2864,1136,2866,514,1
20141226.215918,2866,2,80358,-2,2864,1137,2865,1,1
20141226.21592,2864,2,80360,2,2864,1136,2865,1,0
20141226.215922,2865,2,80362,2,2865,1,2866,552,1
20141226.215923,2865,2,80364,0,2864,1136,2866,552,1
20141226.215928,2865,2,80366,0,2864,1136,2865,12,1
20141226.21593,2865,20,80386,-18,2864,1136,2865,5,1
20141226.215931,2865,26,80412,-4,2865,6,2866,553,1
20141226.215931,2865,12,80424,4,2864,1136,2866,553,1
20141226.215932,2864,4,80428,2,2864,1136,2865,10,0
20141226.215932,2865,2,80430,-2,2864,1136,2865,9,1
20141226.215934,2864,2,80432,0,2864,1135,2865,10,0
20141226.215935,2865,10,80442,0,2864,1135,2865,5,1
20141226.215939,2865,10,80452,-8,2864,1137,2865,17,1
20141226.215939,2865,2,80454,0,2864,1138,2865,16,1
20141226.215941,2865,2,80456,0,2864,1138,2865,17,1
20141226.215942,2864,2,80458,0,2864,1137,2865,17,0
20141226.215944,2865,2,80460,-2,2864,1137,2865,27,1
20141226.215948,2865,202,80662,-168,2865,10,2866,544,1
20141226.215948,2865,38,80700,18,2864,1140,2865,10,1
20141226.215949,2866,36,80736,0,2864,1140,2865,2,1
20141226.215953,2865,6,80742,-4,2864,1141,2865,6,0
20141226.215953,2864,4,80746,4,2864,1140,2865,7,0
20141226.215954,2865,2,80748,2,2864,1140,2865,22,1
20141226.215955,2865,2,80750,2,2864,1142,2865,22,1
20141226.215955,2864,2,80752,0,2864,1141,2865,23,0
20141226.215957,2865,10,80762,10,2864,1144,2865,23,1
20141226.220001,2865,12,80774,12,2864,1148,2865,17,1
20141226.220002,2866,56,80830,-16,2864,1148,2865,10,1
20141226.220002,2866,24,80854,0,2864,1148,2866,528,1
20141226.220003,2866,4,80858,0,2864,1148,2865,10,1
20141226.220004,2865,24,80882,8,2865,33,2866,527,0
20141226.220004,2865,2,80884,2,2865,32,2866,527,0
20141226.220005,2865,18,80902,0,2865,23,2866,527,0
20141226.220005,2865,46,80948,0,2864,1159,2866,527,0
20141226.220006,2865,2,80950,-2,2864,1159,2865,20,0
20141226.220007,2865,10,80960,10,2864,1158,2865,26,0
20141226.220008,2865,52,81012,14,2864,1158,2866,525,0
20141226.220009,2866,2,81014,2,2864,1158,2866,524,1
20141226.220011,2865,2,81016,0,2865,4,2866,524,0
20141226.220011,2865,8,81024,0,2865,10,2866,524,0
20141226.220012,2865,24,81048,-2,2864,1153,2866,529,0
20141226.220013,2865,20,81068,-10,2864,1153,2866,526,0
20141226.220015,2865,20,81088,20,2864,1155,2866,526,0
20141226.220016,2865,202,81290,114,2865,4,2866,525,0
20141226.220017,2865,8,81298,0,2864,1156,2866,525,0
20141226.220017,2865,10,81308,0,2864,1156,2865,12,0
20141226.220018,2865,12,81320,2,2864,1155,2865,6,0
20141226.220019,2865,10,81330,10,2864,1155,2865,4,0
20141226.220022,2865,68,81398,0,2864,1156,2866,526,0
20141226.220022,2864,4,81402,2,2864,1155,2866,528,0
20141226.220023,2865,4,81406,-4,2864,1157,2866,528,1
20141226.220024,2866,2,81408,0,2864,1158,2866,527,1
20141226.220025,2865,4,81412,0,2864,1158,2865,13,0
20141226.220026,2865,2,81414,0,2864,1158,2865,12,0
20141226.220026,2865,20,81434,20,2864,1159,2865,8,0
20141226.220029,2865,62,81496,56,2864,1158,2866,538,0
20141226.220032,2865,2,81498,0,2864,1157,2866,538,0
20141226.220033,2865,2,81500,0,2864,1157,2866,538,0
20141226.220033,2865,2,81502,0,2864,1159,2866,540,0
20141226.220035,2865,20,81522,-20,2864,1159,2865,6,0
20141226.220036,2865,12,81534,0,2864,1160,2866,544,0
20141226.220037,2865,10,81544,0,2864,1161,2865,2,0
20141226.220037,2865,4,81548,2,2864,1161,2866,546,0
20141226.220038,2865,2,81550,-2,2864,1161,2865,4,0
20141226.22004,2865,2,81552,2,2864,1162,2865,3,0
20141226.220044,2865,2,81554,2,2864,1170,2865,8,0
20141226.220045,2865,2,81556,0,2864,1170,2865,7,0
20141226.220045,2865,2,81558,2,2864,1170,2865,16,0
20141226.220046,2865,6,81564,2,2864,1170,2865,13,0
20141226.220051,2865,4,81568,0,2864,1207,2865,40,0
20141226.220052,2865,2,81570,2,2864,1205,2865,58,0
20141226.220056,2865,2,81572,-2,2864,1205,2865,61,0
20141226.220057,2865,2,81574,-2,2864,1224,2865,61,0
20141226.220059,2865,2,81576,0,2864,1224,2865,60,0
20141226.220059,2865,108,81684,70,2864,1224,2865,6,0
20141226.2201,2865,2,81686,2,2864,1224,2865,5,0
20141226.220102,2865,4,81690,0,2864,1237,2866,524,0
20141226.220102,2866,6,81696,-6,2864,1234,2866,523,1
20141226.220103,2865,2,81698,0,2864,1238,2865,10,0
20141226.220106,2865,4,81702,-4,2864,1238,2865,9,0
20141226.220106,2865,2,81704,0,2864,1238,2865,8,0
20141226.220108,2865,2,81706,0,2864,1239,2865,7,0
20141226.22011,2865,14,81720,-12,2865,318,2866,482,0
20141226.220113,2865,100,81820,-100,2865,270,2866,474,0
20141226.220114,2865,22,81842,-2,2865,259,2866,472,0
20141226.220118,2866,48,81890,38,2865,267,2866,491,1
20141226.22012,2865,12,81902,-12,2865,262,2866,490,0
20141226.220127,2865,2,81904,-2,2865,324,2866,492,0
20141226.220129,2865,4,81908,-4,2865,330,2866,492,0
20141226.220132,2866,72,81980,-32,2865,334,2866,447,1
20141226.220139,2865,4,81984,0,2865,354,2866,448,0
20141226.220148,2866,12,81996,0,2865,366,2866,450,1
20141226.220149,2866,2,81998,-2,2865,366,2866,449,1
20141226.22015,2865,10,82008,-10,2865,361,2866,449,0
20141226.220153,2866,2,82010,-2,2865,370,2866,458,1
20141226.220154,2866,38,82048,-30,2865,375,2866,439,1
20141226.220157,2865,2,82050,-2,2865,370,2866,430,0
20141226.220201,2866,2,82052,0,2865,370,2866,430,1
20141226.220205,2865,4,82056,-4,2865,372,2866,430,0
20141226.22021,2865,2,82058,0,2865,374,2866,432,0
20141226.220214,2866,42,82100,24,2865,382,2866,411,1
20141226.220214,2866,2,82102,2,2865,382,2866,410,1
20141226.220216,2865,2,82104,0,2865,381,2866,410,0
20141226.220218,2866,16,82120,0,2865,382,2866,404,1
20141226.220222,2865,2,82122,0,2865,382,2866,404,0
20141226.220228,2866,4,82126,0,2865,388,2866,402,1
20141226.220231,2866,16,82142,-16,2865,395,2866,394,1
20141226.220232,2866,4,82146,0,2865,400,2866,393,1
20141226.220234,2866,60,82206,-2,2865,378,2866,392,1
20141226.22024,2865,2,82208,0,2865,388,2866,393,0
20141226.220241,2866,2,82210,-2,2865,388,2866,392,1
20141226.220243,2866,2,82212,0,2865,389,2866,391,1
20141226.220247,2866,20,82232,-12,2865,394,2867,301,1
20141226.220249,2865,10,82242,-10,2865,390,2867,301,0
20141226.220254,2866,12,82254,-10,2865,391,2867,301,1
20141226.220255,2866,10,82264,0,2865,391,2867,301,1
20141226.220256,2866,2,82266,-2,2865,391,2867,301,1
20141226.220258,2865,2,82268,0,2865,435,2867,301,0
20141226.220259,2866,2,82270,0,2865,435,2867,301,1
20141226.220302,2866,12,82282,-12,2865,440,2867,301,1
20141226.220304,2865,4,82286,-4,2865,439,2867,301,0
20141226.220305,2866,158,82444,-158,2865,439,2867,303,1
20141226.220305,2866,10,82454,0,2865,439,2867,303,1
20141226.220311,2866,4,82458,2,2865,402,2867,265,1
20141226.220315,2866,2,82460,0,2865,403,2867,266,1
20141226.220317,2866,10,82470,-10,2865,403,2867,266,1
20141226.220317,2866,10,82480,0,2865,403,2867,266,1
20141226.220318,2865,8,82488,0,2865,399,2867,266,0
20141226.22032,2865,2,82490,0,2865,398,2867,267,0
20141226.220325,2866,10,82500,-10,2865,409,2867,287,1
20141226.220328,2866,2,82502,-2,2865,412,2867,287,1
20141226.22033,2865,2,82504,-2,2865,409,2867,297,0
20141226.220333,2866,8,82512,-8,2865,418,2867,299,1
20141226.220347,2866,4,82516,0,2865,435,2866,271,1
20141226.220348,2866,40,82556,0,2865,435,2867,297,1
20141226.220349,2865,2,82558,-2,2865,434,2867,297,0
20141226.220359,2866,62,82620,-62,2865,430,2867,298,1
20141226.2204,2866,4,82624,-4,2865,430,2867,298,1
20141226.220403,2866,240,82864,12,2865,427,2867,300,1
20141226.220407,2865,2,82866,-2,2865,441,2866,11,0
20141226.22041,2866,2,82868,2,2865,435,2866,20,1
20141226.22041,2866,8,82876,0,2865,435,2866,16,1
20141226.220412,2866,4,82880,2,2865,450,2866,14,1
20141226.220413,2865,40,82920,0,2865,430,2866,15,0
20141226.220419,2866,20,82940,-12,2865,429,2866,6,1
20141226.220421,2866,10,82950,2,2865,429,2866,3,1
20141226.220426,2866,10,82960,-2,2865,432,2866,9,1
20141226.220426,2866,2,82962,2,2865,432,2866,8,1
20141226.220427,2867,170,83132,152,2865,431,2867,580,1
20141226.220427,2867,4,83136,0,2865,434,2867,578,1
20141226.220428,2867,2,83138,0,2865,434,2867,577,1
20141226.22043,2866,4,83142,0,2865,431,2867,576,0
20141226.220434,2866,2,83144,-2,2865,426,2866,3,0
20141226.220434,2866,2,83146,-2,2865,426,2866,2,0
20141226.220435,2866,4,83150,0,2865,427,2867,578,0
20141226.220436,2866,2,83152,0,2865,423,2867,578,0
20141226.220438,2866,2,83154,0,2865,424,2867,579,0
20141226.220442,2867,4,83158,4,2865,446,2867,578,1
20141226.220446,2866,10,83168,8,2865,460,2867,583,0
20141226.220447,2867,6,83174,0,2865,459,2867,580,1
20141226.220451,2866,2,83176,0,2865,456,2867,583,0
20141226.220452,2866,2,83178,-2,2865,455,2867,583,0
20141226.220453,2866,2,83180,-2,2865,455,2867,583,0
20141226.220456,2867,2,83182,2,2865,457,2867,583,1
20141226.220457,2866,4,83186,0,2865,457,2866,1,0
20141226.220457,2866,2,83188,0,2865,457,2867,582,0
20141226.2205,2866,10,83198,-10,2865,457,2867,227,0
20141226.220503,2866,22,83220,-20,2865,457,2867,228,0
20141226.220504,2867,40,83260,40,2865,458,2867,570,1
20141226.220507,2866,2,83262,0,2865,458,2867,572,0
20141226.220509,2865,4,83266,-4,2865,456,2867,572,0
20141226.22051,2865,4,83270,0,2865,461,2867,572,0
20141226.220512,2866,40,83310,0,2865,461,2867,574,1
20141226.220516,2866,2,83312,-2,2865,460,2866,10,1
20141226.220525,2866,2,83314,2,2865,462,2866,14,1
20141226.220527,2866,28,83342,-8,2866,23,2867,616,1
20141226.220528,2866,66,83408,-66,2865,467,2867,616,1
20141226.220529,2866,2,83410,-2,2865,467,2867,616,1
20141226.22053,2866,20,83430,0,2865,467,2867,617,1
20141226.22053,2866,20,83450,0,2865,467,2867,616,1
20141226.220531,2866,2,83452,0,2865,467,2866,10,1
20141226.220535,2865,4,83456,-4,2865,466,2866,10,0
20141226.22054,2866,2,83458,0,2865,458,2866,40,1
20141226.22054,2866,2,83460,2,2865,458,2866,39,1
20141226.220542,2866,4,83464,0,2865,442,2866,36,1
20141226.220545,2866,2,83466,2,2865,452,2866,36,1
20141226.220547,2866,100,83566,10,2866,10,2867,618,1
20141226.220547,2866,14,83580,-14,2866,3,2867,618,1
20141226.22055,2867,2,83582,2,2866,3,2867,617,1
20141226.22055,2866,2,83584,0,2866,2,2867,617,0
20141226.220552,2866,6,83590,-4,2865,442,2867,618,0
20141226.220554,2866,22,83612,12,2865,444,2867,616,0
20141226.220556,2865,30,83642,0,2865,429,2867,617,0
20141226.220557,2866,2,83644,0,2865,440,2867,619,1
20141226.2206,2867,2,83646,2,2865,440,2867,653,1
20141226.220601,2866,2,83648,-2,2865,440,2867,653,0
20141226.220603,2866,2,83650,-2,2865,438,2867,658,0
20141226.220604,2866,14,83664,-4,2866,93,2867,658,0
20141226.220605,2866,4,83668,0,2866,91,2867,708,0
20141226.220605,2866,182,83850,-2,2865,438,2867,708,0
20141226.220607,2866,2,83852,0,2865,437,2867,708,0
20141226.220609,2867,2,83854,2,2865,437,2867,707,1
20141226.220618,2867,4,83858,2,2866,14,2867,705,1
20141226.220621,2867,2,83860,2,2866,66,2867,705,1
20141226.220624,2866,2,83862,2,2866,70,2867,704,0
20141226.220625,2866,6,83868,0,2866,70,2867,702,0
20141226.220628,2867,38,83906,24,2866,72,2867,683,1
20141226.22063,2866,2,83908,2,2866,72,2867,684,0
20141226.220632,2866,2,83910,2,2866,74,2867,685,0
20141226.220641,2867,2,83912,2,2866,76,2867,695,1
20141226.220643,2866,12,83924,0,2866,70,2867,696,0
20141226.220644,2866,92,84016,-86,2866,29,2867,696,0
20141226.220645,2866,56,84072,20,2866,3,2867,707,0
20141226.220648,2866,602,84674,-580,2866,2,2867,495,0
20141226.220649,2866,2,84676,0,2865,435,2867,494,0
20141226.220655,2866,6,84682,0,2865,435,2867,492,0
20141226.220656,2866,2,84684,0,2865,436,2867,492,0
20141226.220657,2866,10,84694,10,2865,436,2867,487,0
20141226.220658,2865,2,84696,-2,2865,435,2867,487,0
20141226.2207,2865,10,84706,10,2865,435,2867,483,0
20141226.220702,2867,2,84708,0,2865,436,2867,483,1
20141226.220708,2866,8,84716,-8,2865,450,2867,483,0
20141226.22071,2866,2,84718,0,2866,10,2867,483,0
20141226.220715,2866,2,84720,0,2866,10,2867,486,0
20141226.220718,2866,202,84922,200,2866,9,2867,388,0
20141226.220718,2866,2,84924,0,2866,9,2867,388,0
20141226.220719,2866,6,84930,0,2866,9,2867,385,0
20141226.220719,2866,2,84932,0,2866,8,2867,385,0
20141226.22072,2866,10,84942,10,2866,8,2867,380,0
20141226.220724,2866,2,84944,0,2866,21,2867,380,0
20141226.220724,2866,4,84948,0,2866,19,2867,380,0
20141226.220726,2866,4,84952,-4,2866,17,2867,380,0
20141226.220728,2866,2,84954,0,2866,16,2867,380,0
20141226.220729,2866,8,84962,-4,2866,12,2867,380,0
20141226.220729,2866,2,84964,0,2866,11,2867,379,0
20141226.220733,2866,40,85004,18,2865,426,2867,345,0
20141226.220733,2866,2,85006,2,2865,426,2867,345,0
20141226.220737,2866,14,85020,14,2865,427,2867,346,0
20141226.220739,2865,2,85022,-2,2865,426,2867,346,0
20141226.220742,2866,10,85032,10,2865,426,2866,7,1
20141226.220748,2866,10,85042,10,2865,428,2867,350,1
20141226.220757,2865,2,85044,-2,2865,422,2866,9,0
20141226.220801,2865,10,85054,0,2865,417,2866,13,0
20141226.220803,2866,18,85072,-6,2865,417,2866,5,1
20141226.220809,2865,10,85082,2,2865,414,2866,30,0
20141226.220818,2865,20,85102,-20,2865,419,2866,40,0
20141226.220822,2866,4,85106,4,2865,423,2866,42,1
20141226.220823,2866,12,85118,12,2865,423,2866,36,1
20141226.220827,2866,4,85122,4,2865,423,2866,37,1
20141226.220838,2865,20,85142,-14,2865,416,2866,35,0
20141226.220841,2865,2,85144,0,2865,415,2866,35,0
20141226.220852,2865,4,85148,-4,2865,410,2866,83,0
20141226.220903,2865,2,85150,-2,2865,414,2866,86,0
20141226.220905,2865,2,85152,-2,2865,411,2866,86,0
20141226.220926,2865,4,85156,-4,2865,412,2866,106,0
20141226.220931,2866,2,85158,-2,2865,413,2866,106,1
20141226.220935,2867,1500,86658,-838,2866,40,2868,1150,1
20141226.220936,2867,82,86740,-82,2867,209,2868,1148,1
20141226.220936,2867,12,86752,-2,2867,203,2868,1148,1
20141226.220937,2867,10,86762,0,2867,448,2868,1148,1
20141226.220939,2867,2,86764,-2,2866,40,2868,1148,1
20141226.220942,2866,20,86784,-20,2866,68,2867,11,0
20141226.220943,2866,2,86786,-2,2866,67,2867,20,0
20141226.220944,2867,4,86790,0,2866,72,2867,9,1
20141226.220945,2866,2,86792,-2,2866,71,2867,9,0
20141226.220948,2867,20,86812,20,2866,113,2867,1,1
20141226.220953,2866,4,86816,2,2866,134,2867,10,0
20141226.220958,2867,2,86818,2,2866,142,2867,9,1
20141226.221,2866,12,86830,0,2866,141,2867,10,0
20141226.221002,2866,8,86838,0,2866,139,2867,18,0
20141226.221003,2867,2,86840,0,2866,144,2867,17,1
20141226.221004,2867,2,86842,0,2866,144,2867,26,1
20141226.221006,2867,2,86844,0,2866,144,2867,33,1
20141226.221013,2867,2,86846,0,2866,164,2867,40,1
20141226.221017,2866,4,86850,0,2866,162,2867,54,0
20141226.221018,2867,2,86852,0,2866,163,2867,53,1
20141226.221038,2867,140,86992,44,2866,178,2867,30,1
20141226.22104,2867,2,86994,-2,2866,179,2867,29,1
20141226.221042,2867,6,87000,-6,2866,180,2867,25,1
20141226.221043,2867,28,87028,-28,2866,180,2867,11,1
20141226.221045,2867,10,87038,-10,2866,180,2867,6,1
20141226.221045,2866,18,87056,-8,2866,179,2867,1,0
20141226.221046,2867,2,87058,-2,2866,179,2868,1233,1
20141226.221048,2867,10,87068,0,2866,179,2868,846,1
20141226.221054,2867,2,87070,0,2866,176,2868,1100,1
20141226.221058,2867,4,87074,-4,2867,19,2868,1099,1
20141226.221059,2867,8,87082,-8,2867,15,2868,1100,1
20141226.221059,2867,18,87100,0,2867,6,2868,1099,1
20141226.2211,2867,12,87112,0,2866,184,2868,1099,1
20141226.221102,2866,2,87114,2,2866,188,2867,11,0
20141226.221102,2866,10,87124,10,2866,183,2867,11,0
20141226.221105,2866,22,87146,22,2866,179,2867,6,0
20141226.221106,2867,10,87156,0,2866,179,2867,1,1
20141226.221108,2867,4,87160,2,2866,182,2868,734,1
20141226.221116,2867,2,87162,2,2866,152,2867,297,1
20141226.221119,2867,4,87166,2,2866,158,2867,296,1
20141226.221122,2866,40,87206,-36,2866,141,2867,295,0
20141226.221123,2867,10,87216,6,2866,136,2868,748,1
20141226.221124,2867,500,87716,-412,2866,138,2868,748,1
20141226.221125,2868,4,87720,0,2867,249,2868,1078,1
20141226.221125,2867,6,87726,-4,2867,249,2868,1079,0
20141226.221127,2868,4,87730,2,2867,249,2868,1078,1
20141226.221127,2868,4,87734,4,2867,247,2868,1076,1
20141226.221128,2868,10,87744,0,2867,247,2868,1071,1
20141226.221128,2868,500,88244,-88,2867,247,2868,822,1
20141226.221129,2868,1000,89244,-350,2867,255,2869,236,1
20141226.221129,2868,500,89744,-122,2868,3,2869,308,1
20141226.22113,2868,4,89748,-2,2868,11,2869,308,1
20141226.221131,2869,2,89750,-2,2868,33,2869,307,1
20141226.221132,2869,36,89786,-24,2868,33,2869,289,1
20141226.221132,2869,4,89790,-4,2868,53,2869,287,1
20141226.221133,2868,46,89836,16,2868,33,2869,284,0
20141226.221133,2869,4,89840,0,2868,35,2869,282,1
20141226.221134,2869,4,89844,4,2868,35,2869,279,1
20141226.221134,2868,6,89850,2,2868,32,2869,279,0
20141226.221135,2869,16,89866,16,2868,35,2869,271,1
20141226.221136,2868,2,89868,-2,2868,34,2869,271,0
20141226.221136,2868,6,89874,0,2868,32,2869,271,0
20141226.221137,2868,10,89884,-10,2868,30,2869,273,0
20141226.221138,2868,2,89886,-2,2868,30,2869,283,0
20141226.221139,2869,10,89896,6,2868,27,2869,281,1
20141226.22114,2868,6,89902,6,2868,26,2869,279,0
20141226.22114,2869,40,89942,-2,2868,26,2869,259,1
20141226.221141,2869,2,89944,-2,2868,28,2869,258,1
20141226.221141,2868,22,89966,22,2868,17,2869,248,0
20141226.221142,2868,2,89968,0,2868,18,2869,248,0
20141226.221143,2869,4,89972,0,2868,18,2869,248,1
20141226.221144,2868,6,89978,2,2868,17,2869,257,0
20141226.221145,2869,28,90006,-20,2868,7,2869,254,1
20141226.221146,2869,10,90016,-8,2868,7,2869,273,1
20141226.221146,2868,2,90018,2,2868,6,2869,274,0
20141226.221147,2868,12,90030,10,2867,93,2868,4,0
20141226.221147,2868,10,90040,10,2867,93,2868,21,0
20141226.221149,2868,2,90042,2,2867,107,2868,22,0
20141226.22115,2868,20,90062,18,2867,107,2868,13,0
20141226.221151,2868,2,90064,0,2867,108,2868,12,0
20141226.221151,2868,2,90066,-2,2867,108,2868,11,0
20141226.221152,2868,12,90078,-6,2867,108,2868,10,0
20141226.221152,2868,2,90080,0,2867,108,2868,9,0
20141226.221153,2868,2,90082,2,2867,113,2868,8,0
20141226.221154,2868,2,90084,2,2867,116,2868,7,0
20141226.221155,2868,30,90114,-6,2868,1,2869,322,0
20141226.221156,2868,20,90134,2,2868,3,2869,323,0
20141226.221157,2868,2,90136,0,2868,2,2869,325,0
20141226.221157,2868,4,90140,4,2867,124,2868,18,0
20141226.221201,2868,4,90144,2,2867,131,2868,41,0
20141226.221201,2868,2,90146,2,2867,131,2868,45,0
20141226.221202,2868,2,90148,0,2867,132,2868,49,0
20141226.221203,2868,12,90160,0,2867,138,2868,44,0
20141226.221208,2868,20,90180,20,2867,139,2868,40,0
20141226.221208,2867,2,90182,2,2867,138,2868,40,0
20141226.22121,2867,2,90184,0,2867,132,2868,40,0
20141226.221211,2868,2,90186,0,2867,132,2868,40,1
20141226.221211,2868,4,90190,4,2867,132,2868,38,1
20141226.221212,2868,2,90192,2,2867,136,2868,36,1
20141226.221214,2867,40,90232,40,2867,124,2868,36,0
20141226.221216,2868,22,90254,14,2867,98,2868,38,1
20141226.22122,2867,22,90276,-18,2867,87,2868,107,0
20141226.221221,2868,2,90278,0,2867,85,2868,107,1
20141226.221222,2867,2,90280,0,2867,84,2868,109,0
20141226.221223,2867,12,90292,10,2867,78,2868,110,0
20141226.221224,2867,2,90294,0,2867,77,2868,114,0
20141226.221225,2867,20,90314,20,2867,66,2868,117,0
20141226.221227,2868,2,90316,2,2867,66,2868,130,1
20141226.221228,2867,4,90320,2,2867,77,2868,129,0
20141226.221228,2867,20,90340,20,2867,67,2868,129,0
20141226.221229,2867,20,90360,12,2867,77,2868,144,0
20141226.221231,2867,8,90368,0,2867,74,2868,145,0
20141226.221235,2868,2,90370,-2,2867,79,2868,213,1
20141226.221239,2867,2,90372,0,2867,98,2868,233,0
20141226.221243,2868,10,90382,-6,2867,112,2868,238,1
20141226.221254,2868,2,90384,2,2867,114,2868,242,1
20141226.221254,2868,2,90386,2,2867,114,2868,242,1
20141226.221258,2867,4,90390,0,2867,102,2868,252,0
20141226.221305,2868,2,90392,2,2867,104,2868,442,1
20141226.221311,2868,2,90394,2,2867,102,2868,445,1
20141226.221314,2867,2,90396,-2,2867,112,2868,445,0
20141226.221316,2868,2,90398,2,2867,114,2868,445,1
20141226.221321,2868,2,90400,2,2867,115,2868,447,1
20141226.221323,2867,4,90404,4,2867,113,2868,447,0
20141226.221323,2867,6,90410,6,2867,110,2868,447,0
20141226.221325,2867,28,90438,24,2867,100,2868,443,0
20141226.221325,2868,2,90440,2,2867,100,2868,442,1
20141226.221334,2867,4,90444,0,2867,105,2868,448,0
20141226.221336,2867,2,90446,0,2867,105,2868,447,0
20141226.221342,2868,2,90448,-2,2867,115,2868,447,1
20141226.221347,2867,40,90488,32,2867,95,2868,447,0
20141226.221352,2867,2,90490,0,2867,94,2868,452,0
20141226.221353,2867,4,90494,0,2867,98,2868,452,0
20141226.221357,2867,22,90516,-10,2867,87,2868,450,0
20141226.221358,2867,2,90518,2,2867,86,2868,450,0
20141226.221401,2867,2,90520,2,2867,85,2868,457,0
20141226.221402,2867,2,90522,0,2867,84,2868,457,0
20141226.221403,2867,4,90526,4,2867,83,2868,459,0
20141226.221405,2867,40,90566,38,2867,63,2868,470,0
20141226.221407,2868,2,90568,0,2867,63,2868,471,1
20141226.221408,2868,500,91068,-148,2867,71,2868,225,1
20141226.221409,2868,450,91518,-94,2868,25,2869,373,1
20141226.221413,2868,2,91520,-2,2868,9,2869,373,1
20141226.221413,2868,2,91522,-2,2868,8,2869,373,1
20141226.221414,2868,12,91534,-8,2868,2,2869,372,1
20141226.221415,2868,4,91538,0,2867,149,2869,372,1
20141226.221419,2868,4,91542,4,2867,182,2868,9,1
20141226.221424,2868,2,91544,0,2867,147,2868,139,1
20141226.221425,2868,2,91546,2,2867,147,2868,138,1
20141226.22143,2868,6,91552,6,2867,149,2868,136,1
20141226.221431,2868,2,91554,2,2867,151,2868,136,1
20141226.221431,2867,6,91560,0,2867,148,2868,136,0
20141226.221434,2867,6,91566,0,2867,145,2868,146,0
20141226.22144,2867,32,91598,-12,2867,134,2868,147,0
20141226.221441,2868,20,91618,6,2867,134,2868,137,1
20141226.221445,2868,2,91620,-2,2867,178,2868,140,1
20141226.221455,2868,2,91622,-2,2867,177,2868,152,1
20141226.2215,2868,2,91624,0,2867,180,2868,155,1
20141226.221502,2868,6,91630,0,2867,178,2868,152,1
20141226.221505,2868,20,91650,0,2867,178,2868,142,1
20141226.221506,2868,20,91670,0,2867,177,2868,131,1
20141226.221506,2867,8,91678,4,2867,173,2868,131,0
20141226.221507,2868,8,91686,0,2867,173,2868,128,1
20141226.221507,2868,16,91702,-8,2867,173,2868,123,1
20141226.221508,2868,16,91718,0,2867,173,2868,115,1
20141226.221508,2868,2,91720,0,2867,173,2868,114,1
20141226.221509,2868,80,91800,0,2867,176,2868,74,1
20141226.22151,2868,2,91802,-2,2867,178,2868,73,1
20141226.22151,2868,2,91804,-2,2867,217,2868,72,1
20141226.221511,2868,4,91808,0,2867,217,2868,70,1
20141226.221512,2868,100,91908,16,2867,269,2868,20,1
20141226.221513,2868,4,91912,-4,2867,274,2868,23,1
20141226.221513,2868,2,91914,0,2867,274,2868,22,1
20141226.221514,2868,22,91936,-10,2867,214,2868,22,1
20141226.221515,2868,2,91938,0,2867,209,2868,21,1
20141226.221516,2868,44,91982,40,2868,3,2869,588,1
20141226.221517,2869,12,91994,0,2867,210,2869,587,1
20141226.221517,2869,10,92004,-10,2867,210,2869,583,1
20141226.221519,2868,2,92006,2,2867,213,2868,9,0
20141226.221521,2868,18,92024,18,2868,17,2869,600,0
20141226.221526,2868,6,92030,6,2868,237,2869,615,0
20141226.221528,2868,2,92032,0,2868,242,2869,611,0
20141226.221529,2868,2,92034,0,2868,243,2869,611,0
20141226.221533,2868,2,92036,0,2868,245,2869,616,0
20141226.221534,2868,4,92040,4,2868,243,2869,617,0
20141226.221543,2868,8,92048,0,2868,242,2869,664,0
20141226.221549,2868,2,92050,0,2868,244,2869,630,0
20141226.221554,2868,6,92056,6,2868,241,2869,634,0
20141226.221555,2868,2,92058,2,2868,240,2869,628,0
20141226.221557,2869,12,92070,-2,2868,240,2869,623,1
20141226.221558,2869,6,92076,-6,2868,240,2869,620,1
20141226.221604,2869,4,92080,-2,2868,243,2869,770,1
20141226.221605,2869,2,92082,0,2868,243,2869,769,1
20141226.221611,2868,2,92084,0,2868,262,2869,784,0
20141226.221612,2868,2,92086,0,2868,269,2869,781,0
20141226.221612,2869,2,92088,0,2868,269,2869,780,1
20141226.221614,2868,2,92090,-2,2868,275,2869,799,0
20141226.221619,2869,2,92092,0,2868,281,2869,774,1
20141226.221623,2868,10,92102,0,2868,282,2869,744,0
20141226.221623,2868,18,92120,0,2868,273,2869,745,0
20141226.221626,2869,2,92122,0,2868,275,2869,751,1
20141226.221629,2869,2,92124,0,2868,275,2869,751,1
20141226.22163,2868,2,92126,2,2868,274,2869,752,0
20141226.221631,2869,400,92526,-204,2868,274,2869,555,1
20141226.221632,2868,4,92530,0,2868,275,2869,515,0
20141226.221633,2868,2,92532,0,2868,274,2869,515,0
20141226.221637,2869,6,92538,0,2868,279,2869,516,1
20141226.221638,2869,8,92546,-8,2868,280,2869,513,1
20141226.221639,2869,2,92548,0,2868,278,2869,512,1
20141226.22164,2868,2,92550,2,2868,277,2869,512,0
20141226.22164,2869,26,92576,4,2868,277,2869,499,1
20141226.221642,2869,10,92586,-10,2868,327,2869,553,1
20141226.221644,2869,12,92598,-10,2868,327,2869,568,1
20141226.221646,2869,2,92600,0,2868,327,2869,567,1
20141226.221647,2868,20,92620,0,2868,328,2869,576,0
20141226.221648,2868,4,92624,0,2868,326,2869,576,0
20141226.221648,2869,2,92626,2,2868,326,2869,575,1
20141226.221651,2868,4,92630,4,2868,324,2869,576,0
20141226.221651,2869,12,92642,-8,2868,322,2869,572,1
20141226.221654,2869,2,92644,0,2868,323,2869,574,1
20141226.221656,2868,4,92648,0,2868,369,2869,573,0
20141226.221703,2869,10,92658,-6,2868,375,2869,636,1
20141226.221706,2868,12,92670,0,2868,378,2869,638,0
20141226.221707,2868,2,92672,0,2868,377,2869,644,0
20141226.221709,2868,54,92726,0,2868,350,2869,646,0
20141226.22171,2869,4,92730,4,2868,361,2869,645,1
20141226.221712,2869,2,92732,2,2868,362,2869,653,1
20141226.221717,2869,4,92736,0,2868,371,2869,658,1
20141226.221717,2869,10,92746,-10,2868,371,2869,652,1
20141226.221723,2869,8,92754,0,2868,386,2869,638,1
20141226.221727,2868,204,92958,-2,2868,285,2869,648,0
20141226.221727,2868,4,92962,0,2868,283,2869,648,0
20141226.221729,2868,2,92964,2,2868,283,2869,650,0
20141226.22173,2869,8,92972,0,2868,283,2869,648,1
20141226.221731,2868,4,92976,0,2868,282,2869,648,0
20141226.221734,2869,6,92982,-2,2868,287,2869,653,1
20141226.221736,2868,4,92986,4,2868,290,2869,638,0
20141226.221736,2869,2,92988,0,2868,290,2869,639,1
20141226.221738,2868,2,92990,0,2868,289,2869,656,0
20141226.221738,2869,2,92992,-2,2868,289,2869,655,1
20141226.221739,2869,2,92994,0,2868,289,2869,655,1
20141226.221739,2869,2,92996,0,2868,289,2869,646,1
20141226.22174,2868,2,92998,0,2868,288,2869,642,0
20141226.221742,2869,4,93002,0,2868,287,2869,641,1
20141226.221744,2869,2,93004,0,2868,289,2869,643,1
20141226.221749,2869,4,93008,-4,2868,289,2869,640,1
20141226.221749,2869,20,93028,14,2868,289,2869,629,1
20141226.22175,2868,2,93030,2,2868,313,2869,631,0
20141226.221751,2868,40,93070,40,2868,293,2869,633,0
20141226.221752,2869,4,93074,4,2868,291,2869,633,1
20141226.221753,2869,20,93094,6,2868,291,2869,623,1
20141226.221754,2868,2,93096,2,2868,285,2869,623,0
20141226.221755,2868,42,93138,2,2868,265,2869,630,0
20141226.221755,2868,4,93142,2,2868,263,2869,630,0
20141226.221758,2868,2,93144,0,2868,267,2869,630,0
20141226.221759,2868,2,93146,0,2868,267,2869,630,0
20141226.2218,2869,64,93210,-4,2868,269,2869,598,1
20141226.2218,2868,2,93212,0,2868,268,2869,598,0
20141226.221802,2869,4,93216,0,2868,269,2869,596,1
20141226.221803,2869,18,93234,0,2868,268,2869,597,1
20141226.221804,2868,2,93236,0,2868,266,2869,598,0
20141226.221805,2868,10,93246,-2,2868,261,2869,599,0
20141226.221805,2868,2,93248,0,2868,260,2869,600,0
20141226.221806,2868,2,93250,0,2868,259,2869,601,0
20141226.221809,2868,2,93252,0,2868,265,2869,597,0
20141226.22181,2869,20,93272,0,2868,265,2869,588,1
20141226.221812,2869,20,93292,0,2868,266,2869,563,1
20141226.221812,2868,2,93294,2,2868,265,2869,563,0
20141226.221813,2868,2,93296,2,2868,264,2869,563,0
20141226.221815,2869,12,93308,2,2868,263,2869,570,1
20141226.221816,2868,2,93310,2,2868,261,2869,570,0
20141226.22182,2868,4,93314,4,2868,262,2869,565,0
20141226.221821,2868,20,93334,0,2868,252,2869,556,0
20141226.221822,2869,2,93336,-2,2868,252,2869,555,1
20141226.221824,2868,4,93340,0,2868,251,2869,554,0
20141226.221828,2869,6,93346,2,2868,271,2869,571,1
20141226.221829,2869,2,93348,-2,2868,271,2869,561,1
20141226.221829,2868,2,93350,0,2868,270,2869,561,0
20141226.22183,2869,2,93352,0,2868,270,2869,556,1
20141226.221833,2869,4,93356,2,2868,270,2869,555,1
20141226.221834,2869,2,93358,0,2868,270,2869,559,1
20141226.221836,2869,100,93458,0,2868,271,2869,509,1
20141226.221839,2868,2,93460,2,2868,271,2869,502,0
20141226.221843,2869,2,93462,0,2868,275,2869,504,1
20141226.221845,2869,2,93464,0,2868,225,2869,492,1
20141226.221846,2868,2,93466,2,2868,224,2869,492,0
20141226.221846,2869,100,93566,18,2868,224,2869,443,1
20141226.221847,2869,2,93568,0,2868,224,2869,442,1
20141226.221851,2869,894,94462,-330,2869,23,2870,1384,1
20141226.221852,2869,6,94468,-2,2869,20,2870,1384,1
20141226.221853,2869,2,94470,-2,2869,72,2870,1384,1
20141226.221854,2869,2,94472,0,2869,71,2870,1384,1
20141226.221855,2869,12,94484,8,2869,70,2870,1379,1
20141226.221856,2869,2,94486,0,2869,69,2870,1379,1
20141226.221857,2869,4,94490,-2,2869,132,2870,1379,1
20141226.221858,2869,12,94502,0,2869,191,2870,1379,1
20141226.221859,2870,2,94504,2,2869,191,2870,1378,1
20141226.221859,2869,44,94548,-26,2869,193,2870,1367,0
20141226.221859,2870,4,94552,-4,2869,193,2870,1365,1
20141226.221901,2869,2,94554,0,2869,235,2870,1366,0
20141226.221901,2869,4,94558,0,2869,235,2870,1366,0
20141226.221904,2869,2,94560,2,2869,242,2870,1362,0
20141226.221904,2870,4,94564,0,2869,242,2870,1360,1
20141226.221905,2870,6,94570,2,2869,253,2870,1359,1
20141226.221906,2870,10,94580,2,2869,255,2870,1354,1
20141226.221907,2870,2,94582,2,2869,255,2870,1353,1
20141226.221907,2870,2706,97288,-922,2870,2647,2871,716,1
20141226.221908,2871,468,97756,158,2870,2652,2871,477,1
20141226.221908,2871,202,97958,190,2870,2652,2871,376,1
20141226.221909,2871,784,98742,404,2870,2644,2872,931,1
20141226.221909,2871,14,98756,-2,2871,20,2872,925,1
20141226.22191,2871,2,98758,-2,2871,27,2872,923,1
20141226.221911,2872,64,98822,4,2871,20,2872,950,1
20141226.221911,2872,198,99020,86,2871,19,2872,853,1
20141226.221912,2872,140,99160,4,2871,21,2872,783,1
20141226.221912,2872,76,99236,64,2871,21,2872,705,1
20141226.221913,2872,16,99252,4,2871,19,2872,705,1
20141226.221913,2872,4,99256,2,2871,19,2872,702,1
20141226.221914,2872,10,99266,-6,2871,30,2872,702,1
20141226.221914,2871,26,99292,8,2871,24,2872,703,0
20141226.221915,2871,12,99304,2,2871,46,2872,700,0
20141226.221916,2871,4,99308,4,2871,47,2872,702,0
20141226.221916,2871,14,99322,-6,2871,49,2872,696,0
20141226.221917,2871,14,99336,6,2871,47,2872,708,0
20141226.221917,2872,2,99338,-2,2871,48,2872,707,1
20141226.221918,2871,10,99348,2,2871,48,2872,745,0
20141226.221918,2871,2,99350,0,2871,52,2872,745,0
20141226.221919,2871,32,99382,10,2871,49,2872,735,0
20141226.221919,2871,22,99404,16,2871,100,2872,697,0
20141226.22192,2872,20,99424,-12,2871,102,2872,687,1
20141226.221921,2871,4,99428,4,2871,106,2872,687,0
20141226.221922,2872,14,99442,0,2871,106,2872,680,1
20141226.221922,2871,2,99444,2,2871,105,2872,681,0
20141226.221923,2872,120,99564,62,2871,104,2872,624,1
20141226.221924,2871,2,99566,2,2871,105,2872,624,0
20141226.221924,2872,2,99568,2,2871,142,2872,624,1
20141226.221925,2871,240,99808,94,2871,88,2872,595,0
20141226.221926,2872,16,99824,16,2871,91,2872,590,1
20141226.221926,2871,186,100010,-38,2870,720,2871,248,0
20141226.221927,2870,28,100038,0,2870,722,2871,235,0
20141226.221927,2871,18,100056,-6,2870,718,2871,240,1
20141226.221928,2870,10,100066,0,2870,715,2871,238,0
20141226.221928,2870,10,100076,-6,2870,715,2871,235,0
20141226.221929,2871,2,100078,-2,2870,715,2871,234,1
20141226.221929,2871,104,100182,-2,2870,717,2871,183,1
20141226.22193,2871,4,100186,-4,2870,717,2871,181,1
20141226.22193,2871,10,100196,-2,2870,717,2871,177,1
20141226.221931,2870,20,100216,0,2870,767,2871,177,0
20141226.221932,2871,4,100220,-4,2870,768,2871,297,1
20141226.221932,2871,2,100222,-2,2870,768,2871,296,1
20141226.221933,2871,44,100266,0,2870,768,2871,303,1
20141226.221934,2871,22,100288,0,2870,768,2871,334,1
20141226.221934,2871,2,100290,-2,2870,769,2871,335,1
20141226.221935,2871,4,100294,0,2870,770,2871,335,1
20141226.221936,2871,14,100308,0,2870,779,2871,328,1
20141226.221936,2871,40,100348,-4,2870,779,2871,311,1
20141226.221937,2871,42,100390,-40,2870,779,2871,379,1
20141226.221938,2871,2,100392,0,2870,779,2871,378,1
20141226.221939,2871,20,100412,-20,2870,782,2871,370,1
20141226.221939,2871,100,100512,0,2870,781,2871,320,1
20141226.221941,2871,10,100522,-10,2870,802,2871,327,1
20141226.221942,2871,2,100524,0,2870,802,2871,326,1
20141226.221942,2871,18,100542,-10,2870,802,2871,317,1
20141226.221943,2871,4,100546,0,2870,802,2871,316,1
20141226.221944,2871,124,100670,-18,2870,803,2871,274,1
20141226.221944,2871,4,100674,-2,2870,802,2871,273,1
20141226.221945,2871,104,100778,-2,2870,802,2871,222,1
20141226.221946,2871,20,100798,0,2870,807,2871,173,1
20141226.221947,2871,20,100818,-4,2870,807,2871,163,1
20141226.221947,2871,26,100844,16,2870,807,2871,150,1
20141226.221948,2871,12,100856,4,2870,808,2871,145,1
20141226.221949,2871,2,100858,0,2870,808,2871,144,1
20141226.22195,2870,4,100862,-2,2870,812,2871,143,0
20141226.221951,2871,2,100864,0,2870,812,2871,142,1
20141226.221951,2871,2,100866,0,2870,817,2871,177,1
20141226.221952,2871,2,100868,0,2870,817,2871,176,1
20141226.221952,2871,2,100870,0,2870,817,2871,175,1
20141226.221952,2870,4,100874,-4,2870,816,2871,175,0
20141226.221953,2871,2,100876,0,2870,816,2871,175,1
20141226.221954,2871,2,100878,0,2870,811,2871,1975,1
20141226.221955,2871,2,100880,-2,2870,813,2871,2181,1
20141226.221956,2870,6,100886,-2,2870,814,2871,2180,0
20141226.221957,2870,12,100898,-10,2870,799,2871,4187,0
20141226.221958,2870,10,100908,-10,2870,794,2871,4187,0
20141226.221959,2870,10,100918,-10,2870,790,2871,4187,0
20141226.221959,2870,2,100920,0,2870,789,2871,4187,0
20141226.221959,2871,2,100922,0,2870,789,2871,4186,1
20141226.222001,2871,40,100962,0,2870,792,2871,4173,1
20141226.222003,2870,2,100964,-2,2870,792,2871,4174,0
20141226.222003,2870,2,100966,0,2870,794,2871,4174,0
20141226.222004,2871,10,100976,0,2870,804,2871,4169,1
20141226.222005,2870,6,100982,-6,2870,800,2871,4169,0
20141226.222005,2871,4,100986,-2,2870,801,2871,4168,1
20141226.222006,2870,4,100990,-4,2870,799,2871,4163,0
20141226.222006,2871,2000,102990,-96,2870,799,2871,3163,1
20141226.222007,2871,6102,109092,0,2871,976,2872,744,1
20141226.222007,2872,10,109102,10,2871,976,2872,739,1
20141226.222008,2872,2,109104,0,2871,1175,2872,737,1
20141226.222009,2872,4,109108,2,2871,1175,2872,735,1
20141226.22201,2871,2,109110,2,2871,206,2872,727,0
20141226.22201,2872,2,109112,2,2871,206,2872,725,1
20141226.222011,2872,12,109124,0,2871,206,2872,714,1
20141226.222011,2872,2,109126,2,2871,209,2872,714,1
20141226.222012,2872,2,109128,2,2871,409,2872,714,1
20141226.222012,2872,4,109132,4,2871,409,2872,710,1
20141226.222013,2871,14,109146,-4,2871,402,2872,710,0
20141226.222014,2872,2,109148,2,2871,445,2872,709,1
20141226.222014,2872,16,109164,4,2871,448,2872,702,1
20141226.222016,2872,6,109170,6,2871,453,2872,698,1
20141226.222016,2871,2,109172,0,2871,456,2872,700,0
20141226.222017,2872,20,109192,20,2871,467,2872,690,1
20141226.222017,2872,1398,110590,-390,2872,301,2873,716,1
20141226.222017,2872,2,110592,0,2872,308,2873,724,1
20141226.222018,2872,20,110612,-20,2872,298,2873,725,1
20141226.222019,2872,424,111036,28,2872,298,2873,474,1
20141226.222019,2872,18,111054,8,2872,297,2873,466,1
20141226.22202,2873,8,111062,2,2872,298,2873,464,1
20141226.22202,2873,106,111168,94,2872,304,2873,412,1
20141226.222021,2873,42,111210,12,2872,309,2873,391,1
20141226.222022,2873,62,111272,60,2872,308,2873,361,1
20141226.222022,2873,22,111294,16,2872,309,2873,350,1
20141226.222023,2873,4,111298,4,2872,309,2873,348,1
20141226.222023,2872,18,111316,12,2872,308,2873,343,0
20141226.222024,2873,16,111332,16,2872,310,2873,342,1
20141226.222024,2873,22,111354,2,2872,305,2873,331,1
20141226.222025,2873,14,111368,14,2872,305,2873,323,1
20141226.222025,2873,14,111382,14,2872,305,2873,316,1
20141226.222026,2872,42,111424,40,2872,311,2873,297,0
20141226.222026,2873,38,111462,28,2872,311,2873,278,1
20141226.222026,2873,4,111466,0,2872,311,2873,278,1
20141226.222027,2873,2,111468,2,2872,312,2873,279,1
20141226.222027,2873,2,111470,2,2872,314,2873,279,1
20141226.222028,2873,52,111522,-28,2872,294,2873,274,1
20141226.222029,2873,26,111548,6,2872,296,2873,264,1
20141226.222029,2873,2,111550,2,2872,307,2873,261,1
20141226.222029,2873,2,111552,2,2872,317,2873,259,1
20141226.22203,2873,10,111562,8,2872,322,2873,356,1
20141226.222031,2872,10,111572,0,2872,320,2873,357,0
20141226.222031,2873,20,111592,12,2872,316,2873,351,1
20141226.222032,2872,8,111600,6,2872,315,2873,350,0
20141226.222032,2873,70,111670,70,2872,315,2873,315,1
20141226.222033,2873,14,111684,12,2872,320,2873,310,1
20141226.222033,2872,26,111710,24,2872,322,2873,300,0
20141226.222034,2873,2,111712,2,2872,322,2873,299,1
20141226.222034,2873,30,111742,30,2872,322,2873,286,1
20141226.222035,2873,2,111744,2,2872,327,2873,288,1
20141226.222035,2872,4,111748,-4,2872,334,2873,289,0
20141226.222036,2873,14,111762,14,2872,338,2873,289,1
20141226.222036,2873,20,111782,0,2872,333,2873,284,1
20141226.222037,2872,2,111784,0,2872,333,2873,254,0
20141226.222037,2872,124,111908,-80,2872,282,2873,247,0
20141226.222038,2873,14,111922,12,2872,293,2873,241,1
20141226.222038,2872,4,111926,2,2872,292,2873,230,0
20141226.222039,2873,6,111932,-2,2872,291,2873,266,1
20141226.22204,2873,4,111936,2,2872,292,2873,267,1
20141226.222041,2873,24,111960,24,2872,293,2873,261,1
20141226.222042,2872,6,111966,-2,2872,291,2873,267,0
20141226.222042,2872,14,111980,-14,2872,286,2873,317,0
20141226.222043,2873,2,111982,2,2872,287,2873,332,1
20141226.222043,2873,4,111986,0,2872,287,2873,335,1
20141226.222045,2872,16,112002,-2,2872,290,2873,337,0
20141226.222045,2872,80,112082,0,2872,258,2873,349,0
20141226.222046,2873,18,112100,-12,2872,253,2873,426,1
20141226.222046,2872,24,112124,-10,2872,242,2873,1139,0
20141226.222047,2872,898,113022,-100,2871,486,2872,66,0
20141226.222047,2872,12,113034,-2,2871,486,2872,120,0
20141226.222048,2872,290,113324,-164,2872,855,2873,540,0
20141226.222048,2873,108,113432,98,2872,853,2873,489,1
20141226.222049,2872,6,113438,-6,2872,858,2873,511,0
20141226.222049,2872,382,113820,-380,2872,673,2873,512,0
20141226.22205,2872,12,113832,-2,2872,698,2873,520,0
20141226.22205,2872,2,113834,-2,2872,741,2873,601,0
20141226.222051,2872,8,113842,0,2872,759,2873,652,0
20141226.222052,2873,70,113912,-60,2872,729,2873,760,1
20141226.222052,2873,240,114152,-156,2872,729,2873,690,1
20141226.222053,2873,14,114166,0,2872,729,2873,683,1
20141226.222054,2873,14,114180,-4,2872,725,2873,687,1
20141226.222054,2872,40,114220,-40,2872,713,2873,693,0
20141226.222055,2872,22,114242,0,2872,704,2873,692,0
20141226.222057,2873,4,114246,0,2872,719,2873,719,1
20141226.222057,2873,44,114290,0,2872,719,2873,700,1
20141226.222058,2873,2,114292,0,2872,721,2873,699,1
20141226.222058,2873,206,114498,-46,2872,721,2873,596,1
20141226.222059,2872,2,114500,0,2872,719,2873,598,0
20141226.2221,2873,12,114512,12,2872,719,2873,598,1
20141226.2221,2872,8,114520,-8,2872,733,2873,599,0
20141226.222101,2873,102,114622,74,2872,733,2873,549,1
20141226.222101,2872,2,114624,0,2872,862,2873,549,0
20141226.222102,2872,10,114634,0,2872,857,2873,550,0
20141226.222102,2872,4,114638,0,2872,855,2873,554,0
20141226.222103,2873,16,114654,10,2872,854,2873,607,1
20141226.222103,2873,12,114666,10,2872,855,2873,602,1
20141226.222104,2873,1214,115880,460,2873,247,2874,1276,1
20141226.222104,2873,8,115888,2,2873,244,2874,1195,1
20141226.222105,2873,40,115928,0,2873,254,2874,1195,1
20141226.222106,2873,174,116102,-70,2873,269,2874,1106,1
20141226.222106,2873,496,116598,2,2873,275,2874,861,1
20141226.222107,2873,126,116724,124,2873,215,2874,801,1
20141226.222108,2874,102,116826,100,2873,220,2874,751,1
20141226.222108,2874,158,116984,8,2873,234,2874,674,1
20141226.222109,2874,208,117192,-2,2873,236,2874,570,1
20141226.222109,2874,1146,118338,-848,2874,429,2875,1365,1
20141226.22211,2874,60,118398,-60,2874,422,2875,1258,1
20141226.222111,2874,16,118414,0,2874,428,2875,1258,1
20141226.222111,2875,46,118460,4,2874,417,2875,1246,1
20141226.222112,2875,16,118476,2,2874,412,2875,1239,1
20141226.222112,2874,2030,120506,-624,2874,407,2875,232,0
20141226.222113,2875,36,120542,22,2874,406,2875,217,1
20141226.222113,2875,448,120990,-290,2875,202,2876,1082,1
20141226.222114,2875,42,121032,-16,2875,189,2876,1074,1
20141226.222114,2875,46,121078,-26,2875,229,2876,1073,1
20141226.222115,2875,212,121290,-202,2875,129,2876,1072,1
20141226.222115,2875,80,121370,-10,2875,153,2876,1105,1
20141226.222116,2875,316,121686,238,2874,406,2875,156,1
20141226.222116,2874,26,121712,-6,2874,405,2875,155,0
20141226.222117,2875,42,121754,36,2874,405,2875,139,1
20141226.222118,2875,34,121788,0,2874,405,2875,134,1
20141226.222118,2875,2,121790,2,2874,405,2875,141,1
20141226.222119,2874,20,121810,8,2874,404,2875,135,0
20141226.222119,2874,6,121816,2,2874,404,2875,141,0
20141226.22212,2875,16,121832,6,2874,401,2875,189,1
20141226.22212,2875,22,121854,16,2874,406,2875,226,1
20141226.222121,2875,14,121868,4,2874,412,2875,247,1
20141226.222122,2875,2,121870,2,2874,412,2875,250,1
20141226.222122,2875,2,121872,2,2874,412,2875,250,1
20141226.222123,2874,102,121974,4,2874,408,2875,212,0
20141226.222124,2874,20,121994,10,2874,408,2875,430,0
20141226.222124,2874,826,122820,-74,2873,251,2875,154,0
20141226.222125,2874,4,122824,-2,2873,252,2874,85,0
20141226.222125,2874,4,122828,4,2873,262,2874,91,0
20141226.222126,2874,20,122848,0,2873,262,2874,88,0
20141226.222127,2874,20,122868,20,2873,262,2874,89,0
20141226.222128,2874,10,122878,4,2873,271,2874,94,0
20141226.222129,2874,2,122880,2,2873,272,2874,95,0
20141226.22213,2874,2,122882,2,2873,273,2874,115,0
20141226.22213,2874,16,122898,16,2873,275,2874,118,0
20141226.22213,2874,4,122902,4,2873,274,2874,116,0
20141226.222131,2873,202,123104,202,2873,178,2874,60,0
20141226.222131,2873,102,123206,102,2873,122,2874,119,0
20141226.222132,2873,2,123208,2,2873,122,2874,192,0
20141226.222132,2873,4,123212,4,2873,144,2874,293,0
20141226.222133,2873,30,123242,30,2873,140,2874,297,0
20141226.222134,2874,20,123262,20,2873,139,2874,409,1
20141226.222134,2873,4,123266,0,2873,137,2874,415,0
20141226.222135,2873,42,123308,-24,2873,136,2874,400,0
20141226.222135,2873,310,123618,146,2872,720,2874,296,0
20141226.222136,2872,8,123626,-4,2873,2,2874,301,0
20141226.222136,2873,8,123634,-4,2873,38,2874,301,1
20141226.222137,2873,2,123636,-2,2873,37,2874,302,1
20141226.222139,2873,18,123654,2,2873,32,2874,336,1
20141226.22214,2873,22,123676,12,2873,21,2874,332,1
20141226.22214,2873,22,123698,12,2873,15,2874,327,1
20141226.22214,2873,28,123726,10,2873,1,2874,327,1
20141226.222141,2873,16,123742,0,2873,10,2874,324,1
20141226.222142,2874,8,123750,6,2873,7,2874,331,1
20141226.222142,2873,2,123752,0,2873,6,2874,331,0
20141226.222143,2873,2,123754,0,2873,5,2874,331,0
20141226.222143,2873,10,123764,8,2873,21,2874,335,0
20141226.222144,2873,42,123806,6,2872,752,2874,211,0
20141226.222144,2873,62,123868,62,2872,767,2873,126,0
20141226.222145,2873,198,124066,190,2872,767,2873,49,0
20141226.222145,2872,24,124090,10,2872,765,2873,39,0
20141226.222146,2872,2,124092,-2,2872,764,2873,39,0
20141226.222146,2873,78,124170,78,2873,11,2874,550,1
20141226.222147,2873,22,124192,12,2872,772,2874,550,1
20141226.222148,2873,202,124394,150,2872,107,2873,71,1
20141226.222149,2873,2,124396,2,2872,107,2873,84,1
20141226.222149,2873,2,124398,0,2872,107,2873,137,1
20141226.22215,2873,40,124438,6,2872,108,2873,127,1
20141226.22215,2872,54,124492,0,2872,86,2873,133,0
20141226.222152,2872,6,124498,0,2872,87,2873,135,0
20141226.222153,2873,2,124500,0,2872,89,2873,139,1
20141226.222153,2873,14,124514,-14,2872,89,2873,132,1
20141226.222155,2873,4,124518,-4,2872,91,2873,131,1
20141226.222155,2872,2,124520,0,2872,90,2873,131,0
20141226.222156,2872,12,124532,-2,2872,84,2873,131,0
20141226.222157,2872,176,124708,92,2871,683,2872,23,0
20141226.222157,2872,40,124748,24,2871,683,2872,6,0
20141226.222159,2872,28,124776,-20,2872,616,2873,135,0
20141226.222159,2872,2,124778,0,2872,615,2873,136,0
20141226.2222,2872,4,124782,0,2872,640,2873,140,0
20141226.222201,2872,30,124812,0,2872,635,2873,126,0
20141226.222202,2872,2,124814,0,2872,634,2873,127,0
20141226.222204,2872,2,124816,0,2872,634,2873,129,0
20141226.222204,2872,40,124856,0,2872,616,2873,129,0
20141226.222207,2873,100,124956,18,2872,645,2873,91,1
20141226.22221,2872,2,124958,0,2872,651,2873,92,0
20141226.22221,2873,10,124968,2,2872,656,2873,96,1
20141226.222211,2872,102,125070,-100,2872,606,2873,98,0
20141226.222212,2872,120,125190,0,2872,548,2873,98,0
20141226.222213,2873,12,125202,12,2872,548,2873,92,1
20141226.222214,2873,4,125206,-2,2872,548,2873,159,1
20141226.222215,2873,4,125210,0,2872,557,2873,168,1
20141226.222215,2873,2,125212,0,2872,557,2873,168,1
20141226.222217,2872,12,125224,0,2872,545,2873,181,0
20141226.222218,2873,2,125226,2,2872,545,2873,192,1
20141226.222219,2873,40,125266,-6,2872,550,2873,172,1
20141226.22222,2873,2,125268,2,2872,549,2873,182,1
20141226.222222,2873,70,125338,0,2872,580,2873,149,1
20141226.222223,2873,2,125340,2,2872,592,2873,151,1
20141226.222223,2872,22,125362,14,2872,591,2873,142,0
20141226.222225,2873,6,125368,0,2872,575,2873,142,1
20141226.222226,2873,6,125374,0,2872,615,2873,140,1
20141226.222228,2873,44,125418,-34,2872,620,2873,121,1
20141226.222231,2873,100,125518,62,2872,670,2874,305,1
20141226.222231,2872,72,125590,66,2872,668,2874,306,0
20141226.222232,2873,2,125592,0,2872,668,2873,45,1
20141226.222233,2873,20,125612,18,2872,870,2874,306,1
20141226.222234,2873,14,125626,14,2872,870,2874,306,1
20141226.222234,2873,62,125688,18,2873,9,2874,507,1
20141226.222234,2873,18,125706,10,2873,30,2874,507,1
20141226.222235,2874,104,125810,-4,2872,884,2874,486,1
20141226.222236,2873,2,125812,2,2873,49,2874,487,0
20141226.222237,2873,32,125844,24,2873,36,2874,473,0
20141226.222237,2873,2,125846,0,2873,36,2874,473,0
20141226.222237,2873,2,125848,2,2873,38,2874,473,0
20141226.222238,2873,46,125894,2,2873,81,2874,474,0
20141226.222238,2873,42,125936,4,2873,60,2874,464,0
20141226.222239,2874,4,125940,0,2873,60,2874,463,1
20141226.222239,2873,2,125942,0,2873,60,2874,463,0
20141226.22224,2873,6,125948,-4,2873,68,2874,463,0
20141226.22224,2873,2,125950,0,2873,67,2874,463,0
20141226.222241,2874,6,125956,-2,2873,65,2874,462,1
20141226.222242,2873,2,125958,0,2873,64,2874,463,0
20141226.222242,2873,2,125960,0,2873,73,2874,467,0
20141226.222243,2873,8,125968,0,2873,70,2874,467,0
20141226.222243,2874,10,125978,0,2873,67,2874,462,1
20141226.222243,2873,96,126074,12,2873,19,2874,462,0
20141226.222244,2874,6,126080,2,2873,18,2874,467,1
20141226.222245,2874,2,126082,0,2873,19,2874,467,1
20141226.222245,2874,30,126112,0,2873,19,2874,452,1
20141226.222246,2873,2,126114,0,2873,18,2874,452,0
20141226.222246,2873,46,126160,28,2872,936,2873,8,0
20141226.222247,2873,20,126180,-4,2872,936,2874,438,0
20141226.222248,2874,60,126240,-18,2873,3,2874,419,1
20141226.222248,2873,2,126242,2,2873,2,2874,420,0
20141226.222249,2873,2,126244,2,2873,7,2874,423,0
20141226.22225,2873,4,126248,2,2873,5,2874,426,0
20141226.222251,2873,2,126250,2,2873,6,2874,427,0
20141226.222251,2874,24,126274,22,2873,3,2874,428,1
20141226.222251,2873,6,126280,0,2872,939,2874,429,0
20141226.222252,2874,14,126294,4,2873,15,2874,426,1
20141226.222253,2873,4,126298,0,2873,35,2874,425,0
20141226.222254,2874,2,126300,0,2873,36,2874,435,1
20141226.222254,2874,4,126304,0,2873,37,2874,457,1
20141226.222255,2873,2,126306,0,2873,38,2874,457,0
20141226.222256,2873,10,126316,-10,2873,44,2874,452,0
20141226.222257,2873,2,126318,0,2873,44,2874,452,0
20141226.222258,2874,2,126320,-2,2873,97,2874,435,1
20141226.222259,2873,4,126324,-4,2873,101,2874,445,0
20141226.2223,2873,62,126386,-40,2873,75,2874,443,0
20141226.2223,2874,4,126390,0,2873,74,2874,441,1
20141226.222302,2873,2,126392,2,2873,75,2874,446,0
20141226.222303,2873,10,126402,0,2873,82,2874,446,0
20141226.222304,2873,60,126462,60,2873,1057,2874,446,0
20141226.222305,2873,2,126464,2,2873,1064,2874,287,0
20141226.222305,2873,46,126510,4,2873,1051,2874,287,0
20141226.222307,2874,2,126512,0,2873,1053,2874,289,1
20141226.222308,2874,20,126532,0,2873,1056,2874,924,1
20141226.222308,2873,2,126534,2,2873,1045,2874,932,0
20141226.22231,2873,592,127126,-16,2873,750,2874,293,0
20141226.22231,2874,2,127128,0,2873,750,2874,332,1
20141226.222311,2873,86,127214,0,2873,757,2874,341,0
20141226.222313,2873,1524,128738,1500,2872,498,2873,258,0
20141226.222313,2873,2,128740,2,2872,493,2873,297,0
20141226.222314,2873,50,128790,0,2872,495,2873,372,0
20141226.222314,2873,46,128836,46,2872,493,2873,339,0
20141226.222315,2872,2,128838,-2,2872,492,2873,340,0
20141226.222317,2873,2,128840,2,2872,496,2873,361,1
20141226.222318,2872,4,128844,-2,2872,468,2873,361,0
20141226.222318,2873,60,128904,20,2872,468,2873,331,1
20141226.222319,2873,8,128912,0,2872,479,2873,331,1
20141226.222321,2872,2,128914,0,2872,509,2873,331,0
20141226.222322,2872,22,128936,-2,2872,498,2873,324,0
20141226.222323,2872,8,128944,-4,2872,502,2873,324,0
20141226.222324,2873,2,128946,0,2872,510,2873,315,1
20141226.222324,2872,22,128968,-2,2872,499,2873,325,0
20141226.222324,2873,10,128978,10,2872,494,2873,320,1
20141226.222325,2872,4,128982,-4,2872,492,2873,320,0
20141226.222327,2873,8,128990,0,2872,492,2873,337,1
20141226.222328,2873,10,129000,10,2872,492,2873,332,1
20141226.222328,2873,2,129002,2,2872,502,2873,333,1
20141226.222329,2872,2,129004,0,2872,503,2873,336,0
20141226.222331,2873,2,129006,2,2872,497,2873,390,1
20141226.222331,2872,2,129008,0,2872,486,2873,390,0
20141226.222332,2873,2,129010,2,2872,486,2873,389,1
20141226.222332,2873,2,129012,2,2872,486,2873,438,1
20141226.222335,2872,12,129024,-12,2872,493,2873,446,0
20141226.222336,2873,2,129026,2,2872,503,2873,445,1
20141226.222339,2873,2,129028,0,2872,485,2873,483,1
20141226.222341,2872,12,129040,10,2872,480,2873,485,0
20141226.222342,2872,60,129100,-52,2872,450,2873,492,0
20141226.222345,2872,40,129140,-2,2872,434,2873,522,0
20141226.222345,2872,202,129342,198,2872,333,2873,522,0
20141226.222346,2872,120,129462,0,2872,284,2873,496,0
20141226.222347,2872,2,129464,0,2872,284,2873,497,0
20141226.222348,2872,2,129466,0,2872,285,2873,498,0
20141226.222348,2872,6,129472,4,2872,283,2873,498,0
20141226.222349,2872,10,129482,10,2872,279,2873,496,0
20141226.222351,2872,2,129484,0,2872,280,2873,498,0
20141226.222352,2872,24,129508,2,2872,269,2873,499,0
20141226.222353,2872,6,129514,6,2872,266,2873,525,0
20141226.222353,2872,4,129518,4,2872,264,2873,526,0
20141226.222354,2873,10,129528,10,2872,264,2873,521,1
20141226.222355,2871,1274,130802,-732,2870,502,2871,403,0
20141226.222355,2871,2,130804,-2,2870,502,2871,417,0
20141226.222356,2871,2,130806,0,2870,502,2871,436,0
20141226.222358,2871,4,130810,2,2870,501,2871,1444,0
20141226.222359,2871,2,130812,-2,2870,546,2871,1423,0
20141226.222359,2870,2,130814,0,2870,545,2871,1423,0
20141226.222359,2870,118,130932,90,2870,486,2871,1423,0
20141226.2224,2870,28,130960,12,2870,471,2871,1423,0
20141226.222401,2870,2,130962,2,2870,470,2871,1423,0
20141226.222401,2870,2,130964,2,2870,471,2871,1407,0
20141226.222402,2870,6,130970,2,2870,474,2871,1406,0
20141226.222402,2870,4,130974,2,2870,522,2871,1406,0
20141226.222403,2870,28,131002,4,2870,509,2871,1418,0
20141226.222404,2870,6,131008,2,2870,495,2871,1391,0
20141226.222404,2871,4,131012,-4,2870,498,2871,1389,1
20141226.222405,2871,44,131056,2,2870,495,2871,1375,1
20141226.222406,2871,4,131060,-4,2870,507,2871,1373,1
20141226.222407,2870,4,131064,-2,2870,538,2871,1372,0
20141226.222407,2870,10,131074,-8,2870,535,2871,1371,0
20141226.222408,2871,2,131076,-2,2870,539,2871,1370,1
20141226.222409,2871,30,131106,16,2870,528,2871,1367,1
20141226.222409,2870,2,131108,0,2870,528,2871,1367,0
20141226.222409,2870,4,131112,2,2870,536,2871,1367,0
20141226.22241,2870,44,131156,44,2870,514,2871,1367,0
20141226.222411,2871,10,131166,-4,2870,514,2871,1363,1
20141226.222411,2871,2726,133892,-2646,2871,666,2872,99,1
20141226.222412,2871,2,133894,-2,2871,673,2872,72,1
20141226.222412,2871,2,133896,0,2871,672,2872,33,1
20141226.222412,2871,2,133898,0,2871,671,2872,33,1
20141226.222414,2872,4,133902,-2,2871,670,2872,32,1
20141226.222415,2872,68,133970,-10,2872,430,2873,522,1
20141226.222415,2872,4,133974,0,2872,428,2873,521,1
20141226.222416,2872,8,133982,-4,2872,454,2873,521,1
20141226.222417,2872,4,133986,0,2872,460,2873,519,1
20141226.222419,2872,2,133988,0,2872,460,2873,617,1
20141226.222419,2872,120,134108,-10,2872,400,2873,616,1
20141226.222421,2872,2,134110,0,2872,399,2873,624,1
20141226.222421,2872,8,134118,-8,2872,396,2873,626,1
20141226.222422,2872,82,134200,-80,2872,356,2873,631,1
20141226.222422,2872,2,134202,0,2872,355,2873,645,1
20141226.222423,2873,36,134238,32,2872,365,2873,628,1
20141226.222423,2872,12,134250,0,2872,362,2873,627,0
20141226.222424,2872,2,134252,0,2872,411,2873,629,0
20141226.222426,2872,4,134256,-2,2872,420,2873,669,0
20141226.222427,2873,2,134258,2,2872,431,2873,671,1
20141226.222432,2872,12,134270,-6,2872,428,2873,642,0
20141226.222433,2872,8,134278,0,2872,413,2873,640,0
20141226.222435,2872,6,134284,0,2872,410,2873,840,0
20141226.222436,2873,2,134286,2,2872,410,2873,847,1
20141226.222436,2873,4,134290,4,2872,410,2873,845,1
20141226.222437,2873,26,134316,4,2872,399,2873,843,1
20141226.222437,2873,4,134320,4,2872,399,2873,842,1
20141226.22244,2872,2,134322,-2,2872,399,2873,850,0
20141226.222441,2873,2,134324,2,2872,399,2873,850,1
20141226.222443,2872,2,134326,0,2872,398,2873,849,0
20141226.222444,2872,44,134370,-44,2872,385,2873,850,0
20141226.222445,2872,24,134394,0,2872,373,2873,841,0
20141226.222446,2872,2,134396,-2,2872,373,2873,841,0
20141226.222446,2872,16,134412,-14,2872,365,2873,846,0
20141226.222447,2872,2,134414,0,2872,364,2873,844,0
20141226.222448,2873,6,134420,6,2872,374,2873,848,1
20141226.222451,2872,2,134422,0,2872,373,2873,850,0
20141226.222452,2872,2,134424,0,2872,372,2873,851,0
20141226.222457,2873,6,134430,0,2872,375,2873,952,1
20141226.222459,2873,2,134432,2,2872,375,2873,950,1
20141226.2225,2873,2,134434,2,2872,375,2873,956,1
20141226.2225,2873,10,134444,0,2872,378,2873,952,1
20141226.222501,2873,12,134456,12,2872,370,2873,946,1
20141226.222501,2873,6,134462,0,2872,368,2873,950,1
20141226.222503,2873,2,134464,2,2872,368,2873,948,1
20141226.222504,2872,6,134470,0,2872,366,2873,948,0
20141226.222507,2872,2,134472,0,2872,366,2873,949,0
20141226.222508,2872,2,134474,0,2872,365,2873,950,0
20141226.222508,2872,2,134476,0,2872,364,2873,950,0
20141226.22251,2873,2,134478,2,2872,364,2873,950,1
20141226.222511,2873,4,134482,4,2872,363,2873,949,1
20141226.222511,2873,44,134526,40,2872,361,2873,929,1
20141226.222512,2872,2,134528,0,2872,360,2873,929,0
20141226.222512,2872,2,134530,0,2872,360,2873,929,0
20141226.222513,2872,48,134578,-48,2872,336,2873,929,0
20141226.222514,2872,10,134588,-10,2872,332,2873,929,0
20141226.222515,2872,2,134590,-2,2872,331,2873,930,0
20141226.222516,2872,2,134592,0,2872,330,2873,930,0
20141226.222517,2872,2,134594,0,2872,330,2873,930,0
20141226.222519,2872,4,134598,-4,2872,358,2873,931,0
20141226.22252,2872,2,134600,0,2872,355,2873,932,0
20141226.222521,2872,102,134702,-100,2872,304,2873,932,0
20141226.222521,2872,480,135182,-36,2872,84,2873,912,0
20141226.222522,2872,14,135196,0,2872,77,2873,912,0
20141226.222523,2872,154,135350,14,2871,117,2872,17,0
20141226.222526,2872,4,135354,-2,2871,200,2872,94,0
20141226.222527,2872,2,135356,0,2871,202,2872,146,0
20141226.222529,2871,132,135488,66,2871,197,2872,250,0
20141226.22253,2871,8,135496,-6,2871,195,2872,250,0
20141226.222531,2871,24,135520,6,2871,193,2872,261,0
20141226.222532,2871,2,135522,0,2871,202,2872,268,0
20141226.222534,2871,10,135532,0,2871,202,2872,306,0
20141226.222535,2872,2,135534,0,2871,207,2872,307,1
20141226.222536,2871,4,135538,0,2871,208,2872,354,0
20141226.22254,2871,2,135540,2,2871,208,2872,394,0
20141226.222541,2872,20,135560,16,2871,218,2872,383,1
20141226.222543,2871,2,135562,0,2871,220,2872,410,0
20141226.222543,2871,2,135564,0,2871,219,2872,410,0
20141226.222547,2871,10,135574,10,2871,213,2872,441,0
20141226.222547,2871,4,135578,4,2871,211,2872,441,0
20141226.222548,2871,2,135580,0,2871,210,2872,450,0
20141226.22255,2871,14,135594,0,2871,209,2872,563,0
20141226.222551,2872,2,135596,0,2871,210,2872,564,1
20141226.222552,2871,2,135598,2,2871,329,2872,564,0
20141226.222557,2871,2,135600,0,2871,339,2872,568,0
20141226.222559,2872,10,135610,0,2871,337,2872,565,1
20141226.222601,2872,1130,136740,-782,2872,255,2873,679,1
20141226.222602,2872,4,136744,-4,2872,253,2873,679,1
20141226.222602,2872,2,136746,-2,2872,252,2873,687,1
20141226.222603,2872,2,136748,-2,2872,251,2873,687,1
20141226.222603,2872,18,136766,-18,2872,243,2873,687,1
20141226.222605,2872,22,136788,-20,2872,232,2873,681,1
20141226.222605,2872,2,136790,0,2871,341,2872,11,1
20141226.222606,2872,6,136796,4,2871,349,2872,8,1
20141226.222607,2872,16,136812,16,2872,72,2873,671,1
20141226.222607,2872,28,136840,0,2872,73,2873,662,1
20141226.222608,2872,12,136852,0,2872,67,2873,662,1
20141226.22261,2872,6,136858,6,2872,64,2873,662,1
20141226.22261,2872,2,136860,2,2872,64,2873,662,1
20141226.222612,2872,8,136868,4,2872,75,2873,656,1
20141226.222613,2872,6,136874,0,2872,72,2873,656,1
20141226.222613,2872,4,136878,0,2872,70,2873,658,1
20141226.222614,2872,2,136880,0,2872,70,2873,657,1
20141226.222614,2872,304,137184,116,2871,395,2873,657,1
20141226.222615,2872,2,137186,0,2871,435,2872,20,1
20141226.222616,2872,40,137226,0,2871,443,2873,658,1
20141226.222616,2872,2,137228,-2,2871,444,2873,661,1
20141226.222617,2872,80,137308,-10,2872,101,2873,661,1
20141226.222618,2873,2,137310,2,2872,113,2873,660,1
20141226.222618,2872,200,137510,200,2872,13,2873,660,0
20141226.222618,2873,22,137532,-6,2872,3,2873,659,1
20141226.222619,2872,6,137538,4,2871,499,2873,659,0
20141226.22262,2871,2,137540,2,2871,498,2872,2,0
20141226.222621,2872,126,137666,30,2871,501,2873,658,1
20141226.222624,2872,6,137672,-2,2872,9,2873,721,1
20141226.222624,2872,2,137674,-2,2872,58,2873,689,1
20141226.222625,2872,86,137760,52,2872,16,2873,689,1
20141226.222625,2873,34,137794,34,2871,582,2873,688,1
20141226.222628,2872,2,137796,0,2871,592,2872,24,0
20141226.22263,2872,4,137800,2,2871,604,2872,25,0
20141226.22263,2872,20,137820,16,2871,605,2872,15,0
20141226.222631,2872,8,137828,0,2871,607,2872,13,0
20141226.222632,2872,26,137854,10,2872,2,2873,737,0
20141226.222633,2873,2,137856,2,2872,12,2873,735,1
20141226.222633,2873,6,137862,4,2872,67,2873,733,1
20141226.222634,2873,4,137866,4,2872,67,2873,731,1
20141226.222636,2872,156,138022,136,2871,567,2872,33,0
20141226.222637,2872,2,138024,2,2871,562,2872,32,0
20141226.222641,2871,2,138026,2,2871,565,2872,34,0
20141226.222642,2872,20,138046,20,2871,566,2872,24,1
20141226.222643,2872,50,138096,46,2872,47,2873,762,1
20141226.222645,2872,2,138098,2,2872,48,2873,763,1
20141226.222645,2872,2,138100,0,2872,47,2873,763,1
20141226.222646,2872,2,138102,2,2872,46,2873,763,1
20141226.222647,2872,20,138122,20,2872,36,2873,745,1
20141226.222648,2872,2,138124,2,2872,40,2873,746,1
20141226.222649,2872,12,138136,4,2872,35,2873,747,1
20141226.222651,2872,76,138212,54,2871,625,2872,23,1
20141226.222653,2872,48,138260,-2,2871,628,2873,747,1
20141226.222654,2872,2,138262,0,2871,629,2873,749,1
20141226.222658,2872,22,138284,0,2872,2,2873,800,1
20141226.222701,2872,20,138304,4,2871,640,2872,10,1
20141226.222701,2872,6,138310,0,2871,802,2872,9,1
20141226.222702,2873,20,138330,8,2871,801,2872,15,1
20141226.222704,2873,2,138332,0,2871,756,2872,15,1
20141226.222705,2871,22,138354,0,2871,755,2872,5,0
20141226.222706,2872,4,138358,-4,2871,750,2872,3,1
20141226.222707,2872,2,138360,0,2871,750,2872,4,1
20141226.222708,2872,2,138362,0,2871,747,2872,14,1
20141226.222708,2872,2,138364,2,2871,747,2872,13,1
20141226.222709,2872,20,138384,0,2871,748,2872,8,1
20141226.22271,2872,2,138386,0,2871,754,2872,7,1
20141226.222712,2872,2,138388,0,2871,752,2872,43,1
20141226.222713,2872,2,138390,0,2871,752,2872,46,1
20141226.222715,2872,2,138392,2,2871,754,2872,56,1
20141226.222716,2872,10,138402,8,2871,754,2872,51,1
20141226.222719,2872,2,138404,0,2871,754,2872,53,1
20141226.222721,2872,2,138406,0,2871,754,2872,55,1
20141226.222721,2872,4,138410,0,2871,754,2872,54,1
20141226.222723,2872,2,138412,0,2871,759,2872,53,1
20141226.222724,2872,10,138422,10,2871,754,2872,62,1
20141226.222725,2871,400,138822,336,2871,554,2872,64,0
20141226.222726,2871,140,138962,0,2871,484,2872,64,0
20141226.222726,2872,140,139102,32,2871,484,2872,2,1
20141226.222728,2872,12,139114,2,2872,16,2873,828,1
20141226.222728,2871,42,139156,32,2871,476,2873,828,0
20141226.222734,2872,2,139158,2,2871,524,2872,45,1
20141226.222735,2871,400,139558,280,2871,356,2872,53,0
20141226.222736,2872,12,139570,0,2871,356,2872,66,1
20141226.222737,2872,4,139574,-4,2871,356,2872,66,1
20141226.222738,2871,20,139594,0,2871,346,2872,71,0
20141226.222741,2872,8,139602,-8,2871,346,2872,142,1
20141226.222742,2872,2,139604,0,2871,346,2872,149,1
20141226.222744,2871,20,139624,0,2871,336,2872,152,0
20141226.222744,2872,4,139628,-2,2871,336,2872,152,1
20141226.222745,2871,8,139636,-6,2871,333,2872,140,0
20141226.222748,2871,114,139750,-96,2871,302,2872,293,0
20141226.222749,2872,586,140336,-174,2872,668,2873,866,1
20141226.222749,2872,20,140356,0,2872,658,2873,858,1
20141226.22275,2872,10,140366,-10,2872,653,2873,858,1
20141226.222751,2872,6,140372,-6,2872,652,2873,857,1
20141226.222754,2872,2,140374,0,2872,653,2873,859,1
20141226.222755,2872,2,140376,-2,2872,652,2873,859,1
20141226.222756,2872,2,140378,0,2872,651,2873,859,1
20141226.222757,2873,120,140498,116,2872,652,2873,798,1
20141226.222757,2872,12,140510,-12,2872,654,2873,798,0
20141226.222758,2872,2,140512,-2,2872,653,2873,795,0
20141226.222759,2872,4,140516,-2,2872,652,2873,794,0
20141226.222759,2872,6,140522,0,2872,649,2873,875,0
20141226.222801,2872,100,140622,-100,2872,599,2873,898,0
20141226.222801,2872,2,140624,0,2872,598,2873,899,0
20141226.222802,2872,10,140634,0,2872,693,2873,899,0
20141226.222802,2872,2,140636,-2,2872,693,2873,899,0
20141226.222803,2872,10,140646,-10,2872,689,2873,789,0
20141226.222804,2872,18,140664,-18,2872,680,2873,789,0
20141226.222804,2873,2,140666,2,2872,679,2873,797,1
20141226.222805,2873,20,140686,20,2872,680,2873,1287,1
20141226.222805,2872,2,140688,0,2872,680,2873,1287,0
20141226.222807,2872,600,141288,0,2872,380,2873,1288,0
20141226.222809,2872,6,141294,0,2872,369,2873,1289,0
20141226.222811,2872,2,141296,-2,2872,368,2873,1291,0
20141226.222811,2872,2,141298,0,2872,367,2873,1292,0
20141226.222812,2872,2,141300,0,2872,366,2873,1292,0
20141226.222813,2872,80,141380,0,2872,326,2873,1292,0
20141226.222816,2872,2,141382,-2,2872,324,2873,1294,0
20141226.222816,2872,2,141384,-2,2872,475,2873,1297,0
20141226.222817,2873,680,142064,2,2872,138,2873,1294,1
20141226.222818,2872,2,142066,0,2872,137,2873,1353,0
20141226.222819,2872,4,142070,0,2872,135,2873,1353,0
20141226.222819,2872,60,142130,0,2872,108,2873,1354,0
20141226.22282,2872,216,142346,-210,2871,186,2873,1292,0
20141226.222821,2871,232,142578,-204,2871,69,2872,857,0
20141226.222822,2872,82,142660,-40,2871,29,2872,839,1
20141226.222823,2872,2,142662,0,2871,40,2872,918,1
20141226.222827,2872,6,142668,4,2871,45,2872,897,1
20141226.222827,2871,74,142742,-74,2871,16,2872,898,0
20141226.222828,2871,12,142754,-8,2871,11,2872,897,0
20141226.222829,2871,2,142756,0,2871,2,2872,899,0
20141226.22283,2872,1834,144590,-1578,2872,84,2873,1350,1
20141226.22283,2872,20,144610,-20,2872,74,2873,1350,1
20141226.222831,2872,20,144630,-20,2872,79,2873,1606,1
20141226.222832,2872,128,144758,0,2871,72,2872,86,1
20141226.222834,2872,2,144760,0,2871,81,2873,1464,1
20141226.222834,2872,2,144762,0,2871,78,2873,1297,1
20141226.222838,2872,2,144764,2,2871,80,2872,1004,1
20141226.222838,2872,2000,146764,-1896,2871,81,2873,1300,1
20141226.22284,2871,42,146806,-16,2872,3,2873,1299,0
20141226.222842,2872,4,146810,-4,2872,1,2873,1296,1
20141226.222844,2872,2,146812,0,2871,651,2873,1296,1
20141226.222845,2872,2,146814,2,2872,40,2873,1296,1
20141226.222845,2872,22,146836,14,2871,567,2873,1296,1
20141226.222846,2872,2,146838,-2,2871,568,2873,1297,1
20141226.222846,2872,102,146940,-92,2871,604,2873,1297,1
20141226.222847,2872,6,146946,-6,2871,612,2873,1298,1
20141226.222849,2872,38,146984,38,2872,11,2873,1302,1
20141226.22285,2872,2,146986,0,2872,10,2873,1301,1
20141226.22285,2872,20,147006,-20,2871,628,2872,1,1
20141226.222851,2872,4,147010,2,2871,628,2872,29,1
20141226.222851,2872,58,147068,-40,2871,649,2873,1300,1
20141226.222852,2872,200,147268,66,2871,655,2873,1300,1
20141226.222855,2872,2,147270,0,2872,10,2873,1330,1
20141226.222857,2872,12,147282,-12,2872,4,2873,1330,1
20141226.222859,2872,8,147290,-2,2871,710,2873,1331,1
20141226.222901,2872,160,147450,158,2871,711,2873,1331,1
20141226.222903,2872,2,147452,0,2872,1022,2873,1297,1
20141226.222905,2872,2,147454,-2,2872,1045,2873,1297,1
20141226.222905,2872,2,147456,0,2872,1044,2873,1297,1
20141226.222908,2873,2,147458,2,2872,1046,2873,1291,1
20141226.222909,2872,20,147478,0,2872,1036,2873,1296,0
20141226.222912,2872,200,147678,0,2872,937,2873,1297,0
20141226.222914,2872,10,147688,0,2872,937,2873,1295,0
20141226.222915,2872,2,147690,-2,2872,937,2873,1296,0
20141226.222916,2872,4,147694,0,2872,937,2873,1296,0
20141226.222917,2872,4,147698,-2,2872,935,2873,1299,0
20141226.222918,2873,8,147706,8,2872,935,2873,1295,1
20141226.222921,2872,2,147708,-2,2872,57,2873,1301,0
20141226.222921,2872,114,147822,10,2871,680,2872,54,0
20141226.222922,2872,4,147826,2,2871,680,2872,52,0
20141226.222923,2872,2,147828,2,2871,680,2872,61,0
20141226.222923,2872,2,147830,2,2871,680,2872,60,0
20141226.222924,2872,4,147834,4,2871,680,2872,59,0
20141226.222924,2871,2,147836,2,2871,679,2872,59,0
20141226.222925,2872,2,147838,0,2871,680,2872,59,1
20141226.222928,2871,20,147858,20,2871,671,2872,62,0
20141226.222929,2872,6,147864,6,2871,675,2872,61,1
20141226.22293,2872,132,147996,-16,2872,944,2873,1340,1
20141226.222932,2872,20,148016,-10,2871,675,2872,1,1
20141226.222935,2871,6,148022,0,2871,713,2872,24,0
20141226.222935,2872,10,148032,0,2871,713,2872,19,1
20141226.222936,2872,2,148034,2,2871,713,2872,18,1
20141226.222937,2871,6,148040,6,2871,710,2872,19,0
20141226.222939,2872,2,148042,2,2871,711,2872,28,1
20141226.222939,2871,2,148044,2,2871,710,2872,28,0
20141226.22294,2872,2,148046,2,2871,709,2872,27,1
20141226.222943,2872,2,148048,0,2871,707,2872,32,1
20141226.222946,2871,2,148050,2,2871,713,2872,39,0
20141226.222947,2872,40,148090,-8,2871,783,2872,19,1
20141226.222947,2872,2,148092,-2,2871,782,2872,18,1
20141226.222948,2872,2,148094,-2,2871,782,2872,22,1
20141226.22295,2871,20,148114,10,2871,772,2872,23,0
20141226.222951,2871,2,148116,-2,2871,771,2872,39,0
20141226.222954,2872,16,148132,4,2871,771,2872,27,1
20141226.222959,2871,12,148144,2,2871,766,2872,40,0
20141226.223001,2872,36,148180,-20,2871,767,2872,22,1
20141226.223001,2872,16,148196,-4,2871,765,2872,16,1
20141226.223002,2873,152,148348,72,2871,765,2873,730,1
20141226.223002,2872,6,148354,6,2871,765,2872,17,0
20141226.223004,2872,34,148388,0,2872,58,2873,734,0
20141226.223004,2872,10,148398,-10,2872,53,2873,734,0
20141226.223006,2872,20,148418,-20,2872,43,2873,737,0
20141226.223006,2872,4,148422,0,2872,41,2873,737,0
20141226.223007,2872,82,148504,-80,2871,768,2873,736,0
20141226.223008,2872,2,148506,0,2871,768,2873,740,0
20141226.22301,2871,100,148606,-84,2871,718,2872,18,0
20141226.22301,2872,20,148626,-18,2872,192,2873,760,1
20141226.223012,2872,16,148642,-16,2872,184,2873,755,1
20141226.223012,2872,24,148666,-24,2872,174,2873,755,1
20141226.223013,2872,4,148670,0,2872,182,2873,756,1
20141226.223015,2872,60,148730,-20,2872,162,2873,761,1
20141226.223016,2872,20,148750,-20,2872,152,2873,761,1
20141226.223018,2872,2,148752,0,2872,151,2873,762,1
20141226.223019,2872,6,148758,0,2872,148,2873,762,1
20141226.22302,2872,40,148798,0,2872,128,2873,769,1
20141226.223022,2872,258,149056,-28,2871,752,2873,768,1
20141226.223023,2871,16,149072,-16,2871,778,2872,11,0
20141226.223024,2872,26,149098,-2,2872,7,2873,810,1
20141226.223025,2872,2,149100,0,2872,6,2873,810,1
20141226.223025,2872,12,149112,-12,2871,724,2873,810,1
20141226.223027,2872,6,149118,0,2871,758,2872,7,1
20141226.223027,2872,2,149120,2,2871,758,2872,7,1
20141226.223029,2872,6,149126,0,2871,758,2872,5,1
20141226.223029,2872,6,149132,0,2871,768,2872,2,1
20141226.22303,2872,4,149136,-4,2871,637,2873,772,1
20141226.223031,2872,14,149150,-2,2871,632,2873,771,1
20141226.223032,2872,4,149154,0,2871,739,2873,771,1
20141226.223033,2871,20,149174,0,2871,730,2873,752,0
20141226.223034,2871,2,149176,-2,2871,729,2873,692,0
20141226.223035,2873,774,149950,-126,2871,622,2873,305,1
20141226.223035,2873,2,149952,2,2871,622,2873,304,1
20141226.223036,2872,280,150232,-20,2871,602,2873,302,0
20141226.223037,2872,32,150264,-32,2872,223,2873,302,0
20141226.223039,2873,8,150272,8,2872,374,2873,299,1
20141226.223039,2873,4,150276,2,2872,353,2873,298,1
20141226.22304,2873,2,150278,2,2872,353,2873,297,1
20141226.223042,2873,2,150280,2,2872,347,2873,296,1
20141226.223042,2872,2,150282,0,2872,351,2873,296,0
20141226.223043,2873,6,150288,6,2872,365,2873,294,1
20141226.223045,2873,22,150310,20,2872,400,2873,289,1
20141226.223046,2873,422,150732,124,2872,419,2873,79,1
20141226.223047,2873,160,150892,-116,2873,65,2874,266,1
20141226.223047,2873,84,150976,20,2873,34,2874,273,1
20141226.223048,2873,40,151016,4,2873,57,2874,273,1
20141226.223048,2873,8,151024,2,2873,115,2874,272,1
20141226.223049,2873,2,151026,-2,2873,180,2874,272,1
20141226.22305,2874,550,151576,-324,2874,728,2875,443,1
20141226.22305,2874,162,151738,-12,2874,660,2875,402,1
20141226.223051,2874,16,151754,-16,2874,652,2875,402,1
20141226.223051,2874,14,151768,-10,2874,646,2875,401,1
20141226.223052,2874,38,151806,-24,2874,637,2875,401,1
20141226.223052,2874,2,151808,-2,2874,636,2875,401,1
20141226.223053,2874,124,151932,-120,2874,575,2875,400,1
20141226.223053,2874,4,151936,-4,2874,573,2875,400,1
20141226.223054,2874,60,151996,32,2874,570,2875,373,1
20141226.223055,2874,16,152012,-2,2874,566,2875,445,1
20141226.223055,2874,2,152014,-2,2874,565,2875,448,1
20141226.223055,2874,210,152224,-6,2874,463,2875,444,1
20141226.223056,2875,8,152232,-4,2874,462,2875,442,1
20141226.223057,2874,8,152240,-4,2874,460,2875,440,0
20141226.223057,2874,6,152246,0,2874,459,2875,439,0
20141226.223058,2874,16,152262,-8,2874,454,2875,437,0
20141226.223058,2874,76,152338,-38,2874,449,2875,405,0
20141226.223059,2875,84,152422,-12,2874,414,2875,404,1
20141226.223059,2873,810,153232,-624,2873,120,2874,1,0
20141226.2231,2874,4,153236,-2,2873,120,2874,20,1
20141226.2231,2873,4,153240,2,2873,85,2874,240,0
20141226.223101,2874,2,153242,2,2873,85,2874,253,1
20141226.223101,2874,4,153246,0,2873,88,2874,261,1
20141226.223102,2874,6,153252,0,2873,87,2874,260,1
20141226.223103,2874,6,153258,4,2873,82,2874,333,1
20141226.223104,2874,30,153288,8,2873,123,2874,328,1
20141226.223105,2874,4,153292,0,2873,123,2874,326,1
20141226.223105,2873,6,153298,0,2873,121,2874,332,0
20141226.223106,2873,2,153300,0,2873,112,2874,332,0
20141226.223106,2873,4,153304,0,2873,113,2874,337,0
20141226.223107,2873,4,153308,0,2873,112,2874,340,0
20141226.223107,2873,12,153320,0,2873,110,2874,337,0
20141226.223108,2873,4,153324,0,2873,108,2874,342,0
20141226.223108,2873,2,153326,0,2873,111,2874,348,0
20141226.223109,2873,2,153328,0,2873,210,2874,348,0
20141226.223109,2873,2,153330,0,2873,214,2874,348,0
20141226.22311,2873,2,153332,0,2873,213,2874,348,0
20141226.22311,2873,2,153334,0,2873,252,2874,354,0
20141226.223111,2873,42,153376,0,2873,233,2874,354,0
20141226.223111,2873,202,153578,-6,2873,133,2874,352,0
20141226.223112,2873,14,153592,2,2873,127,2874,394,0
20141226.223112,2873,64,153656,2,2873,95,2874,395,0
20141226.223113,2873,2,153658,0,2873,94,2874,398,0
20141226.223113,2872,190,153848,-2,2872,269,2873,21,0
20141226.223114,2872,2,153850,0,2872,276,2873,21,0
20141226.223115,2873,6,153856,0,2872,274,2873,150,1
20141226.223115,2873,2,153858,0,2872,275,2873,149,1
20141226.223116,2873,66,153924,46,2872,317,2873,116,1
20141226.223118,2873,2,153926,0,2872,332,2873,116,1
20141226.223119,2873,8,153934,8,2872,369,2873,115,1
20141226.223124,2872,8,153942,8,2872,467,2873,240,0
20141226.223125,2873,2,153944,2,2872,471,2873,249,1
20141226.223128,2873,2,153946,0,2872,271,2873,263,1
20141226.223129,2872,6,153952,6,2872,234,2873,263,0
20141226.22313,2872,82,154034,0,2872,277,2873,225,0
20141226.223131,2873,6,154040,6,2872,275,2873,251,1
20141226.223132,2872,4,154044,0,2872,275,2873,256,0
20141226.223132,2872,12,154056,12,2872,258,2873,246,0
20141226.223133,2873,28,154084,8,2872,258,2873,242,1
20141226.223133,2872,260,154344,194,2872,73,2873,250,0
20141226.223134,2872,150,154494,38,2871,795,2872,2,0
20141226.223134,2872,12,154506,-8,2871,834,2873,255,0
20141226.223135,2872,4,154510,2,2871,834,2872,5,0
20141226.223135,2872,10,154520,10,2871,835,2872,11,0
20141226.223136,2872,6,154526,4,2871,835,2872,218,0
20141226.223136,2872,40,154566,26,2871,835,2872,199,0
20141226.223138,2871,242,154808,-2,2871,828,2872,88,0
20141226.223138,2872,202,155010,-168,2871,790,2872,39,1
20141226.223138,2872,12,155022,12,2871,790,2872,43,1
20141226.22314,2871,2,155024,-2,2871,789,2872,85,0
20141226.223141,2871,2,155026,0,2871,788,2872,85,0
20141226.223141,2871,2,155028,0,2871,788,2872,85,0
20141226.223141,2872,2,155030,2,2871,788,2872,85,1
20141226.223145,2871,44,155074,0,2871,773,2872,99,0
20141226.223146,2872,2,155076,0,2871,789,2872,101,1
20141226.223147,2872,2,155078,2,2871,789,2872,110,1
20141226.223147,2872,2,155080,2,2871,789,2872,109,1
20141226.223148,2872,4,155084,4,2871,789,2872,107,1
20141226.223148,2871,1578,156662,-1438,2870,767,2871,215,0
20141226.223149,2871,172,156834,-164,2870,704,2871,129,0
20141226.223149,2870,2,156836,0,2870,703,2871,130,0
20141226.22315,2871,10,156846,4,2870,698,2871,130,1
20141226.22315,2871,2,156848,0,2870,697,2871,129,1
20141226.223151,2871,20,156868,-6,2870,688,2871,125,1
20141226.223151,2871,4,156872,-2,2870,688,2871,153,1
20141226.223152,2870,2,156874,0,2870,687,2871,1168,0
20141226.223152,2871,8,156882,-2,2870,689,2871,1173,1
20141226.223153,2870,28,156910,22,2870,675,2871,1223,0
20141226.223154,2870,204,157114,0,2870,574,2871,1227,0
20141226.223154,2870,22,157136,2,2870,562,2871,1227,0
20141226.223155,2870,136,157272,4,2870,558,2871,1164,0
20141226.223155,2871,2,157274,-2,2870,557,2871,1186,1
20141226.223156,2870,20,157294,20,2870,547,2871,1186,0
20141226.223157,2870,12,157306,6,2870,562,2871,1186,0
20141226.223157,2870,24,157330,22,2870,551,2871,1176,0
20141226.223158,2870,6,157336,4,2870,549,2871,1176,0
20141226.223158,2871,2,157338,-2,2870,549,2871,1175,1
20141226.223159,2870,10,157348,2,2870,551,2871,1174,0
20141226.223159,2870,32,157380,0,2870,535,2871,1175,0
20141226.2232,2870,10,157390,6,2870,533,2871,1174,0
20141226.223201,2870,2,157392,2,2870,539,2871,1174,0
20141226.223201,2870,22,157414,22,2870,491,2871,1190,0
20141226.223202,2870,2,157416,0,2870,490,2871,1190,0
20141226.223202,2870,8,157424,2,2870,522,2871,1189,0
20141226.223203,2870,60,157484,-6,2870,497,2871,1189,0
20141226.223204,2870,10,157494,6,2870,493,2871,1191,0
20141226.223204,2870,32,157526,-2,2870,481,2871,1191,0
20141226.223204,2870,426,157952,-136,2870,268,2871,1190,0
20141226.223205,2870,4,157956,0,2870,341,2871,1190,0
20141226.223205,2870,8,157964,4,2870,337,2871,1192,0
20141226.223206,2870,20,157984,20,2870,327,2871,1192,0
20141226.223207,2870,4,157988,0,2870,376,2871,1176,0
20141226.223208,2870,2,157990,2,2870,396,2871,1176,0
20141226.223208,2871,522,158512,-518,2870,404,2871,916,1
20141226.223209,2870,110,158622,2,2870,409,2871,871,0
20141226.223209,2871,22,158644,-22,2870,399,2871,862,1
20141226.22321,2870,10,158654,0,2870,398,2871,862,0
20141226.223211,2870,12,158666,10,2870,392,2871,864,0
20141226.223211,2871,2,158668,0,2870,391,2871,863,1
20141226.223212,2871,1624,160292,-1554,2870,397,2871,50,1
20141226.223212,2870,2,160294,0,2870,406,2871,50,0
20141226.223213,2871,34,160328,20,2870,404,2871,35,1
20141226.223213,2871,6,160334,0,2870,404,2871,32,1
20141226.223214,2871,196,160530,-10,2870,310,2871,29,1
20141226.223216,2871,4,160534,2,2870,246,2871,32,1
20141226.223217,2871,6,160540,0,2870,249,2871,29,1
20141226.223217,2871,24,160564,-12,2870,243,2871,22,1
20141226.223218,2870,10,160574,-10,2870,238,2871,23,0
20141226.223219,2871,90,160664,-28,2871,5,2872,268,1
20141226.22322,2871,8,160672,0,2871,21,2872,281,1
20141226.223221,2871,2,160674,-2,2871,27,2872,281,1
20141226.223221,2871,2,160676,0,2871,26,2872,281,1
20141226.223222,2871,20,160696,-18,2871,17,2872,281,1
20141226.223227,2871,2,160698,0,2871,23,2872,279,1
20141226.223229,2871,4,160702,0,2871,51,2872,265,1
20141226.223232,2871,40,160742,-8,2871,33,2872,184,1
20141226.223233,2871,2,160744,0,2871,34,2872,189,1
20141226.223233,2871,20,160764,20,2871,24,2872,204,1
20141226.223234,2871,2,160766,0,2871,25,2872,180,1
20141226.223235,2871,2,160768,0,2871,30,2872,176,1
20141226.22324,2872,378,161146,170,2872,11,2873,205,1
20141226.22324,2872,4,161150,0,2872,10,2873,206,1
20141226.223242,2872,2,161152,2,2872,171,2873,204,1
20141226.223243,2872,12,161164,10,2872,166,2873,204,1
20141226.223244,2872,2,161166,0,2872,165,2873,204,1
20141226.223246,2872,2,161168,2,2872,182,2873,210,1
20141226.223248,2872,2,161170,2,2872,181,2873,211,1
20141226.223248,2872,2,161172,2,2872,180,2873,212,1
20141226.22325,2872,2,161174,2,2872,190,2873,218,1
20141226.223251,2872,2,161176,2,2872,189,2873,221,1
20141226.223253,2872,2,161178,2,2872,188,2873,246,1
20141226.223302,2872,2,161180,0,2872,188,2873,297,1
20141226.223302,2872,2,161182,0,2872,193,2873,297,1
20141226.223303,2873,10,161192,8,2872,198,2873,293,1
20141226.223305,2873,4,161196,2,2872,98,2873,292,1
20141226.223305,2873,2,161198,0,2872,98,2873,291,1
20141226.223306,2873,228,161426,-182,2872,98,2873,177,1
20141226.223307,2872,2,161428,2,2872,100,2873,179,0
20141226.223313,2872,26,161454,4,2872,110,2873,183,0
20141226.223313,2872,2,161456,2,2872,109,2873,183,0
20141226.223315,2872,60,161516,0,2872,80,2873,184,0
20141226.223316,2872,20,161536,-2,2872,65,2873,334,0
20141226.223317,2872,136,161672,-80,2871,251,2872,142,0
20141226.223318,2872,36,161708,-36,2871,252,2872,189,0
20141226.223321,2872,20,161728,0,2871,263,2872,180,0
20141226.223321,2872,2,161730,-2,2871,262,2872,210,0
20141226.223324,2871,4,161734,0,2871,261,2872,211,0
20141226.223325,2871,12,161746,0,2871,276,2872,213,0
20141226.223327,2871,104,161850,-78,2871,231,2872,206,0
20141226.223328,2871,100,161950,-96,2871,182,2872,215,0
20141226.223329,2872,212,162162,-202,2871,182,2872,110,1
20141226.223329,2871,2,162164,-2,2871,186,2872,110,0
20141226.223332,2872,2,162166,2,2871,186,2872,110,1
20141226.223332,2872,2,162168,2,2871,186,2872,109,1
20141226.223333,2871,2,162170,0,2871,185,2872,139,0
20141226.223336,2871,2,162172,-2,2871,172,2872,170,0
20141226.223336,2871,2,162174,0,2871,171,2872,170,0
20141226.223339,2871,2,162176,0,2871,190,2872,171,0
20141226.223339,2872,4,162180,0,2871,190,2872,169,1
20141226.22334,2872,4,162184,2,2871,190,2872,174,1
20141226.223341,2871,60,162244,-54,2871,449,2872,145,0
20141226.223341,2872,32,162276,-28,2871,447,2872,131,1
20141226.223342,2872,80,162356,-80,2871,447,2872,91,1
20141226.223342,2872,6,162362,0,2871,447,2872,80,1
20141226.223343,2872,20,162382,-2,2871,442,2872,75,1
20141226.223344,2872,10,162392,8,2871,442,2872,70,1
20141226.223345,2872,4,162396,2,2871,450,2872,99,1
20141226.223346,2872,2,162398,2,2871,450,2872,98,1
20141226.223347,2872,120,162518,4,2871,450,2872,48,1
20141226.223347,2871,8,162526,2,2871,449,2872,65,0
20141226.223349,2871,6,162532,-2,2871,447,2872,64,0
20141226.22335,2872,22,162554,-4,2871,440,2872,67,1
20141226.223355,2872,2,162556,-2,2871,472,2872,198,1
20141226.223355,2872,2,162558,-2,2871,471,2872,197,1
20141226.223357,2872,2,162560,0,2871,471,2872,197,1
20141226.223357,2872,4,162564,0,2871,471,2872,195,1
20141226.223402,2871,2,162566,0,2871,471,2872,363,0
20141226.223404,2871,2,162568,0,2871,472,2872,366,0
20141226.223414,2872,2,162570,0,2871,479,2872,399,1
20141226.22342,2871,2,162572,-2,2871,451,2872,401,0
20141226.223421,2872,40,162612,-40,2871,451,2872,382,1
20141226.223422,2871,300,162912,230,2871,301,2872,384,0
20141226.223423,2871,560,163472,198,2870,516,2871,3,0
20141226.223424,2871,60,163532,-6,2870,516,2871,4,0
20141226.223425,2871,2,163534,2,2870,535,2871,36,0
20141226.223426,2870,2,163536,-2,2870,534,2871,36,0
20141226.223427,2871,14,163550,12,2870,527,2871,30,1
20141226.223427,2871,2,163552,2,2870,527,2871,29,1
20141226.22343,2871,4,163556,2,2870,505,2871,305,1
20141226.223431,2870,2,163558,-2,2870,504,2871,305,0
20141226.223433,2871,2,163560,2,2870,504,2871,304,1
20141226.223434,2870,2,163562,2,2870,520,2871,105,0
20141226.223435,2871,2,163564,2,2870,522,2871,104,1
20141226.223436,2871,2,163566,2,2870,397,2871,103,1
20141226.223436,2870,4,163570,2,2870,394,2871,93,0
20141226.223438,2871,10,163580,2,2870,388,2871,92,1
20141226.223438,2871,6,163586,4,2870,390,2871,89,1
20141226.223439,2871,12,163598,12,2870,390,2871,103,1
20141226.22344,2870,2,163600,2,2870,389,2871,109,0
20141226.22344,2871,2,163602,0,2870,389,2871,108,1
20141226.223441,2871,22,163624,20,2870,389,2871,100,1
20141226.223443,2871,8,163632,4,2870,372,2871,99,1
20141226.223444,2871,4,163636,0,2870,353,2871,108,1
20141226.223448,2870,6,163642,2,2870,354,2871,161,0
20141226.223449,2870,2,163644,0,2870,353,2871,192,0
20141226.223452,2870,2,163646,2,2870,351,2871,192,0
20141226.223453,2871,2,163648,0,2870,351,2871,191,1
20141226.223453,2870,20,163668,-16,2870,341,2871,191,0
20141226.223454,2871,150,163818,-52,2871,188,2872,281,1
20141226.223454,2872,60,163878,4,2871,181,2872,261,1
20141226.223455,2871,20,163898,0,2871,171,2872,261,0
20141226.223457,2871,6,163904,0,2871,187,2872,281,0
20141226.223459,2871,2,163906,-2,2871,195,2872,261,0
20141226.223501,2872,38,163944,0,2871,547,2872,219,1
20141226.223502,2872,440,164384,-198,2872,30,2873,408,1
20141226.223503,2872,2,164386,0,2872,39,2873,416,1
20141226.223503,2872,6,164392,-6,2872,37,2873,416,1
20141226.223505,2872,8,164400,-8,2872,50,2873,416,1
20141226.223505,2872,6,164406,-6,2872,47,2873,416,1
20141226.223505,2872,10,164416,-10,2872,43,2873,416,1
20141226.223506,2872,98,164514,-58,2872,198,2873,416,1
20141226.223507,2872,4,164518,0,2872,229,2873,417,1
20141226.223507,2872,12,164530,2,2872,223,2873,417,1
20141226.223508,2872,2,164532,2,2872,222,2873,418,1
20141226.223509,2872,2,164534,2,2872,222,2873,418,1
20141226.223509,2873,4,164538,2,2872,222,2873,416,1
20141226.22351,2873,4,164542,0,2872,223,2873,414,1
20141226.223512,2872,2,164544,2,2872,222,2873,410,0
20141226.223513,2872,2,164546,0,2872,221,2873,410,0
20141226.223514,2872,2,164548,2,2872,220,2873,420,0
20141226.223515,2872,10,164558,4,2872,221,2873,415,0
20141226.223515,2873,2,164560,2,2872,222,2873,414,1
20141226.223516,2872,400,164960,368,2872,22,2873,414,0
20141226.223516,2872,4,164964,0,2872,21,2873,414,0
20141226.223517,2872,42,165006,-36,2871,400,2873,426,0
20141226.223518,2872,10,165016,-6,2872,15,2873,437,0
20141226.223519,2872,6,165022,-2,2872,78,2873,438,0
20141226.223522,2872,2,165024,0,2872,96,2873,475,0
20141226.223523,2872,2,165026,0,2872,95,2873,475,0
20141226.223523,2872,4,165030,-4,2872,94,2873,475,0
20141226.223524,2872,6,165036,-6,2872,91,2873,476,0
20141226.223524,2872,2,165038,-2,2872,90,2873,476,0
20141226.223525,2872,206,165244,90,2872,88,2873,375,0
20141226.223527,2873,60,165304,60,2872,92,2873,346,1
20141226.223528,2870,1400,166704,316,2871,40,2872,58,0
20141226.223529,2872,2,166706,2,2871,50,2872,261,1
20141226.223531,2872,20,166726,20,2871,162,2872,317,1
20141226.223539,2872,2,166728,2,2871,169,2872,318,1
20141226.223541,2871,20,166748,20,2871,217,2872,308,0
20141226.223543,2871,42,166790,-28,2871,196,2872,233,0
20141226.223546,2872,2,166792,0,2871,198,2872,241,1
20141226.223549,2872,2,166794,2,2871,204,2872,244,1
20141226.223553,2871,20,166814,20,2871,198,2872,248,0
20141226.223558,2871,4,166818,4,2871,199,2872,253,0
20141226.2236,2872,2,166820,2,2871,199,2872,238,1
20141226.223601,2871,4,166824,2,2871,290,2872,143,0
20141226.223602,2871,400,167224,64,2871,90,2872,137,0
20141226.223602,2871,20,167244,20,2871,85,2872,137,0
20141226.223603,2872,40,167284,12,2871,88,2872,117,1
20141226.223604,2872,2,167286,2,2871,88,2872,115,1
20141226.223604,2871,2,167288,2,2871,117,2872,116,0
20141226.223604,2872,2,167290,2,2871,117,2872,145,1
20141226.223605,2871,2,167292,2,2871,147,2872,145,0
20141226.223608,2871,40,167332,40,2871,128,2872,148,0
20141226.223609,2872,8,167340,0,2871,139,2872,137,1
20141226.223609,2872,2,167342,2,2871,139,2872,136,1
20141226.22361,2872,260,167602,132,2871,145,2872,6,1
20141226.223611,2872,12,167614,0,2871,172,2872,2,1
20141226.223611,2871,498,168112,320,2870,327,2871,55,0
20141226.223612,2872,130,168242,108,2870,319,2873,366,1
20141226.223613,2872,20,168262,2,2871,116,2872,41,1
20141226.223613,2872,20,168282,-20,2871,116,2872,52,1
20141226.223613,2872,14,168296,0,2871,116,2872,196,1
20141226.223614,2871,402,168698,340,2871,136,2873,364,0
20141226.223617,2872,2,168700,0,2871,196,2872,136,1
20141226.223623,2872,4,168704,0,2871,166,2872,173,1
20141226.223623,2872,346,169050,-272,2872,427,2873,366,1
20141226.223624,2873,4,169054,4,2872,492,2873,364,1
20141226.223624,2872,390,169444,-390,2872,303,2873,364,0
20141226.223626,2873,6,169450,6,2872,304,2873,349,1
20141226.223626,2873,6,169456,0,2872,304,2873,346,1
20141226.223627,2873,2,169458,0,2872,305,2873,350,1
20141226.223628,2873,2,169460,2,2872,306,2873,349,1
20141226.223631,2873,2,169462,2,2872,318,2873,350,1
20141226.223633,2873,2,169464,0,2872,324,2873,361,1
20141226.223637,2872,2,169466,0,2872,327,2873,436,0
20141226.223637,2872,8,169474,0,2872,323,2873,446,0
20141226.223638,2873,14,169488,0,2872,323,2873,440,1
20141226.223639,2872,2,169490,-2,2872,332,2873,440,0
20141226.22364,2872,22,169512,-18,2872,369,2873,428,0
20141226.223641,2873,26,169538,0,2872,369,2873,415,1
20141226.223641,2873,2,169540,2,2872,369,2873,414,1
20141226.223643,2873,2,169542,0,2872,370,2873,422,1
20141226.223644,2873,2,169544,2,2872,380,2873,421,1
20141226.223649,2873,20,169564,20,2872,387,2873,416,1
20141226.22365,2872,2,169566,-2,2872,386,2873,416,0
20141226.22365,2872,6,169572,0,2872,383,2873,418,0
20141226.223652,2873,2,169574,2,2872,383,2873,417,1
20141226.223659,2872,2,169576,-2,2872,440,2873,420,0
20141226.2237,2872,100,169676,-100,2872,390,2873,419,0
20141226.223701,2872,2,169678,0,2872,385,2873,420,0
20141226.223702,2873,6,169684,0,2872,386,2873,418,1
20141226.223702,2872,110,169794,0,2872,337,2873,413,0
20141226.223703,2873,2,169796,2,2872,337,2873,412,1
20141226.223704,2873,20,169816,0,2872,337,2873,404,1
20141226.223704,2872,80,169896,-80,2872,297,2873,404,0
20141226.223705,2872,400,170296,-194,2872,97,2873,404,0
20141226.223706,2872,194,170490,-8,2871,259,2872,10,0
20141226.223706,2872,14,170504,0,2871,259,2872,9,0
20141226.223708,2872,2,170506,-2,2871,259,2872,19,0
20141226.223708,2872,38,170544,8,2872,5,2873,400,0
20141226.223713,2872,8,170552,4,2872,26,2873,400,0
20141226.223714,2872,8,170560,-4,2872,26,2873,399,0
20141226.223715,2872,2,170562,-2,2872,34,2873,398,0
20141226.223716,2872,2,170564,-2,2872,63,2873,400,0
20141226.223717,2872,2,170566,-2,2872,62,2873,401,0
20141226.223718,2873,2,170568,2,2872,62,2873,405,1
20141226.223718,2872,2,170570,-2,2872,61,2873,405,0
20141226.22372,2872,2,170572,0,2872,62,2873,405,0
20141226.223722,2872,98,170670,66,2872,19,2873,403,0
20141226.223726,2872,2,170672,0,2872,48,2873,405,0
20141226.223729,2873,6,170678,6,2872,50,2873,404,1
20141226.22373,2873,14,170692,4,2872,80,2873,397,1
20141226.22373,2873,2,170694,2,2872,82,2873,403,1
20141226.223731,2872,6,170700,2,2872,80,2873,402,0
20141226.223737,2873,2,170702,2,2872,315,2873,394,1
20141226.223739,2872,6,170708,0,2872,312,2873,393,0
20141226.22374,2873,2,170710,0,2872,312,2873,392,1
20141226.223743,2873,2,170712,2,2872,335,2873,392,1
20141226.223744,2873,10,170722,4,2872,340,2873,437,1
20141226.223744,2873,62,170784,52,2872,340,2873,406,1
20141226.223744,2873,2,170786,2,2872,340,2873,405,1
20141226.223745,2873,44,170830,44,2872,357,2873,382,1
20141226.223745,2873,2,170832,2,2872,359,2873,381,1
20141226.223746,2873,100,170932,56,2872,359,2873,332,1
20141226.223746,2873,82,171014,-22,2872,329,2873,292,1
20141226.223747,2873,182,171196,92,2872,330,2873,201,1
20141226.223747,2873,332,171528,-120,2872,330,2873,45,1
20141226.223748,2873,92,171620,50,2873,20,2874,408,1
20141226.223749,2873,20,171640,20,2873,76,2874,414,1
20141226.223752,2873,4,171644,2,2873,137,2874,412,1
20141226.223753,2874,8,171652,-2,2873,137,2874,652,1
20141226.223754,2874,6,171658,4,2873,139,2874,650,1
20141226.223755,2873,6,171664,4,2873,138,2874,650,0
20141226.223756,2874,10,171674,4,2873,189,2874,645,1
20141226.223757,2873,6,171680,4,2873,189,2874,645,0
20141226.223759,2874,20,171700,20,2873,239,2874,634,1
20141226.2238,2874,4,171704,0,2873,263,2874,642,1
20141226.223802,2874,2,171706,2,2873,263,2874,614,1
20141226.223803,2874,14,171720,0,2873,259,2874,608,1
20141226.223806,2874,6,171726,6,2873,287,2874,593,1
20141226.223806,2874,16,171742,-2,2873,287,2874,584,1
20141226.223807,2874,8,171750,6,2873,288,2874,581,1
20141226.223807,2874,4,171754,4,2873,290,2874,579,1
20141226.223808,2874,6,171760,2,2873,290,2874,576,1
20141226.223808,2874,10,171770,-6,2873,297,2874,571,1
20141226.223809,2874,306,172076,260,2873,147,2874,569,1
20141226.223809,2874,10,172086,0,2873,147,2874,564,1
20141226.22381,2874,12,172098,0,2873,147,2874,558,1
20141226.223811,2874,28,172126,-16,2873,148,2874,544,1
20141226.223811,2874,10,172136,0,2873,147,2874,540,1
20141226.223811,2874,2,172138,0,2873,147,2874,549,1
20141226.223812,2874,4,172142,0,2873,150,2874,547,1
20141226.223813,2873,6,172148,6,2873,147,2874,549,0
20141226.223813,2874,68,172216,-2,2873,122,2874,545,1
20141226.223813,2873,84,172300,18,2873,102,2874,523,0
20141226.223814,2873,172,172472,-4,2873,17,2874,524,0
20141226.223815,2873,34,172506,10,2872,384,2874,547,0
20141226.223816,2873,10,172516,0,2872,418,2873,139,0
20141226.223816,2873,2,172518,2,2872,418,2873,139,0
20141226.223817,2873,26,172544,22,2872,416,2873,127,0
20141226.223817,2873,4,172548,4,2872,416,2873,126,0
20141226.223818,2873,2,172550,2,2872,416,2873,126,0
20141226.223818,2873,22,172572,2,2872,416,2873,115,0
20141226.223819,2872,22,172594,20,2872,406,2873,114,0
20141226.223819,2873,4,172598,4,2872,406,2873,112,1
20141226.22382,2873,4,172602,2,2872,405,2873,111,1
20141226.22382,2873,2,172604,2,2872,405,2873,114,1
20141226.223821,2873,4,172608,4,2872,405,2873,112,1
20141226.223822,2873,2,172610,2,2872,405,2873,112,1
20141226.223822,2873,4,172614,4,2872,405,2873,110,1
20141226.223823,2873,4,172618,4,2872,406,2873,108,1
20141226.223823,2873,2,172620,2,2872,408,2873,107,1
20141226.223824,2873,2,172622,2,2872,408,2873,109,1
20141226.223824,2873,2,172624,0,2872,408,2873,108,1
20141226.223825,2873,12,172636,12,2872,408,2873,102,1
20141226.223826,2873,2,172638,2,2872,211,2873,101,1
20141226.223827,2873,8,172646,8,2872,211,2873,100,1
20141226.223827,2873,6,172652,6,2872,211,2873,100,1
20141226.223828,2873,2,172654,2,2872,211,2873,99,1
20141226.223828,2873,2,172656,2,2872,251,2873,98,1
20141226.223829,2873,2,172658,2,2872,242,2873,97,1
20141226.223829,2873,4,172662,4,2872,242,2873,95,1
20141226.22383,2873,2,172664,2,2872,242,2873,94,1
20141226.22383,2873,2,172666,2,2872,242,2873,93,1
20141226.223831,2873,4,172670,4,2872,242,2873,91,1
20141226.223831,2873,16,172686,16,2872,242,2873,83,1
20141226.223832,2873,6,172692,4,2872,242,2873,100,1
20141226.223832,2873,68,172760,6,2872,213,2873,105,1
20141226.223833,2873,4,172764,4,2872,212,2873,105,1
20141226.223834,2872,2,172766,2,2872,211,2873,105,0
20141226.223835,2873,2,172768,2,2872,212,2873,114,1
20141226.223838,2873,60,172828,60,2872,211,2873,86,1
20141226.223839,2873,40,172868,40,2872,212,2873,67,1
20141226.22384,2873,4,172872,0,2872,212,2873,65,1
20141226.223842,2873,130,173002,36,2872,212,2873,2,1
20141226.223843,2873,4,173006,0,2872,218,2874,371,1
20141226.223844,2873,2,173008,0,2873,3,2874,364,1
20141226.223846,2873,2,173010,0,2873,84,2874,364,1
20141226.223848,2874,728,173738,380,2873,92,2875,538,1
20141226.223848,2875,4,173742,4,2873,100,2875,796,1
20141226.223849,2875,26,173768,16,2873,98,2875,786,1
20141226.22385,2875,14,173782,-6,2873,98,2875,779,1
20141226.22385,2875,14,173796,0,2873,198,2875,740,1
20141226.223851,2875,10,173806,0,2873,201,2875,735,1
20141226.223851,2875,10,173816,4,2873,216,2875,730,1
20141226.223852,2875,2,173818,2,2873,368,2875,729,1
20141226.223852,2875,14,173832,2,2873,370,2875,723,1
20141226.223854,2875,10,173842,0,2873,371,2875,718,1
20141226.223856,2875,4,173846,0,2874,40,2875,719,1
20141226.223856,2875,2,173848,-2,2874,70,2875,719,1
20141226.223857,2874,6,173854,0,2874,68,2875,718,0
20141226.223857,2875,22,173876,-22,2874,68,2875,707,1
20141226.223858,2874,2,173878,0,2874,67,2875,707,0
20141226.223859,2874,2,173880,-2,2874,72,2875,707,0
20141226.2239,2875,1414,175294,210,2875,1,2876,813,1
20141226.2239,2875,2,175296,2,2874,72,2876,813,1
20141226.223901,2876,2,175298,2,2874,73,2876,812,1
20141226.223901,2876,170,175468,-8,2874,101,2876,733,1
20141226.223902,2876,62,175530,4,2875,57,2876,709,1
20141226.223902,2876,400,175930,12,2875,107,2876,504,1
20141226.223903,2876,4,175934,2,2875,115,2876,502,1
20141226.223903,2875,8,175942,2,2875,114,2876,601,0
20141226.223904,2875,6,175948,-2,2875,112,2876,620,0
20141226.223904,2876,10,175958,10,2875,112,2876,616,1
20141226.223905,2875,20,175978,0,2875,103,2876,616,0
20141226.223905,2875,4,175982,0,2875,101,2876,617,0
20141226.223906,2876,2,175984,2,2875,63,2876,617,1
20141226.223906,2875,4,175988,-2,2875,62,2876,619,0
20141226.223907,2876,14,176002,-8,2875,58,2876,616,1
20141226.223908,2876,8,176010,2,2875,58,2876,614,1
20141226.223908,2876,14,176024,12,2875,58,2876,607,1
20141226.223909,2875,18,176042,0,2875,51,2876,605,0
20141226.223909,2876,40,176082,38,2875,67,2876,588,1
20141226.22391,2875,2,176084,0,2875,66,2876,588,0
20141226.22391,2876,38,176122,-8,2875,51,2876,617,1
20141226.223911,2875,4,176126,2,2875,50,2876,616,0
20141226.223912,2876,4,176130,0,2875,51,2876,614,1
20141226.223913,2875,8,176138,4,2875,50,2876,614,0
20141226.223913,2875,22,176160,2,2875,41,2876,614,0
20141226.223914,2875,82,176242,78,2874,191,2876,634,0
20141226.223914,2875,10,176252,0,2874,203,2876,642,0
20141226.223915,2876,4,176256,0,2874,197,2875,6,1
20141226.223915,2875,100,176356,80,2874,206,2875,100,0
20141226.223916,2875,1436,177792,672,2874,203,2876,104,0
20141226.223917,2875,8,177800,-4,2874,325,2876,105,0
20141226.223917,2876,2,177802,0,2875,19,2876,105,1
20141226.223919,2875,56,177858,46,2875,289,2876,90,0
20141226.22392,2875,20,177878,20,2875,340,2876,92,0
20141226.22392,2876,12,177890,4,2875,338,2876,89,1
20141226.223921,2876,12,177902,10,2875,342,2876,92,1
20141226.223921,2876,24,177926,-10,2875,350,2876,85,1
20141226.223922,2875,10,177936,4,2875,349,2876,83,0
20141226.223923,2875,4,177940,0,2875,248,2876,120,0
20141226.223924,2875,14,177954,8,2875,247,2876,179,0
20141226.223924,2876,2,177956,0,2875,247,2876,180,1
20141226.223924,2876,106,178062,64,2875,247,2876,136,1
20141226.223925,2876,4,178066,4,2875,247,2876,139,1
20141226.223925,2875,4,178070,4,2875,246,2876,162,0
20141226.223926,2876,4,178074,4,2875,247,2876,227,1
20141226.223927,2875,40,178114,40,2875,229,2876,296,0
20141226.223928,2875,12,178126,12,2875,228,2876,325,0
20141226.223928,2875,64,178190,62,2875,196,2876,325,0
20141226.223929,2876,276,178466,250,2875,62,2876,326,1
20141226.22393,2876,10,178476,10,2875,54,2876,328,1
20141226.22393,2875,8,178484,2,2875,53,2876,326,0
20141226.223932,2875,104,178588,100,2874,347,2875,3,0
20141226.223932,2875,6,178594,0,2875,2,2876,342,0
20141226.223933,2875,26,178620,26,2874,336,2875,148,0
20141226.223934,2875,2,178622,2,2874,301,2875,149,0
20141226.223934,2874,4,178626,-4,2874,299,2875,149,0
20141226.223935,2875,12,178638,12,2874,305,2875,145,1
20141226.223935,2875,12,178650,12,2874,306,2875,139,1
20141226.223936,2875,12,178662,4,2874,310,2875,133,1
20141226.223936,2875,4,178666,2,2874,280,2875,141,1
20141226.223937,2875,14,178680,2,2874,280,2875,135,1
20141226.223939,2875,16,178696,-6,2874,277,2875,174,1
20141226.22394,2874,4,178700,-2,2874,275,2875,301,0
20141226.223942,2875,2,178702,-2,2874,273,2875,305,1
20141226.223944,2875,8,178710,-4,2874,293,2875,308,1
20141226.223945,2874,596,179306,456,2873,269,2874,202,0
20141226.223946,2874,16,179322,8,2873,277,2874,194,0
20141226.223947,2873,20,179342,0,2873,268,2874,194,0
20141226.223948,2873,86,179428,78,2873,225,2874,194,0
20141226.223949,2874,2,179430,2,2873,225,2874,195,1
20141226.22395,2874,60,179490,60,2873,224,2874,168,1
20141226.22395,2873,6,179496,6,2873,223,2874,166,0
20141226.223951,2874,4,179500,0,2873,222,2874,165,1
20141226.223954,2874,4,179504,4,2873,172,2874,681,1
20141226.223954,2873,18,179522,6,2873,165,2874,680,0
20141226.223955,2873,2,179524,0,2873,166,2874,681,0
20141226.223956,2873,4,179528,2,2873,167,2874,681,0
20141226.223958,2874,6,179534,2,2873,171,2874,681,1
20141226.223958,2873,8,179542,6,2873,169,2874,683,0
20141226.223959,2874,10,179552,10,2873,170,2874,683,1
20141226.224001,2873,2,179554,0,2873,172,2874,689,0
20141226.224001,2874,2,179556,0,2873,152,2874,688,1
20141226.224001,2874,2,179558,2,2873,152,2874,687,1
20141226.224003,2874,4,179562,2,2873,161,2874,690,1
20141226.224005,2873,14,179576,4,2873,159,2874,694,0
20141226.224008,2874,2,179578,2,2873,168,2874,691,1
20141226.224012,2874,4,179582,4,2873,227,2874,690,1
20141226.224013,2873,12,179594,0,2873,229,2874,689,0
20141226.224014,2873,2,179596,2,2873,228,2874,689,0
20141226.224015,2873,2,179598,2,2873,227,2874,690,0
20141226.224016,2874,2,179600,2,2873,227,2874,690,1
20141226.224017,2873,2,179602,0,2873,244,2874,690,0
20141226.224019,2873,20,179622,-2,2873,436,2874,691,0
20141226.22402,2874,4,179626,4,2873,437,2874,689,1
20141226.224021,2874,2,179628,2,2873,439,2874,709,1
20141226.224022,2873,10,179638,-10,2873,434,2874,709,0
20141226.224025,2874,2,179640,2,2873,434,2874,713,1
20141226.224026,2873,6,179646,2,2873,431,2874,713,0
20141226.224026,2873,6,179652,-6,2873,438,2874,714,0
20141226.224031,2873,4,179656,-4,2873,438,2874,715,0
20141226.224034,2873,6,179662,4,2873,472,2874,769,0
20141226.224034,2873,2,179664,0,2873,516,2874,769,0
20141226.224036,2874,2,179666,0,2873,516,2874,768,1
20141226.224038,2874,60,179726,60,2873,485,2874,739,1
20141226.224041,2873,2,179728,0,2873,485,2874,760,0
20141226.224042,2873,2,179730,0,2873,484,2874,750,0
20141226.224044,2874,4,179734,4,2873,486,2874,748,1
20141226.224047,2874,100,179834,100,2873,496,2874,691,1
20141226.224048,2873,76,179910,46,2873,458,2874,692,0
20141226.224049,2874,2,179912,0,2873,507,2874,691,1
20141226.22405,2874,10,179922,10,2873,507,2874,686,1
20141226.224052,2873,6,179928,0,2873,504,2874,687,0
20141226.224053,2873,22,179950,-20,2873,495,2874,686,0
20141226.224054,2874,2,179952,2,2873,495,2874,685,1
20141226.224058,2874,20,179972,20,2873,509,2874,686,1
20141226.2241,2873,4,179976,0,2873,507,2874,707,0
20141226.224102,2874,2,179978,2,2873,508,2874,706,1
20141226.224103,2873,30,180008,0,2873,494,2874,707,0
20141226.224105,2873,4,180012,0,2873,495,2874,707,0
20141226.224105,2873,2,180014,-2,2873,496,2874,707,0
20141226.224106,2873,12,180026,0,2873,490,2874,757,0
20141226.224106,2873,100,180126,10,2873,441,2874,765,0
20141226.224108,2873,2,180128,0,2873,432,2874,774,0
20141226.224108,2873,2,180130,0,2873,431,2874,774,0
20141226.224109,2874,4,180134,2,2873,430,2874,772,1
20141226.22411,2873,4,180138,2,2873,430,2874,771,0
20141226.224111,2874,6,180144,6,2873,427,2874,769,1
20141226.224114,2873,4,180148,0,2873,423,2874,781,0
20141226.224115,2874,10,180158,0,2873,425,2874,776,1
20141226.224116,2874,2,180160,2,2873,425,2874,777,1
20141226.224119,2873,2,180162,0,2873,427,2874,778,0
20141226.22412,2874,72,180234,72,2873,424,2874,742,1
20141226.22412,2874,2,180236,0,2873,443,2874,741,1
20141226.224124,2873,2,180238,0,2873,450,2874,730,0
20141226.224125,2873,10,180248,0,2873,445,2874,730,0
20141226.224127,2873,4,180252,-4,2873,443,2874,729,0
20141226.224129,2873,40,180292,-40,2873,427,2874,729,0
20141226.224133,2873,2,180294,-2,2873,426,2874,731,0
20141226.224134,2873,16,180310,-14,2873,418,2874,736,0
20141226.224136,2873,4,180314,2,2873,416,2874,735,0
20141226.224137,2874,2,180316,2,2873,416,2874,744,1
20141226.224138,2873,22,180338,-20,2873,405,2874,744,0
20141226.22414,2874,2,180340,2,2873,406,2874,746,1
20141226.224143,2873,2,180342,0,2873,401,2874,797,0
20141226.224147,2874,10,180352,10,2873,399,2874,813,1
20141226.224148,2874,4,180356,4,2873,398,2874,813,1
20141226.224152,2873,2,180358,-2,2873,401,2874,813,0
20141226.224157,2873,2,180360,-2,2873,403,2874,816,0
20141226.2242,2874,2,180362,0,2873,404,2874,815,1
20141226.224201,2874,2,180364,2,2873,404,2874,814,1
20141226.224204,2873,4,180368,0,2873,401,2874,814,0
20141226.224204,2873,4,180372,0,2873,406,2874,814,0
20141226.224205,2873,4,180376,-4,2873,404,2874,814,0
20141226.224206,2873,4,180380,0,2873,401,2874,814,0
20141226.224206,2874,2,180382,2,2873,401,2874,813,1
20141226.224208,2874,4,180386,4,2873,406,2874,812,1
20141226.224221,2874,30,180416,0,2873,429,2874,794,1
20141226.224222,2874,1060,181476,208,2873,429,2874,256,1
20141226.224222,2874,20,181496,20,2873,452,2874,246,1
20141226.224223,2874,494,181990,60,2874,91,2875,412,1
20141226.224224,2874,8,181998,-8,2874,153,2875,412,1
20141226.224226,2875,2,182000,0,2874,154,2875,411,1
20141226.224227,2874,20,182020,-20,2874,142,2875,411,0
20141226.224227,2874,32,182052,0,2874,125,2875,411,0
20141226.224229,2875,70,182122,-2,2874,127,2875,384,1
20141226.224231,2875,2,182124,0,2874,130,2875,376,1
20141226.224238,2875,30,182154,-30,2874,186,2875,395,1
20141226.224239,2874,10,182164,-6,2874,184,2875,395,0
20141226.22424,2874,104,182268,-64,2874,133,2875,389,0
20141226.224242,2874,246,182514,154,2873,444,2874,28,0
20141226.224243,2874,12,182526,12,2873,444,2874,37,0
20141226.224243,2874,4,182530,0,2873,444,2874,35,0
20141226.224243,2874,4,182534,4,2873,444,2874,33,0
20141226.224245,2874,4,182538,2,2873,447,2874,24,0
20141226.224247,2874,2,182540,0,2873,463,2874,24,0
20141226.224248,2874,10,182550,-10,2873,459,2874,19,0
20141226.224248,2874,2,182552,-2,2873,458,2874,19,0
20141226.224249,2874,16,182568,-14,2873,461,2874,11,0
20141226.22425,2874,2,182570,0,2873,461,2874,10,0
20141226.224251,2874,18,182588,-2,2873,515,2874,2,0
20141226.224251,2874,4,182592,-2,2874,143,2875,560,0
20141226.224252,2874,2,182594,0,2874,142,2875,562,0
20141226.224253,2874,2,182596,0,2874,143,2875,566,0
20141226.224256,2874,20,182616,0,2874,135,2875,559,0
20141226.224259,2874,2,182618,0,2874,137,2875,557,0
20141226.2243,2874,2,182620,-2,2874,136,2875,557,0
20141226.224302,2874,2,182622,0,2874,159,2875,554,0
20141226.224303,2874,2,182624,-2,2874,160,2875,554,0
20141226.224304,2874,172,182796,0,2874,83,2875,559,0
20141226.224305,2874,2,182798,0,2874,82,2875,559,0
20141226.224305,2874,2,182800,-2,2874,83,2875,556,0
20141226.224306,2874,4,182804,0,2874,201,2875,558,0
20141226.224307,2874,100,182904,-50,2874,151,2875,559,0
20141226.224311,2874,304,183208,44,2873,557,2875,653,0
20141226.224313,2874,2,183210,2,2873,527,2874,149,0
20141226.224315,2874,4,183214,4,2873,529,2874,153,0
20141226.224316,2874,10,183224,10,2873,528,2874,149,0
20141226.224317,2874,2,183226,2,2873,529,2874,148,0
20141226.224319,2874,10,183236,10,2873,530,2874,144,0
20141226.22432,2874,12,183248,2,2873,530,2874,139,0
20141226.224321,2874,70,183318,60,2873,525,2874,104,0
20141226.224324,2874,18,183336,4,2873,529,2874,112,0
20141226.224325,2874,12,183348,12,2873,613,2874,106,0
20141226.224326,2874,2,183350,0,2873,613,2874,105,0
20141226.224328,2874,2,183352,2,2873,594,2874,144,0
20141226.224329,2874,6,183358,-2,2873,593,2874,172,0
20141226.224332,2874,4,183362,2,2873,593,2874,172,0
20141226.224333,2874,50,183412,50,2873,593,2874,147,0
20141226.224334,2874,4,183416,4,2873,593,2874,160,0
20141226.224335,2874,2,183418,2,2873,593,2874,179,0
20141226.224335,2874,6,183424,2,2873,592,2874,177,0
20141226.224336,2874,4,183428,4,2873,592,2874,175,0
20141226.224337,2874,16,183444,16,2873,593,2874,166,0
20141226.224337,2874,2,183446,2,2873,593,2874,165,0
20141226.224337,2874,2,183448,2,2873,593,2874,164,0
20141226.224338,2874,4,183452,4,2873,593,2874,162,0
20141226.224339,2874,6,183458,6,2873,594,2874,159,0
20141226.22434,2874,2,183460,2,2873,574,2874,159,0
20141226.22434,2874,10,183470,10,2873,574,2874,155,0
20141226.224341,2873,2,183472,0,2873,573,2874,155,0
20141226.224342,2874,2,183474,0,2873,573,2874,154,1
20141226.224342,2874,2,183476,2,2873,573,2874,156,1
20141226.224343,2873,2,183478,-2,2873,572,2874,156,0
20141226.224343,2874,60,183538,22,2873,572,2874,126,1
20141226.224344,2873,24,183562,-24,2873,574,2874,130,0
20141226.224346,2874,40,183602,0,2873,574,2874,109,1
20141226.224346,2874,222,183824,-108,2873,363,2875,600,1
20141226.224348,2874,92,183916,-78,2873,363,2875,600,1
20141226.224348,2875,34,183950,0,2873,363,2875,583,1
20141226.224348,2874,20,183970,-20,2873,363,2875,583,0
20141226.224349,2875,2,183972,-2,2874,216,2875,582,1
20141226.22435,2874,4,183976,-4,2874,213,2875,582,0
20141226.224351,2874,6,183982,0,2874,216,2875,581,0
20141226.224353,2874,12,183994,-12,2874,312,2875,625,0
20141226.224355,2875,2,183996,0,2874,326,2875,631,1
20141226.224359,2875,60,184056,-48,2874,402,2875,501,1
20141226.2244,2874,2,184058,0,2874,402,2875,502,0
20141226.2244,2874,4,184062,0,2874,400,2875,502,0
20141226.224402,2874,10,184072,0,2874,361,2875,505,0
20141226.224404,2874,20,184092,0,2874,340,2875,505,0
20141226.224408,2875,8,184100,2,2874,344,2875,522,1
20141226.22441,2875,2,184102,2,2874,373,2875,521,1
20141226.224411,2875,4,184106,4,2874,378,2875,519,1
20141226.224412,2875,20,184126,-10,2874,440,2875,502,1
20141226.224414,2874,982,185108,396,2873,545,2874,249,0
20141226.224415,2874,4,185112,2,2873,544,2874,257,0
20141226.224415,2874,40,185152,26,2873,544,2874,237,0
20141226.224417,2874,44,185196,0,2873,555,2874,205,0
20141226.22442,2874,6,185202,6,2873,559,2874,202,0
20141226.22442,2874,6,185208,6,2873,559,2874,201,0
20141226.224422,2873,6,185214,2,2873,565,2874,200,0
20141226.224422,2874,2,185216,2,2873,575,2874,199,1
20141226.224423,2874,2,185218,2,2873,576,2874,218,1
20141226.224424,2874,2,185220,2,2873,575,2874,217,1
20141226.224425,2874,50,185270,50,2873,575,2874,192,1
20141226.224426,2874,10,185280,10,2873,569,2874,187,1
20141226.224428,2874,32,185312,0,2873,569,2874,176,1
20141226.224432,2874,4,185316,4,2873,551,2874,402,1
20141226.224435,2874,2,185318,2,2873,552,2874,442,1
20141226.224437,2873,2,185320,-2,2873,546,2874,445,0
20141226.224438,2873,4,185324,0,2873,569,2874,294,0
20141226.224438,2874,10,185334,0,2873,570,2874,292,1
20141226.224439,2873,10,185344,-10,2873,596,2874,292,0
20141226.224443,2873,2,185346,-2,2873,602,2874,296,0
20141226.224444,2873,20,185366,-20,2873,592,2874,296,0
20141226.224445,2873,2,185368,-2,2873,591,2874,296,0
20141226.224448,2873,60,185428,-60,2873,560,2874,300,0
20141226.224449,2873,2,185430,0,2873,559,2874,300,0
20141226.224451,2873,6,185436,0,2873,557,2874,300,0
20141226.224452,2874,4,185440,4,2873,532,2874,305,1
20141226.224453,2873,8,185448,0,2873,527,2874,306,0
20141226.224454,2873,2,185450,0,2873,545,2874,308,0
20141226.224457,2874,22,185472,20,2873,545,2874,300,1
20141226.224458,2874,4,185476,4,2873,545,2874,298,1
20141226.224459,2874,2,185478,2,2873,546,2874,297,1
20141226.224501,2873,100,185578,2,2873,496,2874,298,0
20141226.224501,2874,36,185614,8,2873,497,2874,300,1
20141226.224502,2874,4,185618,4,2873,522,2874,299,1
20141226.224502,2874,2,185620,2,2873,522,2874,298,1
20141226.224503,2874,8,185628,6,2873,513,2874,294,1
20141226.224503,2874,2,185630,2,2873,513,2874,293,1
20141226.224504,2874,4,185634,4,2873,514,2874,291,1
20141226.224504,2874,2,185636,2,2873,514,2874,290,1
20141226.224506,2874,4,185640,4,2873,514,2874,288,1
20141226.224507,2874,20,185660,20,2873,514,2874,278,1
20141226.224511,2874,2,185662,2,2873,525,2874,247,1
20141226.224512,2874,2,185664,2,2873,536,2874,246,1
20141226.224513,2873,4,185668,-4,2873,534,2874,266,0
20141226.224513,2874,532,186200,-228,2874,740,2875,533,1
20141226.224514,2875,4,186204,4,2874,744,2875,486,1
20141226.224515,2875,2,186206,2,2874,745,2875,485,1
20141226.224515,2875,4,186210,4,2874,755,2875,483,1
20141226.224516,2874,2,186212,0,2874,754,2875,483,0
20141226.224522,2875,4,186216,0,2874,816,2875,476,1
20141226.224523,2874,20,186236,0,2874,811,2875,476,0
20141226.224524,2875,2,186238,2,2874,812,2875,475,1
20141226.224525,2875,42,186280,2,2874,813,2875,450,1
20141226.224527,2875,2,186282,2,2874,814,2875,450,1
20141226.224528,2875,70,186352,-40,2874,806,2875,418,1
20141226.224528,2875,68,186420,42,2874,818,2875,383,1
20141226.224529,2875,66,186486,-6,2874,826,2875,349,1
20141226.224529,2875,4,186490,-2,2874,827,2875,347,1
20141226.22453,2875,544,187034,144,2874,827,2875,75,1
20141226.22453,2875,150,187184,130,2875,52,2876,696,1
20141226.224531,2876,122,187306,-2,2875,2,2876,695,1
20141226.224531,2876,14,187320,-6,2875,1,2876,689,1
20141226.224532,2876,122,187442,-18,2875,14,2876,628,1
20141226.224533,2875,12,187454,8,2875,23,2876,627,0
20141226.224533,2875,2,187456,0,2875,22,2876,628,0
20141226.224534,2875,4,187460,0,2875,71,2876,627,0
20141226.224535,2875,2,187462,0,2875,64,2876,628,0
20141226.224536,2875,2,187464,2,2875,64,2876,628,0
20141226.224537,2875,4,187468,0,2875,79,2876,628,0
20141226.224538,2875,6,187474,2,2875,76,2876,629,0
20141226.224539,2875,8,187482,-2,2875,74,2876,630,0
20141226.224539,2875,2,187484,-2,2875,75,2876,631,0
20141226.224541,2875,218,187702,-94,2874,999,2875,11,0
20141226.224541,2875,2,187704,2,2874,1009,2875,10,0
20141226.224542,2875,12,187716,-12,2874,1009,2875,25,0
20141226.224544,2875,30,187746,2,2874,1000,2875,20,0
20141226.224544,2875,20,187766,0,2874,1001,2875,10,0
20141226.224544,2875,12,187778,-12,2874,1001,2875,4,0
20141226.224545,2875,2,187780,0,2874,1001,2875,4,0
20141226.224545,2875,4,187784,0,2874,1001,2875,2,0
20141226.224547,2875,2,187786,-2,2874,1001,2875,12,0
20141226.224547,2875,4,187790,4,2874,1011,2875,11,0
20141226.224548,2874,2024,189814,538,2873,534,2875,166,0
20141226.224549,2874,8,189822,0,2874,8,2875,174,0
20141226.224549,2874,16,189838,0,2873,534,2875,180,0
20141226.22455,2875,6,189844,6,2873,361,2875,217,1
20141226.22455,2873,2,189846,-2,2873,532,2875,231,0
20141226.224551,2873,1166,191012,920,2872,391,2873,417,0
20141226.224551,2873,66,191078,54,2872,391,2873,384,0
20141226.224552,2873,10,191088,4,2872,391,2873,379,0
20141226.224552,2873,24,191112,12,2872,431,2873,367,0
20141226.224553,2873,8,191120,8,2872,431,2873,363,0
20141226.224553,2873,46,191166,44,2872,433,2873,340,0
20141226.224554,2873,28,191194,18,2872,434,2873,326,0
20141226.224555,2873,4,191198,4,2872,436,2873,329,0
20141226.224555,2873,2,191200,2,2872,441,2873,328,0
20141226.224556,2873,8,191208,8,2872,439,2873,324,0
20141226.224556,2873,34,191242,0,2872,440,2873,307,0
20141226.224558,2873,2,191244,0,2872,443,2873,306,0
20141226.224558,2873,2,191246,2,2872,446,2873,308,0
20141226.224559,2873,46,191292,6,2872,446,2873,293,0
20141226.2246,2873,2,191294,0,2872,454,2873,292,0
20141226.224601,2873,2,191296,2,2872,465,2873,291,0
20141226.224602,2873,10,191306,0,2872,470,2873,286,0
20141226.224604,2873,40,191346,40,2872,484,2873,266,0
20141226.224605,2873,210,191556,210,2872,486,2873,161,0
20141226.224605,2873,78,191634,78,2872,493,2873,122,0
20141226.224606,2873,244,191878,244,2872,508,2874,60,0
20141226.224607,2872,8,191886,0,2872,506,2874,60,0
20141226.224607,2874,6,191892,4,2872,506,2874,108,1
20141226.224607,2872,22,191914,-10,2872,422,2874,258,0
20141226.224608,2872,2,191916,0,2872,427,2874,356,0
20141226.224609,2873,44,191960,-12,2873,20,2874,356,1
20141226.22461,2873,178,192138,178,2872,525,2873,922,1
20141226.224612,2873,10,192148,10,2872,546,2873,997,1
20141226.224612,2872,60,192208,-4,2872,521,2873,1000,0
20141226.224613,2873,10,192218,6,2872,521,2873,995,1
20141226.224613,2873,2,192220,2,2872,541,2873,994,1
20141226.224614,2873,10,192230,10,2872,542,2873,990,1
20141226.224614,2872,54,192284,2,2872,541,2873,963,0
20141226.224615,2873,52,192336,52,2872,540,2873,938,1
20141226.224616,2872,2,192338,0,2872,552,2873,938,0
20141226.224618,2872,2,192340,0,2872,561,2873,928,0
20141226.224618,2872,4,192344,2,2872,577,2873,928,0
20141226.224619,2873,112,192456,108,2872,545,2873,925,1
20141226.22462,2872,2,192458,2,2872,551,2873,933,0
20141226.22462,2872,300,192758,-78,2872,402,2873,933,0
20141226.224621,2873,20,192778,20,2872,403,2873,932,1
20141226.224621,2873,160,192938,-130,2872,328,2873,852,1
20141226.224622,2872,282,193220,140,2872,180,2873,851,0
20141226.224622,2872,246,193466,186,2872,16,2873,851,0
20141226.224623,2872,44,193510,10,2871,636,2872,302,0
20141226.224623,2872,36,193546,22,2871,637,2872,292,0
20141226.224625,2872,12,193558,10,2871,636,2872,322,0
20141226.224625,2872,10,193568,10,2871,636,2872,327,0
20141226.224626,2872,44,193612,12,2871,636,2872,306,0
20141226.224626,2872,2,193614,2,2871,643,2872,306,0
20141226.224629,2872,34,193648,18,2871,635,2872,288,0
20141226.22463,2872,2,193650,0,2871,636,2872,257,0
20141226.22463,2872,2,193652,0,2871,637,2872,256,0
20141226.224631,2872,80,193732,40,2871,638,2872,1039,0
20141226.224632,2872,20,193752,20,2871,638,2872,878,0
20141226.224633,2871,4,193756,0,2871,636,2872,892,0
20141226.224633,2871,204,193960,-180,2871,545,2872,891,0
20141226.224634,2871,4,193964,-4,2871,546,2872,891,0
20141226.224634,2871,102,194066,-96,2871,500,2872,891,0
20141226.224635,2871,4,194070,0,2871,498,2872,891,0
20141226.224636,2871,116,194186,-72,2871,445,2872,885,0
20141226.224636,2872,2,194188,2,2871,446,2872,882,1
20141226.224637,2871,106,194294,-36,2871,419,2872,882,0
20141226.224637,2872,10,194304,4,2871,417,2872,879,1
20141226.224638,2871,40,194344,40,2871,398,2872,879,0
20141226.224638,2871,836,195180,582,2870,399,2871,455,0
20141226.224639,2871,60,195240,30,2870,395,2871,436,0
20141226.224639,2871,4,195244,4,2870,395,2871,484,0
20141226.22464,2870,6,195250,0,2870,394,2871,482,0
20141226.22464,2870,28,195278,-16,2870,386,2871,480,0
20141226.224641,2870,10,195288,2,2870,369,2871,525,0
20141226.224641,2871,8,195296,0,2870,360,2871,522,1
20141226.224643,2871,22,195318,8,2870,369,2871,512,1
20141226.224644,2870,2,195320,0,2870,423,2871,513,0
20141226.224645,2871,304,195624,174,2870,273,2871,512,1
20141226.224645,2871,12,195636,0,2870,282,2871,507,1
20141226.224646,2870,44,195680,32,2870,296,2871,497,0
20141226.224647,2870,6,195686,6,2870,298,2871,497,0
20141226.224648,2870,2,195688,2,2870,353,2871,497,0
20141226.224649,2870,8,195696,-2,2870,359,2871,498,0
20141226.224649,2870,2,195698,0,2870,368,2871,499,0
20141226.224651,2870,42,195740,0,2870,364,2871,499,0
20141226.224652,2871,24,195764,12,2870,370,2871,487,1
20141226.224652,2871,2,195766,2,2870,370,2871,486,1
20141226.224653,2870,46,195812,-6,2870,370,2871,486,0
20141226.224655,2870,2,195814,-2,2870,381,2871,486,0
20141226.224655,2870,2,195816,0,2870,382,2871,486,0
20141226.224655,2870,2,195818,-2,2870,387,2871,486,0
20141226.224656,2870,2,195820,-2,2870,387,2871,486,0
20141226.224657,2871,2,195822,2,2870,390,2871,486,1
20141226.224658,2870,8,195830,-6,2870,401,2871,485,0
20141226.224659,2870,6,195836,-6,2870,418,2871,485,0
20141226.224659,2871,2,195838,2,2870,419,2871,484,1
20141226.224701,2871,10,195848,0,2870,419,2871,477,1
20141226.224701,2870,2,195850,-2,2870,418,2871,477,0
20141226.224702,2871,2,195852,2,2870,424,2871,476,1
20141226.224703,2871,10,195862,0,2870,435,2871,471,1
20141226.224704,2870,24,195886,-10,2870,528,2871,468,0
20141226.224704,2871,2,195888,2,2870,529,2871,467,1
20141226.224705,2871,2,195890,2,2870,549,2871,466,1
20141226.224709,2871,2,195892,2,2870,575,2871,475,1
20141226.22471,2871,6,195898,0,2870,671,2871,472,1
20141226.224711,2871,4,195902,0,2870,669,2871,470,1
20141226.224711,2870,4,195906,-4,2870,667,2871,470,0
20141226.224712,2871,60,195966,60,2870,667,2871,440,1
20141226.224712,2871,4,195970,4,2870,668,2871,438,1
20141226.224713,2871,4,195974,-2,2870,1131,2871,437,1
20141226.224713,2871,2,195976,0,2870,1130,2871,438,1
20141226.224714,2871,98,196074,0,2870,1076,2871,389,1
20141226.224714,2871,104,196178,102,2870,1066,2871,337,1
20141226.224715,2871,24,196202,20,2870,1066,2871,325,1
20141226.224716,2871,202,196404,2,2870,1067,2871,224,1
20141226.224716,2871,246,196650,210,2870,1066,2871,101,1
20141226.224717,2871,202,196852,-170,2871,153,2872,177,1
20141226.224717,2872,2,196854,-2,2871,157,2872,176,1
20141226.224718,2872,100,196954,-94,2871,1184,2872,92,1
20141226.22472,2871,2,196956,-2,2871,1307,2872,328,0
20141226.224721,2872,18,196974,-2,2871,1309,2872,320,1
20141226.224723,2872,8,196982,-2,2871,1317,2872,320,1
20141226.224723,2872,22,197004,0,2871,1312,2872,309,1
20141226.224724,2872,2,197006,-2,2871,1212,2872,308,1
20141226.224724,2871,2002,199008,106,2871,213,2872,307,0
20141226.224725,2871,426,199434,-318,2870,1077,2871,10,0
20141226.224727,2871,2,199436,0,2870,1076,2871,165,0
20141226.224727,2871,6,199442,0,2870,1080,2871,162,0
20141226.224728,2871,22,199464,-12,2870,1079,2871,152,0
20141226.224728,2871,4,199468,4,2870,1078,2871,150,0
20141226.22473,2871,12,199480,4,2870,1083,2871,145,0
20141226.224731,2871,292,199772,-136,2871,5,2872,333,0
20141226.224732,2872,200,199972,62,2871,18,2872,233,1
20141226.224733,2871,20,199992,20,2871,53,2872,234,0
20141226.224735,2871,4,199996,4,2871,116,2872,264,0
20141226.224735,2871,2,199998,2,2871,265,2872,264,0
20141226.224736,2871,2,200000,2,2871,275,2872,264,0
20141226.224738,2872,8,200008,0,2871,298,2872,261,1
20141226.224739,2872,20,200028,-20,2871,300,2872,252,1
20141226.224741,2872,2,200030,0,2871,345,2872,252,1
20141226.224742,2872,2,200032,0,2871,350,2872,251,1
20141226.224742,2872,2,200034,0,2871,355,2872,250,1
20141226.224744,2872,20,200054,0,2871,350,2872,240,1
20141226.224745,2872,2,200056,0,2871,350,2872,239,1
20141226.224747,2872,4,200060,4,2871,362,2872,147,1
20141226.224748,2872,2,200062,2,2871,364,2872,156,1
20141226.224751,2871,4,200066,4,2871,415,2872,161,0
20141226.224751,2871,2,200068,0,2871,420,2872,161,0
20141226.224754,2872,2,200070,0,2871,442,2872,170,1
20141226.224756,2872,2,200072,2,2871,442,2872,169,1
20141226.224757,2871,20,200092,4,2871,435,2872,169,0
20141226.224758,2872,2,200094,-2,2871,455,2872,168,1
20141226.224759,2871,42,200136,-42,2871,434,2872,168,0
20141226.2248,2872,6,200142,-6,2871,434,2872,166,1
20141226.224807,2872,20,200162,0,2871,416,2872,165,1
20141226.224809,2872,2,200164,0,2871,411,2872,166,1
20141226.22481,2871,16,200180,-4,2871,405,2872,166,0
20141226.224811,2872,2,200182,0,2871,406,2872,165,1
20141226.224812,2872,10,200192,8,2871,402,2872,166,1
20141226.224815,2871,2,200194,2,2871,450,2872,169,0
20141226.224816,2872,2,200196,0,2871,451,2872,168,1
20141226.224819,2872,2,200198,0,2871,476,2872,187,1
20141226.22482,2871,2,200200,0,2871,476,2872,187,0
20141226.224821,2871,2,200202,0,2871,485,2872,190,0
20141226.224822,2871,2,200204,2,2871,485,2872,190,0
20141226.224822,2872,202,200406,8,2871,484,2872,90,1
20141226.224827,2872,4,200410,0,2871,499,2872,89,1
20141226.224828,2872,2,200412,0,2871,504,2872,208,1
20141226.224828,2872,2,200414,0,2871,509,2872,207,1
20141226.224829,2872,2,200416,0,2871,509,2872,207,1
20141226.22483,2872,8,200424,0,2871,555,2872,204,1
20141226.22483,2871,6,200430,0,2871,552,2872,204,0
20141226.224834,2871,2,200432,0,2871,402,2872,205,0
20141226.224836,2871,2,200434,2,2871,404,2872,212,0
20141226.224838,2871,4,200438,0,2871,402,2872,213,0
20141226.224839,2872,2,200440,-2,2871,402,2872,212,1
20141226.224839,2872,6,200446,0,2871,400,2872,211,1
20141226.224842,2872,2,200448,-2,2871,411,2872,222,1
20141226.224842,2872,20,200468,0,2871,411,2872,213,1
20141226.224843,2871,2,200470,-2,2871,410,2872,215,0
20141226.224844,2872,2,200472,0,2871,410,2872,217,1
20141226.224844,2871,2,200474,-2,2871,409,2872,217,0
20141226.224846,2871,2,200476,-2,2871,411,2872,270,0
20141226.224846,2871,34,200510,-16,2871,394,2872,270,0
20141226.224851,2871,814,201324,-166,2870,1243,2872,274,0
20141226.224852,2872,4,201328,-4,2871,2,2872,273,1
20141226.224852,2871,2,201330,0,2870,1242,2871,2,0
20141226.224852,2871,4,201334,-2,2870,1242,2871,140,0
20141226.224853,2871,2,201336,0,2870,1242,2871,141,0
20141226.224853,2871,4,201340,0,2870,1242,2871,363,0
20141226.224854,2871,10,201350,10,2870,1242,2871,358,0
20141226.224855,2871,2,201352,2,2870,1241,2871,358,0
20141226.224856,2870,6,201358,0,2870,1238,2871,358,0
20141226.224856,2870,2,201360,-2,2870,1238,2871,438,0
20141226.224857,2870,34,201394,-32,2870,1222,2871,477,0
20141226.224858,2871,20,201414,20,2870,1225,2871,467,1
20141226.224859,2871,4,201418,0,2870,1225,2871,465,1
20141226.2249,2871,2,201420,0,2870,1225,2871,464,1
20141226.224903,2871,2,201422,2,2870,1231,2871,488,1
20141226.224903,2870,2,201424,-2,2870,1230,2871,489,0
20141226.224906,2870,10,201434,-2,2870,1218,2871,491,0
20141226.224907,2871,2,201436,0,2870,1212,2871,490,1
20141226.224907,2871,2,201438,2,2870,1212,2871,489,1
20141226.224908,2871,2,201440,2,2870,1212,2871,488,1
20141226.224909,2871,10,201450,10,2870,1211,2871,484,1
20141226.22491,2870,24,201474,-20,2870,1200,2871,484,0
20141226.224911,2871,968,202442,-628,2871,16,2872,156,1
20141226.224913,2871,26,202468,0,2871,11,2872,146,1
20141226.224914,2871,2,202470,-2,2871,13,2872,146,1
20141226.224914,2871,6,202476,-6,2871,10,2872,146,1
20141226.224915,2871,2,202478,-2,2871,69,2872,146,1
20141226.224916,2871,4,202482,-4,2871,70,2872,146,1
20141226.224917,2871,6,202488,2,2871,72,2872,185,1
20141226.224918,2872,24,202512,12,2871,72,2872,173,1
20141226.22492,2871,2,202514,0,2871,108,2872,173,0
20141226.224921,2872,2,202516,2,2871,115,2872,133,1
20141226.224923,2872,6,202522,6,2871,116,2872,136,1
20141226.224923,2872,6,202528,2,2871,116,2872,133,1
20141226.224926,2871,6,202534,0,2871,217,2872,256,0
20141226.224929,2871,22,202556,2,2871,220,2872,265,0
20141226.22493,2872,2,202558,0,2871,224,2872,264,1
20141226.224931,2871,4,202562,0,2871,224,2872,264,0
20141226.224933,2872,2,202564,-2,2871,224,2872,273,1
20141226.224934,2872,6,202570,-4,2871,223,2872,272,1
20141226.224936,2871,4,202574,0,2871,225,2872,276,0
20141226.224949,2871,20,202594,0,2871,229,2872,376,0
20141226.224949,2872,2,202596,2,2871,229,2872,375,1
20141226.224951,2871,40,202636,0,2871,209,2872,375,0
20141226.224951,2871,12,202648,-12,2871,203,2872,375,0
20141226.224952,2872,6,202654,6,2871,203,2872,372,1
20141226.224956,2872,10,202664,10,2871,208,2872,259,1
20141226.224956,2872,24,202688,-8,2871,202,2872,253,1
20141226.224959,2872,8,202696,8,2871,202,2872,250,1
20141226.225,2871,2,202698,-2,2871,200,2872,160,0
20141226.225001,2871,10,202708,-6,2871,216,2872,160,0
20141226.225002,2872,4,202712,4,2871,221,2872,158,1
20141226.225004,2872,10,202722,4,2871,221,2872,156,1
20141226.225006,2872,2,202724,2,2871,194,2872,155,1
20141226.225008,2872,2,202726,2,2871,196,2872,154,1
20141226.22501,2871,22,202748,12,2871,185,2872,154,0
20141226.225011,2872,2,202750,2,2871,185,2872,159,1
20141226.225011,2871,24,202774,18,2871,175,2872,160,0
20141226.225013,2871,8,202782,0,2871,165,2872,155,0
20141226.225017,2871,4,202786,4,2871,161,2872,152,0
20141226.225019,2871,2,202788,2,2871,173,2872,163,0
20141226.225021,2872,2,202790,0,2871,173,2872,172,1
20141226.225022,2871,2,202792,0,2871,173,2872,172,0
20141226.225023,2872,62,202854,0,2871,141,2872,171,1
20141226.225029,2872,2,202856,0,2871,141,2872,174,1
20141226.22503,2871,4,202860,0,2871,138,2872,178,0
20141226.225033,2871,6,202866,0,2871,131,2872,177,0
20141226.225035,2872,10,202876,6,2871,133,2872,173,1
20141226.225037,2872,10,202886,10,2871,143,2872,170,1
20141226.225038,2871,2,202888,0,2871,142,2872,170,0
20141226.22504,2871,2,202890,0,2871,142,2872,228,0
20141226.225041,2871,4,202894,0,2871,146,2872,228,0
20141226.225043,2871,292,203186,202,2870,1048,2871,354,0
20141226.225047,2871,2,203188,0,2870,1048,2871,357,0
20141226.225048,2871,4,203192,4,2870,1047,2871,356,0
20141226.225049,2871,100,203292,0,2870,1067,2871,306,0
20141226.225053,2870,6,203298,0,2870,1067,2871,306,0
20141226.225054,2871,8,203306,8,2870,1064,2871,302,1
20141226.225054,2870,164,203470,0,2870,1062,2871,302,0
20141226.225056,2871,10,203480,10,2870,1062,2871,297,1
20141226.225057,2871,60,203540,0,2870,1062,2871,267,1
20141226.225058,2870,12,203552,-10,2870,1056,2871,267,0
20141226.225058,2871,534,204086,0,2871,233,2872,420,1
20141226.225059,2871,20,204106,-20,2871,223,2872,420,1
20141226.225059,2871,2,204108,-2,2871,222,2872,426,1
20141226.225101,2871,2,204110,0,2871,221,2872,419,1
20141226.225101,2871,4,204114,-4,2871,219,2872,419,1
20141226.225102,2871,2,204116,-2,2871,223,2872,419,1
20141226.225103,2871,2,204118,0,2871,223,2872,419,1
20141226.225104,2871,2,204120,-2,2871,222,2872,419,1
20141226.225105,2871,94,204214,-94,2871,175,2872,434,1
20141226.225105,2871,4,204218,-4,2871,173,2872,434,1
20141226.225106,2871,2,204220,-2,2871,172,2872,434,1
20141226.225109,2871,2,204222,0,2871,173,2872,421,1
20141226.225116,2871,12,204234,-12,2871,168,2872,501,1
20141226.225117,2871,2,204236,-2,2871,184,2872,507,1
20141226.225118,2871,2,204238,-2,2871,183,2872,542,1
20141226.225123,2871,2,204240,-2,2871,181,2872,554,1
20141226.225124,2871,20,204260,-20,2871,177,2872,555,1
20141226.225125,2871,40,204300,-40,2871,152,2872,555,1
20141226.225127,2871,40,204340,-40,2871,139,2872,557,1
20141226.225128,2871,6,204346,0,2871,136,2872,557,1
20141226.225128,2871,4,204350,-4,2871,134,2872,553,1
20141226.22513,2871,2,204352,0,2871,133,2872,554,1
20141226.225133,2871,60,204412,-60,2871,123,2872,562,1
20141226.225133,2871,2,204414,-2,2871,122,2872,562,1
20141226.225138,2871,2,204416,0,2871,210,2872,562,1
20141226.225139,2871,10,204426,-10,2871,206,2872,562,1
20141226.225143,2871,6,204432,0,2871,353,2872,564,1
20141226.225143,2872,22,204454,8,2871,372,2872,558,1
20141226.225148,2872,300,204754,-282,2871,301,2872,291,1
20141226.225149,2872,64,204818,-60,2871,299,2872,261,1
20141226.225151,2872,2,204820,0,2871,301,2872,250,1
20141226.225153,2872,2,204822,0,2871,301,2872,249,1
20141226.225157,2871,4,204826,-4,2871,319,2872,259,0
20141226.225203,2872,6,204832,0,2871,325,2872,261,1
20141226.225207,2871,2,204834,0,2871,348,2872,259,0
20141226.225207,2872,4,204838,4,2871,358,2872,257,1
20141226.22521,2872,2,204840,2,2871,360,2872,255,1
20141226.225212,2871,4,204844,-4,2871,381,2872,250,0
20141226.225217,2872,2,204846,-2,2871,380,2872,256,1
20141226.225224,2872,2,204848,0,2871,394,2872,263,1
20141226.225224,2871,8,204856,0,2871,374,2872,260,0
20141226.225226,2872,100,204956,2,2871,330,2872,253,1
20141226.225233,2871,2,204958,0,2871,334,2872,255,0
20141226.225234,2872,2,204960,0,2871,334,2872,254,1
20141226.22524,2872,4,204964,-4,2871,328,2872,398,1
20141226.225242,2872,2,204966,0,2871,334,2872,398,1
20141226.225249,2871,80,205046,24,2871,329,2872,355,0
20141226.225251,2871,2,205048,0,2871,330,2872,356,0
20141226.225251,2871,48,205096,-4,2871,308,2872,354,0
20141226.225252,2871,2,205098,0,2871,307,2872,354,0
20141226.225253,2872,2,205100,0,2871,314,2872,353,1
20141226.225256,2872,4,205104,0,2871,316,2872,353,1
20141226.225257,2872,4,205108,0,2871,314,2872,353,1
20141226.225259,2872,20,205128,0,2871,309,2872,342,1
20141226.225303,2871,2,205130,0,2871,307,2872,343,0
20141226.225304,2871,40,205170,0,2871,287,2872,343,0
20141226.225305,2872,2,205172,0,2871,295,2872,342,1
20141226.225312,2872,2,205174,0,2871,340,2872,350,1
20141226.225313,2872,2,205176,-2,2871,340,2872,350,1
20141226.225314,2872,2,205178,-2,2871,341,2872,350,1
20141226.225316,2872,100,205278,-100,2871,347,2872,300,1
20141226.225317,2872,60,205338,0,2871,318,2872,299,1
20141226.225321,2871,20,205358,-20,2871,310,2872,299,0
20141226.225326,2872,2,205360,0,2871,321,2872,301,1
20141226.22533,2871,8,205368,-2,2871,320,2872,297,0
20141226.225334,2872,6,205374,-4,2871,353,2872,294,1
20141226.225341,2872,2,205376,-2,2871,364,2872,291,1
20141226.225344,2872,2,205378,0,2871,370,2872,290,1
20141226.225346,2871,6,205384,0,2871,368,2872,290,0
20141226.225348,2871,2,205386,2,2871,367,2872,280,0
20141226.22535,2872,2,205388,0,2871,386,2872,279,1
20141226.225351,2872,2,205390,0,2871,387,2872,278,1
20141226.225401,2872,62,205452,4,2871,382,2872,282,1
20141226.225402,2871,20,205472,20,2871,373,2872,272,0
20141226.22541,2871,2,205474,0,2871,347,2872,278,0
20141226.225411,2872,2,205476,0,2871,347,2872,277,1
20141226.225415,2871,4,205480,2,2871,345,2872,287,0
20141226.225418,2872,100,205580,-68,2871,346,2872,238,1
20141226.225421,2872,20,205600,0,2871,355,2872,327,1
20141226.225424,2871,602,206202,292,2871,55,2872,330,0
20141226.225425,2871,24,206226,10,2871,43,2872,340,0
20141226.225425,2871,2,206228,0,2871,42,2872,340,0
20141226.225426,2871,26,206254,18,2871,60,2872,300,0
20141226.225426,2871,176,206430,160,2870,1105,2871,42,0
20141226.225427,2871,2,206432,2,2870,1105,2871,55,0
20141226.225428,2871,110,206542,84,2870,959,2872,306,0
20141226.225432,2871,2,206544,0,2871,12,2872,362,0
20141226.225432,2872,10,206554,-10,2871,12,2872,357,1
20141226.225433,2871,26,206580,24,2870,1104,2871,28,0
20141226.225433,2871,56,206636,56,2870,1104,2872,369,0
20141226.225434,2871,10,206646,10,2871,75,2872,369,0
20141226.225434,2871,90,206736,70,2871,30,2872,420,0
20141226.225435,2871,4,206740,2,2871,28,2872,420,0
20141226.225437,2871,22,206762,22,2871,21,2872,420,0
20141226.225438,2871,2,206764,2,2871,22,2872,423,0
20141226.225438,2871,2,206766,0,2871,23,2872,424,0
20141226.225439,2871,2,206768,2,2871,22,2872,424,0
20141226.22544,2871,72,206840,-6,2870,1104,2871,8,0
20141226.22544,2871,16,206856,-6,2870,1104,2872,504,0
20141226.225441,2871,2,206858,0,2870,1107,2872,504,0
20141226.225442,2871,4,206862,-4,2871,1,2872,465,0
20141226.225443,2871,22,206884,0,2870,1105,2871,69,0
20141226.225443,2870,68,206952,0,2870,1104,2871,46,0
20141226.225444,2871,22,206974,-2,2870,1094,2871,75,1
20141226.225445,2870,20,206994,-20,2870,1086,2871,78,0
20141226.225447,2871,8,207002,0,2870,1082,2871,112,1
20141226.225447,2871,2,207004,0,2870,1082,2871,111,1
20141226.225449,2870,2002,209006,-1002,2869,304,2871,112,0
20141226.22545,2870,6,209012,6,2869,304,2871,146,0
20141226.225451,2870,4,209016,0,2869,304,2871,145,0
20141226.225451,2870,4,209020,0,2870,198,2871,145,0
20141226.225452,2870,20,209040,0,2870,188,2871,177,0
20141226.225452,2870,4,209044,0,2870,186,2871,277,0
20141226.225455,2871,2,209046,0,2870,189,2871,296,1
20141226.225457,2870,12,209058,-12,2870,193,2871,304,0
20141226.225457,2870,4,209062,-4,2870,191,2871,304,0
20141226.225459,2870,12,209074,-12,2870,185,2871,306,0
20141226.2255,2870,2,209076,0,2870,184,2871,306,0
20141226.2255,2871,100,209176,44,2870,184,2871,261,1
20141226.225502,2871,8,209184,6,2870,205,2871,260,1
20141226.225503,2870,26,209210,-24,2870,197,2871,259,0
20141226.225505,2871,2,209212,2,2870,199,2871,258,1
20141226.225505,2871,2,209214,2,2870,203,2871,257,1
20141226.225508,2870,2,209216,-2,2870,213,2871,265,0
20141226.225508,2870,2,209218,0,2870,213,2871,265,0
20141226.225509,2871,10,209228,-6,2870,210,2871,264,1
20141226.225511,2870,2,209230,-2,2870,210,2871,264,0
20141226.225511,2870,6,209236,2,2870,209,2871,263,0
20141226.225512,2871,118,209354,34,2870,150,2871,204,1
20141226.225513,2870,2,209356,0,2870,149,2871,214,0
20141226.225513,2871,20,209376,0,2870,206,2871,205,1
20141226.225514,2870,2,209378,-2,2870,205,2871,715,0
20141226.225514,2870,400,209778,182,2870,5,2871,715,0
20141226.225515,2870,10,209788,2,2870,17,2871,715,0
20141226.225515,2870,34,209822,-30,2869,552,2871,715,0
20141226.225516,2870,24,209846,10,2870,4,2871,715,0
20141226.225516,2870,28,209874,-26,2869,553,2871,715,0
20141226.225517,2870,2,209876,0,2869,553,2871,715,0
20141226.225518,2870,2,209878,0,2869,554,2870,34,0
20141226.225519,2870,324,210202,-304,2870,49,2871,250,0
20141226.22552,2870,134,210336,-74,2869,590,2870,435,0
20141226.225521,2870,42,210378,-2,2869,590,2870,434,0
20141226.225522,2869,20,210398,20,2869,566,2870,470,0
20141226.225522,2869,2,210400,0,2869,565,2870,471,0
20141226.225523,2869,28,210428,0,2869,551,2870,471,0
20141226.225523,2869,4,210432,0,2869,544,2870,473,0
20141226.225525,2870,12,210444,8,2869,539,2870,474,1
20141226.225525,2869,2,210446,0,2869,538,2870,444,0
20141226.225526,2870,2,210448,-2,2869,539,2870,443,1
20141226.225527,2870,2,210450,0,2869,538,2870,442,1
20141226.225528,2869,2,210452,-2,2869,537,2870,442,0
20141226.22553,2869,28,210480,22,2869,518,2870,452,0
20141226.225532,2869,2,210482,2,2869,476,2870,454,0
20141226.225532,2869,14,210496,14,2869,468,2870,452,0
20141226.225533,2869,2,210498,0,2869,467,2870,452,0
20141226.225534,2870,80,210578,0,2869,469,2870,412,1
20141226.225534,2869,8,210586,0,2869,465,2870,412,0
20141226.225535,2869,16,210602,4,2869,468,2870,462,0
20141226.225536,2869,4,210606,-4,2869,466,2870,462,0
20141226.225537,2869,582,211188,-252,2869,181,2870,463,0
20141226.225539,2869,12,211200,-8,2869,199,2870,458,0
20141226.22554,2869,6,211206,-4,2869,198,2870,458,0
20141226.22554,2869,126,211332,-42,2868,503,2870,459,0
20141226.225541,2870,2,211334,0,2869,144,2870,459,1
20141226.225542,2869,72,211406,60,2868,913,2870,459,0
20141226.225543,2869,118,211524,2,2868,914,2870,401,0
20141226.225546,2870,4,211528,-2,2869,385,2870,400,1
20141226.225548,2870,20,211548,0,2869,364,2870,392,1
20141226.225549,2870,2,211550,0,2869,365,2870,390,1
20141226.225551,2870,2,211552,0,2869,395,2870,402,1
20141226.225552,2869,22,211574,-22,2869,385,2870,402,0
20141226.225555,2869,20,211594,-18,2869,434,2870,408,0
20141226.225557,2869,2,211596,-2,2869,449,2870,412,0
20141226.225557,2869,4,211600,-4,2869,448,2870,412,0
20141226.225558,2869,2,211602,0,2869,448,2870,411,0
20141226.225558,2870,820,212422,-656,2870,100,2871,379,1
20141226.225559,2870,2,212424,-2,2870,99,2871,379,1
20141226.225559,2870,2,212426,-2,2870,98,2871,379,1
20141226.2256,2870,4,212430,-2,2870,99,2871,379,1
20141226.225601,2870,4,212434,-4,2870,97,2871,379,1
20141226.225602,2870,40,212474,-40,2870,77,2871,380,1
20141226.225602,2870,34,212508,-34,2870,60,2871,380,1
20141226.225603,2871,2,212510,-2,2870,60,2871,379,1
20141226.225603,2870,34,212544,0,2870,43,2871,395,0
20141226.225605,2870,4,212548,-2,2870,42,2871,387,0
20141226.225606,2869,100,212648,26,2869,938,2870,3,0
20141226.225606,2870,32,212680,-26,2869,937,2871,387,1
20141226.225607,2869,10,212690,-4,2870,13,2871,387,0
20141226.225607,2871,2,212692,-2,2870,14,2871,386,1
20141226.225609,2870,4,212696,-2,2870,21,2871,387,0
20141226.225611,2870,2,212698,-2,2870,20,2871,387,0
20141226.225611,2870,2,212700,2,2870,19,2871,389,0
20141226.225612,2870,6,212706,0,2870,16,2871,390,0
20141226.225612,2870,2,212708,0,2870,16,2871,390,0
20141226.225613,2870,2,212710,0,2870,15,2871,393,0
20141226.225614,2871,4,212714,0,2870,15,2871,396,1
20141226.225616,2870,2,212716,0,2870,47,2871,396,0
20141226.225617,2870,20,212736,0,2870,38,2871,392,0
20141226.225617,2870,2,212738,2,2870,37,2871,392,0
20141226.225619,2870,2,212740,0,2870,38,2871,392,0
20141226.22562,2870,2,212742,2,2870,53,2871,397,0
20141226.22562,2870,2,212744,2,2870,52,2871,397,0
20141226.225622,2870,2,212746,2,2870,132,2871,420,0
20141226.225622,2870,4,212750,0,2870,131,2871,420,0
20141226.225625,2870,2,212752,0,2870,130,2871,430,0
20141226.225625,2871,2,212754,0,2870,130,2871,429,1
20141226.225626,2871,2,212756,-2,2870,130,2871,428,1
20141226.22563,2871,2,212758,0,2870,136,2871,432,1
20141226.225631,2870,116,212874,-6,2870,78,2871,432,0
20141226.225632,2870,20,212894,20,2870,171,2871,432,0
20141226.225633,2870,6,212900,6,2870,168,2871,432,0
20141226.225637,2871,8,212908,0,2870,180,2871,428,1
20141226.225637,2870,16,212924,16,2870,172,2871,428,0
20141226.225641,2870,6,212930,6,2870,166,2871,431,0
20141226.225642,2870,22,212952,22,2870,156,2871,431,0
20141226.225642,2870,34,212986,34,2870,139,2871,431,0
20141226.225644,2870,2,212988,2,2870,138,2871,421,0
20141226.225646,2870,10,212998,0,2870,134,2871,426,0
20141226.225647,2870,100,213098,26,2870,85,2871,425,0
20141226.225648,2870,2,213100,-2,2870,84,2871,420,0
20141226.225648,2870,2,213102,-2,2870,83,2871,416,0
20141226.225649,2870,166,213268,32,2869,853,2870,80,0
20141226.225652,2870,20,213288,8,2869,847,2870,336,0
20141226.225654,2869,2,213290,-2,2869,846,2870,347,0
20141226.225655,2869,42,213332,38,2869,849,2870,227,0
20141226.225656,2870,10,213342,10,2869,854,2870,348,1
20141226.225658,2870,6,213348,6,2869,854,2870,345,1
20141226.2257,2870,12,213360,-6,2869,849,2870,350,1
20141226.225702,2870,2,213362,2,2869,848,2870,349,1
20141226.225702,2870,116,213478,62,2869,848,2870,291,1
20141226.225703,2870,2,213480,-2,2869,848,2870,290,1
20141226.225705,2870,586,214066,-340,2870,207,2871,434,1
20141226.225707,2870,2,214068,-2,2870,307,2871,404,1
20141226.225709,2870,22,214090,0,2870,298,2871,404,1
20141226.22571,2870,2,214092,-2,2870,298,2871,414,1
20141226.225711,2870,6,214098,-6,2870,295,2871,409,1
20141226.225712,2870,12,214110,0,2870,290,2871,406,1
20141226.225714,2870,2,214112,-2,2870,290,2871,407,1
20141226.225716,2870,10,214122,-10,2870,296,2871,407,1
20141226.225718,2870,2,214124,-2,2870,295,2871,409,1
20141226.225719,2870,4,214128,0,2870,293,2871,409,1
20141226.225721,2870,2,214130,-2,2870,293,2871,408,1
20141226.225723,2870,6,214136,0,2870,325,2871,408,1
20141226.225725,2870,4,214140,-4,2870,333,2871,408,1
20141226.225725,2870,2,214142,0,2870,332,2871,407,1
20141226.225729,2870,4,214146,-4,2870,335,2871,436,1
20141226.22573,2871,2,214148,-2,2870,348,2871,435,1
20141226.225732,2870,4,214152,-2,2870,352,2871,434,0
20141226.225734,2870,2,214154,-2,2870,355,2871,434,0
20141226.225734,2870,2,214156,-2,2870,354,2871,435,0
20141226.225736,2870,2,214158,0,2870,373,2871,435,0
20141226.225737,2871,2,214160,0,2870,374,2871,434,1
20141226.225739,2870,20,214180,-20,2870,399,2871,434,0
20141226.225742,2870,2,214182,0,2870,410,2871,434,0
20141226.225744,2870,4,214186,-4,2870,432,2871,434,0
20141226.225747,2871,2,214188,2,2870,440,2871,433,1
20141226.225749,2870,4,214192,-4,2870,434,2871,434,0
20141226.225749,2871,8,214200,-2,2870,434,2871,430,1
20141226.22575,2870,12,214212,0,2870,429,2871,429,0
20141226.22575,2871,2,214214,0,2870,429,2871,428,1
20141226.225751,2871,2,214216,0,2870,429,2871,432,1
20141226.225751,2871,2,214218,0,2870,429,2871,431,1
20141226.225752,2871,4,214222,0,2870,434,2871,429,1
20141226.225752,2871,2,214224,0,2870,434,2871,428,1
20141226.225755,2871,2,214226,-2,2870,433,2871,426,1
20141226.225758,2870,10,214236,-10,2870,431,2871,428,0
20141226.225759,2870,2,214238,-2,2870,432,2871,448,0
20141226.225802,2871,2,214240,-2,2870,437,2871,453,1
20141226.225805,2871,4,214244,0,2870,438,2871,482,1
20141226.225805,2871,2,214246,0,2870,438,2871,481,1
20141226.225806,2871,100,214346,-28,2870,439,2871,431,1
20141226.225808,2870,4,214350,-2,2870,437,2871,431,0
20141226.225809,2870,4,214354,-4,2870,436,2871,431,0
20141226.225811,2870,4,214358,0,2870,434,2871,429,0
20141226.225814,2871,2,214360,0,2870,443,2871,429,1
20141226.225815,2870,6,214366,0,2870,441,2871,429,0
20141226.225816,2871,10,214376,0,2870,441,2871,424,1
20141226.225817,2870,4,214380,-4,2870,450,2871,424,0
20141226.225817,2870,100,214480,-100,2870,412,2871,425,0
20141226.22582,2870,2,214482,-2,2870,393,2871,426,0
20141226.225825,2871,2,214484,0,2870,430,2871,404,1
20141226.225828,2871,40,214524,0,2870,437,2871,385,1
20141226.225829,2871,130,214654,-54,2870,439,2871,320,1
20141226.225831,2870,22,214676,14,2870,470,2871,310,0
20141226.225833,2870,20,214696,0,2870,460,2871,310,0
20141226.225835,2871,2,214698,0,2870,465,2871,310,1
20141226.22584,2871,2,214700,2,2870,472,2871,313,1
20141226.225843,2871,4,214704,0,2870,486,2871,316,1
20141226.225845,2871,430,215134,-230,2870,485,2871,96,1
20141226.225846,2871,132,215266,88,2870,486,2871,32,1
20141226.225847,2871,62,215328,36,2871,63,2872,589,1
20141226.225848,2872,14,215342,-8,2871,64,2872,569,1
20141226.225849,2871,20,215362,10,2871,126,2872,597,0
20141226.225852,2871,2,215364,0,2871,126,2872,596,0
20141226.225853,2872,2,215366,0,2871,126,2872,595,1
20141226.225856,2871,12,215378,-6,2871,120,2872,594,0
20141226.225858,2871,2,215380,2,2871,130,2872,614,0
20141226.225901,2871,2,215382,0,2871,209,2872,603,0
20141226.225903,2871,14,215396,14,2871,208,2872,603,0
20141226.225909,2872,40,215436,8,2871,209,2872,580,1
20141226.225909,2871,4,215440,4,2871,207,2872,579,0
20141226.225912,2872,6,215446,-6,2871,215,2872,675,1
20141226.225913,2871,16,215462,16,2871,207,2872,676,0
20141226.225916,2871,60,215522,0,2871,177,2872,678,0
20141226.225917,2871,4,215526,4,2871,175,2872,678,0
20141226.225917,2871,2,215528,0,2871,174,2872,678,0
20141226.22592,2872,300,215828,-274,2871,185,2872,528,1
20141226.22592,2871,2,215830,0,2871,184,2872,529,0
20141226.225922,2872,10,215840,2,2871,182,2872,527,1
20141226.225923,2871,2,215842,0,2871,192,2872,528,0
20141226.225926,2871,2,215844,0,2871,258,2872,530,0
20141226.225931,2872,2,215846,0,2871,266,2872,1274,1
20141226.225934,2871,20,215866,0,2871,262,2872,1269,0
20141226.225936,2871,4,215870,0,2871,269,2872,1264,0
20141226.225939,2872,2,215872,0,2871,285,2872,1264,1
20141226.22594,2872,2,215874,0,2871,295,2872,1263,1
20141226.22594,2871,598,216472,360,2870,315,2871,441,0
20141226.225941,2871,8,216480,4,2870,315,2871,437,0
20141226.225941,2871,4,216484,4,2870,315,2871,435,0
20141226.225943,2871,38,216522,-22,2870,302,2871,430,0
20141226.225944,2871,2,216524,2,2870,302,2871,429,0
20141226.225945,2871,4,216528,0,2870,302,2871,427,0
20141226.225945,2871,4,216532,0,2870,292,2871,425,0
20141226.225946,2871,2,216534,2,2870,293,2871,426,0
20141226.225952,2871,8,216542,0,2870,305,2871,427,0
20141226.225952,2871,40,216582,0,2870,306,2871,1407,0
20141226.225953,2871,20,216602,0,2870,308,2871,1397,0
20141226.225954,2871,2,216604,2,2870,308,2871,1396,0
20141226.225956,2870,60,216664,-60,2870,278,2871,1396,0
20141226.225957,2871,12,216676,0,2870,276,2871,1392,1
20141226.225958,2871,2,216678,2,2870,277,2871,1391,1
20141226.23,2871,18,216696,0,2870,277,2871,1382,1
20141226.230001,2871,64,216760,62,2870,277,2871,1350,1
20141226.230001,2871,18,216778,4,2870,301,2871,1342,1
20141226.230004,2871,2,216780,2,2870,365,2871,1335,1
20141226.230005,2871,2,216782,2,2870,365,2871,1334,1
20141226.230008,2871,1000,217782,0,2870,391,2871,834,1
20141226.230008,2871,1020,218802,10,2870,391,2871,336,1
20141226.230009,2871,2,218804,2,2870,392,2871,335,1
20141226.23001,2871,4,218808,4,2870,393,2871,334,1
20141226.230011,2871,12,218820,12,2870,419,2871,328,1
20141226.230011,2871,2,218822,2,2870,420,2871,328,1
20141226.230012,2871,2,218824,0,2870,420,2871,327,1
20141226.230012,2871,2,218826,2,2870,419,2871,326,1
20141226.230013,2870,12,218838,-12,2870,413,2871,326,0
20141226.230016,2870,4,218842,-4,2870,403,2871,328,0
20141226.230017,2870,6,218848,-6,2870,401,2871,328,0
20141226.230018,2871,2,218850,2,2870,406,2871,327,1
20141226.230019,2871,2,218852,2,2870,408,2871,327,1
20141226.230022,2871,2,218854,0,2870,420,2871,326,1
20141226.230023,2871,2,218856,2,2870,420,2871,325,1
20141226.230025,2871,4,218860,2,2870,422,2871,323,1
20141226.230026,2870,100,218960,-48,2870,374,2871,323,0
20141226.230027,2870,10,218970,-8,2870,369,2871,323,0
20141226.230027,2871,2,218972,2,2870,369,2871,322,1
20141226.23003,2870,2,218974,2,2870,383,2871,324,0
20141226.230033,2870,2,218976,0,2870,389,2871,324,0
20141226.230034,2871,4,218980,2,2870,398,2871,323,1
20141226.230037,2871,2,218982,2,2870,385,2871,324,1
20141226.230037,2871,20,219002,0,2870,385,2871,314,1
20141226.230038,2871,2,219004,0,2870,385,2871,313,1
20141226.230041,2871,2,219006,0,2870,367,2871,311,1
20141226.230042,2871,2,219008,2,2870,367,2871,310,1
20141226.230045,2870,62,219070,12,2870,338,2871,352,0
20141226.230046,2871,24,219094,24,2870,345,2871,340,1
20141226.230047,2870,100,219194,88,2870,295,2871,363,0
20141226.230047,2870,70,219264,-40,2870,260,2871,363,0
20141226.230048,2870,4,219268,4,2870,258,2871,363,0
20141226.230051,2870,2,219270,2,2870,213,2871,364,0
20141226.230051,2870,2,219272,0,2870,213,2871,366,0
20141226.230055,2870,6,219278,6,2870,210,2871,368,0
20141226.230059,2870,2,219280,-2,2870,211,2871,325,0
20141226.2301,2870,2,219282,-2,2870,210,2871,325,0
20141226.230101,2870,72,219354,-14,2870,174,2871,339,0
20141226.230101,2870,100,219454,78,2870,125,2871,339,0
20141226.230102,2870,6,219460,-4,2870,122,2871,339,0
20141226.230102,2870,8,219468,-6,2870,118,2871,339,0
20141226.230103,2870,178,219646,-36,2870,29,2871,339,0
20141226.230103,2870,58,219704,-20,2869,1422,2871,352,0
20141226.230104,2870,2,219706,0,2870,4,2871,388,0
20141226.230105,2870,10,219716,0,2869,1419,2871,403,0
20141226.230105,2871,2,219718,2,2869,1434,2871,387,1
20141226.230106,2869,78,219796,-62,2869,1397,2871,386,0
20141226.230108,2870,20,219816,-16,2869,1384,2870,2,1
20141226.230108,2871,16,219832,10,2869,1388,2871,387,1
20141226.230109,2870,4,219836,0,2869,1390,2870,2,0
20141226.23011,2870,4,219840,0,2869,1390,2870,1,0
20141226.230111,2870,2,219842,0,2869,1405,2871,398,0
20141226.230114,2870,2,219844,0,2869,1391,2870,8,0
20141226.230115,2870,10,219854,-10,2869,1391,2870,13,0
20141226.230116,2870,20,219874,0,2869,1391,2870,4,0
20141226.230118,2870,2,219876,0,2869,1411,2870,390,0
20141226.23012,2869,1000,220876,24,2869,911,2870,394,0
20141226.230122,2869,8,220884,-2,2869,900,2870,489,0
20141226.230124,2869,10,220894,10,2869,895,2870,489,0
20141226.230126,2870,80,220974,-80,2869,867,2870,455,1
20141226.23013,2869,24,220998,0,2869,924,2870,464,0
20141226.230131,2870,4,221002,0,2869,929,2870,463,1
20141226.230132,2870,50,221052,-50,2869,929,2870,438,1
20141226.230134,2869,2,221054,0,2869,905,2870,438,0
20141226.230134,2869,1000,222054,374,2869,407,2870,438,0
20141226.230135,2870,2,222056,-2,2869,408,2870,437,1
20141226.230135,2869,58,222114,-2,2869,380,2870,434,0
20141226.230136,2869,42,222156,2,2869,358,2870,434,0
20141226.230136,2869,10,222166,0,2869,353,2870,435,0
20141226.230137,2869,32,222198,2,2869,337,2870,435,0
20141226.230138,2869,100,222298,0,2869,297,2870,437,0
20141226.230139,2869,22,222320,22,2869,287,2870,442,0
20141226.23014,2869,56,222376,56,2869,245,2870,452,0
20141226.23014,2869,24,222400,10,2869,239,2870,462,0
20141226.230141,2870,4,222404,-4,2869,239,2870,460,1
20141226.230141,2869,8,222412,0,2869,235,2870,462,0
20141226.230142,2869,2,222414,0,2869,234,2870,461,0
20141226.230143,2869,4,222418,0,2869,232,2870,460,0
20141226.230144,2869,20,222438,0,2869,233,2870,460,0
20141226.230144,2869,8,222446,0,2869,229,2870,460,0
20141226.230146,2869,2,222448,0,2869,300,2870,457,0
20141226.230148,2869,80,222528,0,2869,277,2870,462,0
20141226.230149,2869,2,222530,2,2869,277,2870,463,0
20141226.230151,2869,100,222630,100,2869,226,2870,463,0
20141226.230151,2870,4,222634,0,2869,253,2870,460,1
20141226.230152,2869,4,222638,0,2869,323,2870,460,0
20141226.230153,2869,42,222680,40,2869,302,2870,460,0
20141226.230155,2870,2,222682,0,2869,302,2870,459,1
20141226.230155,2869,2,222684,0,2869,301,2870,459,0
20141226.230156,2869,6,222690,0,2869,317,2870,459,0
20141226.230157,2870,4,222694,2,2869,297,2870,459,1
20141226.230159,2869,596,223290,300,2868,862,2869,213,0
20141226.2302,2869,4,223294,4,2868,862,2869,211,0
20141226.2302,2869,2,223296,2,2868,862,2869,210,0
20141226.230201,2869,4,223300,2,2868,862,2869,269,0
20141226.230202,2869,22,223322,22,2868,862,2869,273,0
20141226.230203,2869,2,223324,2,2868,862,2869,272,0
20141226.230204,2869,2,223326,0,2868,862,2869,272,0
20141226.230205,2869,2,223328,2,2868,863,2869,271,0
20141226.230205,2869,4,223332,0,2868,863,2869,269,0
20141226.230206,2869,2,223334,2,2868,863,2869,274,0
20141226.230206,2868,6,223340,2,2868,862,2869,291,0
20141226.230206,2868,4,223344,0,2868,860,2869,291,0
20141226.230207,2868,220,223564,-78,2868,750,2869,291,0
20141226.230207,2868,4,223568,0,2868,748,2869,321,0
20141226.230208,2868,8,223576,6,2868,725,2869,322,0
20141226.230209,2869,4,223580,4,2868,724,2869,321,1
20141226.23021,2868,36,223616,36,2868,705,2869,327,0
20141226.230213,2868,4,223620,0,2868,567,2869,331,0
20141226.230214,2868,4,223624,2,2868,565,2869,331,0
20141226.230215,2869,2,223626,0,2868,563,2869,154,1
20141226.230216,2868,352,223978,186,2868,387,2869,154,0
20141226.230216,2868,2,223980,0,2868,386,2869,155,0
20141226.230217,2868,4,223984,0,2868,384,2869,155,0
20141226.230217,2869,8,223992,-8,2868,439,2869,151,1
20141226.230218,2868,54,224046,-54,2868,413,2869,152,0
20141226.230218,2869,2,224048,-2,2868,413,2869,151,1
20141226.230219,2869,2,224050,0,2868,414,2869,149,1
20141226.230219,2868,4,224054,0,2868,411,2869,149,0
20141226.23022,2869,2,224056,0,2868,411,2869,148,1
20141226.230221,2869,88,224144,2,2868,423,2869,606,1
20141226.230223,2868,12,224156,-12,2868,364,2869,607,0
20141226.230224,2869,4,224160,0,2868,360,2869,606,1
20141226.230225,2868,750,224910,264,2867,648,2868,137,0
20141226.230225,2868,32,224942,32,2867,646,2868,121,0
20141226.230226,2868,2,224944,2,2867,646,2868,150,0
20141226.230226,2868,10,224954,10,2867,645,2868,145,0
20141226.230227,2868,2,224956,2,2867,646,2868,144,0
20141226.230228,2868,2,224958,2,2867,536,2868,144,0
20141226.230228,2868,2,224960,0,2867,536,2868,153,0
20141226.230229,2867,4,224964,4,2867,481,2868,152,0
20141226.23023,2868,26,224990,0,2867,470,2868,190,1
20141226.23023,2868,24,225014,0,2867,470,2868,181,1
20141226.230231,2867,2,225016,0,2867,494,2868,195,0
20141226.230232,2868,22,225038,8,2867,488,2868,212,1
20141226.230233,2868,4,225042,2,2867,487,2868,214,1
20141226.230234,2867,14,225056,12,2867,479,2868,235,0
20141226.230235,2868,250,225306,-154,2867,360,2868,204,1
20141226.230235,2867,42,225348,40,2867,340,2868,203,0
20141226.230235,2868,72,225420,60,2867,340,2868,168,1
20141226.230236,2867,2,225422,2,2867,335,2868,168,0
20141226.230236,2868,4,225426,4,2867,339,2868,166,1
20141226.230237,2868,36,225462,36,2867,340,2868,158,1
20141226.230238,2867,60,225522,60,2867,297,2868,158,0
20141226.230239,2867,42,225564,-36,2867,330,2868,172,0
20141226.23024,2867,146,225710,-64,2867,228,2868,172,0
20141226.23024,2867,4,225714,-2,2867,234,2868,173,0
20141226.230241,2867,4,225718,-2,2867,248,2868,173,0
20141226.230242,2868,2,225720,0,2867,250,2868,172,1
20141226.230243,2868,2,225722,0,2867,266,2868,171,1
20141226.230245,2867,20,225742,-20,2867,232,2868,171,0
20141226.230245,2867,2,225744,0,2867,232,2868,171,0
20141226.230247,2867,36,225780,6,2867,226,2868,171,0
20141226.230248,2867,2,225782,-2,2867,230,2868,130,0
20141226.230249,2868,4,225786,2,2867,234,2868,131,1
20141226.230249,2867,20,225806,-20,2867,223,2868,131,0
20141226.230251,2867,280,226086,100,2867,185,2868,35,0
20141226.230251,2868,60,226146,20,2867,196,2868,5,1
20141226.230252,2868,10,226156,4,2868,5,2869,157,1
20141226.230252,2868,4,226160,0,2868,81,2869,153,1
20141226.230253,2868,2,226162,0,2868,81,2869,153,1
20141226.230253,2868,4,226166,2,2868,79,2869,153,1
20141226.230254,2868,2,226168,0,2868,79,2869,153,1
20141226.230254,2868,4,226172,-2,2868,78,2869,153,1
20141226.230255,2869,4,226176,-2,2868,78,2869,152,1
20141226.230255,2869,208,226384,116,2868,78,2869,48,1
20141226.230256,2868,24,226408,-6,2868,67,2869,49,0
20141226.230256,2868,10,226418,-10,2868,77,2869,49,0
20141226.230257,2868,8,226426,0,2868,246,2869,64,0
20141226.230259,2868,4,226430,-4,2868,261,2869,84,0
20141226.230259,2869,4,226434,0,2868,262,2869,82,1
20141226.2303,2869,2,226436,-2,2868,263,2869,77,1
20141226.230301,2869,20,226456,0,2868,263,2869,67,1
20141226.230301,2868,4,226460,-4,2868,262,2869,67,0
20141226.230302,2868,2,226462,-2,2868,275,2869,69,0
20141226.230302,2869,2,226464,-2,2868,273,2869,68,1
20141226.230303,2869,2,226466,-2,2868,169,2869,569,1
20141226.230304,2869,12,226478,-2,2868,161,2869,567,1
20141226.230307,2868,2,226480,0,2868,146,2869,79,0
20141226.230308,2869,2,226482,-2,2868,146,2869,78,1
20141226.230309,2869,10,226492,-10,2868,165,2869,74,1
20141226.23031,2868,330,226822,60,2867,266,2868,335,0
20141226.23031,2868,70,226892,68,2867,267,2868,300,0
20141226.230311,2868,4,226896,2,2867,264,2868,298,0
20141226.230311,2868,10,226906,6,2867,264,2868,493,0
20141226.230312,2868,2,226908,0,2867,268,2868,492,0
20141226.230313,2868,28,226936,-20,2867,255,2868,491,0
20141226.230313,2868,20,226956,0,2867,245,2868,281,0
20141226.230314,2868,2,226958,2,2867,249,2868,409,0
20141226.230318,2868,2,226960,2,2867,309,2868,408,0
20141226.230319,2867,44,227004,0,2867,309,2868,390,0
20141226.23032,2868,2,227006,2,2867,314,2868,389,1
20141226.230322,2868,2,227008,2,2867,318,2868,396,1
20141226.230324,2867,6,227014,-6,2867,403,2868,396,0
20141226.230324,2868,2,227016,2,2867,403,2868,396,1
20141226.230325,2868,4,227020,4,2867,403,2868,396,1
20141226.230326,2868,2,227022,0,2867,403,2868,395,1
20141226.230327,2867,20,227042,0,2867,394,2868,395,0
20141226.230328,2868,2,227044,0,2867,395,2868,394,1
20141226.230329,2867,2,227046,-2,2867,415,2868,394,0
20141226.230329,2867,200,227246,-126,2867,321,2868,394,0
20141226.230331,2867,2,227248,-2,2867,324,2868,397,0
20141226.230332,2868,4,227252,2,2867,344,2868,397,1
20141226.230332,2868,2,227254,0,2867,348,2868,396,1
20141226.230332,2868,6,227260,6,2867,349,2868,393,1
20141226.230334,2867,4,227264,0,2867,379,2868,398,0
20141226.230335,2867,12,227276,6,2867,375,2868,401,0
20141226.230335,2868,4,227280,0,2867,355,2868,399,1
20141226.230336,2867,74,227354,0,2867,355,2868,363,0
20141226.230336,2868,2,227356,0,2867,355,2868,362,1
20141226.230338,2867,2,227358,0,2867,355,2868,363,0
20141226.230339,2867,2,227360,2,2867,355,2868,364,0
20141226.23034,2867,2,227362,0,2867,430,2868,385,0
20141226.230341,2868,202,227564,-110,2867,318,2868,387,1
20141226.230343,2867,4,227568,0,2867,313,2868,388,0
20141226.230343,2867,8,227576,0,2867,309,2868,388,0
20141226.230343,2867,2,227578,0,2867,307,2868,390,0
20141226.230344,2867,26,227604,0,2867,300,2868,393,0
20141226.230344,2867,12,227616,0,2867,297,2868,390,0
20141226.230345,2867,26,227642,-24,2867,284,2868,391,0
20141226.230346,2868,48,227690,0,2867,260,2868,395,1
20141226.230347,2867,4,227694,0,2867,278,2868,395,0
20141226.230349,2868,60,227754,60,2867,299,2868,370,1
20141226.230349,2867,4,227758,0,2867,297,2868,370,0
20141226.23035,2867,4,227762,0,2867,295,2868,372,0
20141226.230352,2867,2,227764,0,2867,305,2868,382,0
20141226.230352,2868,2,227766,0,2867,315,2868,381,1
20141226.230354,2867,6,227772,4,2867,336,2868,384,0
20141226.230354,2867,20,227792,-20,2867,326,2868,384,0
20141226.230356,2867,2,227794,-2,2867,379,2868,385,0
20141226.230358,2867,2,227796,-2,2867,380,2868,389,0
20141226.230358,2867,20,227816,0,2867,380,2868,388,0
20141226.230359,2867,120,227936,14,2867,356,2868,208,0
20141226.230401,2868,6,227942,2,2867,372,2868,206,1
20141226.230401,2867,4,227946,0,2867,371,2868,205,0
20141226.230402,2868,62,228008,2,2867,372,2868,174,1
20141226.230404,2868,16,228024,0,2867,390,2868,174,1
20141226.230404,2868,10,228034,10,2867,389,2868,167,1
20141226.230407,2868,4,228038,2,2867,394,2868,189,1
20141226.230408,2868,6,228044,4,2867,389,2868,186,1
20141226.230409,2867,30,228074,0,2867,389,2868,172,0
20141226.230411,2868,6,228080,0,2867,398,2868,184,1
20141226.230413,2868,10,228090,10,2867,402,2868,182,1
20141226.230413,2868,120,228210,116,2867,401,2868,122,1
20141226.230414,2868,8,228218,0,2867,400,2868,118,1
20141226.230417,2867,2,228220,0,2867,400,2868,128,0
20141226.230418,2868,8,228228,-2,2867,401,2868,124,1
20141226.230419,2868,2,228230,2,2867,406,2868,123,1
20141226.230419,2867,100,228330,80,2867,356,2868,123,0
20141226.23042,2868,2,228332,0,2867,356,2868,123,1
20141226.230421,2867,10,228342,0,2867,332,2868,122,0
20141226.230423,2868,6,228348,0,2867,332,2868,120,1
20141226.230425,2867,4,228352,0,2867,331,2868,122,0
20141226.230426,2867,2,228354,-2,2867,382,2868,122,0
20141226.230428,2868,2,228356,0,2867,408,2868,122,1
20141226.23043,2867,10,228366,-2,2867,394,2868,118,0
20141226.23043,2867,2,228368,-2,2867,393,2868,118,0
20141226.230432,2867,2,228370,-2,2867,387,2868,521,0
20141226.230433,2868,120,228490,-78,2867,378,2868,462,1
20141226.230433,2868,64,228554,44,2867,365,2868,430,1
20141226.230436,2867,764,229318,188,2866,1060,2867,18,0
20141226.230437,2867,36,229354,10,2866,870,2868,54,0
20141226.230437,2867,2,229356,-2,2866,870,2868,55,0
20141226.230438,2868,4,229360,0,2866,871,2868,82,1
20141226.23044,2867,4,229364,0,2867,258,2868,90,0
20141226.230441,2867,4,229368,4,2867,256,2868,90,0
20141226.230443,2867,8,229376,0,2867,251,2868,121,0
20141226.230445,2867,48,229424,48,2867,228,2868,146,0
20141226.230446,2867,6,229430,6,2867,225,2868,148,0
20141226.230447,2867,6,229436,0,2867,217,2868,138,0
20141226.230449,2867,4,229440,0,2867,217,2868,143,0
20141226.230454,2867,6,229446,4,2867,215,2868,340,0
20141226.230455,2867,2,229448,2,2867,104,2868,342,0
20141226.230456,2867,2,229450,0,2867,103,2868,342,0
20141226.230459,2867,2,229452,0,2867,158,2868,344,0
20141226.230502,2867,2,229454,2,2867,160,2868,344,0
20141226.230505,2867,2,229456,2,2867,299,2868,345,0
20141226.230508,2867,8,229464,8,2867,332,2868,341,0
20141226.23051,2867,4,229468,0,2867,332,2868,341,0
20141226.23051,2868,100,229568,36,2867,333,2868,291,1
20141226.230511,2867,600,230168,542,2867,34,2868,291,0
20141226.230512,2868,8,230176,8,2867,104,2868,286,1
20141226.230514,2867,10,230186,0,2867,174,2868,286,0
20141226.230517,2868,102,230288,-20,2867,129,2868,347,1
20141226.23052,2867,4,230292,0,2867,108,2868,345,0
20141226.23052,2867,2,230294,0,2867,107,2868,345,0
20141226.230524,2868,2,230296,2,2867,240,2868,346,1
20141226.230524,2867,4,230300,0,2867,243,2868,344,0
20141226.230525,2868,2,230302,0,2867,245,2868,343,1
20141226.230528,2868,2,230304,2,2867,258,2868,343,1
20141226.230529,2868,20,230324,0,2867,259,2868,333,1
20141226.23053,2868,2,230326,0,2867,260,2868,332,1
20141226.230532,2868,2,230328,0,2867,402,2868,153,1
20141226.230533,2868,2,230330,0,2867,416,2868,152,1
20141226.230534,2868,2,230332,0,2867,418,2868,147,1
20141226.230535,2868,162,230494,-34,2867,418,2868,66,1
20141226.230535,2868,134,230628,8,2867,454,2869,334,1
20141226.230536,2869,6,230634,-2,2867,497,2869,436,1
20141226.230539,2867,136,230770,76,2867,451,2869,371,0
20141226.23054,2868,4,230774,-4,2867,459,2868,59,1
20141226.230541,2868,118,230892,0,2867,468,2869,371,1
20141226.230542,2868,2,230894,2,2868,1,2869,371,1
20141226.230544,2868,6,230900,2,2868,18,2869,371,1
20141226.230545,2868,2,230902,2,2868,19,2869,342,1
20141226.230545,2868,2,230904,2,2868,18,2869,343,1
20141226.230545,2868,2,230906,2,2868,17,2869,343,1
20141226.230546,2868,8,230914,0,2868,13,2869,346,1
20141226.230548,2868,4,230918,0,2868,21,2869,364,1
20141226.23055,2868,2,230920,2,2868,63,2869,154,1
20141226.23055,2868,2,230922,2,2868,62,2869,146,1
20141226.230551,2868,36,230958,16,2868,104,2869,146,1
20141226.230552,2868,20,230978,-10,2868,100,2869,136,1
20141226.2306,2869,2,230980,-2,2868,53,2869,183,1
20141226.230602,2869,4,230984,0,2868,55,2869,185,1
20141226.230603,2869,4,230988,-4,2868,55,2869,185,1
20141226.230604,2869,10,230998,0,2868,55,2869,182,1
20141226.230607,2868,2,231000,0,2868,63,2869,191,0
20141226.230608,2868,4,231004,4,2868,61,2869,190,0
20141226.230609,2868,26,231030,2,2868,56,2869,202,0
20141226.230611,2868,114,231144,-32,2867,483,2868,11,0
20141226.230612,2868,100,231244,-90,2868,8,2869,381,0
20141226.230613,2869,2,231246,-2,2868,8,2869,382,1
20141226.230615,2868,12,231258,-8,2868,7,2869,187,0
20141226.230615,2868,12,231270,2,2868,6,2869,182,0
20141226.230617,2868,8,231278,8,2868,97,2869,182,0
20141226.230618,2869,2,231280,0,2868,103,2869,183,1
20141226.230619,2868,2,231282,2,2868,102,2869,182,0
20141226.230623,2868,2,231284,2,2868,107,2869,172,0
20141226.230625,2868,4,231288,2,2868,106,2869,174,0
20141226.230626,2868,2,231290,2,2868,106,2869,174,0
20141226.230627,2868,2,231292,2,2868,105,2869,174,0
20141226.230628,2869,2,231294,-2,2868,106,2869,174,1
20141226.230637,2868,2,231296,2,2868,118,2869,186,0
20141226.230639,2869,6,231302,2,2868,118,2869,181,1
20141226.230643,2868,238,231540,220,2867,541,2868,181,0
20141226.230644,2868,2,231542,0,2867,526,2868,180,0
20141226.230648,2868,2,231544,0,2867,587,2868,183,0
20141226.23065,2868,4,231548,4,2867,643,2868,186,0
20141226.23065,2868,2,231550,2,2867,643,2868,185,0
20141226.230653,2868,20,231570,0,2867,668,2868,175,0
20141226.230655,2868,2,231572,2,2867,823,2868,174,0
20141226.230657,2868,2,231574,0,2867,819,2868,173,0
20141226.230657,2868,4,231578,4,2867,819,2868,171,0
20141226.230707,2868,4,231582,2,2867,825,2868,171,0
20141226.230707,2867,2,231584,2,2867,824,2868,172,0
20141226.230708,2868,2,231586,0,2867,824,2868,170,1
20141226.230713,2868,2,231588,2,2867,828,2868,175,1
20141226.230716,2868,2,231590,2,2867,828,2868,177,1
20141226.230717,2868,10,231600,10,2867,838,2868,172,1
20141226.230717,2868,6,231606,6,2867,837,2868,169,1
20141226.230719,2868,4,231610,4,2867,857,2868,168,1
20141226.23072,2868,4,231614,4,2867,857,2868,167,1
20141226.230721,2868,2,231616,2,2867,857,2868,166,1
20141226.230722,2868,4,231620,4,2867,857,2868,164,1
20141226.230724,2868,44,231664,44,2867,855,2868,143,1
20141226.230725,2867,8,231672,8,2867,856,2868,142,0
20141226.230726,2868,14,231686,2,2867,848,2868,135,1
20141226.230727,2868,2,231688,2,2867,851,2868,134,1
20141226.230727,2868,72,231760,72,2867,851,2868,134,1
20141226.230732,2868,2,231762,2,2867,855,2868,132,1
20141226.230734,2868,6,231768,4,2867,856,2868,130,1
20141226.230736,2868,4,231772,2,2867,856,2868,128,1
20141226.230739,2868,2,231774,0,2867,856,2868,128,1
20141226.230743,2868,202,231976,0,2867,766,2868,27,1
20141226.230743,2868,54,232030,30,2867,766,2869,267,1
20141226.230748,2869,200,232230,-114,2868,170,2869,167,1
20141226.230751,2868,2,232232,2,2868,189,2869,169,0
20141226.230758,2869,2,232234,0,2868,226,2869,167,1
20141226.230802,2869,200,232434,-112,2868,225,2869,67,1
20141226.230806,2869,2,232436,0,2868,238,2869,125,1
20141226.230806,2869,12,232448,-10,2868,238,2869,120,1
20141226.230808,2869,2,232450,0,2868,240,2869,119,1
20141226.230813,2869,40,232490,0,2868,248,2869,102,1
20141226.230816,2869,10,232500,-10,2868,250,2869,99,1
20141226.230817,2869,34,232534,-28,2868,301,2869,84,1
20141226.230818,2869,20,232554,12,2868,295,2869,74,1
20141226.230818,2869,6,232560,6,2868,295,2869,71,1
20141226.230821,2869,36,232596,6,2868,297,2869,84,1
20141226.230823,2869,10,232606,-10,2868,300,2869,80,1
20141226.230823,2868,2,232608,0,2868,299,2869,80,0
20141226.230824,2869,2,232610,0,2868,300,2869,79,1
20141226.230828,2869,4,232614,0,2868,301,2869,83,1
20141226.23083,2869,2,232616,0,2868,313,2869,82,1
20141226.230831,2869,2,232618,0,2868,313,2869,81,1
20141226.230833,2869,4,232622,-4,2868,313,2869,79,1
20141226.230834,2869,2,232624,0,2868,305,2869,98,1
20141226.230835,2869,16,232640,0,2868,305,2869,90,1
20141226.230835,2868,6,232646,0,2868,323,2869,120,0
20141226.230839,2868,2,232648,0,2868,322,2869,142,0
20141226.230843,2869,2,232650,-2,2868,321,2869,143,1
20141226.230851,2868,2,232652,0,2868,492,2869,143,0
20141226.230854,2868,2,232654,2,2868,499,2869,143,0
20141226.230855,2869,2,232656,-2,2868,499,2869,142,1
20141226.2309,2868,4,232660,0,2868,498,2869,142,0
20141226.230901,2868,2,232662,2,2868,498,2869,142,0
20141226.230903,2869,8,232670,0,2868,497,2869,138,1
20141226.230904,2868,6,232676,0,2868,494,2869,138,0
20141226.230905,2869,2,232678,-2,2868,494,2869,137,1
20141226.230911,2869,2,232680,-2,2868,499,2869,137,1
20141226.230912,2868,40,232720,0,2868,479,2869,147,0
20141226.230916,2869,10,232730,-10,2868,480,2869,149,1
20141226.230917,2869,6,232736,-6,2868,480,2869,147,1
20141226.230918,2868,2,232738,2,2868,479,2869,158,0
20141226.230923,2869,8,232746,-8,2868,477,2869,158,1
20141226.230929,2868,42,232788,-32,2868,457,2869,158,0
20141226.230937,2869,2,232790,-2,2868,549,2869,206,1
20141226.23094,2869,8,232798,0,2868,549,2869,201,1
20141226.230943,2868,20,232818,0,2868,546,2869,202,0
20141226.230946,2869,10,232828,10,2868,546,2869,197,1
20141226.230946,2869,2,232830,0,2868,546,2869,196,1
20141226.230947,2868,40,232870,-40,2868,526,2869,196,0
20141226.230954,2868,10,232880,-10,2868,525,2869,228,0
20141226.230955,2868,2,232882,0,2868,524,2869,228,0
20141226.230959,2868,20,232902,-20,2868,516,2869,231,0
20141226.231004,2869,4,232906,0,2868,516,2869,231,1
20141226.231008,2869,4,232910,0,2868,517,2869,238,1
20141226.231009,2868,2,232912,0,2868,516,2869,253,0
20141226.23101,2868,4,232916,-4,2868,514,2869,253,0
20141226.231014,2869,2,232918,0,2868,514,2869,254,1
20141226.231021,2869,4,232922,0,2868,536,2869,253,1
20141226.231024,2869,10,232932,0,2868,536,2869,250,1
20141226.231028,2869,2,232934,-2,2868,537,2869,249,1
20141226.231034,2869,2,232936,0,2868,524,2869,279,1
20141226.23104,2869,558,233494,162,2869,261,2870,574,1
20141226.231041,2869,2,233496,2,2869,260,2870,574,1
20141226.231045,2870,4,233500,0,2869,272,2870,583,1
20141226.231045,2870,2,233502,-2,2869,277,2870,582,1
20141226.231045,2870,2,233504,-2,2869,277,2870,581,1
20141226.231046,2869,60,233564,0,2869,252,2870,581,0
20141226.231048,2869,8,233572,8,2869,248,2870,592,0
20141226.231048,2870,2,233574,-2,2869,248,2870,591,1
20141226.231053,2869,2,233576,2,2869,256,2870,591,0
20141226.231056,2870,2,233578,0,2869,272,2870,599,1
20141226.231057,2869,10,233588,10,2869,319,2870,608,0
20141226.231058,2869,2,233590,0,2869,320,2870,608,0
20141226.2311,2870,2,233592,0,2869,321,2870,607,1
20141226.231101,2870,12,233604,-10,2869,320,2870,602,1
20141226.231102,2870,2,233606,-2,2869,320,2870,606,1
20141226.231102,2870,24,233630,-24,2869,320,2870,594,1
20141226.231103,2869,2,233632,0,2869,322,2870,595,0
20141226.231104,2869,4,233636,0,2869,323,2870,594,0
20141226.231107,2870,2,233638,0,2869,325,2870,644,1
20141226.231108,2869,6,233644,6,2869,324,2870,643,0
20141226.231109,2870,4,233648,0,2869,325,2870,642,1
20141226.231109,2869,4,233652,4,2869,323,2870,642,0
20141226.231113,2870,2,233654,0,2869,335,2870,640,1
20141226.231115,2870,28,233682,-20,2869,334,2870,639,1
20141226.231116,2870,2,233684,0,2869,334,2870,638,1
20141226.231117,2870,12,233696,-12,2869,334,2870,633,1
20141226.231122,2870,8,233704,-8,2869,376,2870,666,1
20141226.231126,2869,4,233708,0,2869,452,2870,665,0
20141226.231127,2870,2,233710,0,2869,453,2870,664,1
20141226.231127,2870,8,233718,0,2869,454,2870,660,1
20141226.231128,2870,2,233720,0,2869,454,2870,661,1
20141226.231129,2870,2,233722,0,2869,454,2870,660,1
20141226.23113,2870,12,233734,-12,2869,453,2870,654,1
20141226.231132,2869,20,233754,0,2869,929,2870,654,0
20141226.231134,2870,4,233758,-4,2869,449,2870,653,1
20141226.231134,2869,2,233760,0,2869,448,2870,653,0
20141226.231138,2870,20,233780,-20,2869,449,2870,644,1
20141226.231141,2870,4,233784,0,2869,458,2870,644,1
20141226.231143,2869,8,233792,0,2869,454,2870,647,0
20141226.231144,2870,8,233800,-8,2869,454,2870,643,1
20141226.231148,2870,4,233804,-4,2869,459,2870,631,1
20141226.231149,2870,20,233824,-20,2869,459,2870,621,1
20141226.23115,2869,4,233828,0,2869,458,2870,623,0
20141226.231153,2870,6,233834,-6,2869,460,2870,619,1
20141226.231154,2870,6,233840,0,2869,460,2870,616,1
20141226.231155,2870,8,233848,0,2869,470,2870,634,1
20141226.231156,2870,2,233850,-2,2869,470,2870,634,1
20141226.231157,2869,10,233860,0,2869,465,2870,634,0
20141226.231203,2870,16,233876,-12,2869,668,2870,616,1
20141226.231205,2870,20,233896,-20,2869,672,2870,606,1
20141226.231206,2870,2,233898,-2,2869,673,2870,595,1
20141226.231209,2870,4,233902,0,2869,796,2870,593,1
20141226.23121,2870,2,233904,-2,2869,808,2870,592,1
20141226.231213,2870,10,233914,-10,2869,819,2870,589,1
20141226.231214,2869,20,233934,0,2869,809,2870,589,0
20141226.231216,2870,2,233936,-2,2869,860,2870,568,1
20141226.231216,2870,20,233956,-20,2869,886,2870,558,1
20141226.231217,2870,20,233976,0,2869,911,2870,548,1
20141226.231218,2870,20,233996,0,2869,951,2870,538,1
20141226.231219,2870,24,234020,-4,2869,951,2870,526,1
20141226.231222,2870,2,234022,-2,2869,960,2870,507,1
20141226.231223,2870,14,234036,-10,2869,961,2870,500,1
20141226.231225,2870,2,234038,0,2869,961,2870,500,1
20141226.231228,2870,4,234042,-2,2869,1036,2870,502,1
20141226.231228,2870,26,234068,0,2869,1062,2870,489,1
20141226.231229,2870,24,234092,-20,2869,1069,2870,478,1
20141226.23123,2869,12,234104,2,2869,1068,2870,473,0
20141226.23123,2869,2,234106,2,2869,1069,2870,476,0
20141226.231231,2870,2,234108,0,2869,1069,2870,475,1
20141226.231231,2870,2,234110,0,2869,1069,2870,474,1
20141226.231232,2870,2,234112,0,2869,1093,2870,473,1
20141226.231234,2870,8,234120,-4,2869,1094,2870,468,1
20141226.231235,2870,600,234720,-380,2869,1099,2870,170,1
20141226.231236,2870,144,234864,110,2869,1099,2870,98,1
20141226.231236,2870,126,234990,34,2869,1097,2870,35,1
20141226.231237,2870,64,235054,48,2869,1100,2870,3,1
20141226.231237,2870,8,235062,-6,2869,1100,2870,299,1
20141226.231238,2870,216,235278,-2,2869,1100,2870,191,1
20141226.231238,2870,66,235344,-6,2869,1100,2870,158,1
20141226.231239,2869,12,235356,0,2869,1093,2870,158,0
20141226.23124,2870,2,235358,0,2869,1093,2870,157,1
20141226.231241,2870,4,235362,0,2869,1112,2870,157,1
20141226.231242,2870,4,235366,0,2869,1137,2870,155,1
20141226.231243,2869,72,235438,0,2869,1126,2870,155,0
20141226.231244,2870,42,235480,-42,2869,1126,2870,134,1
20141226.231244,2869,2,235482,0,2869,1149,2870,194,0
20141226.231246,2870,2,235484,0,2869,1174,2870,219,1
20141226.231246,2870,14,235498,-6,2869,1174,2870,212,1
20141226.231247,2870,4,235502,0,2869,1209,2870,210,1
20141226.231249,2870,8,235510,0,2869,1217,2870,207,1
20141226.23125,2870,10,235520,-10,2869,1217,2870,202,1
20141226.231252,2870,14,235534,-14,2869,1227,2870,195,1
20141226.231253,2870,8,235542,-2,2869,1237,2870,191,1
20141226.231254,2870,40,235582,-40,2869,1245,2870,171,1
20141226.231257,2870,2,235584,0,2869,1262,2870,170,1
20141226.231257,2870,4,235588,0,2869,1262,2870,168,1
20141226.231259,2870,10,235598,-10,2869,1262,2870,163,1
20141226.231259,2870,20,235618,-20,2869,1267,2870,153,1
20141226.2313,2870,10,235628,0,2869,1273,2870,148,1
20141226.231301,2870,10,235638,0,2869,1273,2870,144,1
20141226.231301,2870,4,235642,0,2869,1278,2870,142,1
20141226.231302,2870,60,235702,-48,2869,1288,2870,112,1
20141226.231303,2869,830,236532,-140,2869,873,2870,112,0
20141226.231304,2870,12,236544,0,2869,46,2870,88,1
20141226.231305,2870,2,236546,0,2869,46,2870,117,1
20141226.231307,2869,92,236638,-26,2868,763,2869,9,0
20141226.231308,2870,24,236662,0,2869,1,2870,162,1
20141226.231309,2870,8,236670,0,2869,1,2870,159,1
20141226.23131,2869,2,236672,0,2868,763,2870,159,0
20141226.231316,2869,18,236690,-2,2869,29,2870,211,0
20141226.231319,2870,2,236692,-2,2869,18,2870,211,1
20141226.23132,2869,10,236702,-4,2869,15,2870,215,0
20141226.231324,2870,2,236704,-2,2869,25,2870,231,1
20141226.231324,2870,2,236706,0,2869,26,2870,311,1
20141226.231325,2869,2,236708,2,2869,25,2870,316,0
20141226.231326,2869,8,236716,0,2869,24,2870,321,0
20141226.23133,2869,10,236726,0,2869,268,2870,311,0
20141226.231337,2870,200,236926,2,2869,278,2870,172,1
20141226.231344,2869,2,236928,2,2869,85,2870,172,0
20141226.231344,2870,2,236930,0,2869,87,2870,298,1
20141226.231346,2869,2,236932,2,2869,26,2870,337,0
20141226.231347,2869,20,236952,0,2869,18,2870,369,0
20141226.23135,2869,4,236956,0,2869,16,2870,380,0
20141226.231355,2869,2,236958,0,2869,19,2870,381,0
20141226.231357,2869,26,236984,-8,2869,8,2870,382,0
20141226.2314,2869,4,236988,0,2869,7,2870,383,0
20141226.2314,2869,4,236992,0,2869,6,2870,383,0
20141226.231403,2870,2,236994,0,2869,6,2870,472,1
20141226.231404,2869,2,236996,0,2869,5,2870,471,0
20141226.231405,2869,12,237008,-10,2868,559,2869,2,0
20141226.231406,2869,4,237012,0,2868,558,2869,10,0
20141226.231407,2869,4,237016,0,2868,558,2869,8,0
20141226.231407,2869,2,237018,0,2868,558,2869,7,0
20141226.231408,2869,2,237020,0,2868,558,2869,6,0
20141226.231409,2869,6,237026,0,2868,561,2869,3,0
20141226.231413,2869,2,237028,0,2868,561,2869,3,0
20141226.231417,2869,2,237030,-2,2868,562,2869,6,0
20141226.23142,2869,2,237032,0,2868,556,2869,10,0
20141226.231423,2869,2,237034,0,2868,556,2869,10,0
20141226.231425,2869,10,237044,-6,2868,556,2869,41,0
20141226.231429,2868,100,237144,-100,2868,490,2869,215,0
20141226.231435,2868,80,237224,18,2868,477,2869,105,0
20141226.231437,2869,266,237490,-40,2869,167,2870,573,1
20141226.231438,2869,266,237756,-16,2869,34,2870,573,1
20141226.231438,2869,2,237758,0,2869,33,2870,573,1
20141226.231438,2869,66,237824,-66,2868,478,2870,573,1
20141226.231441,2869,10,237834,10,2868,488,2869,18,1
20141226.231446,2868,178,238012,40,2868,372,2869,259,0
20141226.231447,2868,260,238272,88,2868,243,2869,259,0
20141226.231448,2869,2,238274,0,2868,234,2869,258,1
20141226.231448,2868,378,238652,0,2867,341,2869,258,0
20141226.231451,2868,32,238684,30,2867,382,2868,89,0
20141226.231452,2867,8,238692,0,2867,378,2868,89,0
20141226.231452,2868,16,238708,16,2867,369,2868,81,1
20141226.2315,2867,12,238720,12,2867,371,2868,371,0
20141226.231501,2867,6,238726,0,2867,368,2868,171,0
20141226.231502,2867,2,238728,2,2867,367,2868,172,0
20141226.231504,2868,48,238776,48,2867,371,2868,183,1
20141226.231506,2867,8,238784,0,2867,368,2868,183,0
20141226.231508,2868,42,238826,-4,2867,368,2868,162,1
20141226.23151,2867,2,238828,0,2867,367,2868,197,0
20141226.231512,2867,4,238832,-2,2867,365,2868,198,0
20141226.231514,2868,2,238834,0,2867,366,2868,198,1
20141226.231514,2868,60,238894,60,2867,366,2868,174,1
20141226.231516,2867,10,238904,-4,2867,361,2868,179,0
20141226.231517,2867,10,238914,-10,2867,358,2868,179,0
20141226.231517,2868,2,238916,0,2867,357,2868,193,1
20141226.231518,2867,12,238928,10,2867,354,2868,218,0
20141226.231518,2867,600,239528,-354,2866,750,2868,243,0
20141226.23152,2867,4,239532,0,2866,750,2868,270,0
20141226.231521,2867,34,239566,-30,2867,87,2868,277,0
20141226.231522,2868,4,239570,0,2867,236,2868,277,1
20141226.231523,2867,2,239572,2,2867,235,2868,279,0
20141226.231525,2867,22,239594,20,2867,220,2868,279,0
20141226.231526,2867,4,239598,4,2867,228,2868,304,0
20141226.231531,2867,2,239600,0,2867,227,2868,441,0
20141226.231533,2867,4,239604,0,2867,225,2868,441,0
20141226.231533,2867,2,239606,-2,2867,224,2868,441,0
20141226.231534,2867,6,239612,4,2867,223,2868,455,0
20141226.231538,2867,2,239614,-2,2867,213,2868,455,0
20141226.231538,2868,14,239628,-10,2867,208,2868,453,1
20141226.231539,2867,2,239630,-2,2867,208,2868,453,0
20141226.231541,2867,80,239710,0,2867,169,2868,454,0
20141226.231542,2867,10,239720,-10,2867,164,2868,454,0
20141226.231543,2867,20,239740,-20,2867,155,2868,455,0
20141226.231544,2867,4,239744,-4,2867,153,2868,455,0
20141226.231545,2867,2,239746,-2,2867,152,2868,455,0
20141226.231546,2867,2,239748,-2,2867,162,2868,455,0
20141226.231548,2867,22,239770,-22,2867,152,2868,455,0
20141226.231551,2867,4,239774,0,2867,136,2868,455,0
20141226.231552,2867,6,239780,-6,2867,154,2868,455,0
20141226.231552,2867,2,239782,-2,2867,153,2868,455,0
20141226.231553,2867,12,239794,-2,2867,147,2868,454,0
20141226.231555,2867,26,239820,-26,2867,138,2868,455,0
20141226.2316,2868,2,239822,2,2867,152,2868,522,1
20141226.231605,2867,4,239826,0,2867,153,2868,522,0
20141226.231607,2868,252,240078,-40,2868,208,2869,114,1
20141226.231607,2868,100,240178,-100,2868,173,2869,104,1
20141226.231609,2868,24,240202,-24,2868,171,2869,103,1
20141226.23161,2869,6,240208,6,2868,171,2869,99,1
20141226.231611,2868,312,240520,-312,2867,301,2869,101,0
20141226.231611,2868,4,240524,-4,2867,301,2869,101,0
20141226.231614,2868,4,240528,-2,2867,303,2869,102,0
20141226.231615,2867,2,240530,-2,2867,303,2869,104,0
20141226.231617,2868,100,240630,0,2867,306,2869,105,1
20141226.231618,2868,2,240632,0,2867,306,2869,85,1
20141226.23162,2868,2,240634,-2,2867,345,2869,92,1
20141226.231621,2868,4,240638,0,2867,345,2869,92,1
20141226.231622,2868,30,240668,0,2867,347,2868,440,1
20141226.23163,2868,200,240868,-200,2867,365,2869,93,1
20141226.231632,2868,4,240872,2,2867,365,2869,103,1
20141226.231633,2868,2,240874,0,2867,365,2869,103,1
20141226.231636,2868,678,241552,102,2868,71,2869,360,1
20141226.23164,2868,6,241558,6,2868,80,2869,339,1
20141226.231641,2868,2,241560,0,2868,79,2869,339,1
20141226.231642,2869,2,241562,0,2868,79,2869,338,1
20141226.231644,2868,2,241564,0,2868,98,2869,338,0
20141226.231645,2869,2,241566,0,2868,103,2869,230,1
20141226.231648,2868,2,241568,2,2868,104,2869,189,0
20141226.231649,2868,10,241578,0,2868,99,2869,188,0
20141226.231653,2868,6,241584,6,2868,97,2869,189,0
20141226.231656,2869,20,241604,0,2868,103,2869,179,1
20141226.231657,2869,12,241616,0,2868,104,2869,170,1
20141226.231658,2869,2,241618,0,2868,122,2869,170,1
20141226.231659,2868,2,241620,2,2868,121,2869,170,0
20141226.231705,2868,2,241622,2,2868,125,2869,169,0
20141226.231708,2869,20,241642,20,2868,166,2869,159,1
20141226.231711,2869,12,241654,0,2868,180,2869,149,1
20141226.231713,2868,2,241656,2,2868,181,2869,149,0
20141226.231715,2868,2,241658,0,2868,181,2869,147,0
20141226.231718,2868,2,241660,0,2868,182,2869,148,0
20141226.231719,2869,2,241662,0,2868,182,2869,147,1
20141226.231727,2868,10,241672,0,2868,120,2869,152,0
20141226.231739,2869,120,241792,-26,2868,128,2869,136,1
20141226.231739,2869,2,241794,2,2868,128,2869,126,1
20141226.231741,2869,100,241894,72,2868,158,2869,94,1
20141226.231745,2868,42,241936,34,2868,167,2869,72,0
20141226.231748,2868,2,241938,0,2868,166,2869,72,0
20141226.231749,2868,4,241942,0,2868,164,2869,73,0
20141226.23175,2869,2,241944,0,2868,166,2869,61,1
20141226.231752,2869,2,241946,2,2868,177,2869,65,1
20141226.231754,2868,6,241952,0,2868,177,2869,65,0
20141226.231758,2868,20,241972,20,2868,166,2869,270,0
20141226.231804,2869,10,241982,0,2868,170,2869,66,1
20141226.231811,2868,6,241988,0,2868,167,2869,108,0
20141226.231812,2869,8,241996,-8,2868,167,2869,105,1
20141226.231813,2869,2,241998,-2,2868,167,2869,103,1
20141226.231816,2868,18,242016,-2,2868,163,2869,156,0
20141226.231817,2869,4,242020,0,2868,169,2869,146,1
20141226.231826,2868,2,242022,0,2868,220,2869,131,0
20141226.231827,2869,2,242024,2,2868,220,2869,130,1
20141226.231828,2868,102,242126,32,2868,170,2869,129,0
20141226.231835,2868,100,242226,26,2868,120,2869,190,0
20141226.231839,2868,24,242250,0,2868,109,2869,178,0
20141226.23184,2868,2,242252,0,2868,140,2869,175,0
20141226.231843,2868,2,242254,-2,2868,141,2869,205,0
20141226.231846,2868,20,242274,2,2868,136,2869,217,0
20141226.231846,2868,110,242384,46,2868,81,2869,217,0
20141226.231847,2868,2,242386,0,2868,105,2869,217,0
20141226.231849,2868,110,242496,78,2868,50,2869,267,0
20141226.23185,2868,2,242498,-2,2868,49,2869,266,0
20141226.231852,2868,4,242502,-4,2868,47,2869,266,0
20141226.231854,2869,2,242504,-2,2868,48,2869,261,1
20141226.231856,2868,2,242506,0,2868,56,2869,261,0
20141226.231856,2868,34,242540,6,2868,40,2869,261,0
20141226.231858,2869,4,242544,-4,2868,43,2869,280,1
20141226.231859,2868,2,242546,2,2868,42,2869,300,0
20141226.2319,2868,50,242596,50,2868,17,2869,300,0
20141226.231901,2868,56,242652,34,2867,359,2868,7,0
20141226.231902,2868,14,242666,-12,2867,360,2869,320,0
20141226.231902,2868,30,242696,-30,2867,360,2869,320,0
20141226.231908,2868,44,242740,-6,2867,360,2868,8,0
20141226.23191,2868,4,242744,-2,2867,360,2868,27,0
20141226.231912,2868,2,242746,-2,2867,360,2868,27,0
20141226.231912,2868,2,242748,-2,2867,360,2868,26,0
20141226.231913,2868,52,242800,-32,2867,356,2869,517,0
20141226.231914,2869,2,242802,2,2867,357,2868,2,1
20141226.231917,2868,8,242810,8,2867,357,2868,114,0
20141226.231917,2867,2,242812,-2,2867,406,2868,114,0
20141226.231942,2868,2,242814,0,2867,412,2868,198,1
20141226.231955,2868,6,242820,0,2867,416,2868,196,1
20141226.232,2868,412,243232,246,2868,44,2869,478,1
20141226.232001,2868,4,243236,4,2868,44,2869,478,1
20141226.232004,2869,6,243242,6,2868,44,2869,465,1
20141226.232005,2869,2,243244,2,2868,48,2869,464,1
20141226.232006,2868,6,243250,0,2868,45,2869,455,0
20141226.232009,2868,2,243252,2,2868,53,2869,455,0
20141226.232012,2868,2,243254,2,2868,53,2869,456,0
20141226.232012,2868,20,243274,0,2868,44,2869,456,0
20141226.232013,2868,2,243276,2,2868,43,2869,456,0
20141226.232015,2868,6,243282,4,2868,41,2869,456,0
20141226.232016,2868,10,243292,10,2868,36,2869,456,0
20141226.232016,2868,58,243350,36,2868,7,2869,428,0
20141226.232017,2868,18,243368,-10,2867,432,2869,428,0
20141226.232017,2868,4,243372,0,2868,10,2869,429,0
20141226.232018,2868,20,243392,-20,2867,432,2869,429,0
20141226.232019,2868,4,243396,-4,2868,2,2869,426,0
20141226.232019,2868,18,243414,-4,2868,3,2869,426,0
20141226.23202,2868,8,243422,0,2867,440,2869,426,0
20141226.232026,2868,20,243442,0,2867,444,2868,14,0
20141226.232029,2868,2,243444,-2,2867,444,2868,14,0
20141226.23203,2868,2,243446,0,2867,444,2868,13,0
20141226.232032,2868,2,243448,-2,2867,435,2868,13,0
20141226.232034,2868,20,243468,0,2867,435,2868,48,0
20141226.232035,2867,20,243488,-20,2867,425,2868,48,0
20141226.232037,2867,2,243490,0,2867,424,2868,60,0
20141226.232037,2867,2,243492,0,2867,423,2868,60,0
20141226.232038,2867,2,243494,0,2867,422,2868,60,0
20141226.23204,2867,2,243496,-2,2867,430,2868,60,0
20141226.23204,2868,120,243616,-96,2867,430,2869,540,1
20141226.232041,2868,18,243634,0,2867,430,2868,8,1
20141226.232046,2867,10,243644,-10,2867,426,2868,11,0
20141226.232051,2867,18,243662,-18,2867,417,2868,316,0
20141226.232055,2867,2,243664,0,2867,419,2868,332,0
20141226.232103,2867,42,243706,22,2867,428,2868,322,0
20141226.232103,2867,10,243716,-10,2867,423,2868,322,0
20141226.232105,2867,8,243724,0,2867,401,2868,350,0
20141226.232106,2867,14,243738,6,2867,394,2868,350,0
20141226.232107,2867,28,243766,-18,2867,380,2868,350,0
20141226.232111,2867,2,243768,0,2867,378,2868,353,0
20141226.232112,2867,16,243784,0,2867,370,2868,353,0
20141226.232113,2868,2,243786,2,2867,370,2868,352,1
20141226.232123,2867,4,243790,-4,2867,370,2868,369,0
20141226.232129,2868,2,243792,0,2867,371,2868,347,1
20141226.232138,2868,2,243794,0,2867,369,2868,424,1
20141226.232148,2868,18,243812,0,2867,369,2868,459,1
20141226.232201,2867,2,243814,0,2867,373,2868,457,0
20141226.232203,2867,2,243816,-2,2867,372,2868,456,0
20141226.232207,2867,2,243818,-2,2867,371,2868,455,0
20141226.232208,2867,2,243820,-2,2867,370,2868,455,0
20141226.232208,2867,18,243838,-18,2867,361,2868,455,0
20141226.232212,2867,204,244042,-2,2867,270,2868,455,0
20141226.232214,2867,8,244050,-8,2867,270,2868,455,0
20141226.232216,2867,2,244052,0,2867,269,2868,456,0
20141226.232219,2867,2,244054,0,2867,266,2868,456,0
20141226.232222,2867,4,244058,-4,2867,278,2868,456,0
20141226.232226,2867,20,244078,-20,2867,268,2868,447,0
20141226.232229,2867,36,244114,-4,2867,266,2868,431,0
20141226.232234,2867,2,244116,-2,2867,265,2868,435,0
20141226.232235,2867,8,244124,0,2867,261,2868,435,0
20141226.232237,2867,20,244144,-20,2867,252,2868,435,0
20141226.23224,2867,2,244146,-2,2867,250,2868,435,0
20141226.232242,2867,12,244158,-12,2867,245,2868,435,0
20141226.232244,2868,8,244166,8,2867,245,2868,481,1
20141226.232246,2867,4,244170,0,2867,243,2868,481,0
20141226.232249,2867,4,244174,-4,2867,242,2868,491,0
20141226.23225,2867,488,244662,-246,2866,965,2867,51,0
20141226.23225,2867,10,244672,0,2866,963,2867,46,0
20141226.232254,2867,2,244674,-2,2866,961,2867,242,0
20141226.232255,2867,4,244678,-4,2866,961,2867,241,0
20141226.232257,2866,2,244680,-2,2866,959,2867,245,0
20141226.232258,2866,34,244714,-2,2866,943,2867,245,0
20141226.232258,2866,376,245090,-244,2866,572,2867,244,0
20141226.232259,2866,20,245110,-20,2866,562,2867,244,0
20141226.232259,2866,2,245112,-2,2866,561,2867,252,0
20141226.232301,2866,2,245114,-2,2866,566,2867,297,0
20141226.232305,2866,6,245120,-6,2866,556,2867,334,0
20141226.232306,2866,4,245124,0,2866,554,2867,335,0
20141226.23231,2866,20,245144,-18,2866,551,2867,342,0
20141226.232311,2867,2,245146,0,2866,551,2867,341,1
20141226.232311,2866,16,245162,0,2866,543,2867,341,0
20141226.232312,2866,6,245168,-6,2866,540,2867,341,0
20141226.232312,2866,2,245170,-2,2866,539,2867,343,0
20141226.232313,2866,2,245172,-2,2866,540,2867,343,0
20141226.232315,2866,4,245176,-2,2866,538,2867,344,0
20141226.232316,2866,4,245180,-2,2866,536,2867,345,0
20141226.232318,2867,2,245182,-2,2866,536,2867,344,1
20141226.232319,2866,2,245184,-2,2866,535,2867,344,0
20141226.23232,2866,2,245186,0,2866,534,2867,344,0
20141226.232321,2866,40,245226,-40,2866,514,2867,347,0
20141226.232323,2867,2,245228,-2,2866,516,2867,347,1
20141226.232328,2866,2,245230,-2,2866,514,2867,336,0
20141226.23233,2866,2,245232,-2,2866,513,2867,336,0
20141226.232331,2867,4,245236,0,2866,514,2867,336,1
20141226.232332,2866,4,245240,-4,2866,512,2867,337,0
20141226.232333,2866,20,245260,0,2866,502,2867,337,0
20141226.232337,2866,10,245270,-10,2866,499,2867,340,0
20141226.232338,2867,2,245272,-2,2866,506,2867,340,1
20141226.232339,2866,4,245276,-4,2866,514,2867,355,0
20141226.232343,2867,4,245280,-2,2866,513,2867,405,1
20141226.232345,2866,10,245290,-10,2866,508,2867,405,0
20141226.232346,2866,4,245294,-4,2866,506,2867,406,0
20141226.232346,2866,2,245296,-2,2866,505,2867,406,0
20141226.232349,2866,20,245316,-20,2866,507,2867,403,0
20141226.23235,2866,2,245318,-2,2866,506,2867,403,0
20141226.23235,2866,2,245320,-2,2866,505,2867,403,0
20141226.232351,2866,4,245324,-4,2866,503,2867,404,0
20141226.232351,2866,2,245326,-2,2866,503,2867,404,0
20141226.232352,2866,2,245328,-2,2866,502,2867,404,0
20141226.232352,2866,2,245330,-2,2866,501,2867,403,0
20141226.232359,2866,10,245340,-10,2866,492,2867,427,0
20141226.232401,2866,2,245342,-2,2866,494,2867,433,0
20141226.232404,2866,4,245346,-4,2866,492,2867,483,0
20141226.232407,2867,2,245348,-2,2866,497,2867,482,1
20141226.232411,2867,2,245350,-2,2866,499,2867,494,1
20141226.232413,2866,2,245352,-2,2866,498,2867,495,0
20141226.232414,2866,60,245412,-18,2866,468,2867,495,0
20141226.232415,2866,4,245416,0,2866,466,2867,495,0
20141226.232415,2866,20,245436,-4,2866,456,2867,495,0
20141226.232416,2866,4,245440,0,2866,454,2867,495,0
20141226.232418,2866,2,245442,0,2866,455,2867,495,0
20141226.232418,2866,2,245444,0,2866,454,2867,497,0
20141226.232418,2866,4,245448,0,2866,452,2867,497,0
20141226.232419,2866,2,245450,0,2866,451,2867,497,0
20141226.23242,2866,2,245452,0,2866,460,2867,497,0
20141226.232421,2866,2,245454,2,2866,460,2867,498,0
20141226.232424,2866,38,245492,38,2866,443,2867,500,0
20141226.232425,2866,730,246222,512,2866,78,2867,500,0
20141226.232425,2866,156,246378,44,2865,641,2866,124,0
20141226.232426,2865,34,246412,20,2865,625,2866,167,0
20141226.232427,2865,140,246552,-102,2865,509,2866,170,0
20141226.232427,2865,216,246768,-84,2865,401,2866,212,0
20141226.232428,2866,12,246780,2,2865,390,2866,211,1
20141226.232428,2866,2,246782,0,2865,388,2866,210,1
20141226.232429,2866,2,246784,0,2865,369,2866,210,1
20141226.232431,2865,2,246786,0,2865,369,2866,252,0
20141226.232432,2865,6,246792,2,2865,367,2866,257,0
20141226.232432,2865,30,246822,20,2865,352,2866,257,0
20141226.232433,2866,6,246828,2,2865,350,2866,268,1
20141226.232433,2865,6,246834,-2,2865,347,2866,268,0
20141226.232435,2865,246,247080,94,2865,204,2866,270,0
20141226.232435,2865,6,247086,-6,2865,201,2866,270,0
20141226.232436,2865,8,247094,-6,2865,232,2866,273,0
20141226.232436,2865,18,247112,16,2865,223,2866,274,0
20141226.232436,2865,32,247144,2,2865,219,2866,264,0
20141226.232437,2865,62,247206,0,2865,188,2866,278,0
20141226.232438,2865,6,247212,2,2865,180,2866,278,0
20141226.232439,2865,26,247238,-8,2865,267,2866,269,0
20141226.232439,2865,40,247278,-6,2865,247,2866,269,0
20141226.23244,2865,40,247318,0,2865,234,2866,302,0
20141226.232441,2865,42,247360,2,2865,252,2866,303,0
20141226.232442,2865,6,247366,2,2865,359,2866,304,0
20141226.232443,2866,164,247530,58,2865,272,2866,289,1
20141226.232444,2865,2,247532,-2,2865,270,2866,290,0
20141226.232445,2865,2,247534,0,2865,272,2866,294,0
20141226.232446,2865,30,247564,-30,2865,258,2866,292,0
20141226.232447,2865,2,247566,0,2865,258,2866,295,0
20141226.232448,2865,4,247570,-4,2865,256,2866,303,0
20141226.232449,2865,4,247574,-4,2865,255,2866,303,0
20141226.23245,2866,20,247594,0,2865,255,2866,297,1
20141226.232451,2865,2,247596,0,2865,256,2866,306,0
20141226.232454,2866,4,247600,-2,2865,263,2866,307,1
20141226.232455,2865,10,247610,-10,2865,271,2866,309,0
20141226.232456,2865,186,247796,-182,2865,177,2866,311,0
20141226.232458,2865,6,247802,2,2865,171,2866,387,0
20141226.232458,2865,2,247804,2,2865,170,2866,435,0
20141226.232459,2865,6,247810,2,2865,168,2866,444,0
20141226.232459,2865,2,247812,0,2865,137,2866,453,0
20141226.232501,2865,8,247820,8,2865,176,2866,454,0
20141226.232501,2865,102,247922,2,2865,127,2866,455,0
20141226.232502,2865,118,248040,88,2865,68,2866,455,0
20141226.232503,2865,6,248046,0,2865,65,2866,522,0
20141226.232503,2865,32,248078,20,2865,110,2866,523,0
20141226.232504,2865,2,248080,2,2865,110,2866,523,0
20141226.232504,2865,200,248280,6,2865,13,2866,523,0
20141226.232505,2865,34,248314,4,2865,30,2866,587,0
20141226.232505,2865,10,248324,10,2865,25,2866,237,0
20141226.232506,2865,8,248332,8,2865,21,2866,237,0
20141226.232507,2865,2,248334,2,2865,20,2866,237,0
20141226.232508,2865,66,248400,-12,2865,33,2866,349,0
20141226.23251,2865,2,248402,0,2865,137,2866,348,0
20141226.232513,2865,8,248410,8,2865,48,2866,347,0
20141226.232514,2865,2,248412,0,2865,47,2866,347,0
20141226.232514,2865,80,248492,-8,2865,7,2866,347,0
20141226.232515,2865,18,248510,10,2864,810,2865,157,0
20141226.232515,2865,2,248512,0,2864,810,2865,195,0
20141226.232516,2865,6,248518,-2,2864,810,2865,229,0
20141226.232516,2865,6,248524,-6,2864,810,2865,226,0
20141226.232517,2865,4,248528,0,2864,810,2865,224,0
20141226.232517,2865,2,248530,0,2864,822,2865,223,0
20141226.232518,2864,428,248958,-186,2864,821,2866,296,0
20141226.232518,2864,32,248990,-32,2864,808,2866,296,0
20141226.232519,2864,254,249244,-218,2864,697,2865,71,0
20141226.232519,2865,142,249386,142,2865,59,2866,295,1
20141226.23252,2865,2,249388,2,2865,61,2866,295,1
20141226.232521,2865,2,249390,0,2865,60,2866,296,1
20141226.232522,2865,4,249394,0,2865,59,2866,296,1
20141226.232527,2865,2,249396,2,2865,216,2866,308,1
20141226.232531,2865,2,249398,2,2865,306,2866,321,1
20141226.232532,2865,4,249402,0,2865,304,2866,301,1
20141226.232532,2866,6,249408,6,2865,304,2866,298,1
20141226.232533,2866,4,249412,4,2865,347,2866,298,1
20141226.232535,2866,2,249414,0,2865,380,2866,295,1
20141226.232538,2865,14,249428,0,2865,380,2866,283,0
20141226.232539,2866,2,249430,2,2865,383,2866,282,1
20141226.23254,2865,2,249432,2,2865,416,2866,281,0
20141226.232541,2866,104,249536,44,2865,416,2866,231,1
20141226.232544,2866,2,249538,0,2865,429,2866,230,1
20141226.232544,2866,2,249540,2,2865,568,2866,229,1
20141226.232549,2866,50,249590,8,2865,573,2866,186,1
20141226.232549,2866,2,249592,0,2865,573,2866,185,1
20141226.23255,2866,220,249812,-198,2865,573,2866,76,1
20141226.23255,2866,2,249814,0,2865,573,2866,75,1
20141226.232551,2866,4,249818,-4,2865,573,2866,85,1
20141226.232551,2866,16,249834,-8,2865,573,2866,77,1
20141226.232552,2866,4,249838,-4,2865,573,2866,76,1
20141226.232555,2866,10,249848,0,2865,578,2866,163,1
20141226.232556,2866,2,249850,-2,2865,706,2866,164,1
20141226.232558,2866,2,249852,0,2865,706,2866,185,1
20141226.232558,2866,2,249854,0,2865,706,2866,184,1
20141226.232601,2866,2,249856,0,2865,726,2866,189,1
20141226.232602,2865,10,249866,0,2865,742,2866,189,0
20141226.232605,2866,2,249868,-2,2865,761,2866,197,1
20141226.232607,2866,4,249872,0,2865,822,2866,190,1
20141226.232611,2865,4,249876,4,2865,871,2866,191,0
20141226.232616,2866,2,249878,0,2865,885,2866,197,1
20141226.23262,2866,2,249880,-2,2865,892,2866,231,1
20141226.232622,2866,2,249882,0,2865,893,2866,231,1
20141226.232622,2865,2,249884,2,2865,892,2866,226,0
20141226.232623,2866,2,249886,0,2865,892,2866,225,1
20141226.232623,2866,2,249888,0,2865,892,2866,225,1
20141226.232624,2865,12,249900,-2,2865,890,2866,224,0
20141226.232628,2866,2,249902,0,2865,899,2866,232,1
20141226.232628,2866,2,249904,0,2865,899,2866,231,1
20141226.232629,2866,2,249906,0,2865,904,2866,238,1
20141226.23263,2866,48,249954,12,2865,910,2866,214,1
20141226.232631,2866,2,249956,2,2865,912,2866,222,1
20141226.232632,2865,2,249958,0,2865,911,2866,222,0
20141226.232633,2866,2,249960,0,2865,911,2866,221,1
20141226.232636,2866,8,249968,-2,2865,966,2866,216,1
20141226.232639,2865,20,249988,20,2865,967,2866,217,0
20141226.232641,2866,20,250008,-12,2865,967,2866,229,1
20141226.232645,2866,92,250100,-72,2865,968,2866,204,1
20141226.232645,2866,4,250104,0,2865,968,2866,202,1
20141226.232647,2866,2,250106,0,2865,969,2866,201,1
20141226.232649,2866,2,250108,0,2865,969,2866,201,1
20141226.232649,2865,10,250118,0,2865,965,2866,202,0
20141226.23265,2866,2,250120,0,2865,965,2866,204,1
20141226.232651,2866,2,250122,-2,2865,965,2866,203,1
20141226.232655,2865,4,250126,0,2865,983,2866,202,0
20141226.232655,2866,2,250128,0,2865,1023,2866,201,1
20141226.232656,2865,22,250150,2,2865,1019,2866,202,0
20141226.232657,2865,6,250156,0,2865,1033,2866,202,0
20141226.232657,2866,2,250158,0,2865,1036,2866,201,1
20141226.232658,2866,2,250160,-2,2865,1036,2866,200,1
20141226.232658,2866,2,250162,-2,2865,1039,2866,199,1
20141226.2327,2866,54,250216,-14,2865,1044,2866,203,1
20141226.232702,2866,4,250220,0,2865,1065,2866,205,1
20141226.232703,2866,4,250224,0,2865,1053,2866,203,1
20141226.232703,2866,2,250226,0,2865,1053,2866,201,1
20141226.232704,2865,2,250228,2,2865,1046,2866,200,0
20141226.232704,2866,2,250230,-2,2865,1052,2866,199,1
20141226.232705,2866,24,250254,4,2865,1055,2866,187,1
20141226.232706,2866,56,250310,0,2865,1061,2866,159,1
20141226.232706,2866,52,250362,-10,2865,1062,2866,133,1
20141226.232707,2865,14,250376,0,2865,1070,2866,129,0
20141226.232708,2866,258,250634,96,2866,72,2867,342,1
20141226.232708,2867,10,250644,-10,2866,33,2867,322,1
20141226.232709,2867,2,250646,-2,2866,33,2867,323,1
20141226.232709,2867,26,250672,-26,2866,33,2867,324,1
20141226.232711,2866,68,250740,-30,2865,312,2866,11,0
20141226.232713,2866,34,250774,-22,2865,312,2866,152,0
20141226.232714,2866,2,250776,2,2865,313,2866,151,0
20141226.232715,2866,2,250778,2,2865,314,2866,150,0
20141226.232716,2866,32,250810,0,2865,298,2866,134,0
20141226.232717,2866,2,250812,2,2865,269,2866,134,0
20141226.232718,2866,36,250848,-20,2865,270,2866,116,0
20141226.232719,2866,2,250850,0,2865,265,2866,115,0
20141226.232719,2866,4,250854,-2,2865,266,2866,113,0
20141226.23272,2866,6,250860,-6,2865,268,2866,110,0
20141226.232721,2866,4,250864,-4,2865,266,2866,108,0
20141226.232722,2866,2,250866,0,2865,273,2866,107,0
20141226.232724,2866,6,250872,-6,2865,245,2866,104,0
20141226.232725,2866,22,250894,-22,2865,241,2866,94,0
20141226.232725,2866,10,250904,-10,2865,236,2866,89,0
20141226.232726,2866,22,250926,-2,2865,237,2866,78,0
20141226.232727,2866,24,250950,-24,2865,237,2866,66,0
20141226.232728,2866,18,250968,0,2865,237,2866,57,0
20141226.232729,2866,22,250990,0,2865,237,2866,46,0
20141226.23273,2866,4,250994,-2,2865,239,2866,44,0
20141226.23273,2866,2,250996,0,2865,239,2866,43,0
20141226.232731,2866,12,251008,-12,2865,241,2866,37,0
20141226.232732,2866,20,251028,0,2865,237,2866,27,0
20141226.232733,2866,56,251084,-52,2866,83,2867,379,0
20141226.232735,2866,4,251088,0,2865,280,2867,395,0
20141226.232738,2866,2,251090,0,2865,287,2866,10,0
20141226.232738,2866,2,251092,-2,2865,287,2866,10,0
20141226.232739,2866,2,251094,-2,2865,285,2866,9,0
20141226.23274,2866,2,251096,0,2865,300,2866,8,0
20141226.232741,2866,4,251100,0,2865,299,2866,6,0
20141226.232742,2866,2,251102,0,2865,302,2866,5,0
20141226.232742,2866,6,251108,-4,2865,302,2866,8,0
20141226.232744,2866,16,251124,-14,2866,75,2867,382,0
20141226.232746,2866,2,251126,-2,2866,126,2867,374,0
20141226.232748,2866,2,251128,2,2866,51,2867,329,0
20141226.23275,2866,2,251130,2,2866,60,2867,331,0
20141226.232751,2867,10,251140,0,2866,69,2867,327,1
20141226.232751,2866,2,251142,0,2866,68,2867,327,0
20141226.232754,2866,2,251144,0,2866,73,2867,327,0
20141226.232755,2866,152,251296,34,2865,444,2866,229,0
20141226.232756,2866,4,251300,0,2865,473,2866,227,0
20141226.232758,2866,6,251306,2,2865,492,2866,228,0
20141226.232759,2866,4,251310,0,2865,453,2866,227,0
20141226.232802,2866,62,251372,60,2865,461,2866,196,0
20141226.232803,2866,2,251374,2,2865,461,2866,195,0
20141226.232803,2866,20,251394,20,2865,462,2866,185,0
20141226.232804,2866,2,251396,0,2865,462,2866,184,0
20141226.232804,2866,4,251400,2,2865,467,2866,182,0
20141226.232806,2866,4,251404,0,2865,467,2866,181,0
20141226.232807,2866,4,251408,0,2865,467,2866,182,0
20141226.232808,2866,2,251410,2,2865,467,2866,191,0
20141226.232808,2866,4,251414,2,2865,467,2866,189,0
20141226.23281,2866,2,251416,2,2865,466,2866,195,0
20141226.232812,2866,40,251456,0,2865,467,2866,176,0
20141226.232813,2866,2,251458,2,2865,464,2866,175,0
20141226.232814,2866,10,251468,10,2865,494,2866,170,0
20141226.232814,2866,18,251486,0,2865,494,2866,161,0
20141226.232815,2866,30,251516,30,2865,494,2866,146,0
20141226.232816,2866,2,251518,2,2865,493,2866,145,0
20141226.232816,2865,12,251530,8,2865,489,2866,147,0
20141226.232817,2866,6,251536,0,2865,481,2866,144,1
20141226.232818,2866,10,251546,2,2865,480,2866,141,1
20141226.232819,2865,2,251548,0,2865,491,2866,143,0
20141226.23282,2866,4,251552,4,2865,490,2866,141,1
20141226.23282,2866,2,251554,0,2865,490,2866,140,1
20141226.232824,2866,6,251560,0,2865,613,2866,212,1
20141226.232825,2865,2,251562,-2,2865,612,2866,211,0
20141226.232827,2866,6,251568,2,2865,604,2866,208,1
20141226.232827,2865,2,251570,0,2865,603,2866,216,0
20141226.232828,2866,2,251572,2,2865,603,2866,215,1
20141226.232829,2866,2,251574,0,2865,599,2866,214,1
20141226.232831,2866,8,251582,0,2865,565,2866,213,1
20141226.232832,2865,2,251584,2,2865,529,2866,213,0
20141226.232833,2865,10,251594,2,2865,525,2866,212,0
20141226.232834,2866,2,251596,2,2865,525,2866,225,1
20141226.232834,2866,4,251600,2,2865,524,2866,224,1
20141226.232835,2865,8,251608,0,2865,520,2866,224,0
20141226.232835,2866,10,251618,10,2865,521,2866,220,1
20141226.232838,2866,2,251620,2,2865,519,2866,221,1
20141226.23284,2866,2,251622,2,2865,525,2866,245,1
20141226.232841,2866,2,251624,2,2865,531,2866,244,1
20141226.232845,2866,2,251626,2,2865,537,2866,244,1
20141226.232852,2866,2,251628,2,2865,539,2866,252,1
20141226.232854,2865,6,251634,-2,2865,536,2866,242,0
20141226.232858,2865,6,251640,-6,2865,541,2866,272,0
20141226.232901,2866,2,251642,0,2865,541,2866,271,1
20141226.232905,2866,2,251644,0,2865,542,2866,270,1
20141226.232906,2865,2,251646,0,2865,540,2866,270,0
20141226.232909,2866,6,251652,0,2865,536,2866,267,1
20141226.232911,2866,2,251654,2,2865,536,2866,276,1
20141226.232912,2866,6,251660,6,2865,535,2866,285,1
20141226.232916,2866,2,251662,0,2865,542,2866,297,1
20141226.232917,2866,2,251664,2,2865,546,2866,296,1
20141226.232919,2866,2,251666,0,2865,566,2866,309,1
20141226.232921,2866,6,251672,0,2865,553,2866,306,1
20141226.232922,2866,4,251676,4,2865,552,2866,314,1
20141226.232922,2866,2,251678,2,2865,550,2866,313,1
20141226.232923,2865,6,251684,0,2865,547,2866,313,0
20141226.232924,2866,2,251686,0,2865,548,2866,312,1
20141226.232925,2866,2,251688,2,2865,548,2866,311,1
20141226.232927,2866,2,251690,0,2865,548,2866,310,1
20141226.232928,2865,2,251692,2,2865,547,2866,312,0
20141226.232929,2866,4,251696,0,2865,546,2866,310,1
20141226.23293,2866,12,251708,-2,2865,543,2866,306,1
20141226.23293,2866,2,251710,2,2865,543,2866,305,1
20141226.232931,2865,20,251730,-8,2865,533,2866,305,0
20141226.232931,2866,14,251744,14,2865,533,2866,298,1
20141226.232933,2866,2,251746,0,2865,533,2866,295,1
20141226.232934,2865,2,251748,0,2865,532,2866,294,0
20141226.232936,2866,8,251756,8,2865,532,2866,290,1
20141226.232937,2865,20,251776,-10,2865,522,2866,290,0
20141226.232938,2865,2,251778,0,2865,521,2866,290,0
20141226.23294,2866,2,251780,2,2865,521,2866,294,1
20141226.23294,2865,6,251786,0,2865,518,2866,294,0
20141226.232941,2866,2,251788,2,2865,518,2866,294,1
20141226.232942,2866,2,251790,2,2865,518,2866,283,1
20141226.232943,2865,6,251796,-2,2865,538,2866,283,0
20141226.232943,2865,4,251800,-4,2865,536,2866,283,0
20141226.232944,2865,2,251802,0,2865,536,2866,288,0
20141226.232944,2865,2,251804,-2,2865,535,2866,288,0
20141226.232945,2865,2,251806,0,2865,533,2866,322,0
20141226.232946,2865,102,251908,-64,2865,483,2866,321,0
20141226.232947,2865,2,251910,2,2865,511,2866,321,0
20141226.232947,2865,20,251930,0,2865,501,2866,321,0
20141226.23295,2865,2,251932,0,2865,496,2866,322,0
20141226.23295,2865,2,251934,0,2865,495,2866,322,0
20141226.232951,2866,4,251938,0,2865,495,2866,320,1
20141226.232952,2866,2,251940,2,2865,496,2866,319,1
20141226.232954,2866,4,251944,0,2865,509,2866,316,1
20141226.232955,2865,40,251984,-14,2865,490,2866,317,0
20141226.232955,2866,8,251992,0,2865,491,2866,313,1
20141226.232956,2865,2,251994,-2,2865,494,2866,313,0
20141226.232956,2866,4,251998,0,2865,506,2866,341,1
20141226.232957,2866,22,252020,-18,2865,496,2866,339,1
20141226.232959,2865,2,252022,-2,2865,494,2866,341,0
20141226.233,2866,6,252028,6,2865,497,2866,350,1
20141226.233,2866,8,252036,6,2865,497,2866,346,1
20141226.233001,2866,6,252042,0,2865,497,2866,346,1
20141226.233002,2866,2,252044,2,2865,508,2866,348,1
20141226.233003,2865,12,252056,0,2865,505,2866,348,0
20141226.233006,2866,2,252058,2,2865,507,2866,317,1
20141226.233007,2866,10,252068,0,2865,507,2866,309,1
20141226.233009,2866,2,252070,2,2865,509,2866,308,1
20141226.23301,2866,12,252082,10,2865,509,2866,302,1
20141226.23301,2865,4,252086,0,2865,508,2866,301,0
20141226.233012,2865,4,252090,0,2865,507,2866,298,0
20141226.233013,2866,2,252092,2,2865,507,2866,297,1
20141226.233016,2866,2,252094,2,2865,508,2866,294,1
20141226.233016,2866,2,252096,0,2865,508,2866,291,1
20141226.233019,2865,4,252100,-4,2865,516,2866,291,0
20141226.233022,2866,12,252112,10,2865,517,2866,285,1
20141226.233023,2865,2,252114,0,2865,517,2866,287,0
20141226.233024,2866,64,252178,-60,2865,517,2866,255,1
20141226.233028,2866,8,252186,0,2865,520,2866,226,1
20141226.233031,2866,4,252190,0,2865,498,2866,225,1
20141226.233032,2866,2,252192,2,2865,516,2866,226,1
20141226.233033,2866,2,252194,0,2865,515,2866,225,1
20141226.233037,2865,2,252196,0,2865,516,2866,224,0
20141226.233038,2865,2,252198,0,2865,515,2866,233,0
20141226.233038,2865,40,252238,-28,2865,500,2866,233,0
20141226.233042,2866,10,252248,0,2865,507,2866,227,1
20141226.233043,2865,2,252250,2,2865,510,2866,227,0
20141226.233043,2866,50,252300,0,2865,510,2866,205,1
20141226.233046,2865,22,252322,-18,2865,501,2866,205,0
20141226.233047,2866,6,252328,2,2865,501,2866,202,1
20141226.233047,2866,6,252334,6,2865,503,2866,199,1
20141226.233048,2866,8,252342,8,2865,501,2866,195,1
20141226.233048,2866,4,252346,4,2865,501,2866,193,1
20141226.233049,2866,2,252348,0,2865,503,2866,192,1
20141226.23305,2866,4,252352,0,2865,504,2866,190,1
20141226.23305,2866,400,252752,198,2866,27,2867,376,1
20141226.233052,2866,12,252764,0,2866,21,2867,399,1
20141226.233053,2866,2,252766,0,2866,27,2867,399,1
20141226.233054,2867,24,252790,0,2866,31,2867,387,1
20141226.233055,2867,6,252796,-6,2866,31,2867,386,1
20141226.233055,2867,2,252798,-2,2866,32,2867,385,1
20141226.233058,2867,30,252828,0,2866,47,2867,314,1
20141226.233101,2867,20,252848,0,2866,107,2867,294,1
20141226.233102,2867,8,252856,0,2866,145,2867,300,1
20141226.233104,2867,2,252858,0,2866,158,2867,299,1
20141226.233104,2867,2,252860,0,2866,160,2867,298,1
20141226.233105,2867,2,252862,0,2866,165,2867,297,1
20141226.233106,2867,8,252870,0,2866,164,2867,294,1
20141226.233107,2867,4,252874,-4,2866,164,2867,292,1
20141226.233108,2867,38,252912,0,2866,164,2867,273,1
20141226.233108,2867,2,252914,-2,2866,164,2867,272,1
20141226.233109,2867,6,252920,-6,2866,164,2867,269,1
20141226.23311,2867,106,253026,0,2866,168,2867,216,1
20141226.233112,2867,2,253028,0,2866,173,2867,215,1
20141226.233113,2867,2,253030,0,2866,175,2867,214,1
20141226.233115,2867,2,253032,0,2866,175,2867,214,1
20141226.233115,2867,2,253034,-2,2866,175,2867,214,1
20141226.233115,2867,16,253050,0,2866,175,2867,206,1
20141226.233116,2867,2,253052,0,2866,175,2867,207,1
20141226.233117,2866,2,253054,2,2866,177,2867,206,0
20141226.233121,2867,2,253056,0,2866,195,2867,205,1
20141226.233123,2867,8,253064,0,2866,198,2867,211,1
20141226.233125,2866,12,253076,0,2866,191,2867,211,0
20141226.23313,2867,8,253084,0,2866,214,2867,209,1
20141226.233135,2867,2,253086,0,2866,221,2867,241,1
20141226.233135,2867,8,253094,0,2866,222,2867,237,1
20141226.233137,2867,2,253096,0,2866,219,2867,242,1
20141226.233137,2867,2,253098,0,2866,219,2867,241,1
20141226.233138,2867,40,253138,6,2866,220,2867,221,1
20141226.233139,2867,2,253140,2,2866,221,2867,220,1
20141226.233139,2866,8,253148,4,2866,221,2867,216,0
20141226.233141,2867,6,253154,6,2866,231,2867,212,1
20141226.233142,2866,32,253186,30,2866,215,2867,212,0
20141226.233143,2867,4,253190,4,2866,220,2867,210,1
20141226.233146,2867,2,253192,0,2866,220,2867,209,1
20141226.233147,2867,2,253194,2,2866,233,2867,208,1
20141226.23315,2867,2,253196,2,2866,229,2867,208,1
20141226.233153,2867,8,253204,6,2866,230,2867,204,1
20141226.233154,2866,46,253250,24,2866,207,2867,204,0
20141226.233156,2867,4,253254,0,2866,204,2867,202,1
20141226.233157,2866,2,253256,0,2866,206,2867,202,0
20141226.233159,2867,6,253262,-2,2866,208,2867,199,1
20141226.233202,2867,2,253264,2,2866,473,2867,197,1
20141226.233203,2867,10,253274,10,2866,483,2867,194,1
20141226.233205,2867,240,253514,-32,2866,503,2867,74,1
20141226.233205,2867,6,253520,4,2866,504,2867,71,1
20141226.233206,2867,72,253592,22,2866,490,2867,236,1
20141226.233207,2867,8,253600,-6,2866,494,2867,232,1
20141226.233207,2867,2,253602,0,2866,494,2867,231,1
20141226.233208,2867,16,253618,0,2866,505,2867,224,1
20141226.233209,2867,2,253620,0,2866,505,2867,223,1
20141226.233209,2867,2,253622,-2,2866,505,2867,222,1
20141226.23321,2867,6,253628,-4,2866,505,2867,219,1
20141226.233211,2867,2,253630,-2,2866,505,2867,219,1
20141226.233212,2867,14,253644,0,2866,505,2867,212,1
20141226.233213,2867,4,253648,4,2866,505,2867,211,1
20141226.233216,2867,2,253650,0,2866,504,2867,210,1
20141226.233217,2867,2,253652,2,2866,504,2867,213,1
20141226.233219,2867,6,253658,-2,2866,508,2867,210,1
20141226.233221,2867,20,253678,4,2866,503,2867,200,1
20141226.233223,2867,2,253680,-2,2866,504,2867,200,1
20141226.233223,2867,4,253684,-2,2866,507,2867,198,1
20141226.233226,2867,10,253694,-10,2866,515,2867,193,1
20141226.233229,2867,38,253732,0,2866,515,2867,175,1
20141226.233233,2866,10,253742,0,2866,516,2867,177,0
20141226.233233,2866,138,253880,2,2866,515,2867,109,0
20141226.233234,2866,62,253942,-50,2866,524,2867,84,0
20141226.233234,2867,168,254110,18,2867,166,2868,393,1
20141226.233235,2868,2,254112,0,2867,191,2868,382,1
20141226.233235,2868,2,254114,0,2867,194,2868,381,1
20141226.233236,2868,2,254116,0,2867,194,2868,380,1
20141226.233237,2867,2,254118,2,2867,203,2868,379,0
20141226.23324,2868,16,254134,0,2867,213,2868,588,1
20141226.233241,2867,4,254138,2,2867,212,2868,589,0
20141226.233245,2867,2,254140,0,2867,210,2868,588,0
20141226.233245,2868,12,254152,0,2867,211,2868,582,1
20141226.233248,2867,2,254154,2,2867,212,2868,584,0
20141226.233249,2868,2,254156,2,2867,213,2868,582,1
20141226.233249,2868,2,254158,2,2867,213,2868,581,1
20141226.23325,2868,2,254160,2,2867,213,2868,580,1
20141226.233251,2868,22,254182,22,2867,214,2868,593,1
20141226.233252,2868,4,254186,0,2867,217,2868,589,1
20141226.233253,2868,210,254396,200,2867,217,2868,484,1
20141226.233255,2867,4,254400,4,2867,225,2868,482,0
20141226.233256,2868,12,254412,0,2867,235,2868,477,1
20141226.233257,2868,2,254414,2,2867,235,2868,476,1
20141226.233257,2868,6,254420,6,2867,235,2868,473,1
20141226.233258,2868,4,254424,0,2867,235,2868,471,1
20141226.233259,2867,2,254426,2,2867,237,2868,476,0
20141226.233301,2868,2,254428,0,2867,274,2868,475,1
20141226.233302,2868,4,254432,2,2867,279,2868,473,1
20141226.233304,2868,2,254434,2,2867,280,2868,453,1
20141226.233309,2868,20,254454,20,2867,286,2868,422,1
20141226.23331,2868,6,254460,6,2867,287,2868,409,1
20141226.233312,2868,12,254472,12,2867,281,2868,412,1
20141226.233314,2868,2,254474,2,2867,284,2868,428,1
20141226.233315,2867,2,254476,2,2867,283,2868,430,0
20141226.233316,2868,2,254478,2,2867,283,2868,429,1
20141226.233316,2868,4,254482,4,2867,283,2868,427,1
20141226.233317,2868,4,254486,4,2867,531,2868,425,1
20141226.233319,2868,20,254506,20,2867,531,2868,415,1
20141226.23332,2868,20,254526,0,2867,531,2868,400,1
20141226.233321,2868,2,254528,2,2867,533,2868,399,1
20141226.233323,2868,16,254544,4,2867,534,2868,411,1
20141226.233323,2868,2,254546,2,2867,536,2868,410,1
20141226.233324,2868,6,254552,6,2867,536,2868,407,1
20141226.233324,2868,2,254554,2,2867,536,2868,406,1
20141226.233326,2868,4,254558,4,2867,550,2868,404,1
20141226.233327,2868,2,254560,2,2867,550,2868,406,1
20141226.233328,2868,2,254562,2,2867,555,2868,405,1
20141226.233329,2868,2,254564,2,2867,555,2868,404,1
20141226.233331,2868,2,254566,2,2867,555,2868,407,1
20141226.233333,2868,4,254570,2,2867,557,2868,404,1
20141226.233335,2868,24,254594,20,2867,604,2868,383,1
20141226.233337,2868,6,254600,6,2867,605,2868,391,1
20141226.233339,2868,2,254602,0,2867,605,2868,389,1
20141226.233339,2868,2,254604,2,2867,606,2868,388,1
20141226.233341,2868,8,254612,8,2867,603,2868,383,1
20141226.233344,2868,6,254618,4,2867,604,2868,391,1
20141226.233345,2868,2,254620,2,2867,604,2868,390,1
20141226.233347,2867,100,254720,0,2867,555,2868,390,0
20141226.233347,2868,2,254722,2,2867,555,2868,389,1
20141226.233349,2868,2,254724,0,2867,560,2868,388,1
20141226.233354,2867,4,254728,0,2867,558,2868,390,0
20141226.233354,2868,8,254736,8,2867,558,2868,386,1
20141226.233357,2867,4,254740,4,2867,591,2868,386,0
20141226.233359,2868,2,254742,2,2867,598,2868,421,1
20141226.233403,2867,2,254744,0,2867,608,2868,426,0
20141226.233404,2867,4,254748,0,2867,606,2868,427,0
20141226.233407,2868,4,254752,4,2867,607,2868,444,1
20141226.233408,2868,4,254756,4,2867,607,2868,445,1
20141226.233415,2868,2,254758,2,2867,607,2868,461,1
20141226.233416,2868,4,254762,4,2867,607,2868,459,1
20141226.233416,2868,10,254772,8,2867,607,2868,455,1
20141226.23342,2868,48,254820,-36,2867,605,2868,431,1
20141226.233422,2868,4,254824,0,2867,606,2868,458,1
20141226.233427,2868,20,254844,-18,2867,606,2868,444,1
20141226.233428,2868,30,254874,14,2867,606,2868,429,1
20141226.23343,2868,2,254876,2,2867,606,2868,428,1
20141226.233432,2868,4,254880,4,2867,616,2868,426,1
20141226.233435,2868,4,254884,4,2867,591,2868,425,1
20141226.233435,2868,2,254886,0,2867,591,2868,424,1
20141226.233438,2868,2,254888,2,2867,606,2868,423,1
20141226.233443,2868,20,254908,0,2867,608,2868,409,1
20141226.233445,2867,4,254912,0,2867,607,2868,409,0
20141226.233446,2867,56,254968,56,2867,580,2868,409,0
20141226.233453,2867,4,254972,0,2867,580,2868,433,0
20141226.233454,2868,8,254980,8,2867,579,2868,419,1
20141226.233454,2867,2,254982,0,2867,578,2868,419,0
20141226.233456,2867,2,254984,0,2867,552,2868,427,0
20141226.233501,2868,12,254996,12,2867,566,2868,442,1
20141226.233504,2868,4,255000,4,2867,565,2868,436,1
20141226.23351,2868,40,255040,40,2867,572,2868,397,1
20141226.233511,2868,20,255060,20,2867,575,2868,386,1
20141226.233514,2867,4,255064,0,2867,573,2868,387,0
20141226.233515,2867,10,255074,0,2867,568,2868,382,0
20141226.233517,2868,2,255076,2,2867,568,2868,382,1
20141226.233517,2868,2,255078,2,2867,558,2868,381,1
20141226.233527,2867,2,255080,0,2867,620,2868,381,0
20141226.23353,2868,4,255084,4,2867,620,2868,375,1
20141226.233532,2868,6,255090,6,2867,622,2868,372,1
20141226.233534,2868,8,255098,8,2867,622,2868,369,1
20141226.23354,2868,4,255102,2,2867,617,2868,346,1
20141226.233541,2868,4,255106,4,2867,623,2868,344,1
20141226.233542,2867,2,255108,0,2867,621,2868,344,0
20141226.233544,2867,2,255110,0,2867,620,2868,344,0
20141226.233551,2868,4,255114,4,2867,622,2868,344,1
20141226.233552,2868,20,255134,20,2867,622,2868,334,1
20141226.233557,2868,4,255138,4,2867,627,2868,331,1
20141226.233559,2868,12,255150,12,2867,627,2868,313,1
20141226.233559,2868,2,255152,2,2867,637,2868,309,1
20141226.2336,2868,400,255552,318,2867,636,2868,109,1
20141226.233601,2868,2,255554,0,2867,636,2868,109,1
20141226.233602,2868,2,255556,-2,2867,636,2868,127,1
20141226.233603,2868,14,255570,-8,2867,635,2868,122,1
20141226.233603,2868,2,255572,-2,2867,635,2868,121,1
20141226.233604,2868,14,255586,0,2867,636,2868,114,1
20141226.233605,2868,20,255606,8,2867,635,2868,124,1
20141226.233607,2867,30,255636,30,2867,625,2868,122,0
20141226.233608,2868,2,255638,0,2867,628,2868,121,1
20141226.233609,2868,2,255640,2,2867,664,2868,121,1
20141226.233609,2868,20,255660,20,2867,667,2868,111,1
20141226.233612,2868,2,255662,2,2867,671,2868,110,1
20141226.233613,2868,2,255664,2,2867,670,2868,109,1
20141226.233614,2868,2,255666,2,2867,670,2868,109,1
20141226.233618,2868,2,255668,2,2867,776,2868,106,1
20141226.233618,2868,2,255670,2,2867,776,2868,110,1
20141226.233622,2869,400,256070,222,2867,746,2869,882,1
20141226.233623,2869,10,256080,0,2867,760,2869,862,1
20141226.233628,2868,4,256084,0,2868,75,2869,861,0
20141226.233629,2869,2,256086,0,2868,75,2869,860,1
20141226.23363,2868,14,256100,-14,2868,100,2869,861,0
20141226.23363,2869,4,256104,0,2868,100,2869,859,1
20141226.233631,2869,2,256106,0,2868,105,2869,858,1
20141226.233631,2868,60,256166,0,2868,75,2869,858,0
20141226.233633,2868,2,256168,0,2868,74,2869,858,0
20141226.233634,2868,4,256172,0,2868,73,2869,859,0
20141226.23364,2869,4,256176,0,2868,91,2869,863,1
20141226.233641,2869,62,256238,-60,2868,90,2869,843,1
20141226.233641,2869,2,256240,-2,2868,90,2869,842,1
20141226.233642,2868,20,256260,-20,2868,89,2869,842,0
20141226.233645,2868,10,256270,0,2868,89,2869,846,0
20141226.233646,2868,2,256272,0,2868,92,2869,848,0
20141226.233647,2868,56,256328,20,2868,69,2869,845,0
20141226.233648,2869,10,256338,0,2868,109,2869,840,1
20141226.233652,2869,2,256340,0,2868,110,2869,841,1
20141226.233654,2868,30,256370,30,2868,95,2869,841,0
20141226.233654,2868,2,256372,2,2868,96,2869,841,0
20141226.233655,2868,2,256374,2,2868,147,2869,837,0
20141226.233656,2868,12,256386,2,2868,141,2869,837,0
20141226.233656,2869,2,256388,-2,2868,141,2869,836,1
20141226.233701,2868,60,256448,46,2868,88,2869,835,0
20141226.233703,2869,2,256450,0,2868,88,2869,836,1
20141226.233704,2868,2,256452,2,2868,119,2869,842,0
20141226.233705,2869,6,256458,-2,2868,120,2869,839,1
20141226.233706,2869,2,256460,0,2868,120,2869,838,1
20141226.233711,2869,2,256462,0,2868,124,2869,836,1
20141226.233711,2869,2,256464,-2,2868,126,2869,836,1
20141226.233712,2869,2,256466,0,2868,127,2869,835,1
20141226.233712,2869,10,256476,0,2868,128,2869,830,1
20141226.233714,2869,2,256478,-2,2868,195,2869,829,1
20141226.233716,2869,4,256482,0,2868,207,2869,830,1
20141226.233717,2869,4,256486,-4,2868,207,2869,829,1
20141226.233719,2868,12,256498,0,2868,204,2869,827,0
20141226.233723,2869,2,256500,0,2868,213,2869,826,1
20141226.233725,2868,4,256504,4,2868,211,2869,823,0
20141226.233726,2869,10,256514,0,2868,216,2869,818,1
20141226.23373,2868,2,256516,0,2868,247,2869,819,0
20141226.233741,2868,2,256518,2,2868,258,2869,848,0
20141226.233744,2868,2,256520,2,2868,258,2869,847,0
20141226.233744,2868,4,256524,4,2868,256,2869,851,0
20141226.233747,2868,2,256526,2,2868,256,2869,852,0
20141226.233749,2868,2,256528,2,2868,256,2869,864,0
20141226.23375,2868,2,256530,2,2868,255,2869,864,0
20141226.233758,2868,12,256542,12,2868,254,2869,866,0
20141226.233758,2868,2,256544,2,2868,253,2869,866,0
20141226.233759,2868,80,256624,10,2868,213,2869,867,0
20141226.2338,2869,2,256626,0,2868,213,2869,866,1
20141226.233802,2869,2,256628,0,2868,213,2869,845,1
20141226.233804,2868,4,256632,-2,2868,212,2869,845,0
20141226.233805,2869,2,256634,0,2868,212,2869,851,1
20141226.233807,2868,2,256636,-2,2868,211,2869,852,0
20141226.233809,2869,2,256638,0,2868,212,2869,849,1
20141226.233809,2868,2,256640,0,2868,211,2869,849,0
20141226.23381,2868,2,256642,0,2868,210,2869,849,0
20141226.233815,2868,76,256718,54,2868,174,2869,304,0
20141226.23382,2868,2,256720,0,2868,175,2869,304,0
20141226.233821,2868,2,256722,2,2868,194,2869,304,0
20141226.233824,2868,2,256724,2,2868,192,2869,305,0
20141226.233824,2868,14,256738,0,2868,185,2869,305,0
20141226.233825,2868,2,256740,0,2868,184,2869,305,0
20141226.233826,2868,2,256742,0,2868,183,2869,306,0
20141226.233832,2869,2,256744,0,2868,181,2869,367,1
20141226.233833,2868,2,256746,2,2868,180,2869,367,0
20141226.233835,2868,2,256748,2,2868,179,2869,367,0
20141226.23384,2869,2,256750,0,2868,180,2869,371,1
20141226.233853,2869,2,256752,-2,2868,205,2869,367,1
20141226.233857,2869,2,256754,-2,2868,209,2869,367,1
20141226.233901,2869,2,256756,0,2868,209,2869,372,1
20141226.233912,2869,4,256760,0,2868,210,2869,352,1
20141226.233913,2869,2,256762,0,2868,210,2869,351,1
20141226.233914,2869,40,256802,-40,2868,210,2869,333,1
20141226.233915,2868,2,256804,-2,2868,209,2869,333,0
20141226.23392,2869,4,256808,0,2868,229,2869,331,1
20141226.233925,2869,6,256814,0,2868,251,2869,331,1
20141226.233927,2869,2,256816,-2,2868,251,2869,328,1
20141226.233928,2868,2,256818,-2,2868,250,2869,328,0
20141226.23393,2868,6,256824,6,2868,247,2869,328,0
20141226.23393,2868,4,256828,2,2868,245,2869,328,0
20141226.233931,2868,2,256830,2,2868,405,2869,328,0
20141226.233933,2869,2,256832,0,2868,455,2869,327,1
20141226.233937,2868,8,256840,0,2868,449,2869,326,0
20141226.233941,2868,2,256842,0,2868,447,2869,325,0
20141226.233942,2868,100,256942,100,2868,397,2869,325,0
20141226.233943,2869,12,256954,10,2868,391,2869,325,1
20141226.233944,2869,4,256958,-4,2868,391,2869,323,1
20141226.233948,2869,2,256960,-2,2868,391,2869,317,1
20141226.233952,2869,2,256962,0,2868,393,2869,317,1
20141226.233957,2868,2,256964,2,2868,393,2869,319,0
20141226.233958,2868,2,256966,0,2868,392,2869,319,0
20141226.234001,2868,2,256968,2,2868,401,2869,327,0
20141226.234003,2868,54,257022,50,2868,375,2869,327,0
20141226.234008,2868,2,257024,0,2868,374,2869,326,0
20141226.234011,2868,12,257036,12,2868,372,2869,325,0
20141226.234014,2869,2,257038,0,2868,372,2869,324,1
20141226.234016,2868,4,257042,4,2868,369,2869,326,0
20141226.234019,2869,4,257046,0,2868,369,2869,326,1
20141226.234029,2868,2,257048,0,2868,377,2869,375,0
20141226.234031,2868,2,257050,2,2868,376,2869,377,0
20141226.234032,2869,2,257052,0,2868,381,2869,375,1
20141226.234034,2869,200,257252,20,2868,381,2869,275,1
20141226.234035,2869,2,257254,0,2868,384,2869,274,1
20141226.234038,2868,2,257256,2,2868,384,2869,274,0
20141226.234039,2869,2,257258,2,2868,384,2869,273,1
20141226.234041,2869,10,257268,10,2868,385,2869,266,1
20141226.234043,2869,2,257270,2,2868,387,2869,264,1
20141226.234044,2869,2,257272,0,2868,387,2869,263,1
20141226.234046,2869,6,257278,6,2868,396,2869,259,1
20141226.234047,2869,2,257280,2,2868,397,2869,258,1
20141226.23405,2869,2,257282,0,2868,438,2869,255,1
20141226.234051,2869,2,257284,2,2868,433,2869,254,1
20141226.234051,2869,2,257286,2,2868,433,2869,253,1
20141226.234053,2869,6,257292,2,2868,431,2869,251,1
20141226.234055,2869,16,257308,16,2868,424,2869,244,1
20141226.234056,2868,2,257310,2,2868,423,2869,244,0
20141226.234109,2869,10,257320,0,2868,610,2869,244,1
20141226.234111,2869,20,257340,20,2868,624,2869,235,1
20141226.234112,2869,2,257342,2,2868,624,2869,234,1
20141226.234114,2869,2,257344,2,2868,644,2869,236,1
20141226.234115,2869,24,257368,-4,2868,643,2869,225,1
20141226.234115,2869,64,257432,42,2868,641,2869,193,1
20141226.234116,2869,8,257440,0,2868,642,2869,189,1
20141226.234116,2869,4,257444,0,2868,642,2869,187,1
20141226.234117,2869,2,257446,0,2868,642,2869,186,1
20141226.234118,2869,12,257458,8,2868,642,2869,185,1
20141226.234119,2869,26,257484,26,2868,642,2869,176,1
20141226.23412,2869,2,257486,0,2868,642,2869,175,1
20141226.23412,2868,6,257492,2,2868,642,2869,173,0
20141226.234121,2869,2,257494,0,2868,642,2869,172,1
20141226.234121,2869,8,257502,0,2868,642,2869,168,1
20141226.234124,2869,30,257532,-24,2868,642,2869,154,1
20141226.234124,2869,4,257536,4,2868,642,2869,152,1
20141226.234125,2868,4,257540,0,2868,682,2869,167,0
20141226.234125,2869,2,257542,2,2868,682,2869,166,1
20141226.234126,2869,6,257548,6,2868,683,2869,173,1
20141226.234126,2869,2,257550,2,2868,684,2869,172,1
20141226.234127,2869,6,257556,6,2868,687,2869,274,1
20141226.234129,2869,6,257562,2,2868,692,2869,273,1
20141226.234129,2869,4,257566,4,2868,692,2869,281,1
20141226.234131,2869,20,257586,20,2868,694,2869,272,1
20141226.234131,2869,2,257588,2,2868,694,2869,271,1
20141226.234133,2869,2,257590,0,2868,694,2869,270,1
20141226.234135,2869,2,257592,2,2868,704,2869,270,1
20141226.234137,2869,2,257594,0,2868,706,2869,269,1
20141226.234138,2869,10,257604,10,2868,706,2869,264,1
20141226.234139,2869,2,257606,2,2868,706,2869,263,1
20141226.23414,2869,2,257608,2,2868,706,2869,262,1
20141226.234143,2869,6,257614,6,2868,716,2869,258,1
20141226.234148,2868,2,257616,2,2868,701,2869,253,0
20141226.234149,2868,4,257620,4,2868,699,2869,253,0
20141226.234151,2869,2,257622,2,2868,701,2869,252,1
20141226.234154,2868,8,257630,0,2868,717,2869,252,0
20141226.234156,2869,2,257632,2,2868,717,2869,251,1
20141226.234206,2869,2,257634,0,2868,747,2869,252,1
20141226.234206,2868,8,257642,4,2868,746,2869,249,0
20141226.234207,2868,2,257644,2,2868,745,2869,249,0
20141226.234209,2869,2,257646,0,2868,745,2869,249,1
20141226.234211,2869,2,257648,2,2868,746,2869,248,1
20141226.234215,2869,2,257650,2,2868,765,2869,247,1
20141226.234218,2869,12,257662,12,2868,765,2869,241,1
20141226.234221,2869,10,257672,10,2868,764,2869,307,1
20141226.234224,2869,2,257674,2,2868,764,2869,306,1
20141226.234231,2868,2,257676,0,2868,773,2869,307,0
20141226.234236,2869,2,257678,0,2868,774,2869,307,1
20141226.234237,2869,2,257680,0,2868,774,2869,307,1
20141226.234238,2868,10,257690,0,2868,759,2869,308,0
20141226.234241,2869,2,257692,0,2868,759,2869,308,1
20141226.234241,2868,2,257694,2,2868,754,2869,308,0
20141226.234245,2869,4,257698,0,2868,755,2869,308,1
20141226.234246,2869,2,257700,2,2868,755,2869,307,1
20141226.234253,2869,10,257710,10,2868,717,2869,311,1
20141226.234253,2868,20,257730,16,2868,707,2869,311,0
20141226.234254,2869,12,257742,12,2868,707,2869,305,1
20141226.234258,2868,22,257764,-6,2868,698,2869,306,0
20141226.234258,2869,2,257766,2,2868,698,2869,312,1
20141226.234301,2869,44,257810,-42,2868,699,2869,290,1
20141226.234302,2868,24,257834,0,2868,685,2869,290,0
20141226.234303,2869,2,257836,0,2868,695,2869,289,1
20141226.234308,2869,2,257838,-2,2868,693,2869,290,1
20141226.234313,2869,2,257840,-2,2868,708,2869,290,1
20141226.234314,2869,2,257842,0,2868,708,2869,289,1
20141226.234324,2869,8,257850,0,2868,707,2869,291,1
20141226.234325,2869,2,257852,-2,2868,714,2869,290,1
20141226.234326,2869,2,257854,0,2868,714,2869,289,1
20141226.234328,2869,2,257856,-2,2868,713,2869,288,1
20141226.234328,2869,2,257858,0,2868,713,2869,287,1
20141226.234329,2868,10,257868,-10,2868,708,2869,287,0
20141226.234335,2869,16,257884,-16,2868,714,2869,281,1
20141226.234338,2869,8,257892,-6,2868,714,2869,317,1
20141226.234344,2868,2,257894,-2,2868,700,2869,320,0
20141226.234347,2869,2,257896,-2,2868,701,2869,320,1
20141226.234353,2869,200,258096,14,2868,701,2869,221,1
20141226.2344,2868,2,258098,-2,2868,715,2869,231,0
20141226.234401,2868,2,258100,2,2868,714,2869,231,0
20141226.234408,2869,4,258104,0,2868,714,2869,257,1
20141226.234409,2869,2,258106,-2,2868,719,2869,256,1
20141226.23441,2869,6,258112,-2,2868,717,2869,255,1
20141226.234411,2869,2,258114,-2,2868,716,2869,254,1
20141226.234412,2868,20,258134,0,2868,806,2869,254,0
20141226.234413,2869,4,258138,0,2868,806,2869,252,1
20141226.234414,2869,2,258140,0,2868,805,2869,251,1
20141226.234416,2869,10,258150,0,2868,805,2869,246,1
20141226.234417,2869,2,258152,0,2868,806,2869,245,1
20141226.234418,2869,2,258154,0,2868,806,2869,252,1
20141226.234421,2869,4,258158,0,2868,806,2869,250,1
20141226.234421,2869,2,258160,-2,2868,806,2869,249,1
20141226.234423,2868,2,258162,2,2868,805,2869,250,0
20141226.234423,2869,4,258166,0,2868,805,2869,248,1
20141226.234424,2869,20,258186,0,2868,805,2869,238,1
20141226.234428,2868,8,258194,-2,2868,801,2869,239,0
20141226.234429,2869,2,258196,0,2868,802,2869,238,1
20141226.23443,2869,2,258198,0,2868,802,2869,237,1
20141226.234431,2869,4,258202,-4,2868,802,2869,235,1
20141226.234432,2869,2,258204,-2,2868,803,2869,234,1
20141226.234433,2869,2,258206,0,2868,803,2869,233,1
20141226.234434,2869,2,258208,-2,2868,803,2869,231,1
20141226.234436,2869,2,258210,-2,2868,802,2869,230,1
20141226.234447,2868,2,258212,0,2868,801,2869,243,0
20141226.234454,2868,4,258216,0,2868,801,2869,251,0
20141226.234455,2869,232,258448,-72,2868,805,2869,135,1
20141226.234456,2869,2,258450,2,2868,804,2869,128,1
20141226.234457,2869,8,258458,0,2868,804,2869,124,1
20141226.234459,2869,2,258460,2,2868,833,2869,123,1
20141226.234501,2869,22,258482,-6,2868,833,2869,132,1
20141226.234502,2868,4,258486,0,2868,833,2869,132,0
20141226.234502,2868,20,258506,-20,2868,823,2869,132,0
20141226.234503,2868,2,258508,0,2868,829,2869,132,0
20141226.234504,2869,2,258510,0,2868,829,2869,131,1
20141226.234505,2869,284,258794,-156,2869,8,2870,426,1
20141226.234505,2869,16,258810,0,2868,809,2869,14,1
20141226.234506,2869,2,258812,2,2868,809,2869,13,1
20141226.234507,2869,2,258814,0,2868,810,2869,13,1
20141226.234508,2869,2,258816,2,2868,810,2869,42,1
20141226.234509,2869,4,258820,2,2868,810,2869,40,1
20141226.23451,2869,4,258824,0,2868,810,2869,38,1
20141226.234512,2869,8,258832,-6,2868,807,2869,42,1
20141226.234512,2869,2,258834,0,2868,807,2869,43,1
20141226.234513,2869,86,258920,60,2869,37,2870,426,1
20141226.234513,2869,94,259014,0,2868,805,2869,489,1
20141226.234514,2868,2,259016,0,2868,804,2869,739,0
20141226.234515,2869,2,259018,0,2868,806,2869,738,1
20141226.234517,2869,14,259032,0,2868,804,2869,743,1
20141226.234517,2869,2,259034,-2,2868,804,2869,742,1
20141226.234519,2869,6,259040,0,2868,804,2869,740,1
20141226.234519,2869,2,259042,0,2868,806,2869,739,1
20141226.234521,2869,20,259062,0,2868,806,2869,738,1
20141226.234521,2868,2,259064,0,2868,805,2869,738,0
20141226.23453,2869,20,259084,0,2868,691,2869,800,1
20141226.23453,2868,2,259086,-2,2868,690,2869,800,0
20141226.234539,2868,2,259088,-2,2868,691,2869,839,0
20141226.234552,2868,60,259148,56,2868,661,2869,826,0
20141226.234554,2868,2,259150,0,2868,660,2869,827,0
20141226.234556,2868,6,259156,6,2868,658,2869,837,0
20141226.234557,2868,2,259158,0,2868,657,2869,845,0
20141226.234601,2868,2,259160,0,2868,654,2869,845,0
20141226.234603,2868,2,259162,0,2868,653,2869,850,0
20141226.234604,2868,2,259164,2,2868,662,2869,850,0
20141226.234605,2868,2,259166,2,2868,661,2869,851,0
20141226.234606,2868,2,259168,0,2868,660,2869,848,0
20141226.234606,2868,2,259170,0,2868,659,2869,848,0
20141226.234616,2868,2,259172,0,2868,658,2869,871,0
20141226.234619,2868,2,259174,0,2868,656,2869,877,0
20141226.234619,2868,42,259216,2,2868,635,2869,880,0
20141226.23462,2868,2,259218,0,2868,634,2869,880,0
20141226.234622,2868,2,259220,0,2868,632,2869,876,0
20141226.234624,2868,14,259234,0,2868,625,2869,876,0
20141226.234624,2869,4,259238,0,2868,625,2869,874,1
20141226.234631,2868,2,259240,0,2868,627,2869,912,0
20141226.234631,2868,4,259244,4,2868,625,2869,911,0
20141226.234634,2868,8,259252,0,2868,621,2869,911,0
20141226.234638,2868,12,259264,0,2868,616,2869,924,0
20141226.234646,2868,2,259266,2,2868,615,2869,923,0
20141226.234649,2868,42,259308,0,2868,597,2869,923,0
20141226.23465,2868,34,259342,0,2868,580,2869,922,0
20141226.234651,2868,2,259344,0,2868,579,2869,922,0
20141226.234653,2868,2,259346,0,2868,528,2869,922,0
20141226.234654,2868,4,259350,0,2868,525,2869,922,0
20141226.234655,2868,4,259354,4,2868,523,2869,922,0
20141226.234656,2868,4,259358,2,2868,521,2869,922,0
20141226.234656,2868,2,259360,0,2868,520,2869,922,0
20141226.234657,2868,10,259370,10,2868,515,2869,922,0
20141226.234658,2868,8,259378,8,2868,507,2869,923,0
20141226.234659,2868,40,259418,40,2868,487,2869,923,0
20141226.2347,2868,46,259464,38,2868,465,2869,699,0
20141226.2347,2868,2,259466,0,2868,464,2869,690,0
20141226.234701,2868,22,259488,-2,2868,453,2869,689,0
20141226.234703,2868,8,259496,0,2868,450,2869,689,0
20141226.234703,2868,600,260096,518,2868,150,2869,689,0
20141226.234703,2868,300,260396,28,2867,394,2869,692,0
20141226.234704,2868,4,260400,0,2867,391,2868,12,0
20141226.234705,2868,12,260412,2,2867,386,2868,131,0
20141226.234705,2867,2,260414,0,2867,385,2868,132,0
20141226.234706,2867,2,260416,2,2867,384,2868,159,0
20141226.234707,2867,2,260418,0,2867,383,2868,161,0
20141226.23471,2868,2,260420,0,2867,376,2868,174,1
20141226.234714,2867,6,260426,6,2867,373,2868,182,0
20141226.234724,2867,62,260488,0,2867,306,2868,237,0
20141226.234728,2867,2,260490,2,2867,308,2868,241,0
20141226.234731,2867,10,260500,-4,2867,303,2868,243,0
20141226.234732,2868,4,260504,0,2867,286,2868,241,1
20141226.234732,2867,2,260506,0,2867,285,2868,321,0
20141226.234734,2867,2,260508,0,2867,284,2868,321,0
20141226.234735,2867,14,260522,12,2867,279,2868,320,0
20141226.234737,2867,40,260562,40,2867,259,2868,322,0
20141226.234738,2867,502,261064,-300,2866,324,2868,294,0
20141226.23474,2867,2,261066,2,2866,418,2868,296,0
20141226.234741,2867,2,261068,0,2866,324,2868,335,0
20141226.234743,2867,2,261070,0,2866,419,2867,1,0
20141226.234744,2867,2,261072,-2,2866,419,2868,323,0
20141226.234747,2867,2,261074,2,2866,419,2867,5,0
20141226.234748,2867,22,261096,-20,2866,419,2868,327,0
20141226.234748,2867,4,261100,0,2867,10,2868,327,0
20141226.234748,2867,2,261102,0,2867,9,2868,327,0
20141226.23475,2867,2,261104,2,2867,9,2868,329,0
20141226.23475,2867,18,261122,6,2866,419,2868,329,0
20141226.234751,2866,2,261124,2,2866,419,2867,14,0
20141226.234752,2866,2,261126,2,2866,418,2867,14,0
20141226.234752,2867,2,261128,0,2866,418,2867,25,1
20141226.234754,2867,4,261132,0,2866,419,2867,24,1
20141226.234755,2867,6,261138,2,2866,419,2867,22,1
20141226.234758,2866,48,261186,18,2866,420,2868,338,0
20141226.234801,2866,2,261188,0,2866,423,2868,339,0
20141226.234802,2867,2,261190,0,2866,422,2868,340,1
20141226.234802,2867,2,261192,0,2866,422,2867,3,1
20141226.234806,2866,2,261194,2,2866,425,2867,3,0
20141226.234807,2867,2,261196,-2,2866,424,2867,2,1
20141226.23481,2867,2,261198,-2,2866,423,2867,43,1
20141226.234815,2867,10,261208,-2,2866,423,2867,40,1
20141226.234816,2867,2,261210,0,2866,423,2867,42,1
20141226.234821,2867,22,261232,16,2866,414,2867,48,1
20141226.234824,2867,4,261236,2,2866,428,2867,52,1
20141226.234825,2867,104,261340,90,2866,428,2868,301,1
20141226.234825,2867,2,261342,-2,2866,428,2868,301,1
20141226.23483,2868,4,261346,4,2866,435,2868,306,1
20141226.234834,2867,2,261348,2,2866,448,2868,310,0
20141226.234836,2868,4,261352,4,2867,13,2868,307,1
20141226.234838,2868,2,261354,2,2867,13,2868,302,1
20141226.234841,2867,38,261392,30,2866,518,2868,301,0
20141226.234841,2867,2,261394,-2,2866,565,2868,301,0
20141226.234842,2867,2,261396,0,2866,518,2868,301,0
20141226.234843,2868,30,261426,30,2866,518,2868,286,1
20141226.234843,2868,2,261428,2,2866,518,2868,285,1
20141226.234844,2868,4,261432,4,2866,517,2868,284,1
20141226.234844,2868,14,261446,2,2866,517,2868,277,1
20141226.234845,2868,2,261448,2,2866,518,2868,276,1
20141226.234845,2868,6,261454,6,2867,103,2868,273,1
20141226.234846,2868,46,261500,46,2867,80,2868,250,1
20141226.234848,2867,2,261502,0,2867,88,2868,250,0
20141226.23485,2867,2,261504,2,2867,138,2868,251,0
20141226.234851,2867,2,261506,2,2867,137,2868,251,0
20141226.234854,2868,4,261510,0,2867,156,2868,252,1
20141226.234857,2867,2,261512,2,2867,156,2868,262,0
20141226.234858,2867,20,261532,20,2867,146,2868,260,0
20141226.2349,2868,2,261534,0,2867,147,2868,272,1
20141226.234908,2868,4,261538,4,2867,108,2868,277,1
20141226.23491,2867,12,261550,0,2867,102,2868,278,0
20141226.234911,2868,4,261554,4,2867,103,2868,276,1
20141226.234914,2867,2,261556,2,2867,102,2868,276,0
20141226.234915,2868,4,261560,4,2867,105,2868,274,1
20141226.234916,2867,18,261578,0,2867,96,2868,275,0
20141226.234917,2867,2,261580,2,2867,105,2868,276,0
20141226.234917,2867,8,261588,8,2867,103,2868,274,0
20141226.234919,2868,6,261594,2,2867,115,2868,272,1
20141226.234927,2867,2,261596,2,2867,136,2868,273,0
20141226.234928,2867,2,261598,2,2867,135,2868,277,0
20141226.234932,2868,40,261638,0,2867,135,2868,256,1
20141226.234932,2867,4,261642,4,2867,133,2868,256,0
20141226.234934,2867,2,261644,2,2867,132,2868,236,0
20141226.234941,2867,2,261646,2,2867,139,2868,291,0
20141226.234946,2867,2,261648,0,2867,139,2868,291,0
20141226.234948,2867,20,261668,20,2867,131,2868,291,0
20141226.235,2868,26,261694,20,2867,124,2868,280,1
20141226.235,2868,2,261696,0,2867,123,2868,280,1
20141226.235009,2867,2,261698,2,2867,127,2868,280,0
20141226.235017,2867,4,261702,2,2867,123,2868,301,0
20141226.235023,2868,2,261704,0,2867,181,2868,281,1
20141226.235024,2867,2,261706,0,2867,180,2868,280,0
20141226.235025,2868,2,261708,0,2867,180,2868,279,1
20141226.235035,2868,2,261710,2,2867,178,2868,266,1
20141226.235039,2868,2,261712,2,2867,176,2868,265,1
20141226.235044,2868,2,261714,2,2867,176,2868,268,1
20141226.235046,2868,4,261718,4,2867,176,2868,266,1
20141226.235048,2868,2,261720,2,2867,171,2868,267,1
20141226.23505,2868,2,261722,2,2867,171,2868,266,1
20141226.235052,2868,2,261724,2,2867,171,2868,266,1
20141226.235101,2867,20,261744,20,2867,163,2868,268,0
20141226.235107,2867,2,261746,0,2867,153,2868,271,0
20141226.235109,2867,6,261752,0,2867,150,2868,272,0
20141226.235112,2867,6,261758,0,2867,147,2868,272,0
20141226.235115,2867,20,261778,10,2867,121,2868,272,0
20141226.235127,2867,2,261780,-2,2867,122,2868,267,0
20141226.235132,2867,6,261786,0,2867,109,2868,267,0
20141226.235133,2867,6,261792,-6,2867,106,2868,267,0
20141226.235133,2867,2,261794,-2,2867,105,2868,267,0
20141226.235134,2867,2,261796,0,2867,104,2868,267,0
20141226.235134,2867,30,261826,12,2867,81,2868,267,0
20141226.235135,2867,30,261856,4,2867,66,2868,267,0
20141226.235135,2868,10,261866,0,2867,66,2868,262,1
20141226.235136,2867,2,261868,2,2867,66,2868,262,0
20141226.235138,2868,2,261870,0,2867,81,2868,261,1
20141226.23514,2868,2,261872,2,2867,86,2868,260,1
20141226.235141,2867,24,261896,0,2867,74,2868,260,0
20141226.235145,2868,6,261902,0,2867,91,2868,297,1
20141226.235145,2867,2,261904,-2,2867,90,2868,296,0
20141226.235146,2867,14,261918,0,2867,82,2868,296,0
20141226.235201,2867,2,261920,-2,2867,88,2868,299,0
20141226.235204,2868,2,261922,0,2867,87,2868,299,1
20141226.235209,2867,2,261924,0,2867,86,2868,298,0
20141226.235219,2867,2,261926,0,2867,85,2868,295,0
20141226.235219,2867,20,261946,-20,2867,75,2868,295,0
20141226.235228,2868,20,261966,8,2867,85,2868,286,1
20141226.235243,2867,10,261976,0,2867,115,2868,273,0
20141226.235252,2868,30,262006,0,2867,116,2868,258,1
20141226.235259,2867,2,262008,0,2867,106,2868,252,0
20141226.235307,2867,20,262028,0,2867,96,2868,232,0
20141226.235326,2867,2,262030,0,2867,181,2868,223,0
20141226.235346,2867,2,262032,-2,2867,153,2868,233,0
20141226.235347,2868,2,262034,2,2867,153,2868,232,1
20141226.235348,2868,6,262040,0,2867,157,2868,229,1
20141226.235359,2868,2,262042,2,2867,165,2868,226,1
20141226.235406,2868,2,262044,0,2867,163,2868,225,1
20141226.235407,2868,4,262048,0,2867,166,2868,223,1
20141226.235418,2867,2,262050,-2,2867,172,2868,222,0
20141226.235422,2868,6,262056,0,2867,178,2868,219,1
20141226.235426,2868,196,262252,-162,2867,182,2868,122,1
20141226.235428,2868,72,262324,24,2867,197,2868,86,1
20141226.235431,2868,4,262328,0,2867,236,2868,84,1
20141226.235431,2868,2,262330,0,2867,237,2868,83,1
20141226.235433,2868,166,262496,118,2867,239,2869,243,1
20141226.235438,2868,52,262548,-20,2867,249,2869,236,1
20141226.235443,2868,2,262550,0,2868,46,2869,235,1
20141226.235443,2868,2,262552,-2,2868,45,2869,235,1
20141226.235445,2868,2,262554,-2,2868,46,2869,221,1
20141226.235449,2868,2,262556,-2,2868,46,2869,219,1
20141226.23545,2868,2,262558,-2,2868,48,2869,219,1
20141226.235451,2868,10,262568,-10,2868,43,2869,219,1
20141226.235501,2868,4,262572,-4,2868,124,2869,222,1
20141226.235506,2868,2,262574,0,2868,127,2869,223,1
20141226.235507,2868,4,262578,0,2868,130,2869,223,1
20141226.23551,2868,2,262580,-2,2868,133,2869,243,1
20141226.235526,2868,2,262582,0,2868,134,2869,264,1
20141226.235528,2868,2,262584,0,2868,133,2869,264,1
20141226.235534,2869,2,262586,0,2868,133,2869,266,1
20141226.235535,2869,2,262588,2,2868,133,2869,266,1
20141226.235535,2869,4,262592,-4,2868,133,2869,269,1
20141226.235538,2868,6,262598,2,2868,130,2869,269,0
20141226.235541,2869,2,262600,0,2868,130,2869,268,1
20141226.235552,2869,2,262602,-2,2868,151,2869,278,1
20141226.235553,2869,2,262604,0,2868,151,2869,277,1
20141226.235553,2869,2,262606,0,2868,151,2869,276,1
20141226.235554,2869,2,262608,-2,2868,151,2869,275,1
20141226.235556,2869,2,262610,-2,2868,151,2869,274,1
20141226.235558,2869,2,262612,0,2868,151,2869,273,1
20141226.235559,2869,2,262614,-2,2868,151,2869,272,1
20141226.235559,2869,2,262616,-2,2868,151,2869,271,1
20141226.235601,2868,30,262646,30,2868,137,2869,271,0
20141226.235605,2869,2,262648,0,2868,141,2869,270,1
20141226.235607,2868,2,262650,2,2868,145,2869,271,0
20141226.235608,2869,6,262656,0,2868,145,2869,268,1
20141226.23561,2868,4,262660,0,2868,185,2869,269,0
20141226.235613,2869,6,262666,0,2868,185,2869,266,1
20141226.235618,2869,22,262688,-22,2868,189,2869,241,1
20141226.235618,2869,2,262690,0,2868,189,2869,240,1
20141226.235619,2869,2,262692,0,2868,189,2869,239,1
20141226.235624,2869,4,262696,0,2868,210,2869,231,1
20141226.235625,2869,2,262698,-2,2868,211,2869,220,1
20141226.235626,2869,4,262702,0,2868,216,2869,218,1
20141226.235631,2869,4,262706,0,2868,216,2869,217,1
20141226.235636,2869,4,262710,0,2868,237,2869,265,1
20141226.23564,2869,4,262714,0,2868,238,2869,327,1
20141226.235641,2869,6,262720,-6,2868,238,2869,324,1
20141226.235643,2868,100,262820,32,2868,188,2869,324,0
20141226.235645,2869,6,262826,0,2868,191,2869,320,1
20141226.235649,2868,2,262828,0,2868,190,2869,320,0
20141226.235649,2869,20,262848,-6,2868,190,2869,310,1
20141226.235652,2869,6,262854,-4,2868,193,2869,309,1
20141226.235653,2868,2,262856,2,2868,192,2869,310,0
20141226.235657,2869,8,262864,0,2868,191,2869,309,1
20141226.235702,2869,10,262874,2,2868,192,2869,305,1
20141226.235704,2868,2,262876,0,2868,192,2869,295,0
20141226.235705,2869,4,262880,4,2868,193,2869,289,1
20141226.235706,2869,10,262890,10,2868,193,2869,284,1
20141226.235708,2868,386,263276,-152,2867,423,2868,207,0
20141226.235711,2868,14,263290,0,2867,420,2868,200,0
20141226.235713,2868,14,263304,-8,2867,420,2868,213,0
20141226.235714,2868,2,263306,0,2867,420,2868,213,0
20141226.235716,2868,16,263322,0,2867,421,2868,205,0
20141226.235716,2867,2,263324,-2,2867,420,2868,205,0
20141226.235717,2867,2,263326,0,2867,419,2868,205,0
20141226.23572,2868,32,263358,0,2867,527,2868,190,1
20141226.235724,2868,14,263372,0,2867,547,2868,183,1
20141226.235725,2868,2,263374,0,2867,547,2868,182,1
20141226.235726,2868,2,263376,0,2867,544,2868,184,1
20141226.235727,2868,2,263378,0,2867,544,2868,183,1
20141226.235728,2868,2,263380,0,2867,546,2868,182,1
20141226.235728,2868,12,263392,0,2867,546,2868,176,1
20141226.235731,2868,2,263394,0,2867,546,2868,178,1
20141226.235737,2868,2,263396,0,2867,539,2868,178,1
20141226.235741,2868,2,263398,0,2867,540,2868,177,1
20141226.235749,2868,30,263428,0,2867,521,2868,211,1
20141226.235756,2868,2,263430,-2,2867,520,2868,215,1
20141226.235756,2868,2,263432,0,2867,520,2868,214,1
20141226.235758,2867,100,263532,8,2867,468,2868,167,0
20141226.235758,2868,2,263534,0,2867,468,2868,166,1
20141226.235801,2868,2,263536,0,2867,468,2868,166,1
20141226.235802,2868,2,263538,0,2867,468,2868,165,1
20141226.235803,2868,2,263540,0,2867,468,2868,164,1
20141226.235804,2868,184,263724,-154,2867,468,2868,72,1
20141226.235804,2868,2,263726,0,2867,468,2868,71,1
20141226.235807,2868,100,263826,30,2867,483,2868,21,1
20141226.235808,2868,12,263838,2,2867,483,2868,15,1
20141226.235809,2868,2,263840,0,2867,483,2868,13,1
20141226.23581,2868,2,263842,0,2867,484,2868,12,1
20141226.235812,2868,20,263862,14,2867,484,2868,2,1
20141226.235814,2868,2,263864,-2,2867,483,2868,1,1
20141226.235814,2868,2,263866,0,2867,483,2869,236,1
20141226.235817,2869,4,263870,4,2868,14,2869,235,1
20141226.235818,2868,2,263872,0,2868,14,2869,235,0
20141226.235823,2868,2,263874,-2,2868,13,2869,245,0
20141226.235826,2869,10,263884,0,2868,13,2869,240,1
20141226.23583,2868,2,263886,0,2868,15,2869,240,0
20141226.235835,2869,2,263888,2,2868,16,2869,279,1
20141226.235838,2868,2,263890,-2,2868,16,2869,317,0
20141226.235842,2868,2,263892,0,2868,17,2869,317,0
20141226.235858,2868,2,263894,0,2868,83,2869,319,0
20141226.235906,2868,2,263896,0,2868,84,2869,321,0
20141226.235908,2868,4,263900,0,2868,82,2869,321,0
20141226.235908,2868,12,263912,-10,2868,76,2869,321,0
20141226.23591,2868,2,263914,0,2868,74,2869,322,0
20141226.235911,2868,8,263922,-6,2868,70,2869,322,0
20141226.235919,2868,60,263982,-60,2868,70,2869,322,0
20141226.235932,2869,2,263984,0,2868,69,2869,352,1
20141226.235935,2868,2,263986,2,2868,68,2869,352,0
20141226.235943,2868,4,263990,0,2868,78,2869,353,0
20141226.235947,2868,2,263992,0,2868,77,2869,353,0
20141226.235948,2868,4,263996,-4,2868,75,2869,353,0
20141226.235951,2868,8,264004,-2,2868,72,2869,353,0
20141226.235953,2868,2,264006,0,2868,71,2869,353,0
20141227.000001,2868,38,264044,38,2868,52,2869,340,0
20141227.000002,2869,8,264052,-2,2868,52,2869,334,1
20141227.000002,2868,2,264054,0,2868,51,2869,336,0
20141227.000003,2868,2,264056,2,2868,51,2869,336,0
20141227.000003,2868,2,264058,2,2868,50,2869,336,0
20141227.000005,2869,2,264060,0,2868,50,2869,334,1
20141227.000013,2868,20,264080,20,2868,41,2869,334,0
20141227.000016,2868,208,264288,-16,2867,528,2869,312,0
20141227.000017,2867,72,264360,-60,2867,489,2868,10,0
20141227.000017,2867,200,264560,0,2867,489,2868,20,0
20141227.000018,2868,2,264562,2,2867,491,2868,19,1
20141227.000019,2868,8,264570,0,2867,491,2868,15,1
20141227.000022,2868,200,264770,0,2867,490,2868,30,1
20141227.000023,2868,2,264772,2,2867,489,2868,29,1
20141227.00003,2868,2,264774,2,2867,497,2868,50,1
20141227.000033,2868,2,264776,2,2867,510,2868,54,1
20141227.000035,2868,2,264778,0,2867,510,2868,54,1
20141227.000036,2868,2,264780,2,2867,510,2868,54,1
20141227.000042,2867,2,264782,2,2867,521,2868,68,0
20141227.000053,2868,4,264786,0,2867,516,2868,187,1
20141227.000053,2868,2,264788,0,2867,516,2868,187,1
20141227.000057,2868,800,265588,-340,2867,520,2868,188,1
20141227.000103,2867,4,265592,0,2867,518,2868,231,0
20141227.000106,2867,152,265744,0,2867,460,2868,231,0
20141227.000112,2867,2,265746,-2,2867,459,2868,232,0
20141227.000122,2868,4,265750,0,2867,476,2868,238,1
20141227.000149,2867,122,265872,-112,2867,404,2868,269,0
20141227.00015,2868,2,265874,0,2867,417,2868,268,1
20141227.000156,2868,20,265894,12,2867,417,2868,259,1
20141227.000223,2868,400,266294,360,2867,456,2868,78,1
20141227.000224,2868,12,266306,12,2867,456,2868,72,1
20141227.000225,2868,20,266326,12,2867,456,2868,62,1
20141227.00023,2868,118,266444,46,2868,41,2869,331,1
20141227.000234,2868,2,266446,2,2868,41,2869,331,1
20141227.000235,2868,2,266448,0,2868,40,2869,391,1
20141227.000242,2868,2,266450,0,2868,46,2869,646,1
20141227.00025,2868,2,266452,2,2868,56,2869,647,1
20141227.000253,2868,2,266454,2,2868,55,2869,647,1
20141227.000257,2868,10,266464,0,2868,49,2869,647,1
20141227.000305,2868,2,266466,2,2868,50,2869,648,1
20141227.000306,2868,8,266474,0,2868,46,2869,649,1
20141227.000312,2868,2,266476,2,2868,44,2869,651,1
20141227.000317,2868,4,266480,4,2868,43,2869,651,1
20141227.00032,2868,2,266482,0,2868,42,2869,651,1
20141227.000321,2868,84,266566,-12,2867,535,2869,651,1
20141227.000332,2868,2,266568,0,2867,398,2868,9,1
20141227.000335,2868,2,266570,0,2867,398,2868,43,1
20141227.000339,2868,8,266578,-4,2867,395,2868,43,1
20141227.000341,2868,2,266580,2,2867,395,2868,43,1
20141227.000345,2868,2,266582,2,2867,394,2868,55,1
20141227.000346,2868,40,266622,-28,2867,394,2868,35,1
20141227.000347,2868,2,266624,0,2867,394,2868,35,1
20141227.000347,2868,2,266626,0,2867,394,2868,37,1
20141227.000351,2868,2,266628,0,2867,394,2868,37,1
20141227.000353,2868,2,266630,2,2867,396,2868,39,1
20141227.000354,2868,2,266632,2,2867,396,2868,39,1
20141227.000355,2868,2,266634,2,2867,397,2868,38,1
20141227.000409,2868,100,266734,-32,2867,396,2868,13,1
20141227.000417,2868,2,266736,2,2867,395,2868,16,1
20141227.000418,2867,4,266740,-4,2867,393,2868,16,0
20141227.000423,2868,4,266744,4,2867,408,2868,14,1
20141227.000427,2867,6,266750,-6,2867,418,2868,14,0
20141227.000427,2868,20,266770,12,2867,418,2868,4,1
20141227.000436,2868,14,266784,10,2867,398,2869,873,1
20141227.000436,2868,2,266786,2,2867,398,2869,873,1
20141227.000437,2869,220,267006,-98,2867,398,2869,823,1
20141227.000438,2868,2,267008,2,2867,398,2869,823,0
20141227.000445,2868,2,267010,0,2867,408,2869,826,0
20141227.000446,2868,2,267012,2,2867,408,2869,826,0
20141227.000447,2868,2,267014,2,2867,408,2869,826,0
20141227.000451,2868,2,267016,-2,2868,469,2869,837,0
20141227.000501,2868,2,267018,0,2868,483,2869,839,0
20141227.000506,2869,1400,268418,-636,2868,471,2869,142,1
20141227.000507,2869,4,268422,0,2868,499,2869,142,1
20141227.000511,2868,2,268424,0,2868,538,2869,150,0
20141227.000514,2869,4,268428,-4,2868,538,2869,149,1
20141227.000515,2869,4,268432,0,2868,502,2869,163,1
20141227.000515,2869,20,268452,0,2868,502,2869,153,1
20141227.000519,2869,2,268454,0,2868,505,2869,178,1
20141227.00052,2869,14,268468,-14,2868,506,2869,171,1
20141227.00052,2869,2,268470,-2,2868,508,2869,170,1
20141227.000523,2869,2,268472,0,2868,508,2869,153,1
20141227.000523,2869,2,268474,0,2868,508,2869,152,1
20141227.000525,2868,20,268494,-20,2868,498,2869,152,0
20141227.000525,2869,24,268518,-24,2868,498,2869,125,1
20141227.000526,2869,4,268522,-2,2868,499,2869,123,1
20141227.000527,2868,4,268526,-4,2868,497,2869,123,0
20141227.000533,2869,10,268536,0,2868,498,2869,137,1
20141227.000536,2869,6,268542,0,2868,498,2869,146,1
20141227.000537,2869,20,268562,0,2868,486,2869,138,1
20141227.000541,2869,2,268564,0,2868,486,2869,127,1
20141227.000543,2869,2,268566,-2,2868,488,2869,127,1
20141227.000551,2868,2,268568,0,2868,489,2869,131,0
20141227.000556,2869,2,268570,-2,2868,501,2869,132,1
20141227.000557,2868,2,268572,0,2868,499,2869,132,0
20141227.000605,2869,10,268582,0,2868,500,2869,178,1
20141227.000607,2869,2,268584,-2,2868,501,2869,177,1
20141227.000609,2868,2,268586,2,2868,500,2869,176,0
20141227.000616,2868,2,268588,0,2868,52,2869,176,0
20141227.000626,2868,6,268594,6,2868,49,2869,176,0
20141227.000632,2868,2,268596,0,2868,96,2869,160,0
20141227.000642,2868,2,268598,2,2868,98,2869,159,0
20141227.000645,2869,200,268798,-108,2868,100,2869,60,1
20141227.000649,2869,6,268804,2,2868,202,2869,73,1
20141227.00065,2869,354,269158,-106,2869,23,2870,640,1
20141227.000651,2868,48,269206,-46,2868,202,2870,617,0
20141227.000653,2869,2,269208,0,2868,202,2870,617,1
20141227.000709,2869,14,269222,-12,2868,182,2869,529,1
20141227.00071,2869,2,269224,-2,2868,180,2869,529,1
20141227.000711,2869,400,269624,-400,2868,185,2869,329,1
20141227.000713,2869,2,269626,0,2868,185,2869,328,1
20141227.000713,2869,400,270026,-400,2868,186,2869,128,1
20141227.000715,2869,268,270294,-252,2869,66,2870,617,1
20141227.000719,2869,16,270310,0,2869,63,2870,617,1
20141227.00072,2869,2,270312,0,2869,62,2870,617,1
20141227.000721,2869,2,270314,-2,2869,61,2870,616,1
20141227.000721,2870,2,270316,0,2869,62,2870,616,1
20141227.000722,2870,12,270328,-12,2869,69,2870,611,1
20141227.000722,2870,2,270330,-2,2869,69,2870,610,1
20141227.000726,2869,2,270332,-2,2869,81,2870,610,0
20141227.000728,2869,2,270334,0,2869,88,2870,610,0
20141227.000736,2869,2,270336,0,2869,78,2870,613,0
20141227.000745,2869,2,270338,0,2869,77,2870,614,0
20141227.000806,2870,268,270606,114,2869,118,2870,177,1
20141227.000809,2870,362,270968,-298,2869,121,2870,296,1
20141227.00081,2870,4,270972,-4,2869,135,2870,294,1
20141227.000813,2870,588,271560,-182,2869,155,2871,141,1
20141227.000814,2871,8,271568,2,2870,40,2871,111,1
20141227.000815,2870,48,271616,8,2870,23,2871,118,0
20141227.000816,2871,24,271640,-18,2870,23,2871,108,1
20141227.000817,2871,216,271856,124,2871,92,2872,350,1
20141227.000817,2872,4,271860,-4,2871,92,2872,348,1
20141227.000818,2872,26,271886,-18,2871,91,2872,359,1
20141227.000818,2872,20,271906,-10,2871,96,2872,349,1
20141227.000819,2872,10,271916,2,2871,97,2872,344,1
20141227.00082,2871,4,271920,0,2871,98,2872,344,0
20141227.000823,2871,192,272112,188,2871,14,2872,346,0
20141227.000823,2872,2,272114,0,2871,14,2872,345,1
20141227.000824,2871,2,272116,2,2871,17,2872,346,0
20141227.000825,2871,82,272198,-74,2871,14,2872,300,0
20141227.000825,2871,4,272202,-2,2871,13,2872,299,0
20141227.000826,2871,20,272222,-18,2871,8,2872,301,0
20141227.000828,2872,2,272224,0,2871,8,2872,300,1
20141227.000828,2871,2,272226,-2,2871,7,2872,300,0
20141227.000829,2871,2,272228,-2,2871,7,2872,303,0
20141227.00083,2872,4,272232,-2,2871,8,2872,303,1
20141227.00083,2872,40,272272,2,2871,8,2872,295,1
20141227.000831,2872,26,272298,-6,2871,8,2872,285,1
20141227.000831,2871,2,272300,0,2871,7,2872,285,0
20141227.000832,2872,2,272302,0,2871,9,2872,285,1
20141227.000832,2871,4,272306,0,2871,11,2872,285,0
20141227.000833,2872,2,272308,2,2871,11,2872,286,1
20141227.000836,2872,20,272328,10,2871,13,2872,276,1
20141227.000837,2871,10,272338,-2,2871,24,2872,276,0
20141227.000837,2871,16,272354,0,2871,17,2872,275,0
20141227.000838,2871,16,272370,12,2871,11,2872,275,0
20141227.000839,2871,2,272372,0,2871,10,2872,275,0
20141227.00084,2872,2,272374,-2,2871,10,2872,274,1
20141227.000841,2872,102,272476,20,2871,9,2872,228,1
20141227.000843,2872,20,272496,2,2871,12,2872,223,1
20141227.000845,2872,2,272498,0,2871,16,2872,226,1
20141227.000846,2872,20,272518,2,2871,18,2872,229,1
20141227.000847,2871,132,272650,34,2871,16,2872,165,0
20141227.000849,2872,122,272772,0,2871,23,2873,182,1
20141227.00085,2872,2,272774,0,2871,64,2872,135,1
20141227.000851,2872,2,272776,2,2871,76,2872,139,1
20141227.000852,2871,4,272780,4,2871,74,2872,139,0
20141227.000855,2872,4,272784,0,2871,98,2872,137,1
20141227.000856,2872,4,272788,4,2871,100,2872,137,1
20141227.000858,2872,2,272790,0,2871,100,2872,140,1
20141227.000858,2872,2,272792,2,2871,100,2872,139,1
20141227.000901,2872,2,272794,0,2871,112,2872,138,1
20141227.000902,2872,110,272904,80,2871,112,2873,194,1
20141227.000902,2872,2,272906,0,2871,112,2873,194,1
20141227.000903,2872,2,272908,-2,2871,112,2872,79,1
20141227.000904,2872,2,272910,2,2871,115,2873,194,1
20141227.000905,2872,2,272912,0,2871,115,2873,194,1
20141227.000905,2872,4,272916,0,2871,114,2872,82,1
20141227.000906,2872,2,272918,2,2871,114,2873,194,1
20141227.000907,2872,2,272920,0,2871,114,2873,194,1
20141227.000907,2871,4,272924,0,2871,113,2873,194,0
20141227.000908,2872,10,272934,0,2871,114,2872,80,1
20141227.00091,2872,2,272936,0,2871,114,2872,49,1
20141227.000911,2872,4,272940,0,2871,115,2872,57,1
20141227.000912,2872,20,272960,-16,2871,116,2872,69,1
20141227.000913,2872,10,272970,8,2871,116,2872,66,1
20141227.000916,2872,2,272972,2,2871,110,2872,70,1
20141227.000917,2872,6,272978,6,2871,110,2872,67,1
20141227.000919,2872,4,272982,4,2871,110,2872,93,1
20141227.00092,2872,94,273076,-4,2871,109,2873,200,1
20141227.000921,2872,2,273078,0,2871,109,2873,200,1
20141227.000923,2872,16,273094,0,2871,110,2872,66,1
20141227.000924,2872,4,273098,0,2871,111,2872,54,1
20141227.000925,2872,4,273102,4,2871,111,2872,62,1
20141227.000926,2872,2,273104,2,2871,112,2872,57,1
20141227.000927,2872,2,273106,0,2871,112,2872,158,1
20141227.000929,2872,80,273186,-34,2871,109,2872,128,1
20141227.00093,2872,80,273266,-80,2871,129,2872,89,1
20141227.000931,2872,74,273340,2,2871,130,2873,209,1
20141227.000931,2872,2,273342,0,2871,130,2873,209,1
20141227.000932,2872,4,273346,-2,2871,130,2873,209,1
20141227.000933,2872,4,273350,0,2871,130,2873,208,1
20141227.000935,2872,112,273462,0,2872,24,2873,375,1
20141227.000936,2872,88,273550,34,2871,129,2873,355,1
20141227.000936,2873,2,273552,2,2872,5,2873,354,1
20141227.000937,2873,10,273562,-6,2872,10,2873,356,1
20141227.000938,2873,2,273564,-2,2872,10,2873,355,1
20141227.000939,2873,6,273570,-4,2872,18,2873,352,1
20141227.000939,2873,40,273610,4,2872,19,2873,334,1
20141227.00094,2872,6,273616,0,2872,20,2873,332,0
20141227.000941,2872,48,273664,0,2872,17,2873,312,0
20141227.000942,2873,4,273668,-4,2872,16,2873,311,1
20141227.000943,2873,4,273672,-2,2872,16,2873,609,1
20141227.000944,2872,2,273674,0,2872,16,2873,610,0
20141227.000945,2872,2,273676,0,2872,25,2873,610,0
20141227.000946,2873,14,273690,-12,2872,24,2873,594,1
20141227.000948,2873,20,273710,2,2872,34,2873,582,1
20141227.000949,2872,4,273714,0,2872,38,2873,582,0
20141227.00095,2873,40,273754,12,2872,42,2873,562,1
20141227.000952,2872,4,273758,0,2872,40,2873,560,0
20141227.000953,2873,2,273760,0,2872,41,2873,559,1
20141227.000954,2873,4,273764,-4,2872,41,2873,562,1
20141227.000955,2872,12,273776,-4,2872,35,2873,564,0
20141227.000956,2872,76,273852,-26,2871,138,2873,564,0
20141227.000956,2873,6,273858,0,2871,138,2873,563,1
20141227.000957,2872,4,273862,2,2871,138,2873,565,0
20141227.000958,2872,2,273864,0,2872,1,2873,557,0
20141227.000959,2873,8,273872,0,2872,1,2873,553,1
20141227.000959,2872,2,273874,2,2871,135,2872,7,0
20141227.001001,2872,2,273876,0,2871,115,2872,26,0
20141227.001005,2872,2,273878,0,2871,117,2872,34,0
20141227.001005,2872,6,273884,-6,2871,117,2872,31,0
20141227.001007,2872,2,273886,0,2871,117,2872,31,0
20141227.001009,2872,4,273890,2,2871,116,2872,32,0
20141227.00101,2872,804,274694,-102,2871,116,2872,31,0
20141227.001012,2872,42,274736,0,2871,118,2872,10,0
20141227.001013,2872,2,274738,0,2871,115,2872,10,0
20141227.001014,2872,2,274740,0,2871,117,2872,11,0
20141227.001015,2872,2,274742,-2,2871,115,2872,15,0
20141227.001015,2872,10,274752,8,2871,115,2872,10,0
20141227.001016,2871,6,274758,4,2871,114,2872,7,0
20141227.001017,2872,18,274776,-4,2871,214,2873,589,1
20141227.00102,2872,4,274780,-2,2871,213,2873,588,1
20141227.001022,2872,4,274784,0,2872,5,2873,608,1
20141227.001023,2872,10,274794,-6,2871,118,2873,613,1
20141227.001024,2872,4,274798,-4,2871,118,2873,615,1
20141227.001024,2873,2,274800,-2,2872,5,2873,614,1
20141227.001026,2872,10,274810,0,2871,121,2873,614,0
20141227.001028,2872,16,274826,2,2872,4,2873,615,0
20141227.001028,2872,10,274836,-2,2871,122,2873,615,0
20141227.001031,2872,2,274838,2,2871,122,2872,5,0
20141227.001033,2872,8,274846,4,2871,127,2872,1,0
20141227.001035,2872,8,274854,6,2872,24,2873,626,0
20141227.001035,2872,4,274858,0,2872,22,2873,626,0
20141227.001037,2872,12,274870,2,2872,21,2873,626,0
20141227.001039,2872,2,274872,2,2872,20,2873,626,0
20141227.001039,2873,22,274894,16,2872,21,2873,615,1
20141227.00104,2873,4,274898,0,2872,20,2873,614,1
20141227.00104,2872,2,274900,0,2872,20,2873,614,0
20141227.001041,2872,2,274902,0,2872,20,2873,625,0
20141227.001042,2872,42,274944,-8,2872,1,2873,616,0
20141227.001042,2872,2,274946,0,2872,2,2873,616,0
20141227.001044,2872,4,274950,-2,2871,125,2873,616,0
20141227.001045,2872,2,274952,-2,2871,126,2873,618,0
20141227.001046,2872,2,274954,-2,2872,5,2873,617,0
20141227.001047,2872,12,274966,-10,2871,126,2872,34,0
20141227.001047,2872,2,274968,0,2871,126,2872,33,0
20141227.001048,2872,2,274970,-2,2871,126,2872,32,0
20141227.001049,2872,8,274978,0,2871,126,2872,33,0
20141227.00105,2872,4,274982,0,2871,129,2872,31,0
20141227.001051,2872,2,274984,0,2871,129,2872,31,0
20141227.001052,2872,62,275046,2,2872,69,2873,618,0
20141227.001052,2872,40,275086,0,2872,49,2873,618,0
20141227.001053,2872,6,275092,2,2872,47,2873,617,0
20141227.001054,2872,8,275100,0,2872,43,2873,617,0
20141227.001054,2872,18,275118,2,2872,34,2873,617,0
20141227.001055,2872,4,275122,0,2872,32,2873,618,0
20141227.001056,2872,2,275124,2,2872,43,2873,620,0
20141227.001059,2872,10,275134,0,2872,41,2873,620,0
20141227.0011,2873,2,275136,2,2872,41,2873,619,1
20141227.001101,2872,12,275148,0,2872,35,2873,629,0
20141227.001102,2872,70,275218,-26,2871,138,2873,630,0
20141227.001105,2872,4,275222,0,2872,8,2873,631,0
20141227.001109,2872,8,275230,4,2872,4,2873,634,0
20141227.001112,2872,4,275234,0,2872,2,2873,633,0
20141227.001112,2872,2,275236,2,2872,1,2873,633,0
20141227.001113,2872,2,275238,0,2871,140,2872,8,0
20141227.001117,2872,22,275260,6,2871,139,2872,11,0
20141227.001118,2871,278,275538,-58,2870,192,2871,261,0
20141227.001118,2871,4,275542,-4,2870,177,2871,259,0
20141227.001119,2871,10,275552,0,2870,177,2871,254,0
20141227.001121,2871,134,275686,0,2870,185,2871,187,0
20141227.001124,2871,2,275688,0,2870,185,2871,186,0
20141227.001133,2871,2,275690,0,2870,146,2871,305,0
20141227.001134,2871,30,275720,0,2870,142,2871,290,0
20141227.001136,2870,2,275722,-2,2870,141,2871,290,0
20141227.001137,2871,2,275724,0,2870,139,2871,290,1
20141227.001148,2871,10,275734,0,2870,130,2871,286,1
20141227.001152,2871,2,275736,0,2870,133,2871,285,1
20141227.001153,2871,2,275738,-2,2870,133,2871,285,1
20141227.001155,2870,100,275838,-98,2870,84,2871,285,0
20141227.001157,2870,2,275840,-2,2870,91,2871,286,0
20141227.0012,2870,4,275844,-2,2870,175,2871,285,0
20141227.001201,2871,2,275846,-2,2870,175,2871,284,1
20141227.001201,2871,2,275848,0,2870,177,2871,283,1
20141227.001209,2871,2,275850,0,2870,191,2871,291,1
20141227.001222,2871,2,275852,-2,2870,208,2871,290,1
20141227.001225,2871,8,275860,0,2870,209,2871,286,1
20141227.001227,2871,2,275862,-2,2870,208,2871,385,1
20141227.00123,2870,2,275864,-2,2870,211,2871,385,0
20141227.001232,2871,2,275866,-2,2870,241,2871,384,1
20141227.001232,2871,2,275868,-2,2870,241,2871,383,1
20141227.001235,2871,2,275870,0,2870,241,2871,382,1
20141227.001237,2870,84,275954,38,2870,201,2871,382,0
20141227.001238,2871,2,275956,-2,2870,201,2871,382,1
20141227.001246,2870,6,275962,0,2870,189,2871,383,0
20141227.001247,2870,4,275966,0,2870,188,2871,383,0
20141227.001248,2870,4,275970,4,2870,186,2871,383,0
20141227.001248,2870,2,275972,0,2870,185,2871,387,0
20141227.001253,2870,2,275974,0,2870,175,2871,387,0
20141227.001253,2870,4,275978,0,2870,173,2871,392,0
20141227.001254,2870,4,275982,2,2870,171,2871,392,0
20141227.001255,2870,2,275984,2,2870,169,2871,392,0
20141227.001258,2871,2,275986,0,2870,156,2871,458,1
20141227.0013,2870,10,275996,0,2870,151,2871,456,0
20141227.0013,2870,2,275998,0,2870,149,2871,457,0
20141227.001301,2870,6,276004,2,2870,146,2871,458,0
20141227.001306,2870,2,276006,0,2870,176,2871,458,0
20141227.001308,2871,8,276014,0,2870,177,2871,455,1
20141227.001311,2870,2,276016,0,2870,176,2871,387,0
20141227.001313,2870,2,276018,0,2870,175,2871,387,0
20141227.001314,2871,2,276020,-2,2870,175,2871,389,1
20141227.001315,2870,20,276040,20,2870,166,2871,391,0
20141227.001316,2870,16,276056,0,2870,157,2871,389,0
20141227.001319,2870,4,276060,0,2870,155,2871,389,0
20141227.00132,2871,22,276082,-12,2870,153,2871,382,1
20141227.001321,2870,2,276084,2,2870,153,2871,380,0
20141227.001321,2870,4,276088,0,2870,151,2871,382,0
20141227.001322,2870,4,276092,0,2870,149,2871,389,0
20141227.001323,2870,4,276096,0,2870,147,2871,392,0
20141227.001324,2870,2,276098,2,2870,146,2871,392,0
20141227.001325,2870,2,276100,0,2870,144,2871,392,0
20141227.001326,2870,4,276104,0,2870,142,2871,393,0
20141227.001329,2870,72,276176,0,2870,118,2871,443,0
20141227.00133,2870,60,276236,0,2870,87,2871,443,0
20141227.001331,2870,12,276248,2,2870,81,2871,438,0
20141227.001333,2870,2,276250,2,2870,81,2871,438,0
20141227.001333,2870,2,276252,2,2870,116,2871,438,0
20141227.001336,2871,60,276312,-60,2870,117,2871,358,1
20141227.001336,2870,12,276324,12,2870,111,2871,358,0
20141227.001337,2871,10,276334,0,2870,111,2871,354,1
20141227.001341,2870,14,276348,0,2870,173,2871,360,0
20141227.001342,2870,4,276352,0,2870,172,2871,360,0
20141227.00135,2871,6,276358,0,2870,263,2871,353,1
20141227.001353,2870,4,276362,0,2870,287,2871,352,0
20141227.001355,2871,240,276602,48,2870,288,2871,233,1
20141227.001355,2870,4,276606,0,2870,286,2871,251,0
20141227.001355,2870,2,276608,0,2870,286,2871,247,0
20141227.001356,2871,500,277108,-282,2870,297,2872,313,1
20141227.001357,2872,2,277110,0,2870,296,2872,312,1
20141227.001359,2871,56,277166,-56,2870,296,2872,281,0
20141227.001359,2872,260,277426,56,2870,296,2872,156,1
20141227.001401,2872,4,277430,-4,2871,1,2872,154,1
20141227.001405,2872,2,277432,-2,2871,19,2872,153,1
20141227.001409,2872,2,277434,0,2871,305,2872,153,1
20141227.00141,2871,2,277436,0,2871,305,2872,156,0
20141227.001425,2871,2,277438,2,2871,320,2872,174,0
20141227.001427,2872,2,277440,0,2871,269,2872,172,1
20141227.001428,2871,10,277450,10,2871,264,2872,172,0
20141227.001429,2871,2,277452,2,2871,264,2872,172,0
20141227.001438,2871,2,277454,0,2871,262,2872,196,0
20141227.001445,2872,2,277456,0,2871,262,2872,195,1
20141227.00145,2871,2,277458,2,2871,260,2872,197,0
20141227.001508,2872,4,277462,-2,2871,265,2872,210,1
20141227.00151,2871,2,277464,0,2871,263,2872,210,0
20141227.001511,2872,16,277480,-16,2871,263,2872,202,1
20141227.001513,2872,2,277482,0,2871,263,2872,201,1
20141227.001513,2872,2,277484,0,2871,263,2872,202,1
20141227.001514,2872,2,277486,-2,2871,328,2872,201,1
20141227.001516,2872,2,277488,0,2871,336,2872,201,1
20141227.00152,2872,2,277490,-2,2871,401,2872,197,1
20141227.001521,2871,4,277494,-2,2871,400,2872,244,0
20141227.001522,2872,2,277496,0,2871,400,2872,243,1
20141227.001535,2872,400,277896,66,2871,404,2873,749,1
20141227.001536,2872,20,277916,6,2871,404,2873,574,1
20141227.001537,2872,2,277918,-2,2872,14,2873,752,1
20141227.001537,2872,6,277924,-6,2872,12,2873,752,1
20141227.001538,2873,8,277932,2,2872,49,2873,748,1
20141227.001539,2872,100,278032,-94,2871,24,2872,80,0
20141227.001539,2872,10,278042,-10,2871,25,2872,75,0
20141227.00154,2872,2,278044,-2,2871,26,2872,113,0
20141227.001541,2872,150,278194,2,2871,26,2872,38,0
20141227.001542,2872,2,278196,2,2871,36,2872,47,0
20141227.001542,2872,2,278198,2,2871,106,2872,47,0
20141227.001544,2872,2,278200,2,2871,41,2872,46,0
20141227.001544,2871,6,278206,0,2871,39,2872,46,0
20141227.001545,2872,2,278208,2,2871,39,2872,45,1
20141227.001546,2872,10,278218,10,2871,59,2872,40,1
20141227.001554,2872,10,278228,10,2871,150,2872,74,1
20141227.001557,2872,8,278236,4,2871,161,2872,71,1
20141227.001559,2872,4,278240,0,2871,162,2872,70,1
20141227.0016,2872,40,278280,38,2871,162,2872,51,1
20141227.001601,2872,2,278282,-2,2871,161,2872,50,1
20141227.001603,2872,2,278284,-2,2871,192,2872,49,1
20141227.001603,2872,2,278286,0,2871,192,2872,48,1
20141227.001605,2871,2,278288,0,2871,191,2872,54,0
20141227.001608,2872,10,278298,0,2871,190,2872,55,1
20141227.001611,2872,10,278308,6,2871,189,2872,52,1
20141227.001613,2871,4,278312,0,2871,187,2872,56,0
20141227.001618,2872,4,278316,4,2871,187,2872,59,1
20141227.001621,2871,2,278318,2,2871,178,2872,65,0
20141227.001623,2872,2,278320,2,2871,178,2872,66,1
20141227.001626,2872,2,278322,2,2871,178,2872,72,1
20141227.001629,2872,2,278324,2,2871,188,2872,72,1
20141227.001631,2872,2,278326,2,2871,188,2872,74,1
20141227.001636,2872,2,278328,2,2871,187,2872,106,1
20141227.001649,2872,72,278400,60,2871,195,2872,75,1
20141227.001652,2872,2,278402,2,2871,195,2872,85,1
20141227.001654,2872,56,278458,-38,2871,195,2872,60,1
20141227.001655,2871,2,278460,0,2871,195,2872,60,0
20141227.001709,2871,4,278464,0,2871,194,2872,104,0
20141227.00171,2871,2,278466,2,2871,193,2872,104,0
20141227.00172,2871,20,278486,-12,2871,195,2872,115,0
20141227.001722,2871,390,278876,-148,2870,370,2871,5,0
20141227.001725,2871,4,278880,-4,2870,377,2871,3,0
20141227.001728,2870,8,278888,-2,2870,383,2871,134,0
20141227.001728,2871,2,278890,-2,2870,383,2871,133,1
20141227.001732,2870,20,278910,-2,2870,368,2871,141,0
20141227.001734,2871,2,278912,-2,2870,379,2871,140,1
20141227.001737,2870,4,278916,0,2870,257,2871,149,0
20141227.001737,2870,2,278918,2,2870,256,2871,149,0
20141227.001738,2870,6,278924,0,2870,253,2871,149,0
20141227.001742,2871,2,278926,2,2870,246,2871,148,1
20141227.001744,2870,8,278934,8,2870,246,2871,163,0
20141227.001746,2871,12,278946,0,2870,246,2871,160,1
20141227.001752,2871,88,279034,24,2871,46,2872,146,1
20141227.001754,2871,2,279036,2,2871,52,2872,150,1
20141227.001755,2871,12,279048,12,2871,46,2872,151,1
20141227.001756,2871,4,279052,4,2871,44,2872,151,1
20141227.001759,2871,10,279062,0,2871,39,2872,151,1
20141227.001759,2871,8,279070,0,2871,35,2872,151,1
20141227.0018,2871,8,279078,8,2871,32,2872,153,1
20141227.001801,2871,10,279088,0,2871,28,2872,153,1
20141227.001802,2871,2,279090,0,2871,27,2872,153,1
20141227.001803,2871,20,279110,0,2871,18,2872,115,1
20141227.001805,2871,2,279112,0,2871,17,2872,116,1
20141227.001809,2871,2,279114,0,2871,16,2872,120,1
20141227.001812,2871,22,279136,-10,2871,5,2872,122,1
20141227.001812,2871,10,279146,-6,2870,265,2871,1,1
20141227.001813,2871,2,279148,0,2870,265,2872,122,1
20141227.001818,2871,2,279150,-2,2870,270,2872,174,1
20141227.001819,2871,2,279152,2,2870,270,2872,174,1
20141227.001827,2871,2,279154,0,2870,271,2871,59,1
20141227.001831,2870,2,279156,0,2870,268,2871,60,0
20141227.001834,2871,10,279166,0,2870,268,2871,55,1
20141227.001835,2870,2,279168,0,2870,268,2871,55,0
20141227.001838,2871,2,279170,0,2870,268,2871,54,1
20141227.00184,2871,10,279180,0,2870,268,2871,49,1
20141227.00184,2871,2,279182,0,2870,268,2871,50,1
20141227.001851,2870,2,279184,0,2870,271,2871,71,0
20141227.001857,2870,10,279194,10,2870,267,2871,72,0
20141227.001858,2871,2,279196,0,2870,267,2871,71,1
20141227.001902,2871,2,279198,0,2870,268,2871,70,1
20141227.001909,2871,2,279200,0,2870,269,2871,48,1
20141227.001913,2870,4,279204,0,2870,266,2871,48,0
20141227.001916,2871,2,279206,-2,2870,266,2871,47,1
20141227.001919,2871,4,279210,-2,2870,268,2871,47,1
20141227.00192,2871,8,279218,0,2870,268,2871,43,1
20141227.001925,2871,2,279220,0,2870,269,2871,43,1
20141227.001927,2871,4,279224,0,2870,271,2871,41,1
20141227.001928,2871,2,279226,0,2870,271,2871,40,1
20141227.001929,2871,2,279228,0,2870,271,2871,39,1
20141227.001934,2871,4,279232,0,2870,271,2871,37,1
20141227.001936,2871,2,279234,0,2870,270,2871,38,1
20141227.001937,2871,2,279236,0,2870,270,2871,37,1
20141227.001937,2871,2,279238,0,2870,270,2871,36,1
20141227.001938,2870,2,279240,2,2870,269,2871,35,0
20141227.001939,2870,2,279242,2,2870,268,2871,34,0
20141227.00194,2871,4,279246,-4,2870,268,2871,32,1
20141227.001942,2870,2,279248,0,2870,277,2871,32,0
20141227.001943,2870,40,279288,40,2870,258,2871,32,0
20141227.001944,2871,2,279290,0,2870,258,2871,31,1
20141227.001945,2871,18,279308,0,2870,258,2871,23,1
20141227.001946,2871,8,279316,0,2870,257,2871,19,1
20141227.001947,2871,2,279318,-2,2870,257,2871,18,1
20141227.001947,2871,6,279324,0,2870,257,2871,15,1
20141227.001948,2871,4,279328,0,2870,257,2871,13,1
20141227.00195,2871,2,279330,0,2870,257,2871,12,1
20141227.00195,2871,2,279332,0,2870,257,2871,11,1
20141227.001951,2871,22,279354,-12,2870,323,2872,125,1
20141227.001952,2871,2,279356,0,2870,323,2872,125,1
20141227.001953,2872,2,279358,0,2870,323,2872,124,1
20141227.001957,2871,6,279364,6,2870,322,2872,140,0
20141227.001958,2872,2,279366,0,2871,278,2872,147,1
20141227.002007,2872,2,279368,0,2871,280,2872,149,1
20141227.002013,2871,2,279370,-2,2871,280,2872,149,0
20141227.002013,2871,2,279372,0,2871,279,2872,149,0
20141227.002016,2871,2,279374,-2,2871,277,2872,149,0
20141227.002018,2871,2,279376,-2,2871,276,2872,156,0
20141227.00202,2872,4,279380,-4,2871,276,2872,154,1
20141227.002027,2871,4,279384,-4,2871,274,2872,142,0
20141227.002036,2872,2,279386,0,2871,277,2872,154,1
20141227.002038,2871,4,279390,-4,2871,275,2872,163,0
20141227.002054,2872,290,279680,70,2872,55,2873,805,1
20141227.002055,2872,2,279682,0,2872,54,2873,805,1
20141227.002056,2870,1400,281082,1274,2870,122,2872,40,0
20141227.002058,2872,24,281106,20,2870,136,2872,95,1
20141227.002102,2870,4,281110,0,2870,136,2872,103,0
20141227.002102,2872,10,281120,-10,2870,136,2872,98,1
20141227.002104,2872,2,281122,-2,2870,136,2872,105,1
20141227.002105,2870,2,281124,2,2870,138,2872,105,0
20141227.002112,2871,10,281134,10,2871,70,2872,219,1
20141227.002115,2871,4,281138,0,2871,71,2872,244,1
20141227.002118,2871,42,281180,40,2871,51,2872,145,1
20141227.002119,2871,10,281190,10,2871,48,2872,136,1
20141227.00212,2871,10,281200,10,2871,57,2872,136,1
20141227.002121,2871,4,281204,4,2871,55,2872,136,1
20141227.002122,2871,2,281206,2,2871,55,2872,146,1
20141227.002127,2871,2,281208,2,2871,71,2872,147,1
20141227.002127,2871,20,281228,20,2871,61,2872,107,1
20141227.002131,2871,2,281230,0,2871,59,2872,109,1
20141227.002133,2871,2,281232,0,2871,61,2872,112,1
20141227.002137,2871,2,281234,2,2871,69,2872,112,1
20141227.002142,2871,20,281254,0,2871,73,2872,143,1
20141227.002146,2871,4,281258,0,2871,71,2872,143,1
20141227.002148,2871,2,281260,2,2871,72,2872,143,1
20141227.002155,2871,2,281262,2,2871,80,2872,134,1
20141227.002205,2872,4,281266,0,2871,80,2872,123,1
20141227.002206,2872,2,281268,0,2871,80,2872,122,1
20141227.002212,2871,12,281280,0,2871,77,2872,123,0
20141227.00222,2871,4,281284,2,2871,75,2872,144,0
20141227.00222,2872,2,281286,-2,2871,75,2872,143,1
20141227.002222,2871,2,281288,0,2871,74,2872,143,0
20141227.00223,2872,200,281488,96,2871,90,2872,43,1
20141227.002231,2872,4,281492,-4,2871,94,2872,41,1
20141227.002233,2872,58,281550,-30,2871,122,2872,18,1
20141227.002233,2872,36,281586,2,2872,19,2873,682,1
20141227.002234,2873,20,281606,10,2872,35,2873,672,1
20141227.002235,2872,2,281608,0,2872,35,2873,683,0
20141227.002237,2872,2,281610,2,2872,40,2873,683,0
20141227.002237,2872,2,281612,2,2872,50,2873,684,0
20141227.00224,2873,2,281614,0,2872,51,2873,683,1
20141227.00224,2872,22,281636,22,2872,39,2873,683,0
20141227.002243,2872,2,281638,2,2872,50,2873,688,0
20141227.002243,2872,24,281662,0,2872,40,2873,686,0
20141227.002245,2872,84,281746,-2,2872,50,2873,686,0
20141227.002247,2872,4,281750,4,2872,48,2873,686,0
20141227.002249,2872,4,281754,0,2872,46,2873,686,0
20141227.00225,2872,6,281760,6,2872,43,2873,686,0
20141227.00225,2872,2,281762,2,2872,42,2873,686,0
20141227.002253,2872,2,281764,2,2872,41,2873,687,0
20141227.002257,2872,2,281766,2,2872,71,2873,691,0
20141227.002258,2873,2,281768,0,2872,72,2873,689,1
20141227.002259,2872,10,281778,0,2872,67,2873,689,0
20141227.002312,2872,2,281780,2,2872,81,2873,696,0
20141227.002314,2872,2,281782,2,2872,81,2873,696,0
20141227.002318,2873,2,281784,0,2872,81,2873,694,1
20141227.002319,2873,4,281788,0,2872,81,2873,692,1
20141227.002321,2872,162,281950,-10,2871,172,2872,19,0
20141227.002324,2872,56,282006,16,2872,73,2873,692,0
20141227.002325,2872,4,282010,2,2872,73,2873,692,0
20141227.002327,2872,6,282016,6,2872,82,2873,692,0
20141227.002328,2872,2,282018,0,2872,81,2873,693,0
20141227.002331,2872,16,282034,16,2872,73,2873,693,0
20141227.002334,2872,4,282038,4,2872,93,2873,693,0
20141227.002336,2872,46,282084,40,2872,71,2873,693,0
20141227.002339,2872,2,282086,0,2872,72,2873,707,0
20141227.002339,2872,2,282088,0,2872,71,2873,707,0
20141227.002343,2872,2,282090,2,2872,101,2873,715,0
20141227.002345,2872,16,282106,16,2872,152,2873,715,0
20141227.00235,2872,2,282108,2,2872,152,2873,714,0
20141227.002352,2872,2,282110,0,2872,251,2873,713,0
20141227.002352,2873,8,282118,6,2872,251,2873,709,1
20141227.0024,2872,32,282150,32,2872,285,2873,714,0
20141227.002405,2873,6,282156,-6,2872,285,2873,700,1
20141227.002405,2873,2,282158,0,2872,285,2873,699,1
20141227.002408,2873,2,282160,0,2872,290,2873,698,1
20141227.002411,2873,42,282202,26,2872,256,2873,692,1
20141227.002413,2873,2,282204,0,2872,256,2873,691,1
20141227.002416,2873,2,282206,0,2872,262,2873,691,1
20141227.002418,2872,2,282208,0,2872,261,2873,691,0
20141227.002424,2872,4,282212,0,2872,260,2873,691,0
20141227.002426,2873,2,282214,-2,2872,270,2873,697,1
20141227.002431,2873,2,282216,2,2872,270,2873,698,1
20141227.002432,2873,38,282254,28,2872,270,2873,679,1
20141227.002434,2872,2,282256,2,2872,238,2873,679,0
20141227.002436,2873,320,282576,160,2872,238,2873,519,1
20141227.002436,2873,16,282592,8,2872,238,2873,511,1
20141227.002437,2873,4,282596,0,2872,238,2873,510,1
20141227.002439,2873,200,282796,0,2872,238,2873,417,1
20141227.00244,2873,200,282996,112,2872,238,2873,317,1
20141227.00244,2873,66,283062,12,2872,238,2873,284,1
20141227.002442,2873,2,283064,2,2872,238,2873,282,1
20141227.002443,2873,10,283074,-8,2872,238,2873,277,1
20141227.002446,2873,100,283174,12,2872,238,2873,228,1
20141227.002447,2873,10,283184,10,2872,238,2873,223,1
20141227.00245,2873,2,283186,2,2872,241,2873,222,1
20141227.002457,2873,6,283192,6,2872,249,2873,253,1
20141227.0025,2873,2,283194,2,2872,266,2873,298,1
20141227.002501,2872,8,283202,0,2872,263,2873,301,0
20141227.002511,2872,14,283216,0,2872,262,2873,421,0
20141227.002512,2873,20,283236,6,2872,262,2873,411,1
20141227.002513,2872,2,283238,2,2872,271,2873,421,0
20141227.002519,2873,6,283244,0,2872,282,2873,420,1
20141227.00252,2872,2,283246,0,2872,281,2873,430,0
20141227.002522,2872,2,283248,0,2872,280,2873,430,0
20141227.002528,2873,2,283250,0,2872,370,2873,426,1
20141227.002531,2873,8,283258,0,2872,370,2873,422,1
20141227.002532,2873,2,283260,0,2872,370,2873,421,1
20141227.002536,2873,6,283266,4,2872,370,2873,438,1
20141227.002537,2873,10,283276,0,2872,370,2873,433,1
20141227.002538,2872,2,283278,2,2872,369,2873,433,0
20141227.002557,2873,20,283298,20,2872,375,2873,416,1
20141227.0026,2872,2,283300,0,2872,374,2873,419,0
20141227.002601,2872,2,283302,0,2872,373,2873,419,0
20141227.002602,2872,40,283342,0,2872,353,2873,420,0
20141227.002607,2873,6,283348,4,2872,353,2873,436,1
20141227.002609,2873,2,283350,2,2872,353,2873,436,1
20141227.002612,2872,6,283356,0,2872,350,2873,433,0
20141227.002613,2872,2,283358,2,2872,349,2873,453,0
20141227.002618,2872,2,283360,0,2872,368,2873,454,0
20141227.002618,2873,2,283362,2,2872,368,2873,453,1
20141227.00262,2873,40,283402,28,2872,368,2873,433,1
20141227.002625,2872,2,283404,2,2872,367,2873,433,0
20141227.002628,2872,4,283408,0,2872,364,2873,424,0
20141227.00263,2873,6,283414,0,2872,364,2873,418,1
20141227.002633,2872,12,283426,0,2872,359,2873,442,0
20141227.002636,2873,2,283428,2,2872,359,2873,473,1
20141227.00264,2873,10,283438,10,2872,375,2873,471,1
20141227.002642,2873,12,283450,0,2872,375,2873,466,1
20141227.002646,2872,2,283452,2,2872,373,2873,457,0
20141227.002647,2873,10,283462,-10,2872,373,2873,452,1
20141227.002652,2873,4,283466,0,2872,373,2873,462,1
20141227.002653,2873,10,283476,-6,2872,373,2873,457,1
20141227.002656,2872,2,283478,2,2872,372,2873,457,0
20141227.002657,2873,2,283480,0,2872,372,2873,456,1
20141227.002709,2873,10,283490,10,2872,372,2873,470,1
20141227.002711,2873,10,283500,0,2872,373,2873,454,1
20141227.002713,2873,2,283502,2,2872,373,2873,448,1
20141227.002717,2873,12,283514,-6,2872,371,2873,483,1
20141227.00272,2873,2,283516,-2,2872,372,2873,472,1
20141227.002723,2872,16,283532,4,2872,382,2873,467,0
20141227.002728,2873,6,283538,0,2872,383,2873,484,1
20141227.002731,2873,2,283540,0,2872,388,2873,483,1
20141227.002737,2873,10,283550,-10,2872,400,2873,505,1
20141227.002738,2873,2,283552,0,2872,400,2873,504,1
20141227.002742,2873,2,283554,-2,2872,401,2873,503,1
20141227.002751,2872,2,283556,2,2872,400,2873,508,0
20141227.002757,2873,2,283558,-2,2872,498,2873,521,1
20141227.002802,2872,2,283560,2,2872,498,2873,524,0
20141227.002803,2872,4,283564,4,2872,496,2873,524,0
20141227.002805,2873,6,283570,0,2872,496,2873,521,1
20141227.002809,2872,2,283572,2,2872,495,2873,513,0
20141227.002814,2873,2,283574,0,2872,495,2873,512,1
20141227.002815,2872,10,283584,10,2872,490,2873,512,0
20141227.002824,2873,2,283586,0,2872,488,2873,495,1
20141227.002826,2873,4,283590,0,2872,488,2873,558,1
20141227.002827,2873,10,283600,-10,2872,488,2873,553,1
20141227.002834,2872,48,283648,0,2872,464,2873,581,0
20141227.002842,2872,14,283662,0,2872,464,2873,572,0
20141227.002843,2872,2,283664,2,2872,463,2873,572,0
20141227.002844,2872,100,283764,100,2872,413,2873,572,0
20141227.002846,2872,6,283770,4,2872,410,2873,573,0
20141227.00285,2872,4,283774,0,2872,401,2873,568,0
20141227.002857,2872,2,283776,0,2872,398,2873,584,0
20141227.002858,2872,2,283778,2,2872,397,2873,584,0
20141227.002858,2872,2,283780,0,2872,396,2873,584,0
20141227.0029,2872,2,283782,2,2872,395,2873,584,0
20141227.002904,2872,2,283784,0,2872,394,2873,580,0
20141227.002904,2872,2,283786,2,2872,393,2873,575,0
20141227.002907,2872,2,283788,0,2872,392,2873,582,0
20141227.002908,2872,2,283790,2,2872,392,2873,582,0
20141227.002909,2872,120,283910,102,2872,332,2873,612,0
20141227.00291,2872,42,283952,-8,2872,311,2873,622,0
20141227.002913,2872,412,284364,-48,2872,105,2873,622,0
20141227.002914,2872,22,284386,0,2872,94,2873,632,0
20141227.002914,2872,176,284562,148,2871,159,2872,107,0
20141227.002915,2871,30,284592,26,2871,144,2872,110,0
20141227.002915,2871,8,284600,0,2871,115,2872,117,0
20141227.002918,2871,4,284604,2,2871,116,2872,161,0
20141227.002925,2871,2,284606,0,2871,130,2872,211,0
20141227.002926,2871,2,284608,2,2871,130,2872,212,0
20141227.00293,2872,2,284610,2,2871,130,2872,247,1
20141227.002931,2871,38,284648,-20,2871,112,2872,249,0
20141227.002934,2871,2,284650,0,2871,112,2872,305,0
20141227.002936,2871,2,284652,-2,2871,101,2872,305,0
20141227.002936,2871,2,284654,-2,2871,100,2872,305,0
20141227.002941,2871,2,284656,-2,2871,112,2872,306,0
20141227.002946,2871,2,284658,-2,2871,111,2872,342,0
20141227.002957,2871,2,284660,-2,2871,111,2872,394,0
20141227.003009,2871,2,284662,0,2871,104,2872,438,0
20141227.003012,2871,2,284664,-2,2871,115,2872,445,0
20141227.003013,2871,4,284668,-4,2871,113,2872,445,0
20141227.003017,2871,2,284670,0,2871,115,2872,439,0
20141227.003029,2872,2,284672,2,2871,116,2872,446,1
20141227.003032,2872,186,284858,-160,2871,116,2872,44,1
20141227.003033,2872,2,284860,-2,2871,116,2872,43,1
20141227.003035,2872,6,284866,-6,2871,124,2872,38,1
20141227.003037,2872,76,284942,-4,2871,119,2873,204,1
20141227.003038,2872,2,284944,0,2871,119,2873,204,1
20141227.00304,2872,6,284950,0,2872,127,2873,423,1
20141227.003049,2873,2,284952,-2,2872,133,2873,420,1
20141227.003049,2872,12,284964,10,2872,128,2873,419,0
20141227.003056,2873,2,284966,-2,2872,129,2873,416,1
20141227.003057,2872,6,284972,6,2872,136,2873,417,0
20141227.003059,2873,2,284974,-2,2872,136,2873,416,1
20141227.003119,2873,8,284982,0,2872,181,2873,393,1
20141227.003124,2873,100,285082,0,2872,181,2873,341,1
20141227.003134,2873,20,285102,0,2872,203,2873,328,1
20141227.003137,2872,2,285104,0,2872,202,2873,331,0
20141227.003137,2873,2,285106,0,2872,202,2873,330,1
20141227.003148,2873,40,285146,18,2872,205,2873,303,1
20141227.003153,2873,2,285148,0,2872,316,2873,308,1
20141227.003154,2873,6,285154,0,2872,316,2873,305,1
20141227.003154,2873,4,285158,2,2872,315,2873,304,1
20141227.003155,2873,2,285160,0,2872,315,2873,303,1
20141227.003202,2873,2,285162,-2,2872,314,2873,301,1
20141227.003203,2873,4,285166,-2,2872,314,2873,299,1
20141227.003204,2873,8,285174,2,2872,314,2873,295,1
20141227.003205,2873,2,285176,0,2872,314,2873,294,1
20141227.003207,2873,4,285180,-2,2872,315,2873,292,1
20141227.003207,2873,10,285190,-8,2872,315,2873,287,1
20141227.003209,2873,10,285200,0,2872,315,2873,282,1
20141227.00321,2873,2,285202,0,2872,314,2873,281,1
20141227.00321,2873,2,285204,0,2872,314,2873,280,1
20141227.00321,2873,4,285208,0,2872,314,2873,278,1
20141227.003211,2873,2,285210,0,2872,315,2873,277,1
20141227.003212,2873,4,285214,0,2872,315,2873,275,1
20141227.003212,2873,6,285220,-4,2872,315,2873,272,1
20141227.003212,2873,2,285222,0,2872,315,2873,271,1
20141227.003213,2873,2,285224,0,2872,315,2873,270,1
20141227.003214,2873,4,285228,-4,2872,315,2873,268,1
20141227.003218,2872,2,285230,2,2872,316,2873,268,0
20141227.003218,2873,2,285232,0,2872,316,2873,267,1
20141227.003219,2873,2,285234,0,2872,316,2873,265,1
20141227.003219,2873,4,285238,0,2872,316,2873,263,1
20141227.003221,2873,6,285244,0,2872,316,2873,250,1
20141227.003221,2873,2,285246,0,2872,316,2873,234,1
20141227.003222,2873,6,285252,2,2872,316,2873,230,1
20141227.003223,2873,4,285256,-2,2872,315,2873,223,1
20141227.003225,2873,20,285276,0,2872,315,2873,198,1
20141227.003225,2873,262,285538,24,2872,315,2874,362,1
20141227.003226,2874,2,285540,-2,2872,315,2874,525,1
20141227.003226,2874,4,285544,2,2873,49,2874,526,1
20141227.003227,2874,24,285568,-20,2873,57,2874,514,1
20141227.003227,2873,48,285616,-48,2873,36,2874,524,0
20141227.00323,2873,2,285618,-2,2873,55,2874,515,0
20141227.003232,2874,20,285638,4,2873,93,2874,505,1
20141227.003233,2874,4,285642,0,2873,95,2874,504,1
20141227.003239,2873,2,285644,0,2873,104,2874,505,0
20141227.003244,2873,40,285684,24,2873,106,2874,515,0
20141227.003247,2874,2,285686,0,2873,194,2874,520,1
20141227.003257,2874,2,285688,0,2873,398,2874,543,1
20141227.003257,2874,2,285690,0,2873,398,2874,542,1
20141227.003258,2873,2,285692,0,2873,397,2874,542,0
20141227.003259,2874,4,285696,-4,2873,397,2874,539,1
20141227.003301,2874,2,285698,0,2873,439,2874,537,1
20141227.003304,2874,2,285700,0,2873,440,2874,537,1
20141227.003306,2874,60,285760,0,2873,440,2874,508,1
20141227.003306,2874,4,285764,-4,2873,440,2874,516,1
20141227.003308,2873,2,285766,2,2873,439,2874,515,0
20141227.003309,2874,2,285768,0,2873,439,2874,514,1
20141227.003311,2874,2,285770,0,2873,439,2874,519,1
20141227.003314,2874,2,285772,0,2873,449,2874,562,1
20141227.003315,2874,2,285774,2,2873,448,2874,561,1
20141227.003317,2874,4,285778,4,2873,448,2874,559,1
20141227.003318,2874,2,285780,0,2873,469,2874,558,1
20141227.003322,2874,4,285784,4,2873,525,2874,560,1
20141227.003326,2874,10,285794,10,2873,525,2874,555,1
20141227.003327,2874,2,285796,0,2873,525,2874,559,1
20141227.003328,2873,2,285798,2,2873,524,2874,559,0
20141227.003329,2874,1000,286798,600,2873,546,2875,516,1
20141227.003331,2874,2,286800,0,2873,587,2875,660,1
20141227.003332,2874,2,286802,0,2873,586,2874,145,1
20141227.003332,2874,2,286804,-2,2873,593,2874,142,1
20141227.003333,2874,2,286806,0,2873,586,2874,152,1
20141227.003334,2874,4,286810,-2,2873,587,2874,150,1
20141227.003335,2874,300,287110,2,2874,850,2875,660,1
20141227.003335,2875,6,287116,0,2874,850,2875,658,1
20141227.003336,2875,60,287176,0,2874,822,2875,631,1
20141227.003336,2875,98,287274,-60,2874,820,2875,585,1
20141227.003337,2875,40,287314,-40,2874,850,2875,565,1
20141227.003338,2875,2,287316,0,2874,850,2875,575,1
20141227.003339,2875,42,287358,40,2874,835,2875,573,1
20141227.003339,2875,4,287362,0,2874,835,2875,570,1
20141227.00334,2875,14,287376,0,2874,835,2875,558,1
20141227.003341,2875,10,287386,0,2874,835,2875,553,1
20141227.003341,2874,2,287388,2,2874,834,2875,553,0
20141227.003342,2874,6,287394,-2,2874,832,2875,552,0
20141227.003345,2875,2,287396,0,2874,912,2875,560,1
20141227.003345,2874,2,287398,2,2874,912,2875,560,0
20141227.003346,2875,2,287400,0,2874,913,2875,559,1
20141227.003347,2874,2,287402,0,2874,913,2875,559,0
20141227.003347,2874,4,287406,0,2874,915,2875,558,0
20141227.003348,2875,6,287412,0,2874,916,2875,570,1
20141227.003349,2874,12,287424,0,2874,910,2875,568,0
20141227.003351,2875,2,287426,0,2874,909,2875,579,1
20141227.003352,2875,6,287432,0,2874,916,2875,578,1
20141227.003353,2874,2,287434,0,2874,915,2875,579,0
20141227.003354,2875,2,287436,0,2874,915,2875,578,1
20141227.003354,2875,2,287438,0,2874,915,2875,579,1
20141227.003356,2875,2,287440,-2,2874,915,2875,579,1
20141227.003356,2875,2,287442,0,2874,916,2875,578,1
20141227.003356,2875,84,287526,-2,2874,916,2875,537,1
20141227.003358,2875,8,287534,0,2874,916,2875,539,1
20141227.003358,2875,10,287544,0,2874,916,2875,534,1
20141227.003359,2875,2,287546,0,2874,917,2875,533,1
20141227.0034,2875,62,287608,-2,2874,917,2875,509,1
20141227.003401,2875,2,287610,0,2874,917,2875,509,1
20141227.003402,2875,2,287612,-2,2874,912,2875,508,1
20141227.003403,2875,2,287614,0,2874,912,2875,506,1
20141227.003404,2874,4,287618,0,2874,911,2875,505,0
20141227.003408,2874,80,287698,0,2874,872,2875,508,0
20141227.003409,2875,60,287758,0,2874,873,2875,478,1
20141227.003409,2875,2,287760,0,2874,873,2875,482,1
20141227.00341,2875,4,287764,0,2874,873,2875,480,1
20141227.00341,2874,2,287766,2,2874,872,2875,480,0
20141227.003412,2874,2,287768,2,2874,870,2875,480,0
20141227.003413,2875,72,287840,22,2874,870,2875,449,1
20141227.003414,2874,2,287842,0,2874,850,2875,448,0
20141227.003417,2875,10,287852,2,2874,850,2875,445,1
20141227.003418,2875,160,288012,10,2874,851,2875,365,1
20141227.00342,2875,802,288814,156,2875,100,2876,749,1
20141227.003421,2875,4,288818,0,2875,98,2876,749,1
20141227.003421,2875,46,288864,0,2875,75,2876,749,1
20141227.003423,2875,4,288868,2,2875,94,2876,747,1
20141227.003424,2875,4,288872,4,2875,92,2876,747,1
20141227.003424,2875,6,288878,0,2875,90,2876,746,1
20141227.003425,2875,4,288882,0,2875,89,2876,745,1
20141227.003427,2876,20,288902,-18,2875,91,2876,737,1
20141227.003428,2876,2,288904,-2,2875,91,2876,740,1
20141227.003428,2876,12,288916,-12,2875,96,2876,734,1
20141227.003429,2876,2,288918,-2,2875,105,2876,733,1
20141227.003429,2876,2,288920,0,2875,106,2876,732,1
20141227.003431,2875,6,288926,6,2875,106,2876,734,0
20141227.003432,2876,2,288928,0,2875,106,2876,734,1
20141227.003434,2875,80,289008,0,2875,66,2876,734,0
20141227.003434,2875,2,289010,0,2875,65,2876,734,0
20141227.003435,2875,12,289022,2,2875,60,2876,734,0
20141227.003435,2875,44,289066,-4,2875,38,2876,734,0
20141227.003437,2876,4,289070,0,2875,38,2876,738,1
20141227.003439,2875,2,289072,-2,2875,85,2876,739,0
20141227.00344,2875,2,289074,0,2875,87,2876,739,0
20141227.003441,2875,4,289078,0,2875,107,2876,739,0
20141227.003441,2875,6,289084,4,2875,104,2876,737,0
20141227.003443,2875,2,289086,0,2875,127,2876,739,0
20141227.003445,2875,22,289108,18,2875,117,2876,741,0
20141227.003446,2875,6,289114,-4,2875,114,2876,741,0
20141227.003447,2875,2,289116,0,2875,113,2876,741,0
20141227.003449,2875,2,289118,0,2875,116,2876,740,0
20141227.00345,2875,2,289120,2,2875,118,2876,740,0
20141227.003452,2875,2,289122,2,2875,117,2876,743,0
20141227.003454,2875,10,289132,2,2875,113,2876,744,0
20141227.003457,2875,2,289134,0,2875,114,2876,746,0
20141227.003457,2875,2,289136,2,2875,114,2876,756,0
20141227.003458,2875,22,289158,0,2875,103,2876,772,0
20141227.003458,2875,2,289160,2,2875,102,2876,772,0
20141227.0035,2875,2,289162,0,2875,105,2876,772,0
20141227.0035,2875,2,289164,2,2875,104,2876,772,0
20141227.003501,2875,40,289204,40,2875,84,2876,772,0
20141227.003502,2875,4,289208,0,2875,83,2876,771,0
20141227.003503,2875,10,289218,10,2875,78,2876,772,0
20141227.003503,2875,30,289248,28,2875,63,2876,772,0
20141227.003504,2875,22,289270,-20,2875,52,2876,772,0
20141227.003504,2875,6,289276,-2,2875,49,2876,772,0
20141227.003505,2875,4,289280,-2,2875,219,2876,772,0
20141227.003505,2875,10,289290,-10,2875,214,2876,761,0
20141227.003506,2875,4,289294,2,2875,212,2876,761,0
20141227.003506,2876,2,289296,0,2875,222,2876,760,1
20141227.003507,2875,2,289298,2,2875,222,2876,760,0
20141227.003509,2875,2,289300,2,2875,221,2876,750,0
20141227.003511,2875,8,289308,0,2875,217,2876,750,0
20141227.003511,2875,4,289312,4,2875,237,2876,750,0
20141227.003512,2875,2,289314,0,2875,237,2876,752,0
20141227.003514,2875,2,289316,0,2875,138,2876,738,0
20141227.003515,2875,4,289320,0,2875,136,2876,738,0
20141227.003516,2875,2,289322,2,2875,136,2876,738,0
20141227.003517,2875,102,289424,100,2875,85,2876,752,0
20141227.003517,2875,78,289502,78,2875,46,2876,752,0
20141227.003518,2875,2,289504,0,2875,45,2876,752,0
20141227.003518,2875,2,289506,2,2875,54,2876,752,0
20141227.003519,2875,4,289510,2,2875,57,2876,751,0
20141227.003519,2875,2,289512,2,2875,56,2876,751,0
20141227.00352,2875,40,289552,40,2875,46,2876,752,0
20141227.003525,2875,8,289560,0,2875,71,2876,765,0
20141227.003525,2875,6,289566,4,2875,68,2876,765,0
20141227.003526,2875,2,289568,2,2875,68,2876,765,0
20141227.003527,2875,2,289570,0,2875,67,2876,765,0
20141227.003528,2875,2,289572,2,2875,96,2876,766,0
20141227.003528,2875,4,289576,2,2875,94,2876,767,0
20141227.003529,2875,12,289588,6,2875,89,2876,768,0
20141227.003532,2875,2,289590,0,2875,93,2876,768,0
20141227.003532,2875,10,289600,-2,2875,88,2876,768,0
20141227.003534,2875,2,289602,2,2875,88,2876,768,0
20141227.003534,2875,20,289622,20,2875,78,2876,768,0
20141227.003535,2875,10,289632,10,2875,83,2876,768,0
20141227.003536,2875,20,289652,0,2875,73,2876,767,0
20141227.003536,2875,2,289654,2,2875,72,2876,767,0
20141227.003537,2875,20,289674,20,2875,61,2876,768,0
20141227.003538,2875,38,289712,2,2875,42,2876,768,0
20141227.003539,2875,18,289730,6,2875,33,2876,768,0
20141227.00354,2875,18,289748,18,2875,24,2876,769,0
20141227.003541,2875,2,289750,2,2875,23,2876,769,0
20141227.003541,2875,2,289752,0,2875,22,2876,769,0
20141227.003542,2875,6,289758,2,2875,19,2876,769,0
20141227.003545,2875,22,289780,0,2875,13,2876,769,0
20141227.003545,2875,2,289782,2,2875,12,2876,769,0
20141227.003546,2875,2,289784,2,2875,11,2876,771,0
20141227.003547,2875,14,289798,0,2875,4,2876,770,0
20141227.003547,2875,2,289800,0,2875,8,2876,770,0
20141227.003548,2875,6,289806,6,2875,5,2876,770,0
20141227.003548,2875,2,289808,0,2875,4,2876,770,0
20141227.003549,2875,8,289816,2,2874,946,2875,29,0
20141227.00355,2876,320,290136,-316,2874,946,2876,639,1
20141227.00355,2875,44,290180,-44,2874,946,2875,4,0
20141227.003551,2876,10,290190,0,2874,946,2875,5,1
20141227.003551,2875,10,290200,-10,2874,946,2876,638,0
20141227.003552,2875,2,290202,-2,2874,946,2876,638,0
20141227.003552,2875,2,290204,2,2874,946,2876,637,0
20141227.003553,2875,2,290206,2,2874,946,2876,637,0
20141227.003556,2875,10,290216,2,2874,966,2875,52,0
20141227.003558,2875,2,290218,0,2874,966,2875,51,0
20141227.003558,2875,126,290344,124,2874,966,2875,1,0
20141227.003558,2875,4,290348,0,2874,966,2876,639,0
20141227.003559,2875,8,290356,6,2874,965,2876,638,0
20141227.0036,2875,2,290358,0,2874,967,2876,638,0
20141227.003601,2875,16,290374,16,2875,8,2876,638,0
20141227.003601,2875,18,290392,14,2874,967,2876,638,0
20141227.003602,2875,50,290442,-50,2875,30,2876,638,0
20141227.003603,2875,40,290482,20,2875,10,2876,638,0
20141227.003603,2875,2,290484,2,2875,9,2876,638,0
20141227.003604,2875,4,290488,2,2875,8,2876,627,0
20141227.003605,2875,16,290504,12,2874,933,2876,627,0
20141227.003606,2875,8,290512,0,2875,7,2876,627,0
20141227.003607,2875,14,290526,0,2874,933,2875,3,0
20141227.003607,2875,6,290532,0,2875,17,2876,628,0
20141227.003608,2875,6,290538,6,2875,14,2876,628,0
20141227.003609,2875,4,290542,0,2875,42,2876,628,0
20141227.003609,2875,2,290544,0,2875,41,2876,628,0
20141227.00361,2875,6,290550,6,2875,38,2876,628,0
20141227.003612,2875,2,290552,0,2875,37,2876,748,0
20141227.003614,2875,20,290572,0,2875,33,2876,628,0
20141227.003615,2875,10,290582,0,2875,28,2876,628,0
20141227.003616,2875,2,290584,2,2875,27,2876,628,0
20141227.003616,2875,54,290638,54,2874,934,2875,23,0
20141227.003619,2876,80,290718,50,2875,20,2876,611,1
20141227.00362,2876,8,290726,-4,2875,20,2876,611,1
20141227.003621,2875,26,290752,20,2875,8,2876,617,0
20141227.003622,2876,6,290758,0,2875,8,2876,614,1
20141227.003622,2875,22,290780,-4,2874,935,2875,2,0
20141227.003622,2875,4,290784,0,2874,935,2876,624,0
20141227.003624,2875,2,290786,0,2874,935,2876,625,0
20141227.00363,2875,52,290838,52,2874,935,2876,655,0
20141227.003637,2875,4,290842,2,2874,936,2875,2,0
20141227.003637,2875,2,290844,2,2874,936,2875,1,0
20141227.00364,2874,8,290852,8,2874,932,2875,1,0
20141227.003646,2874,2,290854,2,2874,928,2875,21,0
20141227.003647,2874,2,290856,0,2874,927,2875,84,0
20141227.003649,2875,12,290868,2,2874,927,2875,84,1
20141227.00365,2875,2,290870,0,2874,927,2875,83,1
20141227.003655,2874,2,290872,2,2874,927,2875,172,0
20141227.003657,2875,2,290874,0,2874,927,2875,180,1
20141227.003701,2874,4,290878,0,2874,923,2875,177,0
20141227.003703,2875,2,290880,2,2874,923,2875,180,1
20141227.003704,2874,2,290882,2,2874,922,2875,230,0
20141227.003705,2874,10,290892,10,2874,922,2875,230,0
20141227.003706,2875,2,290894,2,2874,923,2875,229,1
20141227.003709,2874,14,290908,0,2874,922,2875,234,0
20141227.003711,2874,2,290910,2,2874,921,2875,236,0
20141227.003712,2875,40,290950,40,2874,921,2875,517,1
20141227.003713,2874,2,290952,2,2874,920,2875,517,0
20141227.003717,2874,4,290956,4,2874,918,2875,542,0
20141227.003717,2874,60,291016,0,2874,888,2875,543,0
20141227.003718,2875,12,291028,12,2874,888,2875,538,1
20141227.003719,2875,8,291036,8,2874,888,2875,544,1
20141227.003721,2874,2,291038,2,2874,887,2875,545,0
20141227.003727,2875,2,291040,0,2874,887,2875,545,1
20141227.003731,2875,2,291042,0,2874,887,2875,566,1
20141227.003737,2875,2,291044,0,2874,887,2875,564,1
20141227.003739,2874,2,291046,2,2874,886,2875,564,0
20141227.003741,2875,110,291156,-12,2874,886,2875,510,1
20141227.003742,2875,1000,292156,874,2874,886,2875,10,1
20141227.003742,2875,20,292176,-8,2874,886,2876,689,1
20141227.003743,2875,220,292396,0,2874,886,2875,290,1
20141227.003746,2875,582,292978,2,2875,209,2876,634,1
20141227.003746,2875,2,292980,2,2875,208,2876,619,1
20141227.003747,2875,2,292982,2,2875,242,2876,624,1
20141227.003748,2875,2,292984,2,2875,241,2876,624,1
20141227.003749,2875,4,292988,4,2875,249,2876,624,1
20141227.00375,2875,18,293006,16,2875,240,2876,624,1
20141227.003751,2876,4,293010,0,2875,242,2876,622,1
20141227.003752,2875,4,293014,2,2875,241,2876,623,0
20141227.003755,2876,2,293016,0,2875,315,2876,622,1
20141227.003755,2876,2,293018,0,2875,342,2876,622,1
20141227.0038,2875,2,293020,0,2875,324,2876,621,0
20141227.003802,2876,40,293060,0,2875,325,2876,603,1
20141227.003805,2875,10,293070,10,2875,321,2876,604,0
20141227.003811,2876,62,293132,16,2875,335,2876,598,1
20141227.003815,2875,2,293134,0,2875,343,2876,598,0
20141227.003815,2875,4,293138,4,2875,343,2876,598,0
20141227.003818,2875,2,293140,2,2875,342,2876,597,0
20141227.003819,2876,4,293144,4,2875,342,2876,595,1
20141227.00382,2875,2,293146,2,2875,341,2876,606,0
20141227.00382,2875,2,293148,2,2875,340,2876,606,0
20141227.003822,2875,2,293150,2,2875,338,2876,607,0
20141227.003826,2876,20,293170,14,2875,334,2876,598,1
20141227.003827,2875,160,293330,0,2875,254,2876,601,0
20141227.003827,2875,82,293412,2,2875,209,2876,606,0
20141227.003829,2875,4,293416,0,2875,246,2876,605,0
20141227.003829,2875,10,293426,10,2875,241,2876,607,0
20141227.00383,2875,2,293428,2,2875,240,2876,608,0
20141227.003833,2876,20,293448,4,2875,244,2876,598,1
20141227.003834,2876,20,293468,14,2875,244,2876,591,1
20141227.003835,2875,2,293470,0,2875,243,2876,591,0
20141227.003835,2875,2,293472,2,2875,242,2876,591,0
20141227.003836,2876,4,293476,-2,2875,242,2876,589,1
20141227.003839,2876,2,293478,2,2875,245,2876,570,1
20141227.00384,2876,148,293626,-136,2875,245,2876,546,1
20141227.003841,2876,148,293774,48,2875,245,2876,472,1
20141227.003842,2876,2,293776,0,2875,245,2876,460,1
20141227.003843,2876,2,293778,0,2875,247,2876,459,1
20141227.003844,2876,4,293782,-2,2875,247,2876,457,1
20141227.003846,2876,60,293842,34,2875,247,2876,428,1
20141227.003852,2876,1000,294842,-846,2875,248,2876,10,1
20141227.003852,2876,22,294864,20,2876,89,2877,1838,1
20141227.003853,2876,6,294870,0,2876,86,2877,1838,1
20141227.003853,2876,108,294978,100,2876,34,2877,1838,1
20141227.003855,2876,2,294980,2,2876,73,2877,1838,1
20141227.003857,2877,4,294984,-2,2876,91,2877,1839,1
20141227.003857,2877,14,294998,-8,2876,90,2877,1833,1
20141227.003858,2877,140,295138,-140,2876,91,2877,1763,1
20141227.003858,2877,96,295234,-72,2876,133,2877,1716,1
20141227.003859,2877,4,295238,0,2876,132,2877,1716,1
20141227.0039,2877,2,295240,-2,2876,635,2877,1715,1
20141227.003901,2877,10,295250,-6,2876,637,2877,1711,1
20141227.003902,2876,66,295316,0,2876,607,2877,1700,0
20141227.003903,2877,2,295318,0,2876,607,2877,1709,1
20141227.003903,2876,2,295320,0,2876,606,2877,1714,0
20141227.003904,2876,2,295322,2,2876,604,2877,1714,0
20141227.003904,2877,6,295328,-6,2876,604,2877,1711,1
20141227.003906,2876,4,295332,4,2876,601,2877,1702,0
20141227.003906,2877,8,295340,0,2876,601,2877,1698,1
20141227.003907,2877,4,295344,4,2876,601,2877,1697,1
20141227.003907,2876,2,295346,2,2876,600,2877,1697,0
20141227.003908,2877,4,295350,2,2876,599,2877,1696,1
20141227.003909,2876,8,295358,4,2876,598,2877,1695,0
20141227.003911,2876,2,295360,2,2876,657,2877,1695,0
20141227.003912,2876,2,295362,2,2876,657,2877,1695,0
20141227.003913,2876,2,295364,2,2876,627,2877,1699,0
20141227.003913,2876,2,295366,0,2876,626,2877,1699,0
20141227.003917,2876,2,295368,0,2876,629,2877,1706,0
20141227.003918,2876,4,295372,2,2876,630,2877,1705,0
20141227.003918,2876,2,295374,2,2876,629,2877,1705,0
20141227.003919,2877,52,295426,52,2876,629,2877,1682,1
20141227.00392,2876,2,295428,2,2876,628,2877,1682,0
20141227.003921,2876,2,295430,2,2876,629,2877,1682,0
20141227.003922,2877,2,295432,0,2876,631,2877,1681,1
20141227.003922,2877,2,295434,2,2876,631,2877,1669,1
20141227.003922,2876,2,295436,2,2876,642,2877,1674,0
20141227.003925,2876,4,295440,2,2876,664,2877,1674,0
20141227.003926,2876,2,295442,2,2876,665,2877,1674,0
20141227.003927,2876,2,295444,2,2876,664,2877,1674,0
20141227.003931,2877,2,295446,2,2876,673,2877,1696,1
20141227.003932,2876,24,295470,4,2876,661,2877,1696,0
20141227.003937,2876,2,295472,0,2876,660,2877,1700,0
20141227.003938,2876,4,295476,0,2876,658,2877,1705,0
20141227.003938,2876,2,295478,2,2876,657,2877,1705,0
20141227.003939,2877,30,295508,30,2876,657,2877,1690,1
20141227.003939,2877,1000,296508,948,2876,656,2877,1189,1
20141227.003941,2877,22,296530,-6,2876,681,2877,630,1
20141227.003942,2877,132,296662,-102,2876,681,2877,563,1
20141227.003942,2877,36,296698,-20,2876,681,2877,545,1
20141227.003943,2877,14,296712,-12,2876,681,2877,540,1
20141227.003943,2877,2,296714,0,2876,682,2877,540,1
20141227.003943,2877,20,296734,0,2876,682,2877,530,1
20141227.003945,2876,40,296774,30,2876,662,2877,529,0
20141227.003948,2877,2,296776,0,2876,678,2877,527,1
20141227.003949,2877,12,296788,-4,2876,678,2877,525,1
20141227.00395,2877,2,296790,0,2876,679,2877,524,1
20141227.003952,2877,1000,297790,-852,2876,184,2878,1199,1
20141227.003952,2876,18,297808,-2,2876,187,2878,1227,0
20141227.003953,2877,14,297822,4,2876,187,2878,1214,1
20141227.003954,2877,12,297834,0,2877,4,2878,1227,1
20141227.003956,2877,2,297836,2,2877,3,2878,1241,1
20141227.003957,2878,4,297840,2,2877,4,2878,1239,1
20141227.003957,2877,12,297852,12,2876,189,2877,60,0
20141227.003958,2877,46,297898,38,2876,203,2877,73,0
20141227.003958,2877,2,297900,2,2876,203,2877,74,0
20141227.003959,2877,2,297902,2,2876,211,2877,73,0
20141227.003959,2877,2,297904,2,2876,212,2877,75,0
20141227.004,2877,52,297956,42,2876,212,2877,106,0
20141227.004,2877,268,298224,150,2876,215,2878,1217,0
20141227.004001,2877,4,298228,4,2877,615,2878,1181,0
20141227.004003,2877,2,298230,2,2877,615,2878,1183,0
20141227.004004,2877,2,298232,2,2877,614,2878,1183,0
20141227.004006,2877,62,298294,0,2877,614,2878,1154,0
20141227.004006,2877,4,298298,4,2877,612,2878,1154,0
20141227.004008,2878,14,298312,4,2877,1258,2878,1159,1
20141227.004009,2877,14,298326,-14,2877,1257,2878,1159,0
20141227.004009,2877,2,298328,0,2877,1258,2878,1160,0
20141227.004011,2877,22,298350,0,2877,1247,2878,1171,0
20141227.004012,2878,14,298364,14,2877,1247,2878,1155,1
20141227.004013,2877,10,298374,-10,2877,1242,2878,1155,0
20141227.004014,2878,2,298376,2,2877,1247,2878,1162,1
20141227.004016,2878,2,298378,0,2877,1260,2878,1162,1
20141227.004017,2878,200,298578,2,2877,1258,2878,1064,1
20141227.004018,2878,2,298580,2,2877,1257,2878,1063,1
20141227.004018,2878,32,298612,0,2877,607,2878,1047,1
20141227.004019,2877,2,298614,0,2877,610,2878,1051,0
20141227.00402,2877,2,298616,0,2877,609,2878,1051,0
20141227.004023,2877,2,298618,-2,2877,607,2878,1141,0
20141227.004024,2877,2,298620,0,2877,606,2878,1144,0
20141227.004025,2878,10,298630,10,2877,606,2878,1136,1
20141227.004028,2878,22,298652,20,2877,606,2878,1131,1
20141227.004028,2877,10,298662,-10,2877,601,2878,1131,0
20141227.00403,2878,1300,299962,-460,2877,644,2878,495,1
20141227.004031,2877,30,299992,-30,2877,630,2878,481,0
20141227.004031,2877,6,299998,-2,2877,628,2878,479,0
20141227.004032,2878,14,300012,0,2877,628,2878,474,1
20141227.004033,2878,4,300016,-4,2877,628,2878,477,1
20141227.004033,2878,10,300026,0,2877,628,2878,472,1
20141227.004038,2877,100,300126,-100,2877,552,2878,489,0
20141227.004039,2878,24,300150,0,2877,582,2878,478,1
20141227.00404,2878,2,300152,-2,2877,584,2878,482,1
20141227.00404,2877,4,300156,0,2877,580,2878,482,0
20141227.004041,2877,100,300256,-100,2877,530,2878,481,0
20141227.004044,2878,14,300270,0,2877,534,2878,506,1
20141227.004046,2878,2,300272,0,2877,531,2878,506,1
20141227.004047,2878,28,300300,0,2877,430,2878,501,1
20141227.004048,2877,2,300302,-2,2877,421,2878,501,0
20141227.004049,2877,4,300306,0,2877,419,2878,501,0
20141227.004052,2877,2,300308,0,2877,419,2878,501,0
20141227.004052,2877,2,300310,0,2877,419,2878,501,0
20141227.004054,2878,2,300312,0,2877,420,2878,500,1
20141227.004055,2877,2,300314,0,2877,417,2878,524,0
20141227.004056,2877,100,300414,-100,2877,368,2878,530,0
20141227.004057,2877,22,300436,-20,2877,359,2878,531,0
20141227.004058,2877,2,300438,-2,2877,358,2878,531,0
20141227.004059,2878,102,300540,0,2877,360,2878,466,1
20141227.004101,2878,2,300542,0,2877,360,2878,464,1
20141227.004104,2877,2,300544,0,2877,369,2878,467,0
20141227.004105,2878,6,300550,0,2877,369,2878,463,1
20141227.004107,2878,30,300580,0,2877,369,2878,447,1
20141227.004109,2878,80,300660,48,2877,369,2878,414,1
20141227.004112,2878,856,301516,-410,2878,424,2879,1117,1
20141227.004112,2878,72,301588,-36,2878,396,2879,1109,1
20141227.004113,2878,4,301592,-4,2878,394,2879,1109,1
20141227.004114,2878,2,301594,-2,2878,419,2879,1109,1
20141227.004115,2879,8,301602,4,2878,423,2879,1104,1
20141227.004115,2879,128,301730,-26,2878,421,2879,1043,1
20141227.004116,2879,72,301802,40,2878,420,2879,1010,1
20141227.004117,2878,2,301804,-2,2878,422,2879,1010,0
20141227.004119,2879,12,301816,2,2878,417,2879,1099,1
20141227.00412,2879,10,301826,10,2878,688,2879,1094,1
20141227.004121,2879,4,301830,4,2878,688,2879,1092,1
20141227.004122,2879,2,301832,2,2878,1190,2879,1092,1
20141227.004123,2879,40,301872,40,2878,1190,2879,1073,1
20141227.004123,2879,16,301888,0,2878,1190,2879,1031,1
20141227.004124,2879,38,301926,16,2878,1190,2879,1014,1
20141227.004125,2878,16,301942,-10,2878,1182,2879,1018,0
20141227.004126,2879,60,302002,60,2878,1185,2879,989,1
20141227.004126,2879,2,302004,2,2878,1185,2879,988,1
20141227.004127,2879,4,302008,2,2878,1185,2879,986,1
20141227.004128,2879,2,302010,2,2878,1185,2879,1004,1
20141227.004129,2879,8,302018,8,2878,1190,2879,1002,1
20141227.004129,2879,4,302022,2,2878,1190,2879,1000,1
20141227.00413,2879,2,302024,2,2878,1191,2879,1000,1
20141227.004131,2878,6,302030,0,2878,1191,2879,998,0
20141227.004132,2879,542,302572,0,2878,920,2879,727,1
20141227.004132,2879,248,302820,-58,2878,917,2879,607,1
20141227.004133,2878,2,302822,-2,2878,916,2879,617,0
20141227.004133,2879,254,303076,-44,2878,916,2879,490,1
20141227.004134,2879,62,303138,-8,2878,916,2879,459,1
20141227.004134,2879,46,303184,-8,2878,908,2879,444,1
20141227.004135,2878,82,303266,14,2878,905,2879,413,0
20141227.004136,2879,4,303270,4,2878,905,2879,449,1
20141227.004136,2879,4,303274,0,2878,904,2879,449,1
20141227.004137,2879,4,303278,0,2878,904,2879,447,1
20141227.004137,2879,2,303280,2,2878,904,2879,448,1
20141227.004138,2879,2,303282,2,2878,904,2879,480,1
20141227.004138,2879,12,303294,4,2878,903,2879,486,1
20141227.004139,2879,4,303298,4,2878,913,2879,484,1
20141227.00414,2879,2,303300,2,2878,913,2879,486,1
20141227.00414,2879,984,304284,-640,2879,9,2880,2199,1
20141227.004141,2879,6,304290,-4,2879,6,2880,2203,1
20141227.004141,2879,12,304302,-10,2878,913,2879,4,1
20141227.004142,2878,44,304346,-8,2878,892,2879,50,0
20141227.004142,2879,6,304352,0,2878,892,2879,47,1
20141227.004143,2879,16,304368,10,2878,897,2879,40,1
20141227.004143,2879,4,304372,2,2878,897,2879,41,1
20141227.004144,2879,4,304376,4,2878,897,2879,67,1
20141227.004145,2878,4,304380,0,2878,896,2879,71,0
20141227.004146,2879,70,304450,70,2878,895,2879,113,1
20141227.004147,2878,10,304460,0,2878,891,2879,157,0
20141227.004148,2879,324,304784,-88,2879,344,2880,2204,1
20141227.004149,2879,106,304890,-38,2879,356,2880,2152,1
20141227.004149,2879,22,304912,-2,2879,349,2880,2150,1
20141227.00415,2879,2,304914,-2,2879,349,2880,2150,1
20141227.004151,2880,6,304920,2,2879,360,2880,2150,1
20141227.004151,2880,282,305202,-104,2879,334,2880,2055,1
20141227.004151,2880,142,305344,-66,2879,338,2880,1990,1
20141227.004152,2880,26,305370,4,2879,339,2880,1980,1
20141227.004153,2879,2,305372,-2,2879,346,2880,1980,0
20141227.004153,2879,4,305376,0,2879,345,2880,1980,0
20141227.004154,2880,4,305380,0,2879,347,2880,1978,1
20141227.004154,2879,12,305392,0,2879,342,2880,1978,0
20141227.004155,2879,2,305394,0,2879,341,2880,1979,0
20141227.004157,2879,8,305402,0,2879,340,2880,1987,0
20141227.004158,2879,8,305410,-2,2879,368,2880,1991,0
20141227.004159,2879,2,305412,0,2879,369,2880,2016,0
20141227.0042,2879,14,305426,-12,2879,367,2880,2017,0
20141227.0042,2880,38,305464,-8,2879,367,2880,2008,1
20141227.004201,2879,98,305562,-82,2879,320,2880,1965,0
20141227.004201,2880,20,305582,4,2879,320,2880,1955,1
20141227.004201,2879,12,305594,0,2879,314,2880,1955,0
20141227.004202,2879,26,305620,-22,2879,313,2880,1956,0
20141227.004203,2880,8,305628,8,2879,313,2880,1952,1
20141227.004203,2879,22,305650,-2,2879,322,2880,1952,0
20141227.004204,2880,2,305652,2,2879,321,2880,1952,1
20141227.004205,2879,2,305654,-2,2879,321,2880,1952,0
20141227.004206,2880,12,305666,-2,2879,320,2880,1951,1
20141227.004208,2879,2,305668,0,2879,313,2880,1933,0
20141227.004208,2880,136,305804,132,2879,314,2880,1868,1
20141227.004209,2880,6,305810,6,2879,320,2880,1871,1
20141227.00421,2880,2,305812,2,2879,324,2880,1871,1
20141227.00421,2879,4,305816,-2,2879,326,2880,1870,0
20141227.004211,2879,4,305820,2,2879,325,2880,1869,0
20141227.004212,2879,10,305830,-2,2879,321,2880,1869,0
20141227.004212,2879,2,305832,0,2879,320,2880,1869,0
20141227.004213,2879,4,305836,0,2879,355,2880,1872,0
20141227.004213,2880,26,305862,2,2879,343,2880,1870,1
20141227.004214,2879,8,305870,4,2879,340,2880,1874,0
20141227.004216,2879,2,305872,0,2879,390,2880,1894,0
20141227.004217,2879,10,305882,2,2879,386,2880,1903,0
20141227.004218,2879,14,305896,10,2879,383,2880,1897,0
20141227.004218,2879,2,305898,0,2879,382,2880,1897,0
20141227.004219,2879,2,305900,0,2879,381,2880,1902,0
20141227.00422,2880,6,305906,2,2879,379,2880,1904,1
20141227.00422,2879,8,305914,-8,2879,376,2880,1905,0
20141227.004221,2879,18,305932,-18,2879,419,2880,1905,0
20141227.004222,2879,22,305954,2,2879,409,2880,1915,0
20141227.004223,2879,6,305960,-2,2879,407,2880,1915,0
20141227.004224,2880,2,305962,2,2879,407,2880,1915,1
20141227.004224,2880,46,306008,2,2879,385,2880,1914,1
20141227.004225,2880,2,306010,2,2879,385,2880,1914,1
20141227.004226,2879,8,306018,4,2879,384,2880,1911,0
20141227.004227,2879,6,306024,0,2879,381,2880,1912,0
20141227.004227,2879,112,306136,-108,2879,327,2880,1920,0
20141227.004228,2879,6,306142,-4,2879,282,2880,1920,0
20141227.004229,2879,2,306144,0,2879,281,2880,1920,0
20141227.004229,2879,42,306186,-36,2879,264,2880,1919,0
20141227.00423,2879,212,306398,-44,2879,158,2880,1919,0
20141227.00423,2879,56,306454,52,2879,131,2880,1899,0
20141227.004231,2879,138,306592,66,2879,62,2880,1908,0
20141227.004231,2879,124,306716,102,2878,880,2879,27,0
20141227.004232,2879,8,306724,0,2878,880,2879,74,0
20141227.004233,2879,84,306808,-2,2878,881,2879,50,0
20141227.004233,2879,16,306824,2,2878,881,2879,45,0
20141227.004234,2879,2,306826,0,2878,881,2879,45,0
20141227.004235,2878,2,306828,-2,2878,881,2879,45,0
20141227.004236,2879,104,306932,-28,2879,451,2880,1940,1
20141227.004237,2879,244,307176,-242,2879,330,2880,1983,1
20141227.004238,2879,2,307178,0,2879,334,2880,1974,1
20141227.004239,2879,2,307180,-2,2879,339,2880,1976,1
20141227.00424,2879,4,307184,-2,2879,345,2880,1979,1
20141227.00424,2879,2,307186,-2,2879,344,2880,1979,1
20141227.004241,2879,20,307206,-12,2879,335,2880,1978,1
20141227.004241,2879,4,307210,-4,2879,333,2880,1978,1
20141227.004242,2879,2,307212,0,2879,332,2880,1977,1
20141227.004242,2879,38,307250,-30,2879,316,2880,1959,1
20141227.004243,2879,16,307266,-4,2879,309,2880,1958,1
20141227.004244,2879,4,307270,-2,2879,307,2880,1965,1
20141227.004245,2880,32,307302,0,2879,306,2880,1950,1
20141227.004245,2880,124,307426,-30,2879,291,2880,1903,1
20141227.004246,2879,252,307678,0,2879,289,2880,1780,0
20141227.004247,2879,2,307680,-2,2879,288,2880,1781,0
20141227.004247,2880,2,307682,2,2879,289,2880,1790,1
20141227.004248,2879,2,307684,0,2879,288,2880,1800,0
20141227.004248,2880,16,307700,16,2879,288,2880,1793,1
20141227.00425,2879,14,307714,-14,2879,281,2880,1819,0
20141227.004251,2879,90,307804,-88,2879,236,2880,1820,0
20141227.004251,2880,6,307810,6,2879,236,2880,1817,1
20141227.004252,2879,36,307846,20,2879,229,2880,1807,0
20141227.004253,2879,4,307850,-4,2879,236,2880,1807,0
20141227.004254,2879,2,307852,-2,2879,235,2880,1810,0
20141227.004254,2879,14,307866,-14,2879,228,2880,1810,0
20141227.004255,2879,12,307878,-10,2879,224,2880,1810,0
20141227.004258,2879,24,307902,0,2879,223,2880,1810,0
20141227.004259,2879,12,307914,-12,2879,217,2880,1810,0
20141227.004259,2880,8,307922,4,2879,216,2880,1810,1
20141227.0043,2879,30,307952,0,2879,203,2880,1810,0
20141227.004301,2879,84,308036,0,2879,161,2880,1810,0
20141227.004301,2879,10,308046,0,2879,156,2880,1810,0
20141227.004302,2879,16,308062,0,2879,148,2880,1810,0
20141227.004302,2879,20,308082,0,2879,138,2880,1810,0
20141227.004303,2879,66,308148,-10,2879,105,2880,1810,0
20141227.004304,2879,16,308164,0,2879,98,2880,1809,0
20141227.004305,2879,196,308360,-114,2878,927,2879,14,0
20141227.004306,2878,2,308362,0,2878,926,2879,17,0
20141227.004306,2878,18,308380,-6,2878,921,2879,13,0
20141227.004307,2878,8,308388,-8,2878,917,2879,13,0
20141227.004308,2879,4,308392,2,2878,917,2879,41,1
20141227.004309,2878,2,308394,-2,2878,916,2879,49,0
20141227.00431,2879,40,308434,18,2878,916,2879,79,1
20141227.004312,2879,2,308436,2,2878,917,2879,111,1
20141227.004315,2879,4,308440,4,2878,925,2879,138,1
20141227.004318,2878,2,308442,-2,2878,923,2879,165,0
20141227.004319,2878,2,308444,-2,2878,917,2879,191,0
20141227.00432,2878,2,308446,0,2878,916,2879,194,0
20141227.004321,2878,22,308468,-2,2878,906,2879,210,0
20141227.004321,2879,466,308934,-372,2879,268,2880,1754,1
20141227.004322,2879,60,308994,-58,2879,239,2880,1725,1
20141227.004322,2879,102,309096,-2,2879,193,2880,1726,1
20141227.004324,2879,2,309098,0,2879,195,2880,1717,1
20141227.004325,2879,6,309104,-6,2879,192,2880,1720,1
20141227.004325,2879,24,309128,-4,2879,180,2880,1720,1
20141227.004326,2879,10,309138,-10,2879,178,2880,1720,1
20141227.004328,2879,20,309158,-20,2879,168,2880,1713,1
20141227.004328,2879,10,309168,0,2879,163,2880,1713,1
20141227.00433,2879,40,309208,0,2879,144,2880,1713,1
20141227.00433,2879,292,309500,-276,2878,957,2879,120,1
20141227.004331,2879,6,309506,0,2878,977,2879,123,1
20141227.004332,2879,64,309570,-64,2878,987,2879,97,1
20141227.004334,2879,228,309798,-176,2879,200,2880,1713,1
20141227.004334,2879,6,309804,4,2879,197,2880,1718,1
20141227.004335,2879,14,309818,12,2879,190,2880,1718,1
20141227.004335,2879,2,309820,0,2879,190,2880,1618,1
20141227.004336,2879,2,309822,0,2879,190,2880,1618,1
20141227.004337,2879,10,309832,10,2879,204,2880,1618,1
20141227.00434,2879,2,309834,2,2879,205,2880,1628,1
20141227.00434,2879,22,309856,0,2879,194,2880,1627,1
20141227.004341,2879,4,309860,0,2879,192,2880,1629,1
20141227.004342,2880,2,309862,2,2879,193,2880,1328,1
20141227.004343,2879,2,309864,2,2879,239,2880,1332,0
20141227.004343,2879,8,309872,8,2879,235,2880,1337,0
20141227.004344,2879,10,309882,10,2879,230,2880,1337,0
20141227.004345,2879,16,309898,10,2879,222,2880,1339,0
20141227.004345,2879,6,309904,6,2879,229,2880,1339,0
20141227.004346,2880,8,309912,0,2879,227,2880,1338,1
20141227.004346,2879,2,309914,0,2879,226,2880,1338,0
20141227.004347,2879,2,309916,0,2879,225,2880,1338,0
20141227.004347,2879,200,310116,0,2879,126,2880,1338,0
20141227.004348,2880,2,310118,2,2879,126,2880,1337,1
20141227.004348,2879,272,310390,170,2878,944,2879,366,0
20141227.00435,2879,12,310402,0,2878,944,2879,360,0
20141227.004352,2878,4,310406,-4,2878,942,2879,361,0
20141227.004352,2878,30,310436,10,2878,932,2879,356,0
20141227.004353,2879,6,310442,0,2878,932,2879,355,1
20141227.004355,2879,6,310448,6,2878,905,2879,353,1
20141227.004358,2878,4,310452,-4,2878,917,2879,365,0
20141227.0044,2878,694,311146,72,2878,570,2879,53,0
20141227.004402,2879,4,311150,4,2878,624,2879,71,1
20141227.004402,2878,2,311152,2,2878,679,2879,89,0
20141227.004404,2878,14,311166,0,2878,733,2879,100,0
20141227.004405,2878,4,311170,0,2878,771,2879,103,0
20141227.004406,2879,1002,312172,948,2878,270,2879,102,1
20141227.004407,2879,2,312174,0,2878,270,2879,123,1
20141227.00441,2878,542,312716,258,2877,146,2878,259,0
20141227.004411,2878,40,312756,40,2877,144,2878,241,0
20141227.004418,2878,12,312768,0,2877,193,2878,243,0
20141227.004419,2877,12,312780,10,2877,188,2878,243,0
20141227.00442,2878,56,312836,30,2877,170,2878,234,1
20141227.00442,2877,4,312840,-2,2877,168,2878,234,0
20141227.004421,2878,2,312842,2,2877,169,2878,233,1
20141227.004422,2877,2,312844,0,2877,168,2878,233,0
20141227.004423,2877,6,312850,4,2877,175,2878,234,0
20141227.004425,2878,4,312854,4,2877,175,2878,235,1
20141227.004426,2877,2,312856,0,2877,175,2878,235,0
20141227.004427,2877,2,312858,2,2877,176,2878,235,0
20141227.004427,2877,12,312870,2,2877,170,2878,235,0
20141227.004428,2877,10,312880,0,2877,165,2878,235,0
20141227.004428,2877,4,312884,0,2877,162,2878,235,0
20141227.00443,2877,2,312886,2,2877,166,2878,236,0
20141227.00443,2877,6,312892,-4,2877,164,2878,236,0
20141227.004431,2877,4,312896,0,2877,162,2878,236,0
20141227.004432,2877,32,312928,32,2877,161,2878,221,0
20141227.004433,2877,2,312930,-2,2877,171,2878,221,0
20141227.004433,2877,2,312932,-2,2877,170,2878,221,0
20141227.004434,2877,2,312934,0,2877,191,2878,222,0
20141227.004435,2877,4,312938,-4,2877,189,2878,222,0
20141227.004437,2877,2,312940,-2,2877,194,2878,222,0
20141227.004438,2877,14,312954,-8,2877,187,2878,222,0
20141227.004438,2877,22,312976,-20,2877,176,2878,222,0
20141227.004439,2877,4,312980,-2,2877,174,2878,222,0
20141227.004439,2878,52,313032,0,2877,174,2878,197,1
20141227.004441,2877,2,313034,0,2877,176,2878,196,0
20141227.004441,2877,10,313044,-2,2877,172,2878,196,0
20141227.004442,2878,2,313046,2,2877,172,2878,195,1
20141227.004442,2877,16,313062,-8,2877,164,2878,195,0
20141227.004443,2877,22,313084,-22,2877,153,2878,201,0
20141227.004443,2878,6,313090,6,2877,153,2878,198,1
20141227.004444,2877,2,313092,-2,2877,152,2878,198,0
20141227.004444,2878,40,313132,0,2877,154,2878,178,1
20141227.004445,2877,2,313134,0,2877,105,2878,181,0
20141227.004447,2877,80,313214,12,2877,68,2878,182,0
20141227.004449,2877,96,313310,-2,2877,70,2878,137,0
20141227.004449,2877,26,313336,0,2877,57,2878,131,0
20141227.00445,2877,26,313362,16,2877,44,2878,131,0
20141227.00445,2877,36,313398,0,2877,26,2878,136,0
20141227.004451,2877,42,313440,28,2877,8,2878,136,0
20141227.004453,2877,2,313442,2,2877,7,2878,137,0
20141227.004453,2878,10,313452,10,2877,7,2878,134,1
20141227.004454,2877,4,313456,4,2877,6,2878,135,0
20141227.004456,2878,4,313460,4,2877,6,2878,141,1
20141227.004456,2877,16,313476,-2,2876,304,2878,157,0
20141227.0045,2877,26,313502,-6,2877,40,2878,168,0
20141227.0045,2877,8,313510,2,2877,47,2878,166,0
20141227.004502,2877,6,313516,0,2877,96,2878,167,0
20141227.004502,2877,40,313556,-40,2877,77,2878,167,0
20141227.004506,2878,2,313558,0,2877,79,2878,163,1
20141227.00451,2878,2,313560,2,2877,88,2878,151,1
20141227.004512,2877,4,313564,-4,2877,86,2878,152,0
20141227.004513,2878,2,313566,2,2877,86,2878,151,1
20141227.004514,2877,6,313572,2,2877,103,2878,151,0
20141227.004516,2877,2,313574,0,2877,224,2878,153,0
20141227.004518,2878,12,313586,10,2877,223,2878,174,1
20141227.004518,2878,8,313594,0,2877,223,2878,170,1
20141227.004519,2878,2,313596,2,2877,223,2878,170,1
20141227.00452,2878,4,313600,2,2877,222,2878,169,1
20141227.00452,2878,10,313610,10,2877,222,2878,164,1
20141227.004524,2878,2,313612,0,2877,217,2878,161,1
20141227.004525,2877,2,313614,0,2877,221,2878,161,0
20141227.004526,2878,20,313634,0,2877,221,2878,151,1
20141227.004529,2878,10,313644,10,2877,223,2878,146,1
20141227.004529,2877,4,313648,-4,2877,221,2878,146,0
20141227.00453,2878,20,313668,20,2877,222,2878,135,1
20141227.004532,2878,2,313670,2,2877,223,2878,148,1
20141227.004534,2878,2,313672,2,2877,223,2878,151,1
20141227.004535,2878,6,313678,4,2877,223,2878,168,1
20141227.004536,2877,2,313680,0,2877,122,2878,170,0
20141227.004538,2878,2,313682,0,2877,122,2878,170,1
20141227.004539,2877,40,313722,16,2877,102,2878,172,0
20141227.004541,2878,8,313730,6,2877,116,2878,173,1
20141227.004548,2877,2,313732,0,2877,122,2878,181,0
20141227.0046,2877,2,313734,0,2877,132,2878,185,0
20141227.004604,2877,4,313738,-2,2877,130,2878,175,0
20141227.004609,2877,2,313740,-2,2877,130,2878,180,0
20141227.00461,2877,14,313754,-14,2877,122,2878,180,0
20141227.004611,2877,2,313756,-2,2877,122,2878,181,0
20141227.004614,2877,2,313758,-2,2877,112,2878,161,0
20141227.004616,2878,2,313760,2,2877,278,2878,127,1
20141227.004617,2878,202,313962,-42,2877,278,2878,26,1
20141227.004617,2878,52,314014,-30,2878,53,2879,203,1
20141227.004618,2879,2,314016,-2,2878,53,2879,172,1
20141227.00462,2878,4,314020,0,2878,81,2879,172,0
20141227.004622,2878,162,314182,62,2877,269,2878,420,0
20141227.004626,2878,20,314202,20,2877,269,2878,412,0
20141227.004632,2878,2,314204,0,2877,279,2878,420,0
20141227.004635,2878,2,314206,2,2877,276,2878,539,0
20141227.004636,2878,4,314210,2,2877,276,2878,547,0
20141227.004645,2878,2,314212,2,2877,286,2878,547,0
20141227.004652,2878,60,314272,60,2877,395,2878,555,0
20141227.004657,2878,2,314274,2,2877,402,2878,554,0
20141227.004706,2878,2,314276,2,2877,430,2878,555,0
20141227.00472,2877,2,314278,-2,2877,423,2878,557,0
20141227.004728,2878,2,314280,0,2877,421,2878,557,1
20141227.00473,2877,2,314282,0,2877,420,2878,557,0
20141227.004731,2877,6,314288,-6,2877,417,2878,557,0
20141227.004733,2877,6,314294,-6,2877,414,2878,558,0
20141227.004736,2877,2,314296,-2,2877,412,2878,557,0
20141227.004736,2877,2,314298,-2,2877,411,2878,557,0
20141227.004737,2877,8,314306,-8,2877,407,2878,557,0
20141227.004738,2877,14,314320,0,2877,401,2878,557,0
20141227.004742,2877,12,314332,10,2877,400,2878,552,0
20141227.004742,2878,2,314334,0,2877,400,2878,551,1
20141227.004744,2878,52,314386,2,2877,390,2878,535,1
20141227.004746,2877,2,314388,-2,2877,389,2878,536,0
20141227.004753,2878,10,314398,10,2877,389,2878,552,1
20141227.004753,2877,2,314400,0,2877,388,2878,552,0
20141227.004753,2877,4,314404,0,2877,386,2878,552,0
20141227.004759,2878,32,314436,16,2877,389,2878,541,1
20141227.0048,2877,6,314442,0,2877,386,2878,541,0
20141227.0048,2877,10,314452,10,2877,381,2878,541,0
20141227.004803,2877,2,314454,2,2877,380,2878,541,0
20141227.004803,2877,6,314460,0,2877,377,2878,541,0
20141227.004805,2877,2,314462,0,2877,376,2878,541,0
20141227.004809,2877,658,315120,422,2876,199,2878,213,0
20141227.004809,2877,4,315124,0,2876,199,2878,213,0
20141227.004811,2876,100,315224,-8,2876,327,2877,2,0
20141227.004811,2876,6,315230,-2,2876,324,2877,2,0
20141227.004812,2876,2,315232,-2,2876,323,2877,2,0
20141227.004813,2876,2,315234,-2,2876,322,2877,27,0
20141227.004814,2877,2,315236,2,2876,322,2877,27,1
20141227.004814,2877,32,315268,16,2876,317,2877,11,1
20141227.004818,2876,2,315270,0,2876,318,2877,515,0
20141227.00482,2877,260,315530,252,2876,318,2877,396,1
20141227.004821,2876,2,315532,0,2876,318,2877,396,0
20141227.004822,2876,2,315534,-2,2876,317,2877,416,0
20141227.004824,2876,2,315536,0,2876,316,2877,416,0
20141227.004826,2876,2,315538,-2,2876,315,2877,421,0
20141227.004828,2876,4,315542,-2,2876,314,2877,473,0
20141227.004829,2876,24,315566,-22,2876,302,2877,474,0
20141227.004829,2876,2,315568,-2,2876,301,2877,474,0
20141227.00483,2876,8,315576,-8,2876,297,2877,474,0
20141227.004833,2877,112,315688,6,2876,247,2877,464,1
20141227.004834,2877,6,315694,6,2876,247,2877,462,1
20141227.004837,2876,2,315696,0,2876,247,2877,462,0
20141227.004841,2876,42,315738,-4,2876,287,2877,483,0
20141227.004843,2876,400,316138,-132,2875,295,2877,533,0
20141227.004844,2876,2,316140,0,2875,296,2877,533,0
20141227.004845,2877,34,316174,18,2875,296,2877,517,1
20141227.004846,2877,10,316184,0,2875,296,2877,512,1
20141227.004846,2876,50,316234,50,2875,296,2877,512,0
20141227.004847,2877,2,316236,0,2875,296,2877,511,1
20141227.004847,2876,50,316286,50,2875,296,2877,511,0
20141227.004848,2877,32,316318,32,2875,294,2877,495,1
20141227.004849,2877,2,316320,2,2875,294,2877,494,1
20141227.004849,2877,2,316322,2,2875,294,2877,493,1
20141227.00485,2876,84,316406,0,2875,354,2876,58,0
20141227.004851,2876,4,316410,0,2875,354,2876,56,0
20141227.004851,2876,114,316524,-112,2876,44,2877,493,0
20141227.004852,2876,2,316526,-2,2876,43,2877,493,0
20141227.004852,2877,2,316528,0,2876,43,2877,492,1
20141227.004853,2876,2,316530,-2,2876,62,2877,492,0
20141227.004854,2876,4,316534,-4,2876,60,2877,492,0
20141227.004854,2876,4,316538,-4,2876,58,2877,492,0
20141227.004856,2876,2,316540,-2,2876,57,2877,497,0
20141227.004857,2876,6,316546,-6,2876,54,2877,497,0
20141227.004857,2876,4,316550,0,2876,53,2877,497,0
20141227.004858,2876,2,316552,0,2876,52,2877,497,0
20141227.004901,2876,20,316572,-20,2876,43,2877,500,0
20141227.004901,2877,88,316660,6,2875,369,2876,3,1
20141227.004902,2875,10,316670,10,2875,364,2876,21,0
20141227.004903,2876,12,316682,-4,2875,363,2876,24,1
20141227.004903,2876,48,316730,0,2876,16,2877,498,1
20141227.004905,2876,100,316830,-2,2876,56,2877,448,1
20141227.004906,2876,24,316854,24,2876,47,2877,448,1
20141227.004908,2876,22,316876,0,2876,39,2877,459,1
20141227.004909,2876,2,316878,2,2876,38,2877,459,1
20141227.00491,2876,2,316880,0,2876,61,2877,461,1
20141227.004911,2877,10,316890,10,2876,61,2877,456,1
20141227.004912,2876,20,316910,0,2876,52,2877,456,0
20141227.004913,2877,4,316914,4,2876,53,2877,454,1
20141227.004914,2877,4,316918,4,2876,53,2877,444,1
20141227.004915,2876,20,316938,10,2876,50,2877,444,0
20141227.004916,2876,2,316940,2,2876,49,2877,444,0
20141227.004917,2876,4,316944,4,2876,47,2877,444,0
20141227.004918,2876,4,316948,0,2876,45,2877,444,0
20141227.004919,2876,20,316968,-12,2876,38,2877,455,0
20141227.004924,2876,100,317068,56,2876,24,2877,459,0
20141227.004925,2876,2,317070,-2,2876,26,2877,459,0
20141227.004927,2876,4,317074,0,2876,49,2877,459,0
20141227.004929,2876,8,317082,-2,2876,48,2877,458,0
20141227.00493,2876,2,317084,0,2876,52,2877,458,0
20141227.004935,2876,20,317104,-16,2876,73,2877,468,0
20141227.004936,2876,2,317106,0,2876,72,2877,468,0
20141227.004938,2877,20,317126,20,2876,72,2877,458,1
20141227.00494,2876,22,317148,-22,2876,63,2877,461,0
20141227.004946,2876,2,317150,-2,2876,80,2877,466,0
20141227.004952,2876,6,317156,-6,2876,99,2877,471,0
20141227.004954,2876,2,317158,0,2876,99,2877,471,0
20141227.004957,2876,20,317178,-20,2876,96,2877,471,0
20141227.005006,2876,4,317182,-4,2876,84,2877,471,0
20141227.005012,2876,2,317184,-2,2876,194,2877,469,0
20141227.005014,2876,6,317190,-6,2876,212,2877,469,0
20141227.005026,2877,2,317192,0,2876,220,2877,450,1
20141227.005029,2877,6,317198,6,2876,222,2877,447,1
20141227.005029,2876,6,317204,2,2876,219,2877,447,0
20141227.005032,2877,2,317206,2,2876,220,2877,398,1
20141227.005033,2876,2,317208,2,2876,219,2877,398,0
20141227.005033,2877,60,317268,0,2876,219,2877,368,1
20141227.005034,2877,4,317272,0,2876,219,2877,386,1
20141227.005035,2877,8,317280,0,2876,220,2877,382,1
20141227.005036,2877,140,317420,0,2876,223,2877,312,1
20141227.005036,2877,40,317460,0,2876,223,2877,292,1
20141227.005037,2877,32,317492,0,2876,223,2877,276,1
20141227.005037,2876,24,317516,8,2876,218,2877,274,0
20141227.005038,2877,8,317524,0,2876,218,2877,270,1
20141227.005038,2877,38,317562,-2,2876,217,2877,252,1
20141227.005039,2877,44,317606,0,2876,217,2877,230,1
20141227.005039,2877,458,318064,-110,2877,89,2878,207,1
20141227.005041,2878,2,318066,2,2877,89,2878,202,1
20141227.005041,2878,14,318080,0,2877,89,2878,195,1
20141227.005041,2878,2,318082,-2,2877,91,2878,194,1
20141227.005045,2876,204,318286,14,2876,226,2877,408,0
20141227.005049,2877,2,318288,0,2876,211,2877,407,1
20141227.005049,2877,18,318306,0,2876,210,2877,398,1
20141227.005053,2876,182,318488,-160,2876,172,2877,398,0
20141227.005056,2877,8,318496,0,2876,215,2877,394,1
20141227.0051,2877,12,318508,0,2876,173,2877,388,1
20141227.0051,2877,14,318522,0,2876,173,2877,381,1
20141227.005101,2877,8,318530,0,2876,173,2877,378,1
20141227.005106,2877,2,318532,0,2876,215,2877,377,1
20141227.005108,2876,4,318536,2,2876,216,2877,378,0
20141227.00511,2877,40,318576,40,2876,216,2877,358,1
20141227.005113,2876,2,318578,0,2876,215,2877,358,0
20141227.005118,2876,2,318580,0,2876,220,2877,376,0
20141227.005128,2877,2,318582,0,2876,436,2877,398,1
20141227.005131,2877,2,318584,2,2876,436,2877,399,1
20141227.005133,2877,76,318660,0,2876,446,2877,359,1
20141227.005134,2877,140,318800,0,2876,446,2877,289,1
20141227.005134,2877,108,318908,0,2876,446,2877,235,1
20141227.005134,2877,36,318944,0,2876,445,2877,217,1
20141227.005135,2877,46,318990,2,2876,444,2877,194,1
20141227.005136,2877,36,319026,0,2876,444,2877,177,1
20141227.005136,2877,4,319030,0,2876,444,2877,175,1
20141227.005137,2877,2,319032,0,2876,444,2877,174,1
20141227.005138,2877,10,319042,6,2876,444,2877,169,1
20141227.005138,2877,2,319044,2,2876,444,2877,168,1
20141227.00514,2877,16,319060,16,2876,450,2877,160,1
20141227.00514,2877,16,319076,0,2876,450,2877,152,1
20141227.005141,2877,52,319128,0,2876,450,2877,126,1
20141227.005142,2877,72,319200,0,2876,449,2877,90,1
20141227.005142,2877,32,319232,0,2876,439,2877,74,1
20141227.005143,2877,8,319240,0,2876,439,2877,70,1
20141227.005143,2877,20,319260,0,2876,439,2877,60,1
20141227.005144,2877,24,319284,4,2876,439,2877,48,1
20141227.005144,2878,104,319388,-10,2876,439,2878,270,1
20141227.005144,2878,40,319428,-40,2876,439,2878,250,1
20141227.005145,2878,4,319432,-4,2877,2,2878,248,1
20141227.005151,2877,4,319436,0,2877,38,2878,245,0
20141227.005157,2878,2,319438,-2,2877,50,2878,254,1
20141227.005158,2877,102,319540,94,2876,369,2877,449,0
20141227.005202,2877,2,319542,0,2876,369,2877,455,0
20141227.005205,2877,2,319544,0,2876,369,2877,454,0
20141227.005208,2877,20,319564,0,2876,369,2877,444,0
20141227.005208,2877,10,319574,0,2876,369,2877,439,0
20141227.005209,2876,4,319578,-4,2876,367,2877,439,0
20141227.005212,2877,878,320456,-12,2877,61,2878,293,1
20141227.005217,2877,2,320458,0,2877,60,2878,303,1
20141227.005218,2877,4,320462,0,2877,58,2878,305,1
20141227.00522,2877,80,320542,-80,2877,18,2878,305,1
20141227.005222,2877,2,320544,-2,2877,17,2878,306,1
20141227.005223,2877,2,320546,-2,2877,16,2878,306,1
20141227.005224,2877,2,320548,0,2877,15,2878,306,1
20141227.005233,2877,30,320578,-30,2877,3,2878,320,1
20141227.005234,2877,2,320580,0,2877,2,2878,320,1
20141227.005235,2877,4,320584,-4,2876,383,2877,5,1
20141227.005236,2877,10,320594,-10,2876,383,2878,320,1
20141227.005243,2878,2,320596,-2,2876,328,2878,317,1
20141227.005255,2878,10,320606,0,2877,52,2878,313,1
20141227.005256,2877,60,320666,-56,2877,22,2878,314,0
20141227.005258,2877,44,320710,0,2876,381,2877,49,0
20141227.005258,2877,24,320734,2,2876,381,2877,37,0
20141227.005259,2877,22,320756,0,2876,379,2877,26,0
20141227.0053,2877,54,320810,54,2876,379,2878,314,0
20141227.0053,2877,2,320812,0,2877,64,2878,314,0
20141227.005305,2878,2,320814,-2,2877,77,2878,316,1
20141227.005306,2877,2,320816,2,2877,77,2878,316,0
20141227.005308,2877,2,320818,2,2877,76,2878,306,0
20141227.00531,2877,6,320824,0,2877,73,2878,306,0
20141227.005312,2877,2,320826,2,2877,72,2878,305,0
20141227.005314,2877,10,320836,0,2877,69,2878,305,0
20141227.005318,2878,2,320838,-2,2877,79,2878,304,1
20141227.005319,2877,2,320840,2,2877,78,2878,304,0
20141227.005319,2877,4,320844,0,2877,76,2878,306,0
20141227.005323,2877,20,320864,0,2877,69,2878,1320,0
20141227.005324,2877,26,320890,0,2877,57,2878,1320,0
20141227.005325,2877,114,321004,-4,2876,390,2877,1,0
20141227.005326,2877,4,321008,-2,2876,414,2878,1325,0
20141227.005329,2878,32,321040,-16,2876,415,2878,1309,1
20141227.005341,2877,2,321042,-2,2876,421,2877,68,0
20141227.005342,2877,4,321046,-4,2876,422,2877,68,0
20141227.005346,2877,10,321056,-10,2876,423,2877,65,0
20141227.005347,2877,62,321118,0,2876,423,2877,34,0
20141227.00535,2877,4,321122,-4,2876,423,2877,33,0
20141227.005352,2877,4,321126,-4,2876,421,2877,31,0
20141227.005352,2877,2,321128,0,2876,421,2877,30,0
20141227.005356,2877,10,321138,-10,2876,382,2877,38,0
20141227.005356,2877,10,321148,0,2876,382,2877,33,0
20141227.005359,2877,16,321164,0,2876,382,2877,32,0
20141227.005403,2877,2,321166,-2,2876,382,2877,42,0
20141227.005404,2877,84,321250,64,2876,382,2878,363,0
20141227.005406,2877,2,321252,0,2876,382,2878,358,0
20141227.005413,2877,2,321254,-2,2876,422,2878,349,0
20141227.005414,2878,16,321270,0,2876,422,2878,341,1
20141227.005417,2878,4,321274,-4,2877,2,2878,340,1
20141227.005422,2878,4,321278,0,2877,1,2878,343,1
20141227.005425,2877,2,321280,0,2877,1,2878,343,0
20141227.005433,2877,2,321282,0,2877,88,2878,343,0
20141227.005438,2877,2,321284,2,2877,88,2878,343,0
20141227.005444,2878,16,321300,0,2877,91,2878,334,1
20141227.005449,2877,4,321304,4,2877,70,2878,326,0
20141227.005458,2877,4,321308,4,2877,144,2878,328,0
20141227.005459,2877,20,321328,20,2877,134,2878,328,0
20141227.005505,2877,2,321330,2,2877,136,2878,330,0
20141227.005511,2877,2,321332,0,2877,145,2878,424,0
20141227.005516,2877,2,321334,0,2877,144,2878,424,0
20141227.005521,2878,6,321340,-6,2877,154,2878,435,1
20141227.005527,2877,10,321350,0,2877,149,2878,435,0
20141227.005531,2878,6,321356,-6,2877,154,2878,427,1
20141227.005532,2878,2,321358,0,2877,154,2878,426,1
20141227.005541,2878,2,321360,-2,2877,155,2878,424,1
20141227.005544,2878,16,321376,0,2877,155,2878,409,1
20141227.00555,2878,2,321378,0,2877,175,2878,403,1
20141227.00561,2878,2,321380,0,2877,206,2878,415,1
20141227.005624,2877,438,321818,-34,2876,467,2878,615,0
20141227.005627,2877,2,321820,-2,2876,467,2878,515,0
20141227.005629,2878,32,321852,-16,2876,468,2878,499,1
20141227.005629,2877,28,321880,-28,2876,468,2877,86,0
20141227.005634,2877,4,321884,-2,2876,458,2877,154,0
20141227.005636,2877,2,321886,-2,2876,458,2877,156,0
20141227.005641,2877,16,321902,0,2876,450,2877,169,0
20141227.005642,2876,12,321914,-8,2876,444,2877,170,0
20141227.005644,2877,16,321930,-16,2876,436,2877,162,1
20141227.005644,2877,16,321946,0,2876,436,2877,154,1
20141227.005659,2877,32,321978,-16,2876,465,2877,239,1
20141227.005659,2876,40,322018,-30,2876,345,2877,239,0
20141227.005706,2877,2,322020,-2,2876,353,2877,238,1
20141227.005706,2876,10,322030,0,2876,349,2877,238,0
20141227.005712,2876,2,322032,0,2876,352,2877,242,0
20141227.005714,2877,32,322064,-16,2876,352,2877,237,1
20141227.005718,2877,38,322102,-38,2876,338,2877,233,1
20141227.005721,2877,2,322104,-2,2876,339,2877,232,1
20141227.005724,2877,8,322112,-8,2876,339,2877,230,1
20141227.005727,2877,2,322114,-2,2876,340,2877,229,1
20141227.005729,2877,44,322158,-28,2876,340,2877,207,1
20141227.005736,2877,2,322160,-2,2876,339,2877,226,1
20141227.005746,2877,6,322166,-6,2876,348,2877,253,1
20141227.005757,2876,4,322170,-4,2876,350,2877,254,0
20141227.005759,2877,2,322172,-2,2876,350,2877,254,1
20141227.005805,2876,8,322180,-8,2876,354,2877,254,0
20141227.005806,2877,10,322190,-10,2876,355,2877,260,1
20141227.005807,2877,2,322192,0,2876,376,2877,259,1
20141227.005821,2877,2,322194,-2,2876,374,2877,253,1
20141227.005829,2877,200,322394,42,2876,374,2877,189,1
20141227.005829,2877,2,322396,0,2876,374,2877,188,1
20141227.005832,2876,4,322400,0,2876,371,2877,248,0
20141227.005834,2877,2,322402,-2,2876,412,2877,248,1
20141227.005843,2877,2,322404,0,2876,410,2877,253,1
20141227.005843,2877,4,322408,-2,2876,410,2877,251,1
20141227.005859,2877,2,322410,-2,2876,436,2877,271,1
20141227.005901,2877,2,322412,0,2876,436,2877,270,1
20141227.005902,2876,2,322414,0,2876,435,2877,270,0
20141227.005903,2877,4,322418,-4,2876,435,2877,268,1
20141227.005904,2877,2,322420,-2,2876,435,2877,267,1
20141227.005904,2876,2,322422,-2,2876,432,2877,270,0
20141227.00591,2877,4,322426,-4,2876,403,2877,281,1
20141227.005917,2877,2,322428,-2,2876,399,2877,287,1
20141227.005918,2877,4,322432,-2,2876,399,2877,285,1
20141227.005919,2877,4,322436,-4,2876,399,2877,283,1
20141227.00592,2877,2,322438,0,2876,399,2877,282,1
20141227.005923,2877,4,322442,-4,2876,399,2877,284,1
20141227.005926,2877,2,322444,-2,2876,399,2877,293,1
20141227.005927,2877,4,322448,-4,2876,400,2877,291,1
20141227.005928,2877,6,322454,-6,2876,400,2877,289,1
20141227.005929,2877,16,322470,0,2876,392,2877,281,1
20141227.005933,2876,20,322490,-20,2876,379,2877,270,0
20141227.005934,2877,4,322494,-4,2876,379,2877,269,1
20141227.005936,2876,2,322496,-2,2876,378,2877,266,0
20141227.005938,2876,2,322498,0,2876,377,2877,266,0
20141227.005938,2877,2,322500,-2,2876,377,2877,265,1
20141227.005939,2877,2,322502,-2,2876,377,2877,264,1
20141227.005941,2877,2,322504,-2,2876,377,2877,261,1
20141227.005944,2876,6,322510,-4,2876,378,2877,255,0
20141227.005947,2877,2,322512,-2,2876,379,2877,254,1
20141227.005954,2877,2,322514,0,2876,381,2877,254,1
20141227.005954,2877,80,322594,0,2876,382,2877,213,1
20141227.005955,2876,10,322604,-2,2876,382,2877,209,0
20141227.005956,2877,2,322606,-2,2876,381,2877,208,1
20141227.005956,2877,2,322608,-2,2876,391,2877,207,1
20141227.005958,2877,26,322634,-26,2876,378,2877,200,1
20141227.005959,2877,16,322650,0,2876,378,2877,192,1
20141227.01,2877,2,322652,-2,2876,378,2877,191,1
20141227.010001,2878,508,323160,-418,2877,136,2878,388,1
20141227.010001,2878,6,323166,-6,2877,224,2878,385,1
20141227.010001,2877,4,323170,-4,2877,224,2878,385,0
20141227.010002,2877,2,323172,0,2877,224,2878,385,0
20141227.010008,2878,12,323184,-12,2877,268,2878,382,1
20141227.010009,2878,4,323188,-4,2877,268,2878,380,1
20141227.01001,2878,8,323196,-8,2877,272,2878,377,1
20141227.01001,2878,4,323200,-4,2877,272,2878,375,1
20141227.010011,2878,8,323208,-8,2877,272,2878,371,1
20141227.010011,2878,4,323212,-4,2877,272,2878,369,1
20141227.010011,2878,4,323216,-4,2877,272,2878,367,1
20141227.010012,2878,4,323220,-4,2877,272,2878,366,1
20141227.010013,2878,44,323264,-42,2877,272,2878,344,1
20141227.010013,2878,8,323272,-6,2877,272,2878,311,1
20141227.010014,2878,58,323330,-36,2877,267,2878,287,1
20141227.010014,2878,40,323370,-40,2877,267,2878,267,1
20141227.010015,2878,34,323404,-18,2877,267,2878,250,1
20141227.010015,2878,282,323686,-6,2877,269,2878,109,1
20141227.010016,2878,26,323712,-22,2877,269,2878,96,1
20141227.010016,2879,194,323906,50,2877,269,2879,251,1
20141227.010017,2879,10,323916,-10,2878,2,2879,247,1
20141227.010017,2879,6,323922,-4,2878,6,2879,245,1
20141227.010018,2878,2,323924,0,2878,6,2879,245,0
20141227.010019,2879,12,323936,-2,2878,6,2879,239,1
20141227.010021,2879,10,323946,10,2878,6,2879,235,1
20141227.010022,2879,2,323948,2,2878,16,2879,234,1
20141227.010024,2878,4,323952,-2,2878,17,2879,234,0
20141227.010027,2878,18,323970,8,2878,12,2879,233,0
20141227.010028,2878,24,323994,20,2877,406,2878,7,0
20141227.010028,2877,38,324032,-14,2877,405,2879,224,0
20141227.010028,2879,12,324044,0,2877,405,2879,218,1
20141227.010029,2878,2,324046,2,2878,7,2879,218,0
20141227.010031,2878,2,324048,0,2878,22,2879,243,0
20141227.010032,2879,2,324050,2,2878,23,2879,245,1
20141227.010034,2878,2,324052,2,2878,25,2879,274,0
20141227.010035,2879,12,324064,12,2878,19,2879,279,1
20141227.010036,2878,6,324070,6,2878,18,2879,279,0
20141227.010037,2878,4,324074,4,2878,17,2879,279,0
20141227.010039,2879,2,324076,2,2878,17,2879,279,1
20141227.01004,2878,22,324098,22,2878,27,2879,280,0
20141227.010041,2879,12,324110,12,2878,26,2879,274,1
20141227.010043,2879,40,324150,36,2878,32,2879,254,1
20141227.010047,2878,2,324152,0,2878,37,2879,255,0
20141227.010047,2879,2,324154,2,2878,37,2879,254,1
20141227.010048,2879,2,324156,0,2878,37,2879,254,1
20141227.01005,2879,2,324158,-2,2878,39,2879,253,1
20141227.01005,2879,2,324160,0,2878,39,2879,252,1
20141227.010051,2878,2,324162,0,2878,40,2879,251,0
20141227.010052,2878,2,324164,0,2878,39,2879,251,0
20141227.010053,2878,2,324166,2,2878,39,2879,251,0
20141227.010056,2879,2,324168,0,2878,41,2879,256,1
20141227.010057,2878,20,324188,20,2878,35,2879,257,0
20141227.010058,2879,2,324190,-2,2878,35,2879,257,1
20141227.010059,2879,16,324206,4,2878,36,2879,249,1
20141227.010105,2878,40,324246,-2,2878,57,2879,1250,0
20141227.010105,2878,118,324364,82,2877,602,2879,1250,0
20141227.010108,2878,12,324376,2,2877,601,2878,7,0
20141227.010108,2878,2,324378,-2,2877,600,2878,6,0
20141227.01011,2878,2,324380,0,2877,601,2878,5,0
20141227.010112,2878,10,324390,4,2878,5,2879,1254,0
20141227.010113,2878,16,324406,0,2877,600,2878,183,0
20141227.010114,2878,16,324422,0,2877,600,2878,175,0
20141227.010115,2877,2,324424,-2,2877,586,2878,175,0
20141227.010116,2878,8,324432,0,2877,586,2878,173,1
20141227.010118,2878,6,324438,-6,2877,587,2878,170,1
20141227.01012,2878,2,324440,0,2877,587,2878,185,1
20141227.010125,2878,2,324442,0,2877,717,2878,201,1
20141227.010131,2878,2,324444,0,2877,752,2878,223,1
20141227.010132,2877,2,324446,0,2877,751,2878,223,0
20141227.010138,2878,8,324454,0,2877,796,2878,286,1
20141227.010143,2877,2,324456,-2,2877,798,2878,297,0
20141227.010147,2877,320,324776,-248,2877,41,2878,140,0
20141227.010148,2877,82,324858,72,2876,379,2877,119,0
20141227.010149,2877,32,324890,0,2876,379,2877,103,0
20141227.010151,2877,48,324938,0,2876,376,2877,80,0
20141227.010152,2877,28,324966,0,2876,376,2877,66,0
20141227.010152,2877,20,324986,0,2876,376,2877,56,0
20141227.010153,2877,6,324992,2,2876,375,2877,53,0
20141227.010153,2877,48,325040,0,2876,375,2877,29,0
20141227.010154,2877,40,325080,0,2876,374,2877,9,0
20141227.010154,2878,30,325110,-2,2877,3,2878,166,1
20141227.010154,2878,8,325118,0,2877,3,2878,162,1
20141227.010156,2877,16,325134,0,2877,1,2878,361,0
20141227.010159,2878,46,325180,-26,2877,1,2878,397,1
20141227.0102,2878,46,325226,42,2877,1,2878,375,1
20141227.010203,2877,2,325228,-2,2876,375,2878,414,0
20141227.010205,2878,42,325270,2,2876,384,2878,404,1
20141227.010205,2878,8,325278,0,2876,384,2878,400,1
20141227.010207,2877,12,325290,10,2876,384,2878,399,0
20141227.010209,2877,12,325302,0,2876,384,2877,1,0
20141227.010209,2877,2,325304,2,2876,383,2878,402,0
20141227.010211,2877,2,325306,-2,2877,1,2878,403,0
20141227.010212,2877,2,325308,-2,2876,385,2878,458,0
20141227.010213,2877,2,325310,0,2877,2,2878,458,0
20141227.010213,2877,6,325316,6,2876,385,2877,4,0
20141227.010214,2878,16,325332,0,2876,385,2878,454,1
20141227.010214,2878,32,325364,0,2876,385,2878,438,1
20141227.010219,2876,2,325366,-2,2876,385,2878,538,0
20141227.010226,2878,2,325368,0,2876,386,2878,538,1
20141227.010231,2876,2,325370,-2,2876,374,2877,1,0
20141227.010233,2876,6,325376,-6,2876,371,2877,1,0
20141227.010234,2877,2,325378,2,2876,371,2877,4,1
20141227.010236,2877,2,325380,2,2876,357,2877,6,1
20141227.010237,2877,2,325382,2,2876,357,2877,5,1
20141227.010238,2876,2,325384,-2,2876,364,2877,6,0
20141227.010238,2876,4,325388,0,2876,363,2877,5,0
20141227.010239,2876,4,325392,0,2876,363,2877,10,0
20141227.01024,2877,2,325394,-2,2876,363,2877,9,1
20141227.010243,2877,20,325414,14,2876,362,2878,651,1
20141227.010245,2877,2,325416,-2,2876,298,2878,656,1
20141227.010246,2876,12,325428,2,2876,293,2878,666,0
20141227.010249,2877,2,325430,-2,2876,289,2877,125,1
20141227.01025,2877,4,325434,0,2876,289,2877,125,1
20141227.010252,2877,2,325436,0,2876,290,2877,125,1
20141227.010253,2877,20,325456,0,2876,290,2877,115,1
20141227.010254,2876,2,325458,-2,2876,289,2877,115,0
20141227.010255,2877,2,325460,0,2876,290,2877,115,1
20141227.010256,2876,30,325490,0,2876,275,2877,116,0
20141227.010258,2877,20,325510,-18,2876,275,2877,113,1
20141227.010308,2877,4,325514,-4,2876,298,2877,143,1
20141227.010308,2877,2,325516,0,2876,298,2877,143,1
20141227.010312,2876,4,325520,-4,2876,296,2877,142,0
20141227.010318,2876,2,325522,0,2876,296,2877,143,0
20141227.01032,2876,2,325524,0,2876,305,2877,163,0
20141227.010321,2876,4,325528,-4,2876,304,2877,162,0
20141227.010321,2876,6,325534,0,2876,301,2877,162,0
20141227.010322,2877,2,325536,-2,2876,301,2877,161,1
20141227.010327,2876,4,325540,-4,2876,303,2877,161,0
20141227.010328,2876,6,325546,-6,2876,300,2877,161,0
20141227.010336,2877,4,325550,-4,2876,301,2877,158,1
20141227.010342,2877,2,325552,0,2876,302,2877,162,1
20141227.010347,2876,48,325600,-34,2876,278,2877,162,0
20141227.010351,2877,4,325604,-4,2876,278,2877,189,1
20141227.010358,2876,100,325704,-98,2876,251,2877,195,0
20141227.0104,2876,20,325724,0,2876,246,2877,195,0
20141227.010401,2877,14,325738,-4,2876,241,2877,193,1
20141227.010404,2876,2,325740,-2,2876,240,2877,193,0
20141227.010406,2877,100,325840,0,2876,250,2877,146,1
20141227.010406,2876,4,325844,0,2876,248,2877,146,0
20141227.010412,2877,2,325846,-2,2876,245,2877,146,1
20141227.010419,2876,2,325848,-2,2876,244,2877,147,0
20141227.010422,2877,30,325878,-30,2876,245,2877,132,1
20141227.010437,2877,2,325880,-2,2876,258,2877,143,1
20141227.010442,2876,8,325888,0,2876,255,2877,158,0
20141227.010443,2877,70,325958,18,2876,256,2877,123,1
20141227.010444,2877,14,325972,8,2876,256,2877,120,1
20141227.010445,2877,2,325974,0,2876,258,2877,121,1
20141227.010448,2876,72,326046,-56,2876,235,2877,98,0
20141227.010449,2876,46,326092,0,2876,212,2877,98,0
20141227.010454,2876,10,326102,-10,2876,213,2877,99,0
20141227.010458,2877,20,326122,0,2876,214,2877,89,1
20141227.010508,2877,2,326124,0,2876,228,2877,88,1
20141227.010509,2877,10,326134,-10,2876,228,2877,83,1
20141227.010516,2877,40,326174,24,2876,228,2877,70,1
20141227.010526,2876,2,326176,-2,2876,244,2877,74,0
20141227.010534,2877,20,326196,0,2876,244,2877,64,1
20141227.010545,2877,4,326200,4,2876,269,2877,67,1
20141227.01055,2877,2,326202,2,2876,273,2877,81,1
20141227.010551,2876,2,326204,-2,2876,272,2877,81,0
20141227.010601,2877,4,326208,4,2876,274,2877,104,1
20141227.010603,2876,10,326218,0,2876,269,2877,104,0
20141227.010614,2877,2,326220,2,2876,268,2877,106,1
20141227.010616,2876,2,326222,0,2876,268,2877,106,0
20141227.010619,2877,2,326224,2,2876,268,2877,105,1
20141227.010623,2877,2,326226,2,2876,289,2877,105,1
20141227.010629,2876,2,326228,-2,2876,287,2877,105,0
20141227.010632,2877,40,326268,36,2876,287,2877,86,1
20141227.010643,2876,4,326272,0,2876,354,2877,87,0
20141227.010644,2877,40,326312,8,2876,354,2877,67,1
20141227.010647,2877,2,326314,0,2876,364,2877,66,1
20141227.010653,2877,2,326316,2,2876,369,2877,56,1
20141227.010657,2877,40,326356,30,2876,370,2877,36,1
20141227.010659,2877,10,326366,-4,2876,370,2877,31,1
20141227.0107,2877,6,326372,-6,2876,371,2877,28,1
20141227.0107,2877,10,326382,-10,2876,371,2877,23,1
20141227.010701,2877,46,326428,-34,2877,168,2878,294,1
20141227.01072,2878,20,326448,20,2877,228,2878,285,1
20141227.010721,2878,4,326452,4,2877,228,2878,285,1
20141227.010722,2878,2,326454,2,2877,228,2878,284,1
20141227.010725,2878,4,326458,2,2877,228,2878,281,1
20141227.010726,2878,10,326468,0,2877,229,2878,276,1
20141227.010727,2878,16,326484,-6,2877,230,2878,267,1
20141227.010727,2878,24,326508,0,2877,230,2878,255,1
20141227.010729,2878,2,326510,2,2877,243,2878,254,1
20141227.010732,2878,2,326512,2,2877,264,2878,253,1
20141227.010732,2877,24,326536,0,2877,252,2878,253,0
20141227.010735,2877,2,326538,-2,2877,271,2878,252,0
20141227.010737,2877,2,326540,-2,2877,259,2878,252,0
20141227.010737,2877,2,326542,-2,2877,258,2878,252,0
20141227.010738,2877,2,326544,-2,2877,257,2878,252,0
20141227.010739,2877,2,326546,-2,2877,256,2878,252,0
20141227.010739,2877,2,326548,-2,2877,255,2878,242,0
20141227.01074,2877,2,326550,-2,2877,254,2878,242,0
20141227.01074,2877,2,326552,-2,2877,253,2878,242,0
20141227.010741,2877,2,326554,-2,2877,252,2878,242,0
20141227.010742,2877,2,326556,-2,2877,251,2878,242,0
20141227.010748,2877,2,326558,-2,2877,251,2878,246,0
20141227.010748,2877,2,326560,-2,2877,250,2878,246,0
20141227.010749,2877,4,326564,-4,2877,248,2878,246,0
20141227.010749,2877,2,326566,-2,2877,247,2878,246,0
20141227.01075,2877,2,326568,-2,2877,246,2878,246,0
20141227.01075,2877,102,326670,-2,2877,245,2878,196,0
20141227.010751,2877,4,326674,-4,2877,244,2878,196,0
20141227.010752,2877,2,326676,-2,2877,243,2878,186,0
20141227.010753,2878,200,326876,112,2877,243,2878,86,1
20141227.010754,2878,78,326954,48,2877,243,2878,47,1
20141227.010754,2878,12,326966,12,2877,244,2878,41,1
20141227.010755,2878,50,327016,30,2877,245,2879,266,1
20141227.010758,2878,2,327018,-2,2878,2,2879,266,1
20141227.0108,2878,4,327022,-2,2877,250,2879,266,1
20141227.010804,2878,2,327024,-2,2877,250,2878,125,1
20141227.010811,2878,20,327044,0,2877,253,2878,126,1
20141227.010812,2878,2,327046,-2,2877,253,2878,125,1
20141227.010813,2878,200,327246,0,2877,253,2878,25,1
20141227.010814,2878,2,327248,0,2877,254,2878,24,1
20141227.010816,2878,40,327288,2,2877,254,2878,43,1
20141227.010817,2878,2,327290,-2,2877,254,2878,42,1
20141227.010818,2878,84,327374,0,2878,38,2879,260,1
20141227.01082,2878,2,327376,0,2878,38,2879,260,1
20141227.010821,2878,2,327378,2,2878,37,2879,260,1
20141227.010821,2878,2,327380,2,2878,36,2879,260,1
20141227.010822,2878,4,327384,4,2878,34,2879,261,1
20141227.010823,2878,70,327454,68,2877,254,2879,261,1
20141227.010828,2878,2,327456,0,2877,254,2878,16,1
20141227.010831,2877,2,327458,-2,2877,253,2878,17,0
20141227.010833,2878,2,327460,0,2877,253,2878,27,1
20141227.010836,2878,10,327470,4,2877,255,2878,44,1
20141227.010839,2878,2,327472,0,2877,255,2878,43,1
20141227.010845,2878,4,327476,-4,2877,275,2878,51,1
20141227.010849,2878,20,327496,4,2877,279,2878,41,1
20141227.010853,2878,4,327500,0,2877,278,2878,65,1
20141227.010854,2878,2,327502,2,2877,278,2878,64,1
20141227.010858,2878,2,327504,2,2877,277,2878,65,1
20141227.010858,2877,2,327506,-2,2877,276,2878,65,0
20141227.010906,2878,2,327508,2,2877,256,2878,115,1
20141227.010911,2878,2,327510,2,2877,257,2878,138,1
20141227.010912,2877,80,327590,-60,2877,217,2878,138,0
20141227.010917,2877,88,327678,76,2877,82,2878,154,0
20141227.010918,2877,88,327766,78,2877,38,2878,154,0
20141227.010919,2877,2,327768,0,2877,37,2878,153,0
20141227.01092,2877,38,327806,-2,2877,18,2878,153,0
20141227.010921,2877,4,327810,0,2877,16,2878,194,0
20141227.010924,2878,4,327814,0,2877,18,2878,191,1
20141227.010927,2877,2,327816,0,2877,17,2878,347,0
20141227.010928,2877,54,327870,32,2876,279,2878,347,0
20141227.010929,2877,6,327876,0,2876,279,2877,2,0
20141227.010931,2877,2,327878,2,2876,274,2877,44,0
20141227.010933,2877,10,327888,2,2876,274,2877,39,0
20141227.010936,2877,2,327890,2,2876,277,2877,4,0
20141227.010937,2877,2,327892,0,2876,284,2877,3,0
20141227.010938,2877,2,327894,2,2876,284,2877,5,0
20141227.01094,2877,2,327896,2,2876,282,2877,4,0
20141227.01094,2877,2,327898,0,2876,282,2877,3,0
20141227.01094,2877,6,327904,0,2876,282,2878,332,0
20141227.010943,2876,100,328004,60,2876,232,2877,12,0
20141227.010944,2877,20,328024,20,2876,232,2877,2,1
20141227.010953,2877,18,328042,-4,2876,218,2877,74,1
20141227.010955,2877,90,328132,0,2876,219,2877,30,1
20141227.010958,2877,2,328134,2,2876,222,2877,30,1
20141227.011001,2877,2,328136,2,2876,222,2877,99,1
20141227.011012,2877,10,328146,10,2876,224,2877,130,1
20141227.011029,2876,16,328162,-16,2876,266,2877,161,0
20141227.011031,2877,2,328164,0,2876,265,2877,160,1
20141227.011048,2877,2,328166,2,2876,239,2877,195,1
20141227.011053,2877,2,328168,2,2876,239,2877,198,1
20141227.011056,2877,28,328196,28,2876,224,2877,184,1
20141227.011121,2876,2,328198,0,2876,227,2877,211,0
20141227.011122,2876,2,328200,-2,2876,226,2877,211,0
20141227.011122,2876,8,328208,-6,2876,222,2877,211,0
20141227.011123,2877,2,328210,2,2876,222,2877,210,1
20141227.011143,2876,2,328212,0,2876,225,2877,253,0
20141227.011152,2877,14,328226,-4,2876,225,2877,246,1
20141227.011153,2876,2,328228,0,2876,224,2877,246,0
20141227.011153,2876,2,328230,2,2876,223,2877,246,0
20141227.011156,2876,4,328234,2,2876,222,2877,246,0
20141227.011159,2877,4,328238,4,2876,222,2877,255,1
20141227.0112,2877,2,328240,2,2876,222,2877,254,1
20141227.011202,2876,414,328654,218,2876,15,2877,265,0
20141227.011206,2877,2,328656,0,2876,54,2877,308,1
20141227.011207,2876,10,328666,0,2876,51,2877,308,0
20141227.011208,2877,2,328668,0,2876,51,2877,307,1
20141227.011209,2876,2,328670,0,2876,64,2877,307,0
20141227.01121,2876,2,328672,0,2876,87,2877,307,0
20141227.011212,2876,2,328674,2,2876,87,2877,306,0
20141227.011213,2876,2,328676,0,2876,86,2877,307,0
20141227.011214,2876,20,328696,-10,2876,76,2877,307,0
20141227.011216,2876,2,328698,-2,2876,105,2877,307,0
20141227.011221,2876,34,328732,-32,2876,211,2877,309,0
20141227.011221,2876,40,328772,-16,2876,191,2877,309,0
20141227.01123,2876,18,328790,0,2876,71,2877,375,0
20141227.011233,2877,2,328792,2,2876,71,2877,1409,1
20141227.011234,2876,50,328842,-50,2876,46,2877,1409,0
20141227.011235,2876,2,328844,0,2876,45,2877,1410,0
20141227.011236,2876,2,328846,-2,2876,44,2877,1410,0
20141227.011237,2876,8,328854,-8,2876,40,2877,1410,0
20141227.011238,2876,42,328896,-42,2876,19,2877,1410,0
20141227.011239,2876,2,328898,0,2876,17,2877,1410,0
20141227.01124,2876,6,328904,-6,2876,14,2877,1408,0
20141227.011241,2876,28,328932,10,2875,230,2876,15,0
20141227.011242,2875,14,328946,0,2875,228,2876,12,0
20141227.011243,2875,2,328948,0,2875,219,2876,13,0
20141227.011243,2876,2,328950,2,2875,219,2876,12,1
20141227.011245,2875,10,328960,10,2875,214,2876,12,0
20141227.011247,2875,4,328964,0,2875,212,2876,19,0
20141227.011248,2875,2,328966,2,2875,211,2876,19,0
20141227.011254,2876,2,328968,2,2875,214,2876,26,1
20141227.011255,2875,22,328990,20,2875,203,2876,28,0
20141227.011257,2875,120,329110,-76,2875,149,2876,29,0
20141227.011307,2875,140,329250,-84,2875,108,2876,43,0
20141227.011308,2875,10,329260,0,2875,103,2876,46,0
20141227.011309,2875,4,329264,-4,2875,105,2876,47,0
20141227.011311,2876,8,329272,8,2875,108,2876,46,1
20141227.011312,2875,2,329274,0,2875,116,2876,47,0
20141227.011314,2875,2,329276,0,2875,120,2876,60,0
20141227.011316,2875,40,329316,26,2875,101,2876,60,0
20141227.011317,2875,2,329318,-2,2875,101,2876,100,0
20141227.01132,2875,200,329518,46,2874,177,2876,105,0
20141227.011321,2875,2,329520,0,2875,18,2876,76,0
20141227.011323,2876,4,329524,0,2875,18,2876,119,1
20141227.011324,2875,2,329526,2,2874,177,2876,119,0
20141227.011325,2875,6,329532,0,2874,176,2876,119,0
20141227.01133,2875,10,329542,0,2875,130,2876,80,0
20141227.011335,2875,20,329562,-20,2875,120,2876,74,0
20141227.01135,2875,2,329564,-2,2875,174,2876,152,0
20141227.011357,2875,48,329612,0,2875,154,2876,153,0
20141227.011359,2875,16,329628,-16,2875,147,2876,149,0
20141227.011401,2875,2,329630,0,2875,146,2876,193,0
20141227.011407,2875,336,329966,-158,2874,368,2875,32,0
20141227.011412,2874,2,329968,-2,2874,368,2875,36,0
20141227.011413,2874,38,330006,-28,2874,358,2875,27,0
20141227.011413,2875,66,330072,0,2875,8,2876,204,1
20141227.011414,2875,2,330074,0,2875,7,2876,204,1
20141227.011415,2875,2,330076,2,2875,106,2876,204,1
20141227.011418,2875,160,330236,-148,2875,27,2876,210,1
20141227.011419,2875,10,330246,0,2875,22,2876,209,1
20141227.01142,2875,4,330250,0,2875,20,2876,209,1
20141227.011421,2875,42,330292,0,2874,359,2876,209,1
20141227.011423,2875,12,330304,0,2875,114,2876,207,1
20141227.011423,2875,2,330306,0,2875,113,2876,207,1
20141227.011427,2875,2,330308,0,2875,114,2876,226,1
20141227.011427,2875,200,330508,0,2875,14,2876,226,1
20141227.011431,2875,8,330516,6,2875,13,2876,236,1
20141227.011433,2875,4,330520,0,2875,11,2876,236,1
20141227.011434,2875,2,330522,0,2875,11,2876,237,1
20141227.011439,2875,12,330534,10,2875,4,2876,237,1
20141227.01145,2875,20,330554,-6,2874,363,2875,55,1
20141227.011451,2874,58,330612,-46,2874,334,2875,55,0
20141227.011451,2874,54,330666,-54,2874,307,2876,144,0
20141227.011452,2874,56,330722,-32,2874,279,2875,8,0
20141227.011453,2874,16,330738,0,2874,271,2875,3,0
20141227.011454,2874,16,330754,0,2874,263,2875,3,0
20141227.011454,2875,2,330756,2,2874,263,2875,2,1
20141227.011458,2875,4,330760,0,2874,275,2875,2,1
20141227.011459,2874,16,330776,0,2874,267,2875,8,0
20141227.011459,2874,2,330778,0,2874,266,2875,8,0
20141227.011501,2874,10,330788,10,2874,262,2875,7,0
20141227.011502,2874,34,330822,0,2874,245,2875,7,0
20141227.011507,2875,2,330824,2,2874,245,2875,28,1
20141227.01151,2875,2,330826,-2,2874,245,2875,29,1
20141227.011511,2875,20,330846,0,2874,235,2875,19,1
20141227.011513,2875,2,330848,-2,2874,235,2875,20,1
20141227.011518,2875,2,330850,0,2874,255,2875,53,1
20141227.01152,2875,2,330852,-2,2874,254,2875,85,1
20141227.01152,2875,2,330854,0,2874,254,2875,84,1
20141227.011522,2875,92,330946,14,2874,255,2875,38,1
20141227.011524,2875,8,330954,-4,2874,255,2875,34,1
20141227.011524,2875,20,330974,-16,2874,255,2875,24,1
20141227.011525,2875,48,331022,-48,2874,775,2875,1,1
20141227.011526,2875,2,331024,-2,2874,775,2876,100,1
20141227.011556,2875,4,331028,2,2875,157,2876,163,1
20141227.01161,2875,2,331030,2,2875,192,2876,167,1
20141227.011622,2876,2,331032,2,2875,259,2876,171,1
20141227.011627,2876,2,331034,2,2875,261,2876,171,1
20141227.011631,2876,2,331036,2,2875,264,2876,209,1
20141227.011632,2876,2,331038,-2,2875,263,2876,207,1
20141227.011642,2876,20,331058,4,2875,299,2876,199,1
20141227.011643,2876,10,331068,10,2875,298,2876,194,1
20141227.011646,2875,42,331110,2,2875,278,2876,193,0
20141227.011647,2876,2,331112,-2,2875,279,2876,214,1
20141227.011651,2876,2,331114,2,2875,282,2876,213,1
20141227.011654,2876,382,331496,116,2876,1,2877,95,1
20141227.011656,2877,80,331576,-48,2876,137,2877,55,1
20141227.011658,2877,2,331578,-2,2876,298,2877,54,1
20141227.011702,2876,400,331978,0,2876,105,2877,55,0
20141227.011703,2877,2,331980,0,2876,105,2877,54,1
20141227.011703,2877,10,331990,-10,2876,105,2877,49,1
20141227.011704,2877,2,331992,0,2876,105,2877,49,1
20141227.011705,2876,2,331994,0,2876,104,2877,49,0
20141227.01171,2876,2,331996,2,2876,99,2877,49,0
20141227.011711,2877,20,332016,14,2876,100,2877,39,1
20141227.011713,2877,90,332106,18,2876,136,2878,233,1
20141227.011716,2877,2,332108,2,2876,171,2877,10,1
20141227.011718,2877,140,332248,4,2876,177,2877,36,1
20141227.011718,2877,8,332256,0,2876,177,2877,32,1
20141227.01172,2877,2,332258,0,2876,143,2877,96,1
20141227.011722,2877,4,332262,-4,2876,143,2877,95,1
20141227.01174,2877,34,332296,-34,2876,509,2877,107,1
20141227.011742,2877,2,332298,-2,2876,509,2877,106,1
20141227.011742,2877,8,332306,-8,2876,519,2877,102,1
20141227.011743,2877,2,332308,0,2876,520,2877,101,1
20141227.011745,2877,2,332310,-2,2876,520,2877,100,1
20141227.011745,2877,40,332350,0,2876,520,2877,80,1
20141227.011746,2877,2,332352,-2,2876,520,2877,79,1
20141227.011747,2877,100,332452,-6,2876,520,2877,29,1
20141227.011747,2877,2,332454,-2,2876,520,2877,7,1
20141227.011748,2877,14,332468,6,2877,22,2878,425,1
20141227.011749,2877,44,332512,14,2876,85,2878,420,1
20141227.011749,2877,4,332516,2,2876,85,2877,4,1
20141227.01175,2877,2,332518,0,2876,85,2877,3,1
20141227.011754,2877,10,332528,10,2876,97,2877,2,1
20141227.011755,2877,4,332532,0,2877,58,2878,413,1
20141227.011756,2877,116,332648,-114,2876,105,2878,413,1
20141227.011758,2877,2,332650,0,2876,105,2878,413,1
20141227.011801,2877,2,332652,0,2877,17,2878,412,1
20141227.011802,2878,144,332796,-92,2877,15,2878,342,1
20141227.011808,2878,40,332836,0,2877,59,2878,344,1
20141227.01181,2877,2,332838,0,2877,58,2878,344,0
20141227.011817,2878,8,332846,-6,2877,115,2878,340,1
20141227.011818,2878,120,332966,2,2877,117,2878,280,1
20141227.011821,2878,2,332968,0,2877,118,2878,162,1
20141227.011822,2878,2,332970,-2,2877,118,2878,164,1
20141227.011823,2878,2,332972,0,2877,119,2878,163,1
20141227.011825,2878,4,332976,0,2877,147,2878,162,1
20141227.011826,2878,2,332978,-2,2877,267,2878,161,1
20141227.011828,2878,2,332980,-2,2877,282,2878,160,1
20141227.011831,2878,2,332982,0,2877,284,2878,159,1
20141227.011832,2878,2,332984,-2,2877,284,2878,157,1
20141227.011834,2878,2,332986,0,2877,284,2878,156,1
20141227.011835,2878,2,332988,0,2877,284,2878,155,1
20141227.011838,2878,2,332990,-2,2877,284,2878,162,1
20141227.011839,2878,2,332992,-2,2877,284,2878,161,1
20141227.01184,2878,2,332994,-2,2877,284,2878,160,1
20141227.01184,2878,40,333034,-40,2877,278,2878,140,1
20141227.011841,2878,2,333036,0,2877,283,2878,139,1
20141227.011842,2878,278,333314,126,2878,361,2879,281,1
20141227.011843,2878,2,333316,0,2878,365,2879,281,1
20141227.011846,2878,2,333318,0,2878,366,2879,280,1
20141227.011847,2878,2,333320,0,2878,365,2879,286,1
20141227.011849,2879,2,333322,-2,2878,365,2879,280,1
20141227.011853,2879,96,333418,78,2878,366,2879,234,1
20141227.011854,2879,2,333420,0,2878,366,2879,233,1
20141227.011855,2878,2,333422,2,2878,365,2879,233,0
20141227.011856,2879,2,333424,0,2878,365,2879,232,1
20141227.011857,2879,4,333428,-4,2878,371,2879,230,1
20141227.011858,2878,2,333430,0,2878,370,2879,229,0
20141227.011859,2879,20,333450,-2,2878,372,2879,191,1
20141227.0119,2879,174,333624,-28,2878,372,2879,117,1
20141227.011901,2878,2,333626,2,2878,371,2879,125,0
20141227.011901,2879,2,333628,2,2878,371,2879,125,1
20141227.011902,2879,26,333654,14,2878,370,2879,113,1
20141227.011902,2879,230,333884,64,2878,370,2880,1345,1
20141227.011903,2879,40,333924,2,2878,370,2880,1663,1
20141227.011904,2879,60,333984,60,2878,370,2880,1663,1
20141227.011904,2878,20,334004,10,2878,405,2879,1,0
20141227.011905,2878,78,334082,78,2878,366,2879,2,0
20141227.011906,2879,2,334084,0,2878,367,2879,4,1
20141227.011907,2879,4,334088,4,2878,366,2879,2,1
20141227.011908,2879,6,334094,2,2878,366,2880,1729,1
20141227.011908,2880,2,334096,2,2878,366,2880,1728,1
20141227.011909,2880,492,334588,-120,2878,327,2879,1,1
20141227.011909,2879,12,334600,-10,2879,143,2880,1478,0
20141227.01191,2879,290,334890,-262,2878,332,2879,867,0
20141227.011911,2878,2,334892,2,2878,331,2879,867,0
20141227.011911,2879,40,334932,-40,2878,341,2879,907,1
20141227.011912,2879,30,334962,-6,2878,339,2879,894,1
20141227.011913,2879,18,334980,0,2878,338,2879,885,1
20141227.011917,2878,10,334990,10,2878,371,2879,936,0
20141227.01192,2879,2,334992,0,2878,372,2879,944,1
20141227.01192,2878,2,334994,2,2878,371,2879,944,0
20141227.011922,2878,14,335008,2,2878,353,2879,938,0
20141227.011924,2878,2,335010,2,2878,352,2879,940,0
20141227.011925,2878,2,335012,2,2878,351,2879,940,0
20141227.011926,2879,2,335014,0,2878,352,2879,939,1
20141227.011927,2878,10,335024,10,2878,472,2879,948,0
20141227.011928,2878,10,335034,0,2878,467,2879,948,0
20141227.011929,2878,10,335044,0,2878,462,2879,949,0
20141227.01193,2878,2,335046,2,2878,457,2879,971,0
20141227.011931,2879,10,335056,0,2878,457,2879,966,1
20141227.011932,2878,20,335076,20,2878,447,2879,966,0
20141227.011935,2878,12,335088,0,2878,441,2879,968,0
20141227.011936,2879,2,335090,0,2878,443,2879,967,1
20141227.011938,2878,2,335092,2,2878,443,2879,967,0
20141227.011939,2879,2,335094,0,2878,443,2879,967,1
20141227.01194,2879,10,335104,-10,2878,443,2879,962,1
20141227.011946,2878,2,335106,2,2878,499,2879,991,0
20141227.011948,2879,100,335206,-100,2878,497,2879,939,1
20141227.011952,2878,2,335208,2,2878,496,2879,941,0
20141227.011954,2878,10,335218,0,2878,491,2879,941,0
20141227.011956,2878,8,335226,8,2878,587,2879,941,0
20141227.011957,2879,4,335230,0,2878,588,2879,942,1
20141227.011958,2879,8,335238,-8,2878,588,2879,933,1
20141227.011959,2879,16,335254,0,2878,588,2879,925,1
20141227.012003,2879,64,335318,-64,2878,588,2879,889,1
20141227.012008,2879,4,335322,0,2878,668,2879,879,1
20141227.012011,2879,2,335324,-2,2878,673,2879,870,1
20141227.012012,2879,2,335326,0,2878,674,2879,869,1
20141227.012017,2879,10,335336,0,2878,676,2879,864,1
20141227.01202,2879,20,335356,-20,2878,678,2879,867,1
20141227.012021,2879,2,335358,0,2878,678,2879,866,1
20141227.012022,2878,2,335360,2,2878,677,2879,868,0
20141227.012023,2879,10,335370,-10,2878,677,2879,863,1
20141227.012023,2878,8,335378,0,2878,673,2879,863,0
20141227.012029,2878,4,335382,0,2878,665,2879,909,0
20141227.01203,2879,10,335392,0,2878,665,2879,904,1
20141227.012035,2879,6,335398,0,2878,671,2879,894,1
20141227.012043,2878,260,335658,0,2878,542,2879,894,0
20141227.012044,2878,2,335660,0,2878,541,2879,894,0
20141227.012045,2878,2,335662,2,2878,540,2879,894,0
20141227.012049,2879,4,335666,-4,2878,540,2879,898,1
20141227.01205,2879,400,336066,0,2878,540,2879,698,1
20141227.012051,2878,2,336068,0,2878,539,2879,698,0
20141227.012051,2879,100,336168,0,2878,539,2879,648,1
20141227.012059,2879,4,336172,-4,2878,540,2879,651,1
20141227.012104,2878,4,336176,2,2878,538,2879,592,0
20141227.012105,2879,2,336178,0,2878,538,2879,592,1
20141227.012105,2879,2,336180,0,2878,538,2879,591,1
20141227.012106,2878,2,336182,2,2878,537,2879,592,0
20141227.012112,2879,52,336234,0,2878,538,2879,569,1
20141227.012117,2878,4,336238,0,2878,536,2879,578,0
20141227.012118,2879,2,336240,0,2878,536,2879,577,1
20141227.012121,2879,4,336244,0,2878,617,2879,575,1
20141227.012122,2878,2,336246,2,2878,616,2879,575,0
20141227.012124,2878,2,336248,0,2878,610,2879,576,0
20141227.012127,2878,2,336250,2,2878,609,2879,577,0
20141227.012129,2879,80,336330,-80,2878,612,2879,541,1
20141227.012134,2879,4,336334,0,2878,605,2879,545,1
20141227.012136,2878,2,336336,2,2878,599,2879,547,0
20141227.012143,2878,20,336356,0,2878,590,2879,579,0
20141227.012148,2878,2,336358,0,2878,588,2879,593,0
20141227.012159,2879,2,336360,0,2878,595,2879,594,1
20141227.012206,2879,6,336366,0,2878,594,2879,588,1
20141227.012208,2878,2,336368,0,2878,593,2879,588,0
20141227.012209,2879,40,336408,0,2878,593,2879,566,1
20141227.012211,2878,4,336412,4,2878,591,2879,566,0
20141227.012212,2878,6,336418,0,2878,588,2879,566,0
20141227.012218,2878,10,336428,0,2878,582,2879,562,0
20141227.012222,2879,40,336468,0,2878,584,2879,543,1
20141227.012223,2878,2,336470,0,2878,583,2879,543,0
20141227.012225,2878,2,336472,2,2878,582,2879,552,0
20141227.012229,2878,8,336480,0,2878,578,2879,555,0
20141227.012229,2879,164,336644,-160,2878,578,2879,473,1
20141227.012232,2878,2,336646,2,2878,497,2879,475,0
20141227.012233,2879,4,336650,-4,2878,496,2879,473,1
20141227.012236,2879,100,336750,0,2878,496,2879,424,1
20141227.012241,2878,6,336756,6,2878,493,2879,433,0
20141227.012248,2879,10,336766,0,2878,494,2879,428,1
20141227.012252,2879,80,336846,-80,2878,494,2879,390,1
20141227.012258,2879,2,336848,0,2878,494,2879,397,1
20141227.012259,2879,6,336854,-6,2878,494,2879,395,1
20141227.0123,2879,6,336860,0,2878,494,2879,392,1
20141227.012305,2878,12,336872,0,2878,490,2879,393,0
20141227.012307,2879,10,336882,0,2878,491,2879,386,1
20141227.012308,2878,6,336888,0,2878,488,2879,386,0
20141227.012309,2878,6,336894,6,2878,485,2879,386,0
20141227.012309,2879,40,336934,-40,2878,485,2879,366,1
20141227.012311,2878,4,336938,0,2878,483,2879,366,0
20141227.012323,2878,100,337038,0,2878,453,2879,417,0
20141227.012328,2879,120,337158,0,2878,453,2879,361,1
20141227.012329,2878,2,337160,2,2878,464,2879,365,0
20141227.012331,2878,32,337192,-14,2878,448,2879,386,0
20141227.012332,2878,2,337194,0,2878,447,2879,386,0
20141227.012333,2878,2,337196,2,2878,446,2879,386,0
20141227.012338,2879,2,337198,-2,2878,446,2879,388,1
20141227.01234,2878,10,337208,10,2878,441,2879,387,0
20141227.012344,2878,8,337216,0,2878,437,2879,390,0
20141227.012401,2879,2,337218,0,2878,439,2879,519,1
20141227.012409,2878,2,337220,0,2878,438,2879,518,0
20141227.012415,2878,4,337224,2,2878,436,2879,517,0
20141227.012424,2878,2,337226,0,2878,355,2879,466,0
20141227.012425,2878,2,337228,0,2878,352,2879,465,0
20141227.012426,2878,48,337276,-30,2878,343,2879,450,0
20141227.012428,2878,8,337284,0,2878,339,2879,460,0
20141227.01243,2878,2,337286,0,2878,338,2879,460,0
20141227.012443,2878,2,337288,0,2878,336,2879,449,0
20141227.012448,2878,2,337290,0,2878,334,2879,449,0
20141227.012456,2878,2,337292,2,2878,334,2879,450,0
20141227.0125,2878,8,337300,0,2878,330,2879,455,0
20141227.012515,2878,2,337302,0,2878,288,2879,655,0
20141227.012517,2878,2,337304,2,2878,286,2879,685,0
20141227.012518,2878,134,337438,0,2878,219,2879,685,0
20141227.012518,2878,2,337440,2,2878,218,2879,685,0
20141227.012519,2878,2,337442,0,2878,217,2879,685,0
20141227.012519,2878,70,337512,-22,2878,182,2879,685,0
20141227.01252,2878,78,337590,0,2878,143,2879,685,0
20141227.01252,2878,284,337874,218,2878,1,2879,685,0
20141227.012521,2878,2,337876,0,2877,322,2878,15,0
20141227.01253,2878,30,337906,28,2877,326,2878,108,0
20141227.01254,2877,2,337908,-2,2877,207,2878,114,0
20141227.012541,2878,2,337910,0,2877,207,2878,113,1
20141227.012552,2878,20,337930,2,2877,326,2878,104,1
20141227.012555,2878,2,337932,-2,2877,327,2878,111,1
20141227.012558,2878,96,338028,50,2877,352,2878,64,1
20141227.012602,2878,10,338038,0,2877,352,2878,60,1
20141227.012604,2878,2,338040,0,2877,352,2878,59,1
20141227.012605,2878,10,338050,0,2877,352,2878,54,1
20141227.012607,2878,2,338052,2,2877,352,2878,53,1
20141227.012615,2877,6,338058,0,2877,357,2878,47,0
20141227.01262,2877,200,338258,146,2877,257,2878,47,0
20141227.012625,2878,10,338268,10,2877,253,2878,69,1
20141227.012627,2877,2,338270,2,2877,253,2878,97,0
20141227.012629,2877,100,338370,-10,2877,203,2878,97,0
20141227.012629,2877,100,338470,92,2877,153,2878,97,0
20141227.012632,2878,20,338490,20,2877,153,2878,91,1
20141227.012637,2878,30,338520,0,2877,155,2878,98,1
20141227.012646,2877,2,338522,0,2877,156,2878,149,0
20141227.01265,2878,2,338524,0,2877,156,2878,148,1
20141227.0127,2878,28,338552,24,2877,159,2878,137,1
20141227.012722,2878,2,338554,0,2877,184,2878,137,1
20141227.012723,2877,2,338556,0,2877,183,2878,137,0
20141227.012727,2878,10,338566,0,2877,183,2878,163,1
20141227.012729,2877,366,338932,-152,2876,391,2877,17,0
20141227.012729,2877,30,338962,0,2876,376,2877,2,0
20141227.012735,2877,4,338966,0,2876,336,2877,7,0
20141227.012739,2877,2,338968,0,2876,339,2877,7,0
20141227.012743,2877,14,338982,2,2876,332,2878,212,0
20141227.01275,2877,2,338984,2,2877,10,2878,235,0
20141227.01275,2877,4,338988,4,2877,8,2878,235,0
20141227.012752,2877,2,338990,0,2877,57,2878,235,0
20141227.012805,2877,10,339000,0,2877,144,2878,240,0
20141227.012812,2877,2,339002,-2,2877,143,2878,239,0
20141227.012813,2878,2,339004,-2,2877,143,2878,238,1
20141227.01282,2877,2,339006,0,2877,140,2878,238,0
20141227.012823,2878,2,339008,0,2877,140,2878,247,1
20141227.01283,2878,6,339014,0,2877,141,2878,242,1
20141227.012836,2878,6,339020,0,2877,145,2878,230,1
20141227.01284,2878,4,339024,-4,2877,215,2878,228,1
20141227.012848,2878,4,339028,-4,2877,144,2878,229,1
20141227.012848,2877,6,339034,0,2877,141,2878,229,0
20141227.012854,2877,2,339036,-2,2877,139,2878,230,0
20141227.012855,2878,6,339042,0,2877,139,2878,227,1
20141227.012855,2877,2,339044,-2,2877,138,2878,227,0
20141227.012858,2877,2,339046,-2,2877,138,2878,227,0
20141227.012859,2877,4,339050,-4,2877,136,2878,227,0
20141227.012904,2878,2,339052,-2,2877,137,2878,226,1
20141227.012905,2878,4,339056,-4,2877,137,2878,225,1
20141227.012906,2878,4,339060,0,2877,137,2878,223,1
20141227.012907,2877,2,339062,-2,2877,136,2878,223,0
20141227.01291,2878,2,339064,0,2877,136,2878,242,1
20141227.012911,2877,6,339070,0,2877,133,2878,242,0
20141227.012913,2877,4,339074,-4,2877,131,2878,242,0
20141227.01292,2877,2,339076,-2,2877,132,2878,245,0
20141227.012923,2878,10,339086,6,2877,132,2878,219,1
20141227.012923,2877,10,339096,-10,2877,127,2878,219,0
20141227.012925,2878,10,339106,10,2877,122,2878,214,1
20141227.012927,2877,82,339188,-82,2877,81,2878,215,0
20141227.012929,2877,58,339246,0,2877,52,2878,215,0
20141227.012929,2877,2,339248,-2,2877,51,2878,215,0
20141227.01293,2878,300,339548,-84,2877,51,2878,64,1
20141227.012936,2877,40,339588,-40,2877,101,2878,71,0
20141227.012937,2878,2,339590,0,2877,101,2878,70,1
20141227.012947,2878,2,339592,0,2877,120,2878,159,1
20141227.012948,2878,20,339612,-12,2877,123,2878,150,1
20141227.012949,2878,2,339614,0,2877,119,2878,149,1
20141227.012951,2878,2,339616,2,2877,119,2878,238,1
20141227.012952,2877,2,339618,-2,2877,118,2878,239,0
20141227.012954,2877,66,339684,16,2877,19,2878,241,0
20141227.012955,2877,2,339686,0,2877,17,2878,242,0
20141227.012956,2877,34,339720,8,2876,357,2877,16,0
20141227.012956,2877,40,339760,40,2876,337,2877,51,0
20141227.012957,2877,2,339762,2,2876,337,2877,50,0
20141227.012959,2877,2,339764,0,2876,337,2877,85,0
20141227.013,2877,2,339766,2,2876,337,2877,84,0
20141227.013007,2877,100,339866,98,2876,357,2877,39,0
20141227.013008,2877,78,339944,70,2877,11,2878,244,0
20141227.013008,2878,78,340022,-42,2877,11,2878,203,1
20141227.013009,2878,2,340024,0,2877,11,2878,202,1
20141227.013016,2877,2,340026,2,2877,34,2878,268,0
20141227.013021,2877,2,340028,2,2877,64,2878,304,0
20141227.013028,2877,60,340088,-32,2877,36,2878,310,0
20141227.013029,2878,16,340104,2,2877,36,2878,302,1
20141227.013045,2877,2,340106,-2,2877,10,2878,394,0
20141227.013047,2877,20,340126,8,2876,331,2878,394,0
20141227.01305,2877,20,340146,0,2876,341,2877,5,0
20141227.013052,2877,12,340158,0,2876,335,2878,394,0
20141227.013058,2877,2,340160,0,2877,64,2878,397,0
20141227.013058,2877,40,340200,0,2877,44,2878,397,0
20141227.0131,2877,2,340202,0,2877,43,2878,391,0
20141227.013102,2877,2,340204,2,2877,42,2878,391,0
20141227.013103,2877,6,340210,6,2877,39,2878,391,0
20141227.01311,2877,2,340212,0,2877,41,2878,392,0
20141227.013139,2877,100,340312,-46,2876,317,2878,541,0
20141227.013143,2877,4,340316,0,2876,317,2878,540,0
20141227.013143,2877,2,340318,2,2876,317,2878,540,0
20141227.01315,2877,4,340322,4,2876,267,2878,540,0
20141227.013151,2877,30,340352,30,2876,267,2878,540,0
20141227.013153,2877,30,340382,30,2876,267,2878,540,0
20141227.013155,2877,80,340462,80,2876,267,2878,560,0
20141227.013156,2878,202,340664,124,2876,267,2878,460,1
20141227.013157,2878,100,340764,66,2876,267,2878,410,1
20141227.013158,2878,200,340964,200,2877,11,2878,310,1
20141227.013158,2878,200,341164,200,2877,11,2878,210,1
20141227.013206,2877,96,341260,26,2876,427,2877,82,0
20141227.013207,2878,264,341524,200,2876,427,2878,160,1
20141227.013218,2877,80,341604,-80,2877,93,2878,199,0
20141227.013219,2877,2,341606,-2,2877,92,2878,199,0
20141227.01322,2877,8,341614,0,2877,91,2878,199,0
20141227.013225,2877,2,341616,-2,2877,94,2878,200,0
20141227.013226,2877,64,341680,0,2877,62,2878,440,0
20141227.013228,2877,2,341682,-2,2877,71,2878,439,0
20141227.013231,2877,2,341684,-2,2877,71,2878,493,0
20141227.013233,2877,20,341704,0,2877,61,2878,494,0
20141227.013237,2877,8,341712,-8,2877,69,2878,496,0
20141227.013237,2878,200,341912,200,2877,69,2878,396,1
20141227.013238,2878,400,342312,396,2877,69,2878,198,1
20141227.01324,2878,100,342412,100,2877,74,2878,148,1
20141227.013241,2878,100,342512,100,2877,75,2878,98,1
20141227.013244,2877,2,342514,-2,2877,103,2878,138,0
20141227.013245,2877,2,342516,0,2877,102,2878,138,0
20141227.013251,2877,2,342518,-2,2877,112,2878,139,0
20141227.013256,2878,200,342718,156,2877,132,2878,39,1
20141227.013257,2878,78,342796,78,2878,111,2879,655,1
20141227.0133,2878,50,342846,0,2878,138,2879,655,1
20141227.013301,2878,4,342850,0,2878,137,2879,654,1
20141227.013302,2878,2,342852,0,2878,136,2879,654,1
20141227.013302,2878,14,342866,0,2878,129,2879,654,1
20141227.013303,2878,2,342868,0,2878,312,2879,655,1
20141227.013304,2878,2,342870,2,2878,311,2879,655,1
20141227.01331,2878,4,342874,0,2878,309,2879,658,1
20141227.01331,2878,2,342876,0,2878,308,2879,658,1
20141227.013324,2878,2,342878,2,2878,323,2879,630,1
20141227.013324,2879,2,342880,0,2878,323,2879,629,1
20141227.013326,2879,20,342900,-20,2878,323,2879,606,1
20141227.013328,2878,2,342902,2,2878,322,2879,607,0
20141227.013336,2879,1212,344114,-598,2879,213,2880,1440,1
20141227.01334,2879,20,344134,-20,2879,244,2880,1441,1
20141227.01335,2879,6,344140,0,2879,295,2880,1441,1
20141227.013351,2879,2,344142,0,2879,294,2880,1441,1
20141227.013351,2879,4,344146,0,2879,292,2880,1441,1
20141227.013353,2879,40,344186,0,2879,271,2880,1441,1
20141227.013354,2879,2,344188,0,2879,270,2880,1441,1
20141227.013355,2879,2,344190,0,2879,272,2880,1441,1
20141227.013402,2879,2,344192,0,2879,287,2880,1441,1
20141227.013405,2879,24,344216,-24,2879,275,2880,1441,1
20141227.013408,2879,2,344218,-2,2879,274,2880,1441,1
20141227.01341,2879,2,344220,-2,2879,271,2880,1468,1
20141227.013413,2879,2,344222,0,2879,270,2880,1470,1
20141227.013415,2880,6,344228,0,2879,255,2880,1467,1
20141227.013415,2880,2,344230,-2,2879,255,2880,1466,1
20141227.013416,2880,2,344232,-2,2879,255,2880,1465,1
20141227.013417,2879,20,344252,0,2879,245,2880,1465,0
20141227.013419,2879,490,344742,14,2878,197,2879,55,0
20141227.013421,2879,24,344766,0,2878,197,2879,43,0
20141227.013422,2879,100,344866,0,2879,30,2880,1462,0
20141227.013422,2879,10,344876,-10,2879,155,2880,1463,0
20141227.013424,2879,50,344926,-40,2879,131,2880,1462,0
20141227.013425,2879,2,344928,2,2879,130,2880,1464,0
20141227.01343,2879,2,344930,2,2879,152,2880,1467,0
20141227.013435,2879,2,344932,2,2879,153,2880,1470,0
20141227.013437,2879,6,344938,6,2879,151,2880,1470,0
20141227.013438,2879,2,344940,0,2879,150,2880,1469,0
20141227.013439,2879,2,344942,2,2879,166,2880,1474,0
20141227.013439,2879,4,344946,4,2879,164,2880,1481,0
20141227.013442,2879,2,344948,0,2879,173,2880,1482,0
20141227.013442,2879,4,344952,2,2879,171,2880,1482,0
20141227.013443,2879,4,344956,4,2879,169,2880,1481,0
20141227.013446,2879,4,344960,2,2879,157,2880,1481,0
20141227.013448,2879,2,344962,0,2879,155,2880,1481,0
20141227.013455,2879,20,344982,20,2879,145,2880,1483,0
20141227.013457,2879,2,344984,2,2879,144,2880,1483,0
20141227.013458,2879,2,344986,0,2879,143,2880,1483,0
20141227.013502,2879,20,345006,20,2879,213,2880,1483,0
20141227.013502,2880,12,345018,0,2879,213,2880,1477,1
20141227.013503,2879,8,345026,2,2879,209,2880,1477,0
20141227.013506,2879,2,345028,2,2879,210,2880,1477,0
20141227.013507,2879,2,345030,2,2879,209,2880,1478,0
20141227.013511,2879,6,345036,0,2879,241,2880,1479,0
20141227.013518,2879,2,345038,0,2879,241,2880,1481,0
20141227.013522,2880,8,345046,-8,2879,241,2880,1477,1
20141227.013528,2879,4,345050,4,2879,280,2880,1477,0
20141227.013532,2879,6,345056,6,2879,277,2880,1477,0
20141227.013539,2880,2,345058,-2,2879,277,2880,1476,1
20141227.013539,2880,2,345060,0,2879,277,2880,1475,1
20141227.01354,2879,6,345066,6,2879,274,2880,1475,0
20141227.01354,2879,6,345072,6,2879,271,2880,1475,0
20141227.013542,2880,2,345074,0,2879,271,2880,1473,1
20141227.013544,2880,2,345076,0,2879,283,2880,1472,1
20141227.013546,2880,2,345078,0,2879,283,2880,1471,1
20141227.013547,2880,2,345080,0,2879,283,2880,1470,1
20141227.013553,2879,4,345084,0,2879,282,2880,1472,0
20141227.013554,2879,134,345218,-32,2879,119,2880,1472,0
20141227.013554,2879,6,345224,6,2879,116,2880,1472,0
20141227.013554,2879,16,345240,0,2879,108,2880,1472,0
20141227.013555,2879,4,345244,0,2879,106,2880,1470,0
20141227.013556,2879,12,345256,12,2879,100,2880,1470,0
20141227.013556,2879,40,345296,40,2879,80,2880,1470,0
20141227.013557,2879,20,345316,0,2879,70,2880,1470,0
20141227.013558,2879,82,345398,74,2879,29,2880,1470,0
20141227.013559,2879,10,345408,10,2879,24,2880,1470,0
20141227.013601,2879,10,345418,0,2879,20,2880,1470,0
20141227.013603,2879,2,345420,2,2879,19,2880,1469,0
20141227.013604,2879,12,345432,2,2879,14,2880,1469,0
20141227.013605,2879,14,345446,12,2879,7,2880,1470,0
20141227.013606,2879,14,345460,0,2878,95,2879,53,0
20141227.01361,2879,10,345470,0,2878,95,2879,62,0
20141227.01361,2879,126,345596,20,2879,256,2880,1470,0
20141227.013613,2879,2,345598,0,2879,255,2880,1462,0
20141227.013614,2879,2,345600,2,2879,255,2880,1462,0
20141227.013614,2879,2,345602,0,2879,254,2880,1462,0
20141227.013615,2879,22,345624,22,2879,244,2880,1462,0
20141227.013617,2879,2,345626,2,2879,243,2880,1442,0
20141227.013617,2879,2,345628,2,2879,244,2880,1442,0
20141227.013618,2879,2,345630,2,2879,243,2880,1442,0
20141227.013619,2879,10,345640,10,2879,238,2880,1442,0
20141227.01362,2879,2,345642,0,2879,237,2880,1442,0
20141227.013634,2879,2,345644,0,2879,265,2880,1468,0
20141227.013636,2880,402,346046,38,2879,264,2880,1268,1
20141227.013636,2880,4,346050,-4,2879,264,2880,1266,1
20141227.013637,2879,6,346056,-2,2879,263,2880,1264,0
20141227.013637,2879,6,346062,6,2879,260,2880,1264,0
20141227.013641,2880,2,346064,0,2879,260,2880,1263,1
20141227.013646,2879,10,346074,10,2879,256,2880,1263,0
20141227.013646,2879,2,346076,0,2879,255,2880,1263,0
20141227.013647,2880,20,346096,0,2879,255,2880,1253,1
20141227.013651,2879,20,346116,0,2879,246,2880,1255,0
20141227.013653,2879,2,346118,2,2879,248,2880,1257,0
20141227.0137,2880,1000,347118,552,2879,249,2880,758,1
20141227.013701,2880,334,347452,324,2879,250,2880,591,1
20141227.013702,2880,368,347820,244,2879,250,2880,406,1
20141227.013702,2880,550,348370,404,2879,250,2881,246,1
20141227.013703,2880,42,348412,-28,2879,250,2881,246,1
20141227.013703,2880,84,348496,-50,2879,248,2881,246,1
20141227.013704,2880,4,348500,-2,2879,247,2881,247,1
20141227.013705,2880,4,348504,-4,2879,245,2881,247,1
20141227.013705,2880,10,348514,0,2879,245,2881,247,1
20141227.013706,2880,8,348522,0,2879,245,2881,247,1
20141227.013707,2880,24,348546,0,2879,216,2881,247,1
20141227.013708,2880,2,348548,0,2879,218,2881,248,1
20141227.013709,2880,30,348578,0,2879,218,2881,248,1
20141227.01371,2880,6,348584,0,2879,223,2880,30,1
20141227.013711,2880,12,348596,0,2879,224,2880,24,1
20141227.013713,2880,2,348598,0,2879,245,2880,24,1
20141227.013713,2880,52,348650,12,2879,246,2881,253,1
20141227.013715,2880,6,348656,0,2879,247,2881,253,1
20141227.013716,2880,56,348712,0,2880,23,2881,346,1
20141227.013716,2880,4,348716,0,2880,21,2881,346,1
20141227.013717,2880,6,348722,6,2880,176,2881,346,1
20141227.013719,2880,2,348724,0,2880,207,2881,345,1
20141227.013722,2881,2,348726,2,2880,407,2881,344,1
20141227.013722,2881,4,348730,-2,2880,408,2881,339,1
20141227.013723,2881,72,348802,-36,2880,397,2881,314,1
20141227.013723,2881,4,348806,4,2880,398,2881,312,1
20141227.013724,2881,10,348816,0,2880,399,2881,307,1
20141227.013725,2881,20,348836,8,2880,466,2881,312,1
20141227.013726,2881,30,348866,-30,2880,466,2881,299,1
20141227.013728,2881,8,348874,-6,2880,505,2881,296,1
20141227.013729,2881,60,348934,60,2880,505,2881,266,1
20141227.01373,2881,2,348936,2,2880,505,2881,268,1
20141227.013731,2881,30,348966,18,2880,575,2881,254,1
20141227.013732,2881,24,348990,-4,2880,565,2881,252,1
20141227.013733,2881,2,348992,0,2880,618,2881,251,1
20141227.013734,2881,22,349014,22,2880,622,2881,241,1
20141227.013736,2881,28,349042,2,2880,622,2881,227,1
20141227.013736,2881,26,349068,18,2880,619,2881,214,1
20141227.013736,2881,420,349488,198,2880,619,2882,384,1
20141227.013737,2882,236,349724,-134,2881,4,2882,602,1
20141227.013738,2882,110,349834,48,2881,46,2882,597,1
20141227.013738,2881,136,349970,-66,2880,620,2881,214,0
20141227.013739,2881,18,349988,-16,2880,620,2881,205,0
20141227.013739,2881,2,349990,0,2880,622,2881,211,0
20141227.01374,2880,2,349992,0,2880,621,2881,211,0
20141227.01374,2882,1624,351616,808,2882,188,2883,534,1
20141227.013741,2882,2,351618,0,2882,187,2883,534,1
20141227.013742,2883,4,351622,4,2882,187,2883,532,1
20141227.013742,2882,1114,352736,184,2881,44,2882,46,0
20141227.013743,2883,182,352918,56,2881,42,2884,241,1
20141227.013743,2882,4,352922,0,2882,44,2883,132,0
20141227.013744,2882,6,352928,0,2881,50,2883,2,0
20141227.013746,2882,2,352930,0,2881,57,2883,167,0
20141227.013747,2882,2,352932,0,2881,57,2883,170,0
20141227.013749,2882,116,353048,-10,2882,1,2883,325,0
20141227.01375,2882,2,353050,0,2881,47,2882,49,0
20141227.013751,2881,2,353052,2,2881,102,2882,51,0
20141227.013755,2881,6,353058,0,2881,208,2882,76,0
20141227.013756,2881,2,353060,2,2881,207,2882,77,0
20141227.013756,2882,4,353064,-2,2881,207,2882,75,1
20141227.013757,2881,2,353066,0,2881,206,2882,81,0
20141227.013759,2881,22,353088,-12,2881,195,2882,81,0
20141227.013805,2882,236,353324,68,2882,90,2883,362,1
20141227.013806,2882,4,353328,2,2882,88,2883,362,1
20141227.013808,2882,2,353330,2,2882,87,2883,384,1
20141227.01381,2882,4,353334,2,2882,86,2883,414,1
20141227.013813,2883,2,353336,-2,2882,91,2883,418,1
20141227.013814,2883,140,353476,0,2882,92,2883,349,1
20141227.013818,2882,8,353484,2,2882,91,2883,360,0
20141227.013818,2882,2,353486,2,2882,91,2883,360,0
20141227.013821,2882,2,353488,2,2882,98,2883,361,0
20141227.013823,2882,2,353490,2,2882,97,2883,361,0
20141227.013824,2882,2,353492,0,2882,96,2883,362,0
20141227.013827,2882,16,353508,0,2882,102,2883,363,0
20141227.013828,2882,2,353510,2,2882,104,2883,363,0
20141227.013829,2883,8,353518,6,2882,101,2883,362,1
20141227.013831,2882,12,353530,-10,2882,120,2883,360,0
20141227.013835,2882,46,353576,2,2882,99,2883,389,0
20141227.013837,2883,80,353656,0,2882,99,2883,349,1
20141227.013838,2883,6,353662,-6,2882,106,2883,346,1
20141227.013838,2883,116,353778,0,2882,48,2883,348,1
20141227.01384,2882,2,353780,0,2882,67,2883,369,0
20141227.01384,2882,2,353782,0,2882,66,2883,370,0
20141227.013842,2882,100,353882,-24,2882,16,2883,371,0
20141227.013843,2882,24,353906,22,2882,5,2883,366,0
20141227.013843,2882,2,353908,2,2882,4,2883,366,0
20141227.013845,2882,4,353912,0,2881,195,2883,366,0
20141227.013846,2883,22,353934,-22,2882,2,2883,355,1
20141227.013846,2882,4,353938,4,2881,195,2883,355,0
20141227.01385,2882,4,353942,0,2882,3,2883,389,0
20141227.013851,2882,6,353948,0,2881,216,2882,7,0
20141227.013852,2882,4,353952,-4,2881,196,2882,17,0
20141227.013857,2882,2,353954,0,2881,197,2882,38,0
20141227.013857,2882,2,353956,-2,2881,197,2882,37,0
20141227.013859,2882,20,353976,14,2881,198,2882,74,0
20141227.0139,2882,2,353978,2,2881,198,2882,73,0
20141227.0139,2882,40,354018,10,2881,198,2882,64,0
20141227.013901,2882,132,354150,52,2881,199,2882,8,0
20141227.013902,2882,22,354172,-22,2882,14,2883,446,0
20141227.013904,2882,2,354174,0,2882,117,2883,447,0
20141227.013905,2882,40,354214,-26,2882,99,2883,425,0
20141227.013907,2882,2,354216,2,2882,98,2883,425,0
20141227.013907,2882,10,354226,10,2882,143,2883,407,0
20141227.013911,2882,2,354228,2,2882,192,2883,407,0
20141227.013912,2882,2,354230,0,2882,191,2883,411,0
20141227.013913,2882,2,354232,0,2882,192,2883,413,0
20141227.013915,2882,2,354234,0,2882,191,2883,413,0
20141227.013916,2882,2,354236,0,2882,321,2883,408,0
20141227.013918,2882,10,354246,10,2882,318,2883,402,0
20141227.013919,2883,140,354386,82,2882,322,2883,332,1
20141227.013926,2883,2,354388,2,2882,322,2883,330,1
20141227.013928,2882,10,354398,10,2882,320,2883,331,0
20141227.01393,2882,98,354496,-4,2882,272,2883,333,0
20141227.013935,2882,2,354498,2,2882,272,2883,340,0
20141227.013938,2882,2,354500,0,2882,273,2883,346,0
20141227.013945,2882,2,354502,0,2882,274,2883,350,0
20141227.013946,2882,2,354504,0,2882,273,2883,350,0
20141227.013949,2883,4,354508,2,2882,273,2883,345,1
20141227.01395,2882,100,354608,98,2882,223,2883,345,0
20141227.013956,2882,2,354610,0,2882,219,2883,416,0
20141227.014,2883,200,354810,-192,2882,220,2883,318,1
20141227.014,2883,24,354834,2,2882,230,2883,306,1
20141227.014001,2882,4,354838,0,2882,228,2883,302,0
20141227.014001,2883,20,354858,20,2882,228,2883,292,1
20141227.014002,2883,56,354914,46,2882,238,2883,265,1
20141227.014005,2882,18,354932,2,2882,231,2883,265,0
20141227.014006,2883,4,354936,4,2882,231,2883,263,1
20141227.014011,2883,2,354938,0,2882,223,2883,290,1
20141227.014016,2883,2,354940,0,2882,224,2883,291,1
20141227.014018,2882,10,354950,10,2882,219,2883,310,0
20141227.014025,2882,12,354962,12,2882,216,2883,308,0
20141227.014027,2882,6,354968,0,2882,212,2883,308,0
20141227.014027,2883,20,354988,0,2882,212,2883,298,1
20141227.014027,2883,10,354998,10,2882,212,2883,293,1
20141227.014028,2883,4,355002,4,2882,211,2883,292,1
20141227.01403,2883,10,355012,10,2882,211,2883,287,1
20141227.014032,2883,2,355014,0,2882,1011,2883,341,1
20141227.014033,2882,10,355024,0,2882,1008,2883,361,0
20141227.014033,2883,4,355028,0,2882,1009,2883,359,1
20141227.014034,2883,2,355030,2,2882,209,2883,357,1
20141227.014034,2883,50,355080,10,2882,209,2883,332,1
20141227.014035,2883,2,355082,0,2882,208,2883,331,1
20141227.014038,2883,4,355086,4,2882,204,2883,329,1
20141227.014041,2883,2,355088,2,2882,205,2883,328,1
20141227.014042,2883,2,355090,0,2882,205,2883,333,1
20141227.014043,2883,2,355092,0,2882,205,2883,328,1
20141227.014047,2882,10,355102,10,2882,200,2883,330,0
20141227.014049,2883,4,355106,0,2882,200,2883,328,1
20141227.014055,2883,2,355108,2,2882,197,2883,327,1
20141227.014057,2883,10,355118,2,2882,202,2883,340,1
20141227.014058,2883,2,355120,0,2882,202,2883,339,1
20141227.014101,2883,2,355122,0,2882,202,2883,340,1
20141227.014103,2882,6,355128,0,2882,199,2883,343,0
20141227.014104,2883,2,355130,2,2882,199,2883,342,1
20141227.014105,2882,2,355132,2,2882,198,2883,353,0
20141227.014108,2883,2,355134,0,2882,198,2883,350,1
20141227.014108,2882,4,355138,4,2882,196,2883,350,0
20141227.014109,2883,4,355142,0,2882,76,2883,348,1
20141227.01411,2882,4,355146,2,2882,74,2883,348,0
20141227.01411,2882,148,355294,98,2881,140,2882,56,0
20141227.014111,2882,2,355296,2,2881,140,2882,89,0
20141227.014116,2882,2,355298,2,2881,256,2882,127,0
20141227.014121,2881,4,355302,2,2881,256,2882,146,0
20141227.014123,2881,2,355304,-2,2881,255,2882,197,0
20141227.014124,2882,14,355318,0,2881,250,2882,197,1
20141227.014127,2881,2,355320,0,2881,251,2882,199,0
20141227.014129,2881,4,355324,0,2881,253,2882,200,0
20141227.014133,2881,2,355326,0,2881,251,2882,201,0
20141227.014134,2881,10,355336,0,2881,246,2882,256,0
20141227.014135,2881,10,355346,-10,2881,241,2882,257,0
20141227.014138,2882,4,355350,0,2881,232,2882,262,1
20141227.014139,2881,192,355542,-154,2881,136,2882,262,0
20141227.01414,2881,14,355556,-4,2881,9,2882,262,0
20141227.01414,2881,18,355574,16,2880,167,2881,30,0
20141227.014148,2881,20,355594,0,2880,129,2881,168,0
20141227.014209,2880,8,355602,0,2880,131,2881,245,0
20141227.014211,2880,2,355604,-2,2880,130,2881,250,0
20141227.014214,2880,2,355606,-2,2880,129,2881,250,0
20141227.014215,2880,4,355610,-4,2880,127,2881,200,0
20141227.014217,2880,200,355810,-70,2880,40,2881,210,0
20141227.014218,2880,80,355890,-36,2879,250,2880,60,0
20141227.014218,2879,10,355900,-2,2879,226,2880,61,0
20141227.014219,2879,2,355902,0,2879,230,2880,79,0
20141227.014219,2880,2,355904,0,2879,230,2880,78,1
20141227.014223,2880,232,356136,-90,2880,44,2881,214,1
20141227.014224,2881,6,356142,4,2880,42,2881,213,1
20141227.014225,2880,22,356164,0,2880,31,2881,213,0
20141227.014228,2880,2,356166,0,2880,31,2881,213,0
20141227.014228,2881,60,356226,58,2880,2,2881,183,1
20141227.014229,2880,8,356234,-8,2879,234,2880,1,0
20141227.01423,2880,4,356238,-2,2879,235,2881,183,0
20141227.014233,2880,6,356244,6,2880,5,2881,183,0
20141227.014237,2880,4,356248,0,2880,6,2881,184,0
20141227.014242,2881,42,356290,0,2880,25,2881,164,1
20141227.014246,2880,2,356292,2,2880,25,2881,165,0
20141227.014249,2880,2,356294,2,2880,25,2881,173,0
20141227.01425,2880,2,356296,2,2880,34,2881,173,0
20141227.014252,2880,2,356298,2,2880,39,2881,174,0
20141227.014254,2880,2,356300,2,2880,40,2881,176,0
20141227.014256,2880,2,356302,0,2880,39,2881,176,0
20141227.014258,2880,2,356304,2,2880,41,2881,177,0
20141227.014301,2880,2,356306,2,2880,40,2881,221,0
20141227.014303,2880,42,356348,18,2880,19,2881,226,0
20141227.014304,2879,80,356428,-34,2879,218,2881,226,0
20141227.014305,2880,2,356430,0,2880,99,2881,226,1
20141227.014311,2880,2,356432,0,2880,104,2881,302,1
20141227.014312,2880,2,356434,-2,2880,103,2881,383,1
20141227.014314,2881,4,356438,0,2880,103,2881,381,1
20141227.014317,2881,160,356598,0,2880,103,2881,301,1
20141227.014322,2881,6,356604,0,2880,106,2881,351,1
20141227.014325,2881,2,356606,2,2880,222,2881,352,1
20141227.014327,2881,2,356608,2,2880,224,2881,351,1
20141227.014331,2881,120,356728,120,2880,224,2881,285,1
20141227.014332,2880,2,356730,0,2880,223,2881,285,0
20141227.014335,2880,2,356732,0,2880,222,2881,330,0
20141227.014339,2880,10,356742,0,2880,216,2881,330,0
20141227.01434,2880,2,356744,0,2880,216,2881,331,0
20141227.014341,2880,20,356764,0,2880,206,2881,331,0
20141227.014345,2880,12,356776,-2,2880,200,2881,341,0
20141227.014347,2880,4,356780,-4,2880,198,2881,341,0
20141227.014351,2880,30,356810,-30,2880,203,2881,346,0
20141227.0144,2881,4,356814,0,2880,183,2881,381,1
20141227.014405,2880,4,356818,-4,2880,288,2881,381,0
20141227.014411,2881,2,356820,0,2880,175,2881,413,1
20141227.014413,2880,10,356830,0,2880,170,2881,413,0
20141227.014414,2880,2,356832,-2,2880,169,2881,413,0
20141227.014415,2880,2,356834,-2,2880,168,2881,413,0
20141227.014417,2880,2,356836,-2,2880,167,2881,413,0
20141227.014418,2880,12,356848,-4,2880,161,2881,413,0
20141227.014421,2881,44,356892,-8,2880,159,2881,393,1
20141227.014423,2880,10,356902,-10,2880,154,2881,393,0
20141227.014426,2880,10,356912,0,2880,149,2881,441,0
20141227.01443,2880,2,356914,0,2880,145,2881,439,0
20141227.014431,2880,6,356920,0,2880,142,2881,439,0
20141227.014435,2880,2,356922,0,2880,141,2881,439,0
20141227.014437,2880,22,356944,-22,2880,130,2881,440,0
20141227.014438,2880,2,356946,-2,2880,129,2881,440,0
20141227.01444,2880,2,356948,0,2880,128,2881,440,0
20141227.01444,2880,4,356952,-4,2880,126,2881,441,0
20141227.014441,2880,2,356954,0,2880,125,2881,485,0
20141227.014444,2880,2,356956,-2,2880,124,2881,486,0
20141227.014447,2880,2,356958,-2,2880,123,2881,496,0
20141227.014449,2880,12,356970,-10,2880,217,2881,496,0
20141227.01445,2880,10,356980,-2,2880,212,2881,501,0
20141227.014451,2881,172,357152,150,2880,126,2881,415,1
20141227.014451,2881,32,357184,32,2880,110,2881,399,1
20141227.014452,2881,202,357386,-156,2880,114,2881,299,1
20141227.014457,2880,2,357388,-2,2880,113,2881,303,0
20141227.014457,2880,2,357390,0,2880,112,2881,303,0
20141227.0145,2881,2,357392,-2,2880,112,2881,412,1
20141227.014501,2881,4,357396,0,2880,112,2881,411,1
20141227.014501,2881,4,357400,-2,2880,112,2881,409,1
20141227.014504,2881,6,357406,0,2880,113,2881,450,1
20141227.01451,2880,20,357426,12,2880,123,2881,450,0
20141227.014514,2881,52,357478,-30,2880,123,2881,424,1
20141227.014516,2881,94,357572,-26,2881,107,2882,127,1
20141227.014518,2882,178,357750,28,2881,107,2883,156,1
20141227.01453,2882,6,357756,0,2881,130,2882,34,1
20141227.014531,2882,2,357758,0,2881,130,2882,33,1
20141227.014534,2881,2,357760,2,2881,32,2882,45,0
20141227.014534,2881,2,357762,2,2881,31,2882,45,0
20141227.014536,2881,2,357764,2,2881,38,2882,73,0
20141227.014544,2882,80,357844,-56,2881,169,2883,151,1
20141227.014548,2881,2,357846,0,2881,166,2882,14,0
20141227.014549,2882,20,357866,-18,2881,167,2883,154,1
20141227.0146,2882,16,357882,-14,2882,113,2883,300,1
20141227.014612,2882,2,357884,0,2882,167,2883,311,1
20141227.014614,2883,320,358204,-72,2882,167,2883,150,1
20141227.014615,2883,2,358206,0,2882,167,2883,154,1
20141227.014616,2883,8,358214,6,2882,167,2883,150,1
20141227.014617,2883,2,358216,2,2882,167,2883,149,1
20141227.014617,2883,2,358218,0,2882,167,2884,287,1
20141227.014618,2882,8,358226,0,2882,168,2884,287,0
20141227.014618,2882,24,358250,-2,2882,159,2884,292,0
20141227.014619,2883,4,358254,-2,2882,159,2884,292,1
20141227.01462,2882,4,358258,0,2882,158,2884,292,0
20141227.014621,2882,2,358260,-2,2882,157,2884,292,0
20141227.014622,2883,240,358500,-196,2882,157,2884,295,1
20141227.014627,2883,2,358502,-2,2882,158,2884,296,1
20141227.014628,2882,4,358506,-4,2882,156,2884,296,0
20141227.014629,2883,8,358514,-8,2882,156,2884,296,1
20141227.014632,2883,2,358516,0,2882,164,2884,298,1
20141227.014638,2883,2,358518,0,2882,176,2883,24,1
20141227.014638,2883,2,358520,0,2882,176,2883,23,1
20141227.014641,2883,52,358572,-52,2883,34,2884,1196,1
20141227.014644,2883,20,358592,0,2883,25,2884,1198,1
20141227.014645,2883,6,358598,-2,2883,23,2884,1198,1
20141227.014646,2883,2,358600,0,2883,22,2884,1198,1
20141227.014648,2883,10,358610,0,2883,17,2884,1198,1
20141227.014649,2883,4,358614,0,2883,16,2884,1198,1
20141227.014652,2883,2,358616,-2,2883,15,2884,1198,1
20141227.014653,2883,4,358620,-2,2883,13,2884,1197,1
20141227.014656,2883,2,358622,0,2883,22,2884,1198,1
20141227.014657,2883,2,358624,-2,2883,21,2884,1198,1
20141227.014659,2883,2,358626,0,2883,21,2884,1198,1
20141227.014659,2883,2,358628,0,2883,20,2884,1198,1
20141227.014701,2883,2,358630,0,2883,19,2884,1198,1
20141227.014703,2882,90,358720,-44,2882,297,2884,1199,0
20141227.014709,2882,2,358722,0,2882,297,2883,29,0
20141227.014712,2883,2,358724,2,2882,301,2883,38,1
20141227.014715,2883,4,358728,0,2882,290,2883,46,1
20141227.014719,2882,8,358736,-8,2882,386,2883,48,0
20141227.014724,2883,2,358738,0,2882,383,2883,51,1
20141227.014726,2882,8,358746,-8,2882,379,2883,50,0
20141227.014731,2883,2,358748,0,2882,380,2883,53,1
20141227.014731,2882,2,358750,0,2882,379,2883,54,0
20141227.014732,2883,2,358752,0,2882,379,2883,53,1
20141227.014735,2882,4,358756,-4,2882,377,2883,63,0
20141227.014737,2883,4,358760,0,2882,379,2883,62,1
20141227.01474,2883,14,358774,-10,2882,381,2883,58,1
20141227.014741,2883,40,358814,-8,2882,381,2883,39,1
20141227.014742,2882,6,358820,0,2882,378,2883,39,0
20141227.014743,2883,10,358830,-8,2882,378,2883,34,1
20141227.014746,2882,4,358834,-4,2882,376,2883,95,0
20141227.014746,2882,20,358854,-20,2882,366,2883,95,0
20141227.014747,2883,48,358902,20,2882,364,2883,71,1
20141227.01475,2882,4,358906,-4,2882,362,2883,73,0
20141227.014753,2882,300,359206,180,2882,212,2883,77,0
20141227.014754,2883,2,359208,0,2882,212,2883,76,1
20141227.014754,2883,12,359220,12,2882,213,2883,70,1
20141227.014757,2883,2,359222,2,2882,213,2883,100,1
20141227.0148,2883,2,359224,2,2882,213,2883,111,1
20141227.014805,2883,2,359226,2,2882,214,2883,260,1
20141227.014828,2883,2,359228,2,2882,304,2883,309,1
20141227.014833,2882,4,359232,0,2882,302,2883,316,0
20141227.014836,2883,240,359472,-64,2882,302,2883,196,1
20141227.01484,2882,2,359474,2,2882,301,2883,201,0
20141227.014842,2882,2,359476,2,2882,300,2883,200,0
20141227.014858,2882,2,359478,2,2882,299,2883,232,0
20141227.014911,2883,476,359954,-144,2883,62,2884,1418,1
20141227.014914,2883,4,359958,0,2883,60,2884,1418,1
20141227.014915,2883,2,359960,-2,2883,60,2884,1418,1
20141227.014916,2883,2,359962,0,2883,62,2884,1418,1
20141227.014917,2883,2,359964,0,2883,61,2884,1418,1
20141227.014922,2883,4,359968,-4,2883,60,2884,1418,1
20141227.014926,2883,2,359970,-2,2883,60,2884,1418,1
20141227.014928,2883,2,359972,0,2883,59,2884,1418,1
20141227.014929,2883,2,359974,0,2883,58,2884,1418,1
20141227.014934,2883,4,359978,0,2883,57,2884,1418,1
20141227.014937,2883,2,359980,0,2883,69,2884,1418,1
20141227.014942,2883,6,359986,0,2883,69,2884,1418,1
20141227.014943,2883,2,359988,0,2883,68,2884,1417,1
20141227.014945,2884,8,359996,-6,2883,68,2884,1414,1
20141227.014945,2884,112,360108,0,2883,69,2884,1358,1
20141227.014946,2884,78,360186,4,2883,69,2884,1319,1
20141227.014946,2884,80,360266,56,2883,69,2884,1279,1
20141227.014947,2884,44,360310,26,2883,107,2884,1257,1
20141227.014951,2883,10,360320,0,2883,104,2884,1256,0
20141227.014951,2883,2,360322,0,2883,103,2884,1256,0
20141227.014953,2883,18,360340,0,2883,95,2884,1258,0
20141227.014956,2883,4,360344,0,2883,124,2884,1258,0
20141227.014958,2883,2,360346,0,2883,123,2884,1239,0
20141227.014959,2884,2,360348,-2,2883,125,2884,1238,1
20141227.015,2883,2,360350,0,2883,124,2884,1236,0
20141227.015,2884,8,360358,0,2883,154,2884,1227,1
20141227.015001,2884,2,360360,-2,2883,155,2884,1226,1
20141227.015002,2883,4,360364,0,2883,153,2884,1226,0
20141227.015003,2883,2,360366,0,2883,152,2884,1226,0
20141227.015011,2883,2,360368,-2,2883,160,2884,1216,0
20141227.015015,2884,32,360400,-16,2883,160,2884,1209,1
20141227.015016,2883,2,360402,0,2883,159,2884,1209,0
20141227.015018,2883,40,360442,0,2883,122,2884,1210,0
20141227.015024,2883,72,360514,-12,2883,117,2884,1213,0
20141227.015025,2883,2,360516,0,2883,116,2884,1213,0
20141227.015026,2884,36,360552,-16,2883,107,2884,1224,1
20141227.015029,2884,32,360584,6,2883,107,2884,1207,1
20141227.01503,2883,2,360586,0,2883,106,2884,1207,0
20141227.015032,2883,2,360588,2,2883,105,2884,1233,0
20141227.015033,2883,42,360630,20,2883,84,2884,1233,0
20141227.015034,2883,168,360798,-148,2882,321,2883,5,0
20141227.015034,2883,10,360808,0,2883,25,2884,1234,0
20141227.015035,2883,4,360812,2,2883,23,2884,1235,0
20141227.015037,2883,2,360814,2,2883,22,2884,1208,0
20141227.015038,2883,2,360816,0,2883,21,2884,1208,0
20141227.015038,2883,2,360818,0,2883,20,2884,1209,0
20141227.015039,2883,40,360858,18,2882,321,2883,1,0
20141227.015044,2883,8,360866,0,2883,4,2884,1230,0
20141227.015045,2883,4,360870,-4,2883,2,2884,1230,0
20141227.015047,2883,4,360874,0,2882,321,2883,4,0
20141227.015048,2884,16,360890,8,2882,321,2883,5,1
20141227.015054,2883,2,360892,0,2882,322,2883,136,0
20141227.015057,2883,2,360894,0,2882,322,2883,167,0
20141227.015057,2883,4,360898,4,2882,322,2883,165,0
20141227.015058,2883,80,360978,80,2882,322,2883,125,0
20141227.015059,2883,32,361010,16,2882,322,2883,114,0
20141227.015101,2883,2,361012,2,2882,322,2883,113,0
20141227.015106,2882,2,361014,0,2882,321,2883,114,0
20141227.01511,2883,30,361044,30,2882,327,2883,135,1
20141227.015114,2883,16,361060,0,2882,327,2883,149,1
20141227.015114,2883,16,361076,16,2882,327,2883,142,1
20141227.015118,2882,10,361086,10,2882,321,2883,143,0
20141227.015123,2882,2,361088,0,2882,340,2883,159,0
20141227.015124,2882,2,361090,0,2882,339,2883,159,0
20141227.015141,2883,26,361116,26,2882,337,2883,210,1
20141227.015141,2882,2,361118,0,2882,336,2883,210,0
20141227.015142,2882,2,361120,2,2882,335,2883,215,0
20141227.015143,2882,2,361122,0,2882,334,2883,215,0
20141227.015144,2882,60,361182,20,2882,206,2883,216,0
20141227.015145,2882,2,361184,2,2882,205,2883,220,0
20141227.015145,2882,400,361584,354,2881,148,2883,237,0
20141227.015146,2881,120,361704,30,2881,130,2883,237,0
20141227.015146,2881,4,361708,-2,2881,128,2882,5,0
20141227.015147,2881,2,361710,0,2881,127,2882,15,0
20141227.015147,2881,6,361716,0,2881,124,2882,19,0
20141227.015149,2881,2,361718,-2,2881,123,2882,64,0
20141227.015152,2881,2,361720,0,2881,152,2882,114,0
20141227.015152,2882,2,361722,0,2881,152,2882,113,1
20141227.015153,2881,10,361732,-10,2881,146,2882,113,0
20141227.015153,2882,2,361734,0,2881,146,2882,119,1
20141227.015154,2882,2,361736,0,2881,146,2882,118,1
20141227.015156,2881,10,361746,0,2881,145,2882,118,0
20141227.015156,2882,4,361750,0,2881,145,2882,116,1
20141227.015157,2881,16,361766,-16,2881,245,2882,116,0
20141227.015158,2881,2,361768,-2,2881,239,2882,116,0
20141227.015159,2882,16,361784,16,2881,239,2882,111,1
20141227.015202,2881,8,361792,-8,2881,232,2882,107,0
20141227.015209,2882,222,362014,-20,2882,89,2883,349,1
20141227.01521,2882,4,362018,-2,2882,87,2883,349,1
20141227.015211,2882,2,362020,0,2882,88,2883,349,1
20141227.015212,2882,8,362028,-4,2882,85,2883,339,1
20141227.015214,2883,16,362044,16,2882,85,2883,332,1
20141227.015216,2882,2,362046,0,2882,84,2883,329,0
20141227.015218,2882,6,362052,-6,2882,81,2883,331,0
20141227.015219,2882,2,362054,0,2882,80,2883,331,0
20141227.015221,2882,6,362060,0,2882,117,2883,331,0
20141227.015229,2883,16,362076,16,2882,119,2883,431,1
20141227.015235,2882,4,362080,0,2882,116,2883,393,0
20141227.015238,2882,2,362082,-2,2882,115,2883,393,0
20141227.015239,2882,2,362084,0,2882,114,2883,403,0
20141227.015242,2882,4,362088,0,2882,135,2883,404,0
20141227.015243,2882,6,362094,-6,2882,232,2883,404,0
20141227.015245,2882,2,362096,-2,2882,232,2883,424,0
20141227.015249,2882,4,362100,-4,2882,231,2883,429,0
20141227.015249,2882,2,362102,0,2882,230,2883,429,0
20141227.015252,2882,2,362104,-2,2882,229,2883,519,0
20141227.0153,2882,20,362124,0,2882,203,2883,484,0
20141227.0153,2882,2,362126,-2,2882,202,2883,484,0
20141227.015303,2882,4,362130,0,2882,200,2883,484,0
20141227.015304,2882,32,362162,-12,2882,184,2883,484,0
20141227.015305,2882,40,362202,0,2882,164,2883,484,0
20141227.015306,2882,40,362242,-26,2882,150,2883,484,0
20141227.015307,2882,88,362330,86,2882,106,2883,484,0
20141227.015309,2882,24,362354,24,2882,93,2883,488,0
20141227.01531,2882,8,362362,2,2882,89,2883,488,0
20141227.01531,2882,4,362366,0,2882,87,2883,488,0
20141227.015312,2882,22,362388,20,2882,78,2883,495,0
20141227.015313,2882,4,362392,0,2882,76,2883,495,0
20141227.015313,2882,56,362448,0,2882,48,2883,495,0
20141227.015314,2882,12,362460,12,2882,42,2883,499,0
20141227.015314,2882,4,362464,0,2882,39,2883,499,0
20141227.015315,2882,50,362514,40,2882,14,2883,501,0
20141227.015317,2882,28,362542,-4,2881,164,2882,6,0
20141227.015327,2882,2,362544,-2,2881,164,2882,47,0
20141227.015345,2881,16,362560,0,2881,157,2882,127,0
20141227.01535,2881,20,362580,-10,2881,148,2882,128,0
20141227.015352,2881,2,362582,2,2881,147,2882,129,0
20141227.015354,2881,6,362588,-2,2881,144,2882,124,0
20141227.015359,2881,10,362598,0,2881,139,2882,148,0
20141227.0154,2881,2,362600,2,2881,138,2882,148,0
20141227.015401,2881,104,362704,52,2881,86,2882,148,0
20141227.015402,2881,6,362710,2,2881,83,2882,149,0
20141227.015402,2881,10,362720,2,2881,78,2882,159,0
20141227.015403,2881,2,362722,0,2881,77,2882,163,0
20141227.015404,2881,2,362724,2,2881,76,2882,163,0
20141227.015404,2881,56,362780,8,2881,48,2882,163,0
20141227.015406,2881,96,362876,-2,2880,427,2881,14,0
20141227.015406,2881,28,362904,0,2880,427,2882,153,0
20141227.015407,2880,8,362912,0,2880,426,2881,101,0
20141227.015407,2880,4,362916,0,2880,427,2881,102,0
20141227.015411,2880,10,362926,4,2880,423,2881,112,0
20141227.015412,2880,2,362928,-2,2880,422,2881,112,0
20141227.015414,2879,1166,364094,-946,2878,58,2881,113,0
20141227.015416,2878,2,364096,-2,2878,77,2880,74,0
20141227.015417,2878,8,364104,-4,2878,73,2880,74,0
20141227.015421,2879,2,364106,0,2878,113,2879,165,1
20141227.015422,2879,2,364108,0,2878,115,2879,164,1
20141227.015423,2878,2,364110,0,2878,121,2879,300,0
20141227.015425,2878,2,364112,2,2878,121,2879,300,0
20141227.015425,2878,8,364120,8,2878,117,2879,300,0
20141227.015426,2878,6,364126,0,2878,118,2879,300,0
20141227.015434,2878,2,364128,0,2879,302,2880,73,0
20141227.015436,2879,2,364130,0,2879,301,2880,39,1
20141227.015437,2880,20,364150,20,2879,2,2880,29,1
20141227.015441,2879,20,364170,-6,2879,161,2880,60,0
20141227.015442,2879,2,364172,0,2879,160,2880,67,0
20141227.015442,2880,134,364306,-28,2880,234,2881,16,1
20141227.015445,2881,42,364348,20,2881,39,2882,230,1
20141227.015446,2881,48,364396,28,2881,15,2882,231,1
20141227.015446,2881,2,364398,0,2881,14,2882,193,1
20141227.015447,2881,2,364400,0,2881,13,2882,518,1
20141227.015448,2881,2,364402,2,2881,12,2882,518,1
20141227.015451,2881,14,364416,10,2881,5,2882,518,1
20141227.015451,2881,4,364420,4,2881,3,2882,518,1
20141227.015452,2881,8,364428,0,2880,235,2881,13,1
20141227.015455,2881,2,364430,-2,2880,5,2881,26,1
20141227.015458,2881,2,364432,0,2880,43,2881,146,1
20141227.015503,2880,2,364434,0,2880,44,2881,254,0
20141227.015504,2881,2,364436,0,2880,46,2881,253,1
20141227.015505,2880,4,364440,0,2880,45,2881,352,0
20141227.015506,2881,10,364450,4,2880,42,2881,350,1
20141227.015508,2880,84,364534,-80,2879,132,2880,58,0
20141227.015513,2880,2,364536,0,2879,132,2880,63,0
20141227.015514,2880,84,364620,-84,2879,132,2880,141,0
20141227.015518,2879,20,364640,14,2879,95,2880,142,0
20141227.015519,2880,100,364740,-30,2879,96,2880,103,1
20141227.015523,2880,100,364840,0,2879,147,2880,54,1
20141227.015528,2880,2,364842,0,2879,131,2880,54,1
20141227.015533,2880,4,364846,4,2879,130,2880,52,1
20141227.015535,2880,4,364850,4,2879,130,2880,50,1
20141227.015536,2880,2,364852,2,2879,130,2880,49,1
20141227.015538,2880,4,364856,0,2879,130,2880,47,1
20141227.015544,2880,6,364862,0,2879,132,2880,49,1
20141227.015546,2880,84,364946,-4,2879,134,2880,10,1
20141227.015547,2880,22,364968,2,2879,124,2880,10,1
20141227.015548,2881,22,364990,-8,2880,10,2881,805,1
20141227.015548,2880,20,365010,-20,2879,104,2880,115,0
20141227.015549,2880,2,365012,-2,2879,104,2880,114,0
20141227.015558,2880,2,365014,-2,2879,105,2880,214,0
20141227.015559,2880,4,365018,-4,2879,105,2880,212,0
20141227.015618,2880,60,365078,0,2879,106,2880,268,0
20141227.015624,2879,10,365088,10,2879,101,2880,269,0
20141227.015629,2880,16,365104,0,2879,101,2880,261,1
20141227.015632,2880,80,365184,0,2879,102,2880,223,1
20141227.015635,2880,2,365186,-2,2879,102,2880,223,1
20141227.01564,2880,4,365190,-4,2879,222,2880,240,1
20141227.01564,2880,4,365194,0,2879,222,2880,238,1
20141227.015642,2880,40,365234,-40,2879,222,2880,218,1
20141227.015644,2880,16,365250,0,2879,220,2880,210,1
20141227.015647,2879,4,365254,0,2879,219,2880,207,0
20141227.015649,2880,106,365360,6,2879,220,2880,154,1
20141227.01565,2880,310,365670,-210,2880,45,2881,720,1
20141227.015651,2880,4,365674,-4,2880,44,2881,720,1
20141227.015653,2881,10,365684,-10,2880,47,2881,715,1
20141227.015654,2880,2,365686,0,2880,179,2881,715,0
20141227.015654,2880,6,365692,-6,2880,176,2881,858,0
20141227.015658,2880,4,365696,-2,2880,175,2881,999,0
20141227.015659,2880,4,365700,-4,2880,173,2881,998,0
20141227.015701,2880,62,365762,-2,2880,138,2881,188,0
20141227.015702,2880,30,365792,-12,2880,128,2881,183,0
20141227.015706,2880,8,365800,0,2880,125,2881,177,0
20141227.015706,2880,2,365802,2,2880,125,2881,177,0
20141227.015708,2880,2,365804,2,2880,124,2881,179,0
20141227.015709,2880,6,365810,6,2880,123,2881,179,0
20141227.015712,2880,10,365820,10,2880,17,2881,187,0
20141227.015713,2880,2,365822,0,2880,16,2881,186,0
20141227.015718,2880,4,365826,0,2880,14,2881,186,0
20141227.015729,2880,2,365828,2,2880,33,2881,187,0
20141227.015731,2880,4,365832,4,2880,31,2881,187,0
20141227.015736,2880,2,365834,0,2880,33,2881,187,0
20141227.015737,2880,2,365836,2,2880,32,2881,187,0
20141227.015741,2880,2,365838,2,2880,31,2881,267,0
20141227.015745,2880,40,365878,-30,2880,11,2881,267,0
20141227.01575,2880,2,365880,-2,2880,10,2881,267,0
20141227.015758,2880,2,365882,0,2880,13,2881,267,0
20141227.015759,2880,30,365912,4,2879,200,2880,14,0
20141227.015801,2880,2,365914,0,2879,200,2880,15,0
20141227.015802,2880,8,365922,0,2879,200,2880,13,0
20141227.01581,2880,2,365924,0,2879,226,2880,12,0
20141227.015811,2880,4,365928,4,2879,226,2880,10,0
20141227.015812,2880,14,365942,2,2879,230,2880,3,0
20141227.015819,2880,20,365962,-14,2880,3,2881,269,0
20141227.01582,2880,2,365964,-2,2880,2,2881,269,0
20141227.015826,2880,2,365966,-2,2880,104,2881,269,0
20141227.015828,2881,2,365968,0,2880,114,2881,268,1
20141227.01583,2880,10,365978,0,2880,112,2881,266,0
20141227.015831,2880,80,366058,0,2880,72,2881,266,0
20141227.01584,2880,8,366066,8,2880,73,2881,267,0
20141227.015844,2881,2,366068,0,2880,73,2881,266,1
20141227.015849,2880,36,366104,-30,2879,231,2880,8,0
20141227.015852,2880,2,366106,-2,2879,232,2880,7,0
20141227.015853,2880,10,366116,-10,2879,232,2880,2,0
20141227.015853,2880,4,366120,-4,2879,232,2881,266,0
20141227.015854,2879,40,366160,-20,2879,202,2880,12,0
20141227.015855,2879,10,366170,-10,2879,202,2880,12,0
20141227.015858,2880,2,366172,2,2879,224,2880,14,1
20141227.015858,2880,2,366174,0,2879,224,2880,13,1
20141227.015859,2880,8,366182,8,2879,224,2880,9,1
20141227.0159,2880,2,366184,0,2879,224,2880,8,1
20141227.015902,2880,6,366190,6,2879,226,2880,5,1
20141227.01591,2880,22,366212,-8,2880,5,2881,272,1
20141227.01591,2880,10,366222,0,2879,226,2880,6,1
20141227.015914,2880,10,366232,10,2879,226,2880,2,1
20141227.01592,2880,2,366234,2,2879,234,2880,2,1
20141227.015921,2880,2,366236,-2,2879,234,2880,1,1
20141227.015922,2880,4,366240,2,2879,233,2881,272,1
20141227.015926,2880,6,366246,0,2880,33,2881,273,1
20141227.015927,2881,2,366248,0,2880,34,2881,272,1
20141227.01593,2880,90,366338,14,2879,234,2880,70,0
20141227.015931,2880,48,366386,2,2879,234,2880,46,0
20141227.015935,2880,8,366394,0,2879,234,2880,42,0
20141227.015937,2880,2,366396,2,2879,234,2880,41,0
20141227.015943,2880,2,366398,0,2879,243,2880,40,0
20141227.015947,2879,2,366400,0,2879,243,2880,50,0
20141227.015949,2880,60,366460,60,2879,259,2880,20,1
20141227.015949,2880,2,366462,0,2879,259,2880,19,1
20141227.015952,2880,2,366464,2,2879,259,2880,18,1
20141227.015956,2880,4,366468,0,2879,276,2880,17,1
20141227.015957,2880,2,366470,2,2879,276,2880,16,1
20141227.015958,2880,2,366472,0,2879,280,2880,15,1
20141227.015958,2879,4,366476,0,2879,278,2880,15,0
20141227.020001,2880,2,366478,0,2879,278,2880,14,1
20141227.020002,2881,402,366880,120,2880,2,2881,75,1
20141227.020002,2881,28,366908,16,2880,10,2881,62,1
20141227.020002,2881,2,366910,2,2880,12,2881,61,1
20141227.020004,2880,4,366914,-2,2880,12,2881,61,0
20141227.020029,2880,2,366916,-2,2880,176,2881,42,0
20141227.020051,2881,2,366918,0,2880,175,2881,44,1
20141227.020102,2881,20,366938,0,2880,175,2881,34,1
20141227.020107,2881,4,366942,4,2880,175,2881,32,1
20141227.020109,2881,2,366944,2,2880,191,2881,31,1
20141227.020111,2881,2,366946,2,2880,191,2881,30,1
20141227.020118,2881,4,366950,4,2880,173,2881,78,1
20141227.020121,2881,10,366960,10,2880,134,2881,73,1
20141227.020121,2881,4,366964,4,2880,134,2881,71,1
20141227.020123,2881,4,366968,0,2880,134,2881,69,1
20141227.020129,2881,2,366970,0,2880,147,2881,69,1
20141227.020214,2881,10,366980,-6,2880,261,2881,74,1
20141227.020216,2881,2,366982,0,2880,261,2881,73,1
20141227.020237,2880,2,366984,0,2880,250,2881,74,0
20141227.020237,2881,2,366986,-2,2880,250,2881,75,1
20141227.020244,2881,6,366992,-2,2880,250,2881,127,1
20141227.020247,2881,4,366996,0,2880,250,2881,127,1
20141227.020317,2880,4,367000,2,2880,249,2881,184,0
20141227.020344,2881,4,367004,2,2880,255,2881,205,1
20141227.020349,2880,2,367006,2,2880,254,2881,207,0
20141227.020403,2881,2,367008,0,2880,685,2881,207,1
20141227.020413,2881,10,367018,-6,2880,684,2881,206,1
20141227.020416,2880,4,367022,4,2880,682,2881,206,0
20141227.020421,2881,8,367030,8,2880,679,2881,138,1
20141227.020424,2880,2,367032,0,2880,676,2881,138,0
20141227.020429,2881,2,367034,0,2880,712,2881,137,1
20141227.020439,2881,2,367036,2,2880,714,2881,144,1
20141227.020442,2881,2,367038,2,2880,712,2881,142,1
20141227.020442,2881,4,367042,0,2880,712,2881,140,1
20141227.020443,2881,2,367044,0,2880,712,2881,139,1
20141227.020448,2881,2,367046,2,2880,682,2881,138,1
20141227.02045,2881,2,367048,0,2880,682,2881,137,1
20141227.020453,2881,4,367052,0,2880,682,2881,135,1
20141227.020455,2881,2,367054,0,2880,682,2881,134,1
20141227.0205,2881,6,367060,0,2880,684,2881,131,1
20141227.020505,2881,4,367064,0,2880,685,2881,130,1
20141227.020507,2881,4,367068,0,2880,685,2881,128,1
20141227.020512,2881,44,367112,0,2880,663,2881,108,1
20141227.020513,2881,4,367116,4,2880,663,2881,106,1
20141227.020514,2881,40,367156,6,2880,663,2881,86,1
20141227.020515,2881,2,367158,0,2880,663,2881,85,1
20141227.020516,2881,6,367164,-6,2880,663,2881,82,1
20141227.020516,2881,2,367166,0,2880,663,2881,81,1
20141227.020517,2881,2,367168,-2,2880,663,2881,80,1
20141227.020518,2881,2,367170,-2,2880,663,2881,79,1
20141227.020518,2881,2,367172,0,2880,663,2881,78,1
20141227.02052,2881,12,367184,-8,2880,663,2881,72,1
20141227.020521,2881,144,367328,-24,2880,663,2882,400,1
20141227.020523,2882,8,367336,-8,2881,12,2882,396,1
20141227.020524,2881,2,367338,-2,2881,16,2882,396,0
20141227.020525,2881,2,367340,-2,2881,19,2882,396,0
20141227.020525,2881,2,367342,-2,2881,20,2882,396,0
20141227.020536,2881,2,367344,-2,2881,26,2882,396,0
20141227.020544,2881,2,367346,0,2881,26,2882,397,0
20141227.020546,2881,2,367348,-2,2881,27,2882,399,0
20141227.020548,2881,2,367350,0,2881,28,2882,399,0
20141227.020549,2881,10,367360,-6,2881,23,2882,399,0
20141227.02055,2881,2,367362,0,2881,22,2882,399,0
20141227.02055,2881,2,367364,2,2881,21,2882,399,0
20141227.020552,2881,10,367374,-4,2881,16,2882,399,0
20141227.020554,2882,2,367376,-2,2881,16,2882,398,1
20141227.020555,2882,10,367386,-10,2881,18,2882,393,1
20141227.020558,2881,42,367428,-18,2880,712,2881,25,0
20141227.020558,2881,50,367478,-50,2880,712,2882,393,0
20141227.020606,2882,2,367480,0,2880,712,2882,391,1
20141227.020613,2881,2,367482,-2,2880,712,2882,391,0
20141227.020617,2881,4,367486,2,2881,1,2882,391,0
20141227.020618,2882,8,367494,0,2881,1,2882,387,1
20141227.020624,2882,2,367496,2,2881,6,2882,387,1
20141227.020625,2881,200,367696,-2,2880,710,2882,387,0
20141227.020635,2881,6,367702,2,2880,711,2882,390,0
20141227.020636,2881,2,367704,-2,2880,711,2882,390,0
20141227.020637,2881,4,367708,0,2880,712,2882,390,0
20141227.02064,2881,2,367710,-2,2880,715,2882,390,0
20141227.020645,2881,2,367712,-2,2880,715,2882,392,0
20141227.020651,2881,6,367718,0,2880,715,2881,7,0
20141227.020651,2881,2,367720,-2,2880,715,2881,6,0
20141227.020655,2881,4,367724,-2,2880,714,2881,9,0
20141227.020658,2881,20,367744,0,2880,714,2882,411,0
20141227.020713,2881,2,367746,-2,2880,719,2882,411,0
20141227.02072,2881,2,367748,0,2880,722,2882,411,0
20141227.020731,2881,2,367750,0,2881,1,2882,412,0
20141227.020732,2881,2,367752,0,2880,724,2882,412,0
20141227.020745,2881,2,367754,0,2880,723,2882,409,0
20141227.020749,2881,2,367756,-2,2880,723,2882,409,0
20141227.020752,2881,6,367762,-6,2880,724,2882,409,0
20141227.020759,2882,4,367766,0,2880,724,2882,407,1
20141227.0208,2882,2,367768,0,2880,724,2882,406,1
20141227.020801,2881,2,367770,0,2880,695,2881,2,0
20141227.020802,2881,4,367774,0,2880,696,2882,406,0
20141227.020804,2881,2,367776,-2,2880,696,2882,406,0
20141227.020808,2881,2,367778,2,2880,696,2882,406,0
20141227.020824,2881,8,367786,0,2880,694,2881,1,0
20141227.020825,2881,2,367788,0,2880,694,2882,408,0
20141227.020835,2881,2,367790,-2,2880,694,2881,2,0
20141227.020851,2881,2,367792,0,2880,693,2881,89,0
20141227.0209,2880,2,367794,0,2880,692,2881,163,0
20141227.020901,2880,2,367796,0,2880,691,2881,163,0
20141227.020902,2880,2,367798,0,2880,690,2881,163,0
20141227.020907,2881,2,367800,2,2880,694,2881,176,1
20141227.020909,2880,60,367860,-38,2880,664,2881,187,0
20141227.020912,2881,18,367878,14,2880,664,2881,179,1
20141227.020921,2881,2,367880,2,2880,664,2881,193,1
20141227.020922,2881,14,367894,14,2880,664,2881,186,1
20141227.020942,2881,2,367896,0,2880,641,2881,176,1
20141227.020959,2880,60,367956,-60,2880,595,2881,200,0
20141227.021022,2880,60,368016,-60,2880,568,2881,102,0
20141227.021051,2880,12,368028,-12,2880,478,2881,120,0
20141227.021101,2880,100,368128,44,2880,428,2881,119,0
20141227.021103,2880,2,368130,2,2880,427,2881,169,0
20141227.021105,2880,2,368132,2,2880,436,2881,170,0
20141227.021108,2881,6,368138,2,2880,436,2881,168,1
20141227.021122,2880,40,368178,-38,2880,433,2881,121,0
20141227.021125,2880,2,368180,0,2880,432,2881,121,0
20141227.02113,2880,24,368204,-24,2880,423,2881,119,0
20141227.021146,2881,6,368210,0,2880,424,2881,117,1
20141227.021148,2881,4,368214,0,2880,424,2881,117,1
20141227.021158,2880,22,368236,0,2880,423,2881,117,0
20141227.021205,2881,2,368238,-2,2880,424,2881,123,1
20141227.021215,2881,2,368240,0,2880,425,2881,123,1
20141227.021225,2879,1188,369428,-280,2878,217,2880,575,0
20141227.021229,2878,60,369488,-36,2878,187,2880,575,0
20141227.021229,2878,16,369504,-14,2878,179,2880,575,0
20141227.021237,2879,2,369506,2,2878,205,2879,122,1
20141227.021238,2878,2,369508,-2,2878,205,2879,122,0
20141227.021238,2878,20,369528,-20,2878,200,2879,122,0
20141227.021242,2879,10,369538,0,2878,200,2879,117,1
20141227.021242,2879,4,369542,0,2878,200,2879,117,1
20141227.021244,2879,16,369558,16,2878,198,2879,109,1
20141227.021245,2879,2,369560,0,2878,197,2879,108,1
20141227.021247,2878,2,369562,0,2878,196,2879,108,0
20141227.021247,2879,2,369564,0,2878,196,2879,107,1
20141227.021249,2879,36,369600,0,2878,215,2879,89,1
20141227.02125,2879,10,369610,0,2878,216,2879,84,1
20141227.021251,2879,2,369612,0,2878,218,2879,82,1
20141227.021253,2879,10,369622,0,2878,229,2879,112,1
20141227.021255,2879,4,369626,4,2878,230,2879,110,1
20141227.021258,2879,2,369628,0,2878,230,2879,109,1
20141227.021259,2879,16,369644,16,2878,232,2879,101,1
20141227.021303,2879,10,369654,0,2878,231,2879,96,1
20141227.021308,2878,40,369694,-20,2878,212,2879,133,0
20141227.02131,2879,4,369698,0,2878,213,2879,153,1
20141227.021314,2879,16,369714,16,2878,204,2879,145,1
20141227.021325,2879,10,369724,0,2878,210,2879,161,1
20141227.021329,2879,16,369740,16,2878,210,2879,153,1
20141227.021332,2878,4,369744,-2,2878,208,2879,158,0
20141227.021337,2878,2,369746,-2,2878,207,2879,196,0
20141227.021343,2878,2,369748,0,2878,209,2879,197,0
20141227.021344,2879,16,369764,16,2878,209,2879,188,1
20141227.021344,2879,20,369784,20,2878,209,2879,178,1
20141227.021345,2878,2,369786,-2,2878,208,2879,178,0
20141227.021351,2879,18,369804,0,2878,208,2879,169,1
20141227.021355,2878,100,369904,26,2878,162,2879,202,0
20141227.021357,2878,8,369912,0,2878,159,2879,202,0
20141227.021358,2878,16,369928,0,2878,151,2879,202,0
20141227.021402,2878,8,369936,8,2878,148,2879,202,0
20141227.021405,2878,2,369938,0,2878,147,2879,202,0
20141227.021407,2878,4,369942,0,2878,145,2879,202,0
20141227.021409,2878,4,369946,-2,2878,143,2879,202,0
20141227.021412,2879,10,369956,0,2878,143,2879,197,1
20141227.021414,2878,8,369964,-8,2878,139,2879,214,0
20141227.021432,2878,6,369970,-4,2878,145,2879,274,0
20141227.021433,2878,40,370010,-40,2878,125,2879,282,0
20141227.021435,2878,8,370018,0,2878,121,2879,278,0
20141227.021436,2878,242,370260,-80,2877,277,2878,4,0
20141227.021437,2878,8,370268,-8,2877,277,2879,278,0
20141227.021444,2878,2,370270,-2,2877,272,2878,128,0
20141227.021446,2878,230,370500,-230,2877,283,2878,13,0
20141227.021448,2878,38,370538,2,2878,43,2879,295,0
20141227.021449,2878,2,370540,2,2878,47,2879,245,0
20141227.021452,2878,96,370636,84,2877,295,2878,72,0
20141227.021453,2878,2,370638,0,2877,295,2878,71,0
20141227.0215,2878,2,370640,0,2877,306,2878,74,0
20141227.021501,2878,6,370646,4,2877,308,2878,71,0
20141227.021507,2878,2,370648,0,2877,308,2878,75,0
20141227.02151,2878,2,370650,2,2877,318,2878,74,0
20141227.021513,2878,4,370654,0,2877,317,2878,74,0
20141227.021515,2878,2,370656,0,2877,317,2878,76,0
20141227.021523,2878,2,370658,2,2877,315,2878,75,0
20141227.021523,2878,14,370672,0,2877,315,2878,68,0
20141227.021524,2878,2,370674,0,2877,315,2878,67,0
20141227.021526,2878,2,370676,2,2877,375,2878,66,0
20141227.021531,2878,2,370678,2,2877,380,2878,67,0
20141227.021531,2878,4,370682,0,2877,380,2878,65,0
20141227.021534,2878,132,370814,-26,2878,50,2879,342,0
20141227.021536,2878,2,370816,-2,2878,249,2879,342,0
20141227.021537,2878,2,370818,-2,2878,249,2879,342,0
20141227.021538,2878,2,370820,-2,2878,253,2879,342,0
20141227.021538,2878,2,370822,-2,2878,258,2879,342,0
20141227.021539,2878,4,370826,-4,2878,284,2879,386,0
20141227.021543,2878,4,370830,-4,2878,316,2879,428,0
20141227.021546,2878,2,370832,0,2878,361,2879,494,0
20141227.0216,2878,2,370834,-2,2878,361,2879,602,0
20141227.021601,2879,6,370840,0,2878,360,2879,600,1
20141227.021602,2879,20,370860,12,2878,360,2879,590,1
20141227.021607,2879,66,370926,-52,2879,6,2880,612,1
20141227.02162,2879,90,371016,-22,2878,375,2879,14,1
20141227.021626,2879,34,371050,6,2879,3,2880,612,1
20141227.021629,2879,6,371056,6,2878,387,2879,3,1
20141227.021631,2879,8,371064,8,2879,1,2880,597,1
20141227.021639,2880,6,371070,0,2879,2,2880,594,1
20141227.021647,2880,2,371072,0,2879,9,2880,595,1
20141227.021657,2879,10,371082,2,2879,13,2880,610,0
20141227.0217,2880,2,371084,0,2879,15,2880,608,1
20141227.021714,2879,10,371094,-4,2879,19,2880,614,0
20141227.021734,2879,2,371096,-2,2879,10,2880,615,0
20141227.021744,2879,2,371098,0,2879,10,2880,615,0
20141227.021748,2879,2,371100,-2,2879,11,2880,615,0
20141227.02175,2879,4,371104,-4,2879,9,2880,625,0
20141227.021752,2879,2,371106,-2,2879,8,2880,625,0
20141227.021811,2880,2,371108,-2,2879,17,2880,685,1
20141227.021831,2879,2,371110,0,2879,28,2880,635,0
20141227.021834,2879,2,371112,0,2879,27,2880,635,0
20141227.021839,2879,6,371118,2,2879,25,2880,635,0
20141227.021841,2879,4,371122,2,2879,23,2880,637,0
20141227.021842,2880,2,371124,-2,2879,23,2880,636,1
20141227.021848,2879,4,371128,0,2879,21,2880,636,0
20141227.021853,2879,42,371170,-20,2878,145,2879,4,0
20141227.021857,2879,2,371172,-2,2878,145,2879,104,0
20141227.021912,2879,2,371174,-2,2878,101,2879,107,0
20141227.021928,2879,2,371176,-2,2878,102,2879,142,0
20141227.021929,2878,4,371180,-4,2878,100,2879,142,0
20141227.021933,2878,4,371184,0,2878,99,2879,143,0
20141227.021939,2878,8,371192,-8,2878,97,2879,155,0
20141227.021948,2878,34,371226,-34,2878,81,2879,163,0
20141227.021955,2878,4,371230,-4,2878,78,2879,164,0
20141227.021958,2879,100,371330,-100,2878,78,2879,115,1
20141227.022016,2878,2,371332,0,2878,208,2879,115,0
20141227.022017,2878,2,371334,-2,2878,207,2879,115,0
20141227.022025,2878,2,371336,-2,2878,205,2879,115,0
20141227.022025,2879,4,371340,-4,2878,205,2879,113,1
20141227.02203,2879,4,371344,0,2878,205,2879,111,1
20141227.02205,2879,4,371348,0,2878,240,2879,113,1
20141227.022054,2879,2,371350,-2,2878,245,2879,112,1
20141227.022058,2879,2,371352,0,2878,244,2879,111,1
20141227.022118,2879,2,371354,0,2878,156,2879,114,1
20141227.022121,2879,4,371358,-4,2878,156,2879,112,1
20141227.022133,2878,10,371368,2,2878,151,2879,118,0
20141227.022134,2878,2,371370,2,2878,150,2879,118,0
20141227.022137,2878,2,371372,2,2878,149,2879,126,0
20141227.022142,2879,6,371378,-6,2878,153,2879,132,1
20141227.022146,2879,2,371380,-2,2878,154,2879,131,1
20141227.022151,2879,2,371382,-2,2878,155,2879,130,1
20141227.022159,2879,32,371414,-16,2878,146,2879,114,1
20141227.022202,2879,4,371418,-4,2878,152,2879,112,1
20141227.022204,2879,20,371438,0,2878,154,2879,102,1
20141227.022206,2879,2,371440,-2,2878,153,2879,101,1
20141227.02221,2879,2,371442,-2,2878,155,2879,100,1
20141227.022213,2879,10,371452,2,2878,155,2879,95,1
20141227.022214,2879,20,371472,-20,2878,225,2879,85,1
20141227.022214,2879,16,371488,0,2878,225,2879,77,1
20141227.022215,2879,72,371560,14,2878,225,2879,40,1
20141227.022216,2879,20,371580,4,2878,225,2879,30,1
20141227.022217,2879,2,371582,0,2878,226,2879,29,1
20141227.022218,2879,58,371640,-36,2879,83,2880,668,1
20141227.022219,2880,4,371644,0,2879,83,2880,666,1
20141227.02222,2879,2,371646,0,2879,82,2880,666,0
20141227.022229,2880,32,371678,-16,2879,93,2880,658,1
20141227.022242,2880,2,371680,0,2879,242,2880,651,1
20141227.022252,2880,10,371690,-10,2879,243,2880,646,1
20141227.022256,2879,84,371774,-84,2879,289,2880,647,0
20141227.022314,2880,2,371776,0,2879,312,2880,664,1
20141227.022314,2879,2,371778,0,2879,311,2880,664,0
20141227.022318,2880,2,371780,0,2879,315,2880,663,1
20141227.022325,2879,2,371782,0,2879,324,2880,665,0
20141227.022344,2880,40,371822,0,2879,326,2880,646,1
20141227.022351,2879,16,371838,-16,2879,320,2880,646,0
20141227.022353,2879,2,371840,-2,2879,319,2880,647,0
20141227.022419,2879,2,371842,-2,2879,301,2880,669,0
20141227.022437,2880,4,371846,-4,2879,307,2880,669,1
20141227.022503,2880,2,371848,-2,2879,311,2880,675,1
20141227.022506,2879,24,371872,-4,2879,309,2880,674,0
20141227.022507,2880,2,371874,0,2879,309,2880,673,1
20141227.02251,2880,2,371876,0,2879,309,2880,672,1
20141227.022523,2880,2,371878,-2,2879,308,2880,666,1
20141227.022523,2880,4,371882,-4,2879,318,2880,664,1
20141227.022525,2880,2,371884,0,2879,318,2880,663,1
20141227.022526,2879,40,371924,-40,2879,298,2880,713,0
20141227.022534,2879,2,371926,-2,2879,299,2880,691,0
20141227.022534,2880,6,371932,0,2879,299,2880,689,1
20141227.022538,2879,10,371942,-10,2879,294,2880,691,0
20141227.022541,2879,20,371962,-20,2879,284,2880,691,0
20141227.022555,2879,2,371964,0,2879,300,2880,691,0
20141227.022601,2879,2,371966,-2,2879,399,2880,692,0
20141227.022603,2879,2,371968,0,2879,398,2880,692,0
20141227.022615,2880,2,371970,-2,2879,410,2880,691,1
20141227.022619,2879,20,371990,-20,2879,400,2880,691,0
20141227.022624,2880,18,372008,-18,2879,399,2880,682,1
20141227.022628,2880,2,372010,-2,2879,399,2880,682,1
20141227.022629,2880,64,372074,-64,2879,378,2880,674,1
20141227.022629,2880,16,372090,0,2879,378,2880,666,1
20141227.02263,2879,4,372094,-4,2879,376,2880,665,0
20141227.022632,2879,4,372098,-4,2879,377,2880,665,0
20141227.022636,2879,2,372100,-2,2879,375,2880,665,0
20141227.022637,2879,2,372102,-2,2879,374,2880,665,0
20141227.022638,2879,2,372104,-2,2879,373,2880,665,0
20141227.02264,2879,2,372106,-2,2879,372,2880,665,0
20141227.022644,2879,120,372226,-120,2879,313,2880,665,0
20141227.022644,2880,32,372258,-16,2879,313,2880,649,1
20141227.022649,2879,2,372260,-2,2879,312,2880,192,0
20141227.022651,2880,22,372282,-16,2879,311,2880,181,1
20141227.022652,2880,78,372360,2,2879,311,2880,142,1
20141227.022654,2880,284,372644,16,2880,137,2881,114,1
20141227.022655,2880,40,372684,0,2880,117,2881,114,1
20141227.022655,2881,2,372686,-2,2880,117,2881,113,1
20141227.022659,2880,2,372688,0,2880,124,2881,113,0
20141227.022704,2880,2,372690,2,2880,141,2881,115,0
20141227.022706,2881,40,372730,4,2880,142,2881,124,1
20141227.022706,2881,2,372732,-2,2880,142,2881,123,1
20141227.022708,2880,4,372736,0,2880,145,2881,123,0
20141227.02271,2881,40,372776,-40,2880,147,2881,107,1
20141227.022713,2881,4,372780,-4,2880,156,2881,107,1
20141227.022714,2880,2,372782,0,2880,155,2881,107,0
20141227.022715,2880,2,372784,0,2880,156,2881,107,0
20141227.022716,2880,322,373106,-90,2879,235,2880,301,0
20141227.022717,2880,6,373112,0,2879,235,2880,298,0
20141227.022717,2880,4,373116,-2,2879,235,2880,296,0
20141227.02272,2880,2,373118,0,2879,235,2880,296,0
20141227.022723,2880,10,373128,0,2879,238,2880,291,0
20141227.022726,2880,30,373158,-30,2879,239,2880,277,0
20141227.022726,2880,160,373318,-160,2879,239,2880,207,0
20141227.022732,2880,20,373338,-20,2879,249,2880,200,0
20141227.022733,2879,2,373340,-2,2879,248,2880,200,0
20141227.022734,2880,38,373378,0,2879,245,2880,181,1
20141227.022737,2880,8,373386,-8,2879,261,2880,225,1
20141227.022739,2880,6,373392,-6,2879,261,2880,222,1
20141227.022739,2879,2,373394,-2,2879,270,2880,222,0
20141227.022742,2879,4,373398,-4,2879,269,2880,222,0
20141227.022749,2879,2,373400,-2,2879,282,2880,223,0
20141227.02275,2880,2,373402,-2,2879,282,2880,223,1
20141227.022751,2880,2,373404,0,2879,292,2880,223,1
20141227.022754,2880,2,373406,-2,2879,292,2880,222,1
20141227.022755,2879,2,373408,-2,2879,293,2880,222,0
20141227.022756,2879,2,373410,0,2879,292,2880,222,0
20141227.022802,2880,4,373414,-4,2879,302,2880,226,1
20141227.022804,2880,4,373418,-4,2879,305,2880,225,1
20141227.022804,2879,2,373420,0,2879,304,2880,225,0
20141227.022808,2879,2,373422,0,2879,333,2880,232,0
20141227.022811,2879,2,373424,0,2879,332,2880,232,0
20141227.022812,2880,2,373426,-2,2879,332,2880,232,1
20141227.022815,2879,2,373428,0,2879,331,2880,233,0
20141227.022817,2879,10,373438,-10,2879,327,2880,233,0
20141227.022817,2879,6,373444,-6,2879,324,2880,233,0
20141227.022818,2880,2,373446,-2,2879,324,2880,232,1
20141227.022818,2880,2,373448,-2,2879,324,2880,231,1
20141227.022819,2879,2,373450,0,2879,323,2880,233,0
20141227.022822,2879,2,373452,0,2879,322,2880,243,0
20141227.022824,2880,120,373572,-120,2879,322,2880,183,1
20141227.022824,2880,120,373692,-120,2879,322,2880,123,1
20141227.022825,2879,2,373694,0,2879,321,2880,121,0
20141227.022826,2880,8,373702,-8,2879,325,2880,137,1
20141227.022827,2880,162,373864,-90,2879,325,2880,56,1
20141227.022828,2880,2,373866,-2,2879,325,2880,55,1
20141227.02283,2880,2,373868,-2,2879,325,2880,53,1
20141227.022831,2879,2,373870,0,2879,324,2880,53,0
20141227.022832,2880,18,373888,-16,2879,324,2880,44,1
20141227.022833,2880,2,373890,-2,2879,323,2880,49,1
20141227.022834,2880,4,373894,-4,2879,323,2880,47,1
20141227.022834,2880,4,373898,0,2879,323,2880,45,1
20141227.022835,2880,4,373902,-2,2879,310,2880,44,1
20141227.022836,2880,2,373904,-2,2879,310,2880,44,1
20141227.022837,2880,2,373906,-2,2879,310,2880,53,1
20141227.022838,2879,2,373908,0,2879,309,2880,53,0
20141227.022839,2880,2,373910,-2,2879,311,2880,52,1
20141227.022841,2880,12,373922,-8,2879,311,2880,48,1
20141227.022842,2880,2,373924,0,2879,306,2880,99,1
20141227.022843,2880,40,373964,16,2879,307,2880,79,1
20141227.022844,2879,2,373966,0,2879,304,2880,78,0
20141227.022847,2880,4,373970,-4,2879,304,2880,80,1
20141227.022848,2880,6,373976,-6,2879,304,2880,77,1
20141227.022849,2879,2,373978,0,2879,303,2880,77,0
20141227.02285,2880,2,373980,-2,2879,302,2880,76,1
20141227.022853,2879,2,373982,-2,2879,299,2880,86,0
20141227.022856,2880,2,373984,-2,2879,289,2880,86,1
20141227.022857,2880,12,373996,-12,2879,289,2880,80,1
20141227.022857,2880,2,373998,-2,2879,289,2880,79,1
20141227.022858,2879,2,374000,0,2879,288,2880,79,0
20141227.0229,2880,10,374010,-8,2879,288,2880,74,1
20141227.022901,2881,268,374278,-218,2879,288,2881,5,1
20141227.022902,2881,2,374280,2,2879,325,2881,4,1
20141227.022902,2881,2,374282,0,2879,325,2881,3,1
20141227.022904,2881,4,374286,4,2880,10,2881,1,1
20141227.02291,2880,30,374316,-10,2880,45,2881,13,0
20141227.022915,2881,2,374318,0,2880,62,2881,15,1
20141227.022916,2880,2,374320,-2,2880,63,2881,15,0
20141227.022917,2881,14,374334,-8,2880,58,2881,12,1
20141227.022918,2881,2,374336,-2,2880,60,2881,11,1
20141227.022919,2881,4,374340,-4,2880,60,2881,9,1
20141227.02292,2880,12,374352,-6,2880,56,2881,9,0
20141227.022923,2880,140,374492,34,2880,106,2881,53,0
20141227.022924,2880,2,374494,-2,2880,115,2881,53,0
20141227.022926,2880,4,374498,-4,2880,132,2881,58,0
20141227.022928,2881,2,374500,-2,2880,132,2881,57,1
20141227.022929,2881,2,374502,-2,2880,132,2881,60,1
20141227.022929,2880,10,374512,-10,2880,128,2881,60,0
20141227.022929,2881,6,374518,-6,2880,128,2881,58,1
20141227.022931,2881,4,374522,-2,2880,128,2881,72,1
20141227.022932,2881,16,374538,-14,2880,128,2881,64,1
20141227.022933,2881,8,374546,-6,2880,125,2881,91,1
20141227.022934,2880,2,374548,-2,2880,124,2881,92,0
20141227.022934,2881,8,374556,-8,2880,132,2881,88,1
20141227.022935,2881,82,374638,-2,2880,132,2881,47,1
20141227.022935,2881,8,374646,-4,2880,132,2881,43,1
20141227.022936,2881,2,374648,2,2880,132,2881,42,1
20141227.022937,2881,2,374650,2,2880,132,2881,41,1
20141227.022937,2881,4,374654,0,2880,132,2881,39,1
20141227.022938,2881,2,374656,0,2880,132,2881,38,1
20141227.022941,2881,8,374664,0,2880,137,2881,45,1
20141227.022941,2880,6,374670,-4,2880,135,2881,44,0
20141227.022942,2881,78,374748,-58,2880,135,2881,48,1
20141227.022943,2881,12,374760,10,2880,156,2881,43,1
20141227.022944,2881,2,374762,2,2880,156,2881,40,1
20141227.022945,2881,2,374764,-2,2880,156,2881,39,1
20141227.022946,2881,8,374772,-8,2880,157,2882,225,1
20141227.022946,2880,18,374790,-16,2880,156,2882,225,0
20141227.022947,2881,2,374792,-2,2880,156,2882,225,1
20141227.022947,2881,2,374794,0,2880,156,2882,225,1
20141227.022949,2881,38,374832,-38,2880,146,2881,179,1
20141227.02295,2881,6,374838,-6,2880,146,2881,176,1
20141227.02295,2881,6,374844,0,2880,146,2881,196,1
20141227.022951,2881,2,374846,-2,2880,146,2881,195,1
20141227.022953,2880,2,374848,-2,2880,148,2881,195,0
20141227.022954,2881,58,374906,-40,2880,148,2881,166,1
20141227.022955,2881,4,374910,-2,2880,149,2881,166,1
20141227.022957,2881,2,374912,-2,2880,151,2881,185,1
20141227.022957,2880,6,374918,-6,2880,148,2881,185,0
20141227.022958,2881,102,375020,-102,2880,147,2881,133,1
20141227.022959,2881,58,375078,-2,2880,115,2881,104,1
20141227.022959,2880,2,375080,-2,2880,124,2881,105,0
20141229.090001,2882,2562,377642,1942,2882,87,2884,1105,1
20141229.090002,2884,440,378082,226,2883,47,2884,789,1
20141229.090003,2884,1310,379392,354,2883,49,2885,959,1
20141229.090003,2885,2160,381552,-350,2884,7,2885,1030,1
20141229.090003,2885,1054,382606,-284,2884,66,2885,1384,1
20141229.090003,2884,622,383228,-110,2884,28,2885,1179,0
20141229.090004,2885,1284,384512,240,2883,71,2885,554,1
20141229.090004,2885,234,384746,-24,2884,46,2885,564,1
20141229.090005,2885,568,385314,-256,2883,85,2884,2,1
20141229.090005,2884,192,385506,68,2883,77,2885,560,0
20141229.090006,2884,252,385758,80,2883,89,2884,166,0
20141229.090006,2884,650,386408,-156,2883,40,2884,15,0
20141229.090007,2885,156,386564,18,2884,14,2885,661,1
20141229.090007,2884,548,387112,-14,2884,24,2885,678,0
20141229.090008,2882,116,387228,22,2882,215,2884,54,0
20141229.090008,2884,92,387320,-54,2883,39,2884,68,1
20141229.090009,2884,1426,388746,-18,2883,4,2884,22,1
20141229.090009,2883,500,389246,-238,2883,25,2884,9,0
20141229.09001,2884,96,389342,-16,2883,325,2884,10,1
20141229.09001,2884,134,389476,-8,2883,503,2884,42,1
20141229.090011,2884,110,389586,78,2883,564,2884,95,1
20141229.090011,2883,440,390026,150,2883,401,2885,220,0
20141229.090012,2884,142,390168,-24,2884,243,2885,164,1
20141229.090012,2884,122,390290,-76,2884,369,2885,132,1
20141229.090013,2884,262,390552,-262,2884,376,2885,133,1
20141229.090013,2885,64,390616,-44,2884,362,2885,115,1
20141229.090014,2885,274,390890,-166,2884,420,2886,422,1
20141229.090014,2886,208,391098,-122,2884,415,2886,347,1
20141229.090015,2886,40,391138,6,2885,8,2886,328,1
20141229.090015,2885,388,391526,-58,2884,389,2885,35,0
20141229.090016,2887,268,391794,-204,2885,133,2887,204,1
20141229.090016,2887,320,392114,-52,2886,30,2887,142,1
20141229.090017,2887,364,392478,-246,2886,39,2888,293,1
20141229.090017,2888,320,392798,-186,2886,74,2888,444,1
20141229.090018,2886,724,393522,-208,2886,60,2887,31,0
20141229.090018,2887,344,393866,88,2886,73,2887,41,1
20141229.090019,2887,66,393932,2,2886,98,2887,42,1
20141229.090019,2888,262,394194,60,2887,6,2888,222,1
20141229.09002,2887,108,394302,74,2886,179,2887,21,0
20141229.09002,2887,306,394608,-46,2887,38,2888,232,0
20141229.090021,2887,162,394770,-88,2886,185,2887,150,0
20141229.090021,2887,148,394918,-106,2886,190,2888,133,0
20141229.090022,2887,64,394982,-2,2886,205,2887,98,0
20141229.090023,2886,130,395112,92,2886,206,2887,162,0
20141229.090023,2887,188,395300,78,2886,175,2887,134,1
20141229.090024,2887,360,395660,12,2886,194,2887,24,1
20141229.090024,2887,50,395710,16,2887,523,2888,130,1
20141229.090025,2887,72,395782,-40,2887,710,2888,42,1
20141229.090025,2887,338,396120,-226,2887,576,2888,42,1
20141229.090026,2887,224,396344,96,2887,549,2889,516,1
20141229.090026,2887,114,396458,-6,2887,636,2889,517,1
20141229.090027,2888,158,396616,-28,2887,571,2889,683,1
20141229.090027,2888,736,397352,-518,2887,587,2888,51,1
20141229.090027,2888,118,397470,-10,2888,33,2889,702,1
20141229.090028,2888,604,398074,-168,2887,590,2888,1,1
20141229.090029,2889,186,398260,-20,2888,50,2889,524,1
20141229.090029,2889,294,398554,234,2888,112,2889,379,1
20141229.09003,2889,648,399202,124,2888,15,2889,221,1
20141229.09003,2889,162,399364,-82,2887,545,2888,9,1
20141229.090031,2889,56,399420,-10,2888,15,2889,246,1
20141229.090031,2889,542,399962,-78,2888,18,2889,209,1
20141229.090032,2889,164,400126,-100,2888,17,2889,364,1
20141229.090032,2888,144,400270,-22,2888,122,2889,475,0
20141229.090033,2887,266,400536,14,2887,428,2888,57,0
20141229.090033,2888,60,400596,48,2887,454,2888,207,1
20141229.090034,2888,162,400758,92,2887,448,2888,542,1
20141229.090034,2887,118,400876,18,2887,438,2888,545,0
20141229.090034,2887,2,400878,-2,2887,438,2888,540,0
20141229.090035,2888,130,401008,6,2887,397,2888,591,1
20141229.090036,2888,76,401084,42,2887,390,2888,566,1
20141229.090036,2887,1346,402430,-360,2887,226,2888,67,0
20141229.090037,2888,136,402566,2,2887,174,2888,99,1
20141229.090037,2888,254,402820,124,2887,260,2888,21,1
20141229.090038,2888,116,402936,-78,2887,244,2888,39,1
20141229.090038,2887,20,402956,-6,2887,236,2888,124,0
20141229.090039,2888,256,403212,-28,2887,294,2888,17,1
20141229.090039,2888,74,403286,6,2887,212,2888,54,1
20141229.09004,2887,484,403770,110,2886,243,2888,41,0
20141229.09004,2887,86,403856,44,2886,209,2887,46,0
20141229.090041,2887,46,403902,-16,2886,208,2887,8,0
20141229.090041,2888,74,403976,16,2886,317,2887,1,1
20141229.090042,2887,160,404136,10,2886,298,2888,504,0
20141229.090042,2886,634,404770,-474,2885,1015,2887,53,0
20141229.090042,2886,30,404800,-4,2885,1015,2887,118,0
20141229.090043,2885,1248,406048,-1000,2885,484,2886,54,0
20141229.090043,2885,80,406128,-80,2885,363,2886,65,0
20141229.090044,2885,174,406302,-132,2885,394,2886,84,0
20141229.090045,2885,790,407092,-418,2884,71,2885,9,0
20141229.090045,2885,216,407308,-194,2884,208,2885,169,0
20141229.090046,2884,406,407714,-228,2884,442,2886,40,0
20141229.090046,2888,1086,408800,-240,2887,349,2888,827,1
20141229.090047,2886,1310,410110,-296,2885,77,2886,49,0
20141229.090047,2886,78,410188,-54,2885,146,2886,106,0
20141229.090048,2886,88,410276,-12,2885,181,2886,63,0
20141229.090048,2886,254,410530,-214,2886,15,2887,97,0
20141229.090049,2885,104,410634,50,2885,146,2886,5,0
20141229.090049,2885,444,411078,-308,2884,265,2885,83,0
20141229.09005,2887,452,411530,-298,2884,275,2887,114,1
20141229.09005,2886,138,411668,-42,2886,57,2887,109,0
20141229.090051,2885,384,412052,-54,2884,278,2886,2,0
20141229.090051,2884,2,412054,-2,2884,286,2886,37,0
20141229.090052,2885,608,412662,-564,2883,110,2885,164,1
20141229.090052,2885,26,412688,-24,2884,6,2885,487,1
20141229.090053,2885,398,413086,24,2884,127,2885,646,1
20141229.090053,2887,1384,414470,-542,2885,6,2887,175,1
20141229.090054,2887,134,414604,-48,2885,318,2886,441,1
20141229.090054,2885,6,414610,-2,2885,295,2886,453,0
20141229.090055,2885,100,414710,-16,2885,311,2886,441,0
20141229.090055,2886,224,414934,-18,2885,322,2886,433,1
20141229.090056,2885,22,414956,-22,2885,313,2886,433,0
20141229.090056,2885,248,415204,-184,2885,208,2886,426,0
20141229.090057,2885,136,415340,-82,2885,169,2886,422,0
20141229.090057,2886,168,415508,-84,2885,125,2886,373,1
20141229.090058,2885,14,415522,12,2885,119,2886,379,0
20141229.090058,2886,34,415556,0,2885,126,2886,376,1
20141229.090059,2885,338,415894,170,2884,138,2885,624,0
20141229.0901,2885,484,416378,206,2884,90,2886,330,0
20141229.0901,2885,292,416670,-166,2884,73,2886,331,0
20141229.090101,2885,146,416816,-36,2884,89,2886,346,0
20141229.090101,2885,100,416916,-2,2885,312,2886,407,0
20141229.090102,2886,46,416962,-22,2885,300,2886,435,1
20141229.090102,2886,54,417016,-30,2885,13,2886,473,1
20141229.090103,2886,2068,419084,-1300,2886,5,2888,770,1
20141229.090103,2885,156,419240,-38,2885,199,2887,115,0
20141229.090104,2889,2168,421408,-1396,2886,167,2889,285,1
20141229.090104,2889,982,422390,-476,2889,593,2890,1464,1
20141229.090105,2889,1164,423554,-616,2889,68,2890,1460,1
20141229.090105,2888,330,423884,-70,2888,24,2889,286,0
20141229.090106,2887,122,424006,22,2887,239,2889,329,0
20141229.090106,2888,20,424026,-20,2887,247,2888,1,1
20141229.090107,2888,58,424084,54,2887,231,2888,87,1
20141229.090107,2888,128,424212,-110,2887,168,2888,101,1
20141229.090108,2890,1276,425488,-414,2889,410,2890,1280,1
20141229.090108,2890,12,425500,-10,2889,408,2890,1056,1
20141229.090109,2889,242,425742,-200,2889,1300,2890,1043,0
20141229.090109,2889,658,426400,152,2889,1375,2890,710,0
20141229.09011,2890,1364,427764,688,2889,1409,2890,39,1
20141229.09011,2890,900,428664,220,2890,275,2892,461,1
20141229.090111,2890,470,429134,-254,2890,125,2892,494,1
20141229.090111,2891,174,429308,-30,2890,60,2892,753,1
20141229.090112,2891,278,429586,-44,2890,26,2892,825,1
20141229.090112,2891,72,429658,50,2890,108,2891,348,1
20141229.090113,2891,230,429888,-204,2889,323,2891,310,1
20141229.090113,2890,766,430654,-422,2888,215,2890,136,0
20141229.090114,2889,12,430666,2,2888,241,2890,48,0
20141229.090114,2890,38,430704,-4,2889,268,2890,135,1
20141229.090115,2890,28,430732,-20,2889,260,2890,81,1
20141229.090115,2890,128,430860,-48,2889,215,2890,96,1
20141229.090116,2890,152,431012,26,2889,14,2890,59,1
20141229.090116,2890,54,431066,-10,2889,99,2890,124,1
20141229.090117,2890,20,431086,0,2889,102,2890,300,1
20141229.090117,2888,248,431334,46,2888,285,2890,338,0
20141229.090118,2889,414,431748,246,2889,50,2890,161,1
20141229.090118,2890,426,432174,-268,2890,798,2891,391,1
20141229.090119,2890,116,432290,-112,2890,740,2891,349,1
20141229.090119,2890,624,432914,-170,2890,627,2891,204,1
20141229.09012,2891,50,432964,-4,2890,685,2891,159,1
20141229.09012,2891,34,432998,-14,2890,731,2891,148,1
20141229.090121,2890,16,433014,-12,2890,184,2891,120,0
20141229.090121,2891,444,433458,128,2890,242,2891,71,1
20141229.090122,2891,44,433502,-16,2890,236,2891,134,1
20141229.090122,2891,52,433554,-42,2890,233,2891,121,1
20141229.090123,2891,54,433608,-46,2890,231,2891,60,1
20141229.090123,2891,192,433800,22,2891,113,2892,684,1
20141229.090124,2892,28,433828,6,2891,110,2892,640,1
20141229.090124,2891,172,434000,40,2891,98,2892,589,0
20141229.090125,2891,442,434442,-16,2890,214,2891,634,0
20141229.090125,2891,158,434600,48,2890,174,2891,607,0
20141229.090126,2891,204,434804,192,2890,146,2891,573,0
20141229.090126,2891,220,435024,220,2890,143,2891,478,0
20141229.090127,2891,24,435048,14,2890,151,2891,554,0
20141229.090127,2890,386,435434,10,2890,645,2891,375,0
20141229.090128,2891,1538,436972,-502,2890,237,2891,508,1
20141229.090128,2891,362,437334,-356,2890,54,2891,570,1
20141229.090129,2890,146,437480,-86,2889,522,2890,96,0
20141229.090129,2889,38,437518,24,2889,510,2890,201,0
20141229.09013,2890,48,437566,-6,2889,516,2890,238,1
20141229.09013,2890,46,437612,-28,2889,515,2890,225,1
20141229.090131,2890,44,437656,0,2889,494,2890,237,1
20141229.090131,2889,22,437678,-4,2889,490,2890,272,0
20141229.090132,2889,2260,439938,-334,2888,112,2891,132,0
20141229.090133,2889,424,440362,-204,2888,93,2889,348,0
20141229.090133,2888,502,440864,30,2888,188,2890,296,0
20141229.090134,2888,294,441158,-168,2888,86,2890,367,0
20141229.090134,2888,16,441174,-2,2888,81,2890,369,0
20141229.090135,2890,68,441242,-64,2888,138,2889,85,1
20141229.090135,2888,2,441244,2,2888,181,2889,177,0
20141229.090136,2888,78,441322,40,2888,171,2889,162,0
20141229.090136,2889,80,441402,-34,2888,183,2889,255,1
20141229.090137,2889,570,441972,-282,2889,220,2890,903,1
20141229.090137,2889,8,441980,-6,2889,267,2890,934,1
20141229.090138,2889,134,442114,-122,2889,200,2890,941,1
20141229.090138,2890,608,442722,0,2889,200,2890,637,1
20141229.090139,2889,422,443144,100,2888,248,2889,28,0
20141229.090139,2888,156,443300,-126,2888,190,2889,136,0
20141229.09014,2889,330,443630,64,2889,39,2890,1520,1
20141229.09014,2889,86,443716,-78,2888,92,2889,41,1
20141229.090141,2889,646,444362,388,2888,98,2889,82,1
20141229.090141,2888,38,444400,12,2888,233,2889,58,0
20141229.090142,2889,22,444422,22,2888,233,2889,110,1
20141229.090142,2888,206,444628,182,2888,231,2889,11,0
20141229.090143,2889,92,444720,50,2888,269,2890,1281,1
20141229.090143,2889,48,444768,36,2889,87,2890,1283,1
20141229.090144,2889,400,445168,116,2888,232,2889,44,1
20141229.090144,2889,76,445244,-68,2889,523,2890,1054,1
20141229.090145,2890,44,445288,0,2889,503,2890,1039,1
20141229.090145,2889,44,445332,-16,2889,495,2890,1084,0
20141229.090146,2889,1364,446696,-890,2888,108,2889,155,0
20141229.090146,2889,16,446712,-12,2888,126,2889,269,0
20141229.090147,2888,254,446966,-218,2887,305,2888,23,0
20141229.090147,2888,10,446976,0,2887,280,2888,58,0
20141229.090148,2888,72,447048,-48,2887,306,2888,30,0
20141229.090148,2888,1098,448146,-248,2888,305,2889,70,0
20141229.090149,2889,192,448338,42,2888,452,2889,4,1
20141229.090149,2890,1106,449444,-108,2888,476,2890,179,1
20141229.09015,2890,10,449454,-4,2889,334,2890,222,1
20141229.09015,2889,80,449534,-2,2889,289,2890,219,0
20141229.09015,2889,6,449540,-2,2889,874,2890,229,0
20141229.090151,2890,482,450022,-396,2890,302,2891,615,1
20141229.090152,2891,1644,451666,-1158,2889,648,2891,464,1
20141229.090152,2889,20,451686,0,2889,597,2890,151,0
20141229.090153,2889,122,451808,-100,2889,569,2890,166,0
20141229.090153,2890,8,451816,6,2889,569,2890,162,1
20141229.090154,2890,22,451838,14,2889,584,2890,162,1
20141229.090154,2890,114,451952,114,2889,525,2890,117,1
20141229.090155,2890,504,452456,-154,2890,310,2891,562,1
20141229.090155,2890,472,452928,244,2890,275,2891,280,1
20141229.090156,2890,48,452976,-4,2890,276,2891,286,1
20141229.090156,2890,518,453494,372,2890,277,2891,35,1
20141229.090157,2890,52,453546,-6,2890,345,2891,35,1
20141229.090157,2890,72,453618,-2,2890,368,2891,1,1
20141229.090158,2890,16,453634,-6,2890,424,2891,25,1
20141229.090158,2890,50,453684,-18,2890,395,2891,175,1
20141229.090158,2890,106,453790,-2,2890,343,2891,175,1
20141229.090159,2891,20,453810,-6,2890,334,2891,286,1
20141229.0902,2890,550,454360,-312,2890,151,2891,329,0
20141229.0902,2890,302,454662,-40,2889,703,2890,1,0
20141229.090201,2889,112,454774,-100,2889,701,2890,209,0
20141229.090201,2890,26,454800,0,2889,721,2890,145,1
20141229.090202,2891,362,455162,-234,2889,487,2891,190,1
20141229.090202,2890,38,455200,-38,2890,59,2891,188,0
20141229.090203,2891,8,455208,-6,2890,142,2891,219,1
20141229.090203,2890,44,455252,-4,2890,1151,2891,206,0
20141229.090204,2891,406,455658,-20,2891,1,2892,1162,1
20141229.090204,2891,12,455670,0,2891,258,2892,1061,1
20141229.090205,2891,44,455714,-20,2891,411,2892,905,1
20141229.090205,2891,36,455750,-18,2891,391,2892,893,1
20141229.090206,2892,978,456728,392,2891,445,2892,411,1
20141229.090206,2891,4,456732,-4,2891,604,2892,404,0
20141229.090207,2891,42,456774,-18,2891,597,2892,393,0
20141229.090207,2892,826,457600,248,2892,190,2893,717,1
20141229.090208,2892,1188,458788,196,2891,228,2892,208,1
20141229.090208,2891,84,458872,-16,2891,273,2892,176,0
20141229.090209,2892,1080,459952,-228,2892,772,2893,261,1
20141229.090209,2892,698,460650,588,2892,773,2893,13,1
20141229.09021,2892,118,460768,64,2892,797,2893,3,1
20141229.09021,2892,20,460788,-14,2893,119,2894,1893,1
20141229.090211,2892,306,461094,256,2892,769,2893,175,1
20141229.090211,2892,212,461306,190,2892,776,2893,322,1
20141229.090212,2893,350,461656,330,2892,798,2893,185,1
20141229.090212,2892,44,461700,22,2892,807,2893,174,0
20141229.090213,2893,12,461712,4,2892,826,2893,302,1
20141229.090213,2893,74,461786,44,2892,846,2893,179,1
20141229.090214,2892,12,461798,-6,2892,853,2893,176,0
20141229.090214,2892,300,462098,196,2892,735,2893,200,0
20141229.090215,2892,42,462140,-10,2892,718,2893,65,0
20141229.090215,2893,220,462360,-70,2893,393,2894,1979,1
20141229.090216,2893,744,463104,-570,2893,100,2894,1910,1
20141229.090216,2893,386,463490,-190,2893,20,2894,1932,1
20141229.090217,2893,218,463708,-52,2892,728,2893,36,1
20141229.090217,2893,10,463718,-6,2892,725,2893,24,1
20141229.090218,2892,24,463742,0,2892,748,2893,338,0
20141229.090218,2894,682,464424,-176,2893,171,2894,1961,1
20141229.090219,2894,1030,465454,-532,2893,63,2894,1908,1
20141229.090219,2894,226,465680,26,2893,384,2894,1791,1
20141229.09022,2893,576,466256,160,2893,117,2894,1794,0
20141229.09022,2893,232,466488,-228,2892,606,2893,15,0
20141229.090221,2892,1590,468078,-250,2891,442,2893,48,0
20141229.090221,2893,664,468742,-132,2892,145,2893,116,1
20141229.090222,2893,422,469164,-354,2891,355,2893,274,1
20141229.090222,2893,46,469210,2,2892,1,2893,591,1
20141229.090223,2892,76,469286,66,2891,476,2893,514,0
20141229.090224,2891,50,469336,24,2891,445,2893,674,0
20141229.090225,2891,22,469358,22,2891,461,2893,796,0
20141229.090226,2892,1066,470424,-298,2892,11,2893,442,1
20141229.090226,2892,186,470610,-58,2892,42,2893,528,1
20141229.090227,2892,530,471140,52,2892,29,2893,433,1
20141229.090227,2892,36,471176,-4,2892,17,2893,493,1
20141229.090228,2892,106,471282,-6,2891,425,2892,14,1
20141229.090228,2892,104,471386,-28,2892,219,2893,402,1
20141229.090229,2892,56,471442,-8,2892,339,2893,377,1
20141229.090229,2892,8,471450,-4,2892,345,2893,377,1
20141229.09023,2892,38,471488,0,2892,392,2893,327,1
20141229.09023,2892,70,471558,-68,2892,396,2893,267,1
20141229.090231,2893,82,471640,6,2892,396,2893,230,1
20141229.090231,2892,968,472608,-4,2892,79,2893,255,0
20141229.090232,2892,110,472718,-64,2891,249,2893,260,0
20141229.090232,2893,624,473342,384,2892,88,2893,142,1
20141229.090233,2893,42,473384,32,2892,199,2893,171,1
20141229.090233,2893,190,473574,-70,2892,168,2893,235,1
20141229.090234,2893,172,473746,22,2892,162,2893,375,1
20141229.090234,2892,20,473766,6,2892,153,2893,419,0
20141229.090235,2893,256,474022,74,2891,276,2893,684,1
20141229.090235,2893,42,474064,36,2891,173,2892,1,1
20141229.090236,2891,164,474228,34,2891,161,2893,787,0
20141229.090236,2892,22,474250,-12,2891,192,2892,22,1
20141229.090237,2892,16,474266,-4,2891,191,2892,104,1
20141229.090238,2892,34,474300,-12,2891,191,2892,178,1
20141229.090238,2891,8,474308,-8,2891,187,2892,181,0
20141229.090239,2892,38,474346,-38,2891,187,2892,162,1
20141229.090239,2892,70,474416,-64,2891,188,2892,220,1
20141229.09024,2892,112,474528,-76,2891,201,2892,170,1
20141229.09024,2891,834,475362,148,2890,595,2891,281,0
20141229.09024,2892,610,475972,566,2891,59,2892,127,1
20141229.090241,2892,344,476316,-116,2891,25,2892,33,1
20141229.090242,2892,112,476428,2,2891,172,2892,75,1
20141229.090242,2892,432,476860,64,2890,537,2892,112,1
20141229.090243,2892,48,476908,0,2891,23,2892,156,1
20141229.090243,2892,318,477226,114,2891,22,2892,171,1
20141229.090244,2891,64,477290,26,2891,67,2892,192,0
20141229.090244,2891,134,477424,46,2891,92,2892,208,0
20141229.090245,2892,532,477956,-56,2891,68,2892,422,1
20141229.090245,2892,4,477960,0,2891,148,2892,408,1
20141229.090246,2891,300,478260,-116,2890,424,2891,3,0
20141229.090246,2891,8,478268,0,2890,434,2891,50,0
20141229.090247,2891,52,478320,-30,2890,417,2891,178,0
20141229.090247,2891,2,478322,-2,2890,411,2891,177,0
20141229.090248,2891,38,478360,-34,2890,411,2891,169,0
20141229.090248,2890,14,478374,0,2890,409,2891,170,0
20141229.090249,2890,4,478378,-2,2890,408,2891,173,0
20141229.090249,2891,6,478384,-6,2890,508,2891,170,1
20141229.09025,2891,28,478412,-8,2890,534,2891,165,1
20141229.09025,2890,510,478922,-54,2890,279,2891,165,0
20141229.090251,2890,660,479582,-118,2889,645,2890,131,0
20141229.090251,2889,60,479642,-56,2889,441,2890,232,0
20141229.090252,2890,180,479822,-160,2889,440,2890,203,1
20141229.090252,2890,88,479910,-6,2889,438,2890,235,1
20141229.090253,2890,288,480198,80,2889,316,2890,227,1
20141229.090253,2889,488,480686,-310,2889,313,2891,586,0
20141229.090254,2891,48,480734,-16,2890,2,2891,838,1
20141229.090254,2889,14,480748,-4,2889,315,2890,71,0
20141229.090255,2889,74,480822,-50,2889,292,2890,65,0
20141229.090255,2890,16,480838,14,2889,297,2890,148,1
20141229.090256,2890,4,480842,2,2889,297,2890,177,1
20141229.090256,2890,1266,482108,810,2890,108,2891,850,1
20141229.090257,2890,256,482364,192,2889,242,2890,30,1
20141229.090257,2891,534,482898,-176,2890,9,2891,568,1
20141229.090258,2890,62,482960,-10,2889,300,2890,25,0
20141229.090258,2890,36,482996,36,2889,304,2890,103,0
20141229.090259,2889,202,483198,-198,2889,256,2890,147,0
20141229.0903,2889,10,483208,-2,2889,420,2890,219,0
20141229.0903,2889,24,483232,-18,2889,411,2890,223,0
20141229.090301,2889,30,483262,-20,2889,394,2890,206,0
20141229.090301,2890,6,483268,6,2889,397,2890,199,1
20141229.090302,2890,12,483280,4,2889,398,2890,185,1
20141229.090302,2890,18,483298,0,2889,461,2890,198,1
20141229.090303,2890,4,483302,-2,2889,460,2890,205,1
20141229.090303,2890,10,483312,8,2889,456,2890,206,1
20141229.090304,2890,696,484008,-474,2890,44,2891,620,1
20141229.090304,2890,122,484130,-50,2889,160,2891,620,1
20141229.090305,2890,18,484148,14,2890,150,2891,619,1
20141229.090306,2890,62,484210,14,2890,216,2891,607,1
20141229.090306,2890,78,484288,8,2890,274,2891,569,1
20141229.090307,2890,42,484330,24,2890,278,2891,560,1
20141229.090307,2890,24,484354,24,2890,312,2891,535,1
20141229.090308,2890,10,484364,4,2890,312,2891,576,1
20141229.090308,2890,30,484394,0,2890,312,2891,605,1
20141229.090309,2890,6,484400,6,2890,374,2891,605,1
20141229.090309,2890,6,484406,2,2890,372,2891,605,1
20141229.09031,2890,14,484420,12,2890,367,2891,603,1
20141229.09031,2890,2,484422,0,2890,371,2891,555,1
20141229.09031,2890,76,484498,46,2890,333,2891,553,1
20141229.090311,2890,68,484566,30,2890,304,2891,578,1
20141229.090312,2890,4,484570,-2,2890,303,2891,588,1
20141229.090313,2890,14,484584,2,2890,297,2891,505,1
20141229.090313,2890,6,484590,-4,2890,295,2891,504,1
20141229.090314,2890,28,484618,-24,2890,279,2891,504,1
20141229.090314,2891,10,484628,0,2890,277,2891,504,1
20141229.090315,2891,18,484646,0,2890,282,2891,493,1
20141229.090315,2890,10,484656,0,2890,277,2891,492,0
20141229.090316,2890,48,484704,-34,2890,262,2891,606,0
20141229.090317,2891,46,484750,-34,2890,252,2891,648,1
20141229.090317,2890,8,484758,0,2890,253,2891,688,0
20141229.090318,2890,690,485448,222,2890,102,2891,400,0
20141229.090318,2890,24,485472,14,2890,93,2891,403,0
20141229.090319,2890,6,485478,0,2890,91,2891,405,0
20141229.090319,2891,14,485492,2,2890,137,2891,404,1
20141229.09032,2890,34,485526,-8,2890,121,2891,405,0
20141229.09032,2890,20,485546,4,2890,540,2891,398,0
20141229.090321,2890,14,485560,0,2890,506,2891,393,0
20141229.090321,2890,10,485570,10,2890,506,2891,393,0
20141229.090322,2891,32,485602,16,2890,509,2891,382,1
20141229.090322,2891,772,486374,540,2891,16,2892,916,1
20141229.090323,2891,494,486868,-264,2890,366,2891,84,1
20141229.090323,2891,128,486996,-84,2890,390,2891,31,1
20141229.090324,2891,214,487210,-200,2890,202,2891,59,1
20141229.090325,2890,2,487212,0,2890,221,2891,180,0
20141229.090326,2891,2,487214,0,2890,322,2891,240,1
20141229.090326,2891,4,487218,0,2890,1925,2891,262,1
20141229.090327,2891,132,487350,-102,2890,3164,2891,186,1
20141229.090327,2891,258,487608,-34,2891,26,2892,796,1
20141229.090328,2891,70,487678,-6,2891,100,2892,776,1
20141229.090328,2891,224,487902,28,2890,4355,2891,496,1
20141229.090329,2891,16,487918,0,2890,4394,2891,753,1
20141229.090329,2891,24,487942,6,2890,4413,2891,340,1
20141229.09033,2891,18,487960,0,2890,435,2891,331,1
20141229.09033,2890,830,488790,-398,2889,592,2890,33,0
20141229.090331,2890,102,488892,-54,2889,479,2890,75,0
20141229.090331,2890,6,488898,2,2889,479,2890,75,0
20141229.090332,2890,30,488928,30,2889,479,2890,104,0
20141229.090332,2890,38,488966,14,2889,478,2890,88,0
20141229.090333,2890,38,489004,-24,2889,462,2890,84,0
20141229.090333,2890,98,489102,18,2889,462,2890,48,0
20141229.090334,2890,30,489132,20,2889,420,2890,33,0
20141229.090334,2890,20,489152,20,2889,430,2890,23,0
20141229.090335,2889,20,489172,10,2889,425,2890,18,0
20141229.090335,2890,66,489238,36,2890,4,2891,675,1
20141229.090336,2890,216,489454,-196,2889,419,2890,77,1
20141229.090336,2890,94,489548,6,2889,398,2890,153,1
20141229.090337,2890,16,489564,16,2889,402,2890,145,1
20141229.090337,2890,196,489760,-28,2889,406,2890,162,1
20141229.090338,2890,120,489880,-80,2889,354,2890,176,1
20141229.090338,2890,324,490204,32,2889,353,2890,35,1
20141229.090339,2890,8,490212,-8,2889,491,2890,39,1
20141229.090339,2889,518,490730,-12,2889,380,2891,728,0
20141229.09034,2890,2,490732,-2,2890,61,2891,638,1
20141229.09034,2890,132,490864,-100,2889,638,2890,2,1
20141229.090341,2891,24,490888,-4,2890,11,2891,729,1
20141229.090341,2890,54,490942,10,2890,3,2891,612,0
20141229.090342,2891,8,490950,0,2890,284,2891,636,1
20141229.090342,2890,106,491056,0,2890,237,2891,644,0
20141229.090343,2890,28,491084,-26,2890,225,2891,644,0
20141229.090343,2890,10,491094,-6,2890,235,2891,641,0
20141229.090344,2890,2,491096,0,2890,234,2891,643,0
20141229.090344,2890,2,491098,-2,2890,484,2891,643,0
20141229.090345,2890,240,491338,0,2890,418,2891,645,0
20141229.090346,2891,54,491392,-10,2890,383,2891,663,1
20141229.090346,2890,48,491440,-40,2890,359,2891,638,0
20141229.090346,2890,20,491460,-20,2890,349,2891,638,0
20141229.090347,2890,42,491502,-36,2890,377,2891,640,0
20141229.090349,2890,8,491510,-8,2890,383,2891,652,0
20141229.09035,2890,50,491560,-42,2890,369,2891,648,0
20141229.09035,2890,14,491574,14,2890,363,2891,648,0
20141229.090351,2890,14,491588,12,2890,361,2891,644,0
20141229.090351,2890,36,491624,28,2890,353,2891,834,0
20141229.090352,2891,22,491646,-2,2890,352,2891,702,1
20141229.090352,2890,126,491772,-12,2890,299,2891,698,0
20141229.090353,2891,2,491774,2,2890,304,2891,717,1
20141229.090353,2890,6,491780,-2,2890,301,2891,761,0
20141229.090354,2890,2,491782,-2,2890,300,2891,772,0
20141229.090355,2890,140,491922,-18,2890,234,2891,771,0
20141229.090355,2890,358,492280,24,2890,68,2891,784,0
20141229.090356,2890,178,492458,92,2889,440,2890,258,0
20141229.090356,2890,88,492546,28,2889,559,2890,252,0
20141229.090357,2890,6,492552,-2,2889,430,2890,273,0
20141229.090357,2890,98,492650,2,2889,429,2890,227,0
20141229.090358,2890,22,492672,20,2889,427,2890,219,0
20141229.090358,2889,112,492784,-32,2889,413,2890,201,0
20141229.090359,2889,18,492802,-8,2889,534,2890,186,0
20141229.090359,2890,50,492852,2,2889,545,2890,188,1
20141229.0904,2890,14,492866,0,2889,545,2890,174,1
20141229.0904,2890,206,493072,-108,2889,489,2890,134,1
20141229.090401,2889,2,493074,0,2889,498,2890,337,0
20141229.090401,2890,28,493102,0,2889,491,2890,334,1
20141229.090402,2890,16,493118,0,2889,492,2890,442,1
20141229.090402,2890,334,493452,22,2889,492,2890,281,1
20141229.090402,2889,88,493540,-46,2889,463,2890,266,0
20141229.090403,2889,1318,494858,-1102,2888,581,2890,416,0
20141229.090404,2889,14,494872,-8,2889,124,2890,514,0
20141229.090404,2890,38,494910,4,2889,125,2890,487,1
20141229.090405,2889,364,495274,340,2889,131,2890,327,0
20141229.090405,2889,20,495294,-20,2889,215,2890,340,0
20141229.090406,2889,16,495310,-2,2889,264,2890,239,0
20141229.090406,2890,500,495810,366,2890,290,2891,964,1
20141229.090407,2890,196,496006,160,2890,195,2891,802,1
20141229.090407,2890,34,496040,-34,2890,679,2891,819,1
20141229.090408,2890,150,496190,-116,2890,621,2891,795,1
20141229.090408,2890,58,496248,40,2890,594,2891,761,1
20141229.090409,2890,52,496300,2,2890,569,2891,708,1
20141229.090409,2890,6,496306,4,2890,571,2891,809,1
20141229.09041,2890,68,496374,66,2890,582,2891,780,1
20141229.09041,2890,2,496376,0,2890,581,2891,779,1
20141229.090411,2890,444,496820,-350,2890,359,2891,824,1
20141229.090411,2891,40,496860,-20,2890,351,2891,814,1
20141229.090412,2890,12,496872,0,2890,344,2891,817,0
20141229.090412,2891,40,496912,-6,2890,332,2891,816,1
20141229.090413,2890,4,496916,0,2890,330,2891,841,0
20141229.090413,2890,668,497584,-626,2889,263,2890,184,0
20141229.090414,2890,12,497596,12,2889,258,2890,299,0
20141229.090415,2890,44,497640,2,2889,220,2890,301,0
20141229.090415,2889,42,497682,-2,2889,205,2890,315,0
20141229.090416,2890,296,497978,-118,2890,422,2891,751,1
20141229.090416,2890,98,498076,-42,2890,408,2891,693,1
20141229.090417,2891,430,498506,-30,2890,195,2891,705,1
20141229.090417,2890,504,499010,-400,2889,265,2890,302,0
20141229.090418,2890,10,499020,-8,2889,270,2890,302,0
20141229.090418,2890,14,499034,0,2889,273,2890,298,0
20141229.090419,2890,22,499056,-2,2889,275,2890,399,0
20141229.090419,2890,120,499176,-114,2889,269,2890,376,0
20141229.09042,2891,1064,500240,-556,2890,232,2891,536,1
20141229.09042,2891,1368,501608,-1218,2889,394,2890,6,1
20141229.090421,2890,6,501614,4,2889,397,2890,160,0
20141229.090421,2890,64,501678,-2,2889,564,2890,129,0
20141229.090422,2890,176,501854,-6,2889,604,2890,125,0
20141229.090422,2890,352,502206,-78,2890,457,2891,459,0
20141229.090423,2890,102,502308,-40,2890,592,2891,460,0
20141229.090423,2891,86,502394,-76,2890,580,2891,429,1
20141229.090424,2890,122,502516,-34,2890,588,2891,376,0
20141229.090424,2891,106,502622,52,2890,591,2891,328,1
20141229.090425,2890,2,502624,-2,2890,591,2891,320,0
20141229.090426,2890,246,502870,-54,2890,455,2891,335,0
20141229.090426,2890,84,502954,-6,2890,383,2891,316,0
20141229.090427,2891,120,503074,-2,2890,394,2891,271,1
20141229.090427,2891,20,503094,-20,2890,399,2891,266,1
20141229.090428,2891,242,503336,-86,2890,3399,2891,157,1
20141229.090429,2892,454,503790,142,2891,59,2892,1348,1
20141229.090429,2892,20,503810,-20,2891,109,2892,1308,1
20141229.09043,2891,224,504034,0,2890,3514,2891,261,0
20141229.09043,2890,6,504040,0,2890,3456,2891,362,0
20141229.090431,2891,16,504056,0,2890,3496,2891,367,1
20141229.090431,2891,46,504102,-40,2890,3496,2891,344,1
20141229.090432,2891,178,504280,-162,2890,3495,2891,257,1
20141229.090432,2891,2,504282,0,2890,3495,2891,176,1
20141229.090433,2890,44,504326,-40,2890,3542,2891,160,0
20141229.090433,2891,2,504328,-2,2890,3571,2891,164,1
20141229.090434,2891,4,504332,0,2890,3581,2891,163,1
20141229.090434,2890,36,504368,-4,2890,3579,2891,147,0
20141229.090435,2892,300,504668,-28,2891,2,2892,1229,1
20141229.090435,2891,38,504706,-2,2891,34,2892,1255,0
20141229.090436,2891,74,504780,58,2891,2,2892,1255,0
20141229.090436,2892,26,504806,20,2891,4,2892,1241,1
20141229.090437,2892,32,504838,14,2891,21,2892,1227,1
20141229.090437,2891,1634,506472,1028,2890,558,2892,1216,0
20141229.090438,2891,12,506484,-4,2890,537,2891,143,0
20141229.090438,2891,4,506488,0,2890,470,2891,550,0
20141229.090439,2890,40,506528,0,2890,456,2891,661,0
20141229.09044,2891,16,506544,0,2890,458,2891,862,1
20141229.09044,2891,16,506560,-10,2890,458,2891,861,1
20141229.090441,2891,12,506572,0,2890,464,2891,857,1
20141229.090441,2891,4,506576,0,2890,465,2891,857,1
20141229.090442,2891,98,506674,-80,2890,426,2891,850,1
20141229.090443,2891,900,507574,-216,2890,455,2891,406,1
20141229.090443,2890,10,507584,-4,2890,453,2891,404,0
20141229.090444,2891,14,507598,-4,2890,454,2891,524,1
20141229.090444,2891,1014,508612,776,2890,195,2891,578,1
20141229.090445,2890,406,509018,-116,2889,607,2890,28,0
20141229.090445,2891,98,509116,-40,2890,626,2891,551,1
20141229.090446,2891,604,509720,-368,2890,302,2891,605,1
20141229.090447,2890,10,509730,-10,2890,297,2891,713,0
20141229.090448,2890,12,509742,10,2890,297,2891,705,0
20141229.090448,2890,14,509756,-2,2890,391,2891,706,0
20141229.090449,2891,10,509766,0,2890,388,2891,707,1
20141229.090449,2890,18,509784,-10,2890,526,2891,708,0
20141229.09045,2890,16,509800,-16,2890,525,2891,720,0
20141229.09045,2891,4,509804,0,2890,525,2891,720,1
20141229.090451,2891,2,509806,2,2890,528,2891,720,1
20141229.090451,2891,34,509840,0,2890,529,2891,664,1
20141229.090452,2891,56,509896,-14,2890,518,2891,712,1
20141229.090452,2891,22,509918,-22,2890,519,2891,606,1
20141229.090453,2890,118,510036,-6,2890,535,2891,608,0
20141229.090453,2891,2,510038,-2,2890,551,2891,605,1
20141229.090454,2890,10,510048,-4,2890,550,2891,651,0
20141229.090454,2890,28,510076,-22,2890,537,2891,652,0
20141229.090455,2891,110,510186,-92,2890,538,2891,597,1
20141229.090455,2891,914,511100,-222,2891,197,2892,1498,1
20141229.090456,2892,1278,512378,388,2891,714,2892,755,1
20141229.090457,2892,1544,513922,648,2892,111,2893,918,1
20141229.090457,2893,586,514508,376,2892,123,2893,562,1
20141229.090458,2893,1072,515580,628,2893,991,2894,2287,1
20141229.090458,2893,32,515612,28,2893,988,2894,2174,1
20141229.090459,2894,294,515906,2,2893,393,2894,2070,1
20141229.090459,2894,1114,517020,412,2893,430,2894,1513,1
20141229.0905,2894,718,517738,284,2893,317,2894,1154,1
20141229.0905,2895,2006,519744,1350,2894,102,2895,1127,1
20141229.090501,2895,1900,521644,590,2894,337,2895,78,1
20141229.090501,2896,310,521954,22,2895,119,2896,605,1
20141229.090502,2896,576,522530,30,2895,313,2896,291,1
20141229.090502,2895,684,523214,338,2895,390,2897,388,0
20141229.090503,2897,316,523530,-20,2896,178,2897,482,1
20141229.090503,2896,948,524478,-218,2895,270,2896,97,0
20141229.090504,2896,456,524934,-316,2895,320,2896,21,0
20141229.090504,2896,360,525294,-200,2895,459,2896,54,0
20141229.090505,2896,88,525382,70,2895,302,2896,18,0
20141229.090506,2896,184,525566,40,2896,12,2897,503,0
20141229.090506,2896,70,525636,0,2896,109,2897,504,0
20141229.090507,2897,106,525742,38,2896,531,2897,474,1
20141229.090507,2896,474,526216,374,2896,523,2897,258,0
20141229.090508,2897,156,526372,96,2896,480,2897,314,1
20141229.090508,2896,54,526426,-28,2896,466,2897,485,0
20141229.090509,2897,436,526862,388,2896,472,2897,316,1
20141229.090509,2896,20,526882,-4,2896,465,2897,367,0
20141229.09051,2896,220,527102,44,2896,461,2897,262,0
20141229.09051,2896,34,527136,-26,2896,446,2897,261,0
20141229.090511,2897,546,527682,248,2897,71,2898,931,1
20141229.090511,2897,212,527894,-22,2897,28,2898,993,1
20141229.090512,2897,638,528532,180,2896,711,2897,73,1
20141229.090512,2898,354,528886,-134,2896,611,2898,767,1
20141229.090512,2898,196,529082,-42,2896,541,2898,706,1
20141229.090513,2898,634,529716,374,2897,106,2898,323,1
20141229.090514,2897,390,530106,234,2897,246,2898,188,0
20141229.090514,2897,14,530120,6,2897,574,2898,242,0
20141229.090515,2898,522,530642,380,2898,280,2899,1323,1
20141229.090515,2898,1036,531678,-362,2898,92,2899,1319,1
20141229.090515,2898,232,531910,-200,2897,558,2898,303,1
20141229.090516,2898,504,532414,94,2897,594,2898,291,1
20141229.090517,2898,580,532994,464,2897,537,2898,49,1
20141229.090517,2898,102,533096,64,2898,306,2899,1354,1
20141229.090517,2898,708,533804,136,2897,656,2898,12,1
20141229.090518,2898,322,534126,-54,2897,589,2898,753,1
20141229.090518,2898,32,534158,0,2897,581,2898,776,1
20141229.090519,2898,282,534440,78,2897,1460,2898,823,1
20141229.09052,2898,62,534502,48,2897,5472,2898,822,1
20141229.09052,2897,28,534530,12,2897,5480,2898,801,0
20141229.090521,2897,200,534730,64,2897,5437,2898,807,0
20141229.090521,2898,26,534756,10,2897,5431,2898,1020,1
20141229.090522,2898,1042,535798,-582,2897,16,2898,912,1
20141229.090522,2896,190,535988,-2,2896,599,2897,135,0
20141229.090523,2897,44,536032,2,2896,590,2897,187,1
20141229.090523,2897,56,536088,-2,2896,578,2897,175,1
20141229.090524,2897,4,536092,-2,2896,583,2897,166,1
20141229.090524,2896,46,536138,0,2896,573,2897,155,0
20141229.090525,2897,96,536234,14,2896,581,2897,109,1
20141229.090525,2896,110,536344,-8,2896,577,2897,74,0
20141229.090525,2897,286,536630,-92,2897,1025,2898,1003,1
20141229.090526,2897,32,536662,-4,2897,1012,2898,872,1
20141229.090527,2898,46,536708,-20,2897,1001,2898,603,1
20141229.090527,2897,30,536738,-2,2897,993,2898,597,0
20141229.090528,2897,14,536752,4,2897,1189,2898,593,0
20141229.090528,2897,26,536778,-22,2897,1316,2898,588,0
20141229.090529,2897,68,536846,-2,2897,1110,2898,591,0
20141229.090529,2898,22,536868,10,2897,1114,2898,582,1
20141229.09053,2897,818,537686,-16,2897,706,2898,731,0
20141229.09053,2898,120,537806,-12,2897,671,2898,729,1
20141229.090531,2897,1458,539264,106,2896,528,2897,63,0
20141229.090531,2896,2,539266,-2,2896,428,2897,65,0
20141229.090532,2897,104,539370,-26,2896,423,2897,559,1
20141229.090532,2897,12,539382,0,2896,515,2897,577,1
20141229.090533,2897,280,539662,-116,2896,579,2897,442,1
20141229.090533,2897,2,539664,0,2896,518,2897,797,1
20141229.090534,2896,1078,540742,518,2895,530,2896,276,0
20141229.090534,2896,68,540810,22,2895,479,2896,260,0
20141229.090535,2896,28,540838,16,2895,479,2896,264,0
20141229.090535,2896,212,541050,-106,2895,379,2896,258,0
20141229.090536,2896,18,541068,4,2895,411,2896,262,0
20141229.090536,2896,2,541070,2,2895,473,2896,261,0
20141229.090537,2895,1000,542070,498,2894,574,2895,220,0
20141229.090537,2895,26,542096,26,2894,589,2895,515,0
20141229.090538,2895,8,542104,6,2894,387,2895,535,0
20141229.090538,2894,588,542692,478,2894,263,2895,392,0
20141229.090539,2895,40,542732,-2,2894,326,2895,358,1
20141229.090539,2895,1130,543862,132,2895,2,2896,454,1
20141229.09054,2895,44,543906,-4,2895,83,2896,456,1
20141229.09054,2895,168,544074,-76,2895,22,2896,434,1
20141229.090541,2896,338,544412,-176,2895,81,2896,301,1
20141229.090541,2895,68,544480,-56,2895,92,2896,301,0
20141229.090542,2896,46,544526,28,2895,196,2896,300,1
20141229.090542,2895,74,544600,26,2895,303,2896,284,0
20141229.090543,2896,6,544606,0,2895,311,2896,255,1
20141229.090543,2895,104,544710,0,2895,327,2896,193,0
20141229.090544,2896,368,545078,-130,2895,327,2896,9,1
20141229.090545,2897,210,545288,-2,2896,712,2897,553,1
20141229.090545,2896,34,545322,12,2896,606,2897,551,0
20141229.090546,2896,48,545370,10,2896,622,2897,474,0
20141229.090546,2896,2160,547530,258,2896,75,2897,464,0
20141229.090547,2897,70,547600,-46,2896,419,2897,331,1
20141229.090547,2897,182,547782,-2,2896,362,2897,321,1
20141229.090548,2896,26,547808,-4,2896,329,2897,315,0
20141229.090548,2897,10,547818,-6,2896,329,2897,314,1
20141229.090549,2896,194,548012,0,2896,232,2897,227,0
20141229.090549,2897,30,548042,-12,2896,250,2897,208,1
20141229.09055,2896,122,548164,2,2896,242,2897,236,0
20141229.09055,2896,16,548180,-2,2896,207,2897,272,0
20141229.090551,2896,72,548252,-2,2896,183,2897,273,0
20141229.090551,2896,38,548290,-24,2896,206,2897,317,0
20141229.090552,2897,24,548314,-18,2896,204,2897,327,1
20141229.090552,2896,22,548336,-10,2896,200,2897,342,0
20141229.090553,2896,266,548602,-108,2896,281,2897,234,0
20141229.090553,2896,8,548610,6,2896,278,2897,234,0
20141229.090554,2897,6,548616,6,2896,278,2897,263,1
20141229.090554,2896,4,548620,4,2896,284,2897,250,0
20141229.090554,2897,1724,550344,-266,2896,293,2898,257,1
20141229.090555,2898,1736,552080,1110,2898,230,2899,813,1
20141229.090556,2899,96,552176,4,2898,1396,2899,751,1
20141229.090556,2898,298,552474,198,2898,1426,2899,628,0
20141229.090556,2899,622,553096,250,2898,1425,2899,318,1
20141229.090557,2899,1228,554324,318,2899,551,2900,3572,1
20141229.090558,2900,630,554954,-448,2899,1415,2900,3272,1
20141229.090558,2900,724,555678,-14,2899,1361,2900,2885,1
20141229.090558,2900,868,556546,8,2899,1579,2900,2452,1
20141229.090559,2900,528,557074,272,2899,1922,2900,2190,1
20141229.0906,2900,242,557316,194,2899,1931,2900,2071,1
20141229.0906,2899,370,557686,100,2899,1798,2900,2019,0
20141229.0906,2899,44,557730,8,2899,1788,2900,2009,0
20141229.090601,2900,74,557804,16,2899,1787,2900,1958,1
20141229.090602,2900,1652,559456,408,2899,971,2900,2013,1
20141229.090602,2899,1630,561086,332,2899,161,2900,2021,0
20141229.090603,2899,676,561762,-344,2898,1006,2899,504,0
20141229.090603,2899,10,561772,-8,2898,1005,2899,752,0
20141229.090604,2898,68,561840,-36,2898,998,2899,687,0
20141229.090604,2899,364,562204,-364,2898,979,2899,383,1
20141229.090605,2898,30,562234,-10,2898,945,2899,383,0
20141229.090605,2898,460,562694,-8,2898,936,2899,167,0
20141229.090606,2899,16,562710,-6,2898,992,2899,365,1
20141229.090606,2899,782,563492,332,2899,145,2900,1966,1
20141229.090607,2899,548,564040,456,2899,80,2900,1880,1
20141229.090607,2900,182,564222,6,2899,73,2900,1803,1
20141229.090608,2900,642,564864,452,2899,61,2900,1507,1
20141229.090608,2899,1226,566090,342,2899,37,2900,954,0
20141229.090609,2900,164,566254,74,2899,249,2900,907,1
20141229.090609,2900,808,567062,470,2899,49,2900,882,1
20141229.09061,2900,20,567082,12,2899,176,2900,779,1
20141229.09061,2899,550,567632,-94,2898,1219,2899,85,0
20141229.090611,2899,210,567842,42,2899,75,2900,905,0
20141229.090611,2899,380,568222,24,2898,1125,2899,54,0
20141229.090612,2900,276,568498,-86,2899,64,2900,700,1
20141229.090612,2900,770,569268,-244,2899,37,2900,322,1
20141229.090613,2900,36,569304,34,2899,296,2900,315,1
20141229.090613,2900,668,569972,428,2899,373,2901,367,1
20141229.090614,2901,148,570120,10,2899,370,2901,239,1
20141229.090614,2901,172,570292,94,2899,517,2901,172,1
20141229.090615,2901,272,570564,-120,2900,152,2901,24,1
20141229.090615,2901,394,570958,-102,2900,170,2901,192,1
20141229.090616,2900,196,571154,-114,2900,186,2901,169,0
20141229.090616,2901,50,571204,-4,2900,185,2901,288,1
20141229.090617,2900,256,571460,-182,2900,273,2901,323,0
20141229.090617,2900,102,571562,0,2900,230,2901,286,0
20141229.090618,2900,52,571614,-38,2900,222,2901,432,0
20141229.090618,2901,98,571712,-70,2900,210,2901,459,1
20141229.090619,2901,94,571806,26,2900,125,2901,475,1
20141229.090619,2901,70,571876,-10,2900,120,2901,463,1
20141229.09062,2900,332,572208,160,2899,413,2900,167,0
20141229.09062,2899,28,572236,0,2899,259,2900,320,0
20141229.090621,2900,326,572562,150,2899,257,2900,164,1
20141229.090621,2900,128,572690,32,2899,258,2900,104,1
20141229.090622,2899,10,572700,8,2899,257,2900,125,0
20141229.090623,2900,66,572766,30,2899,317,2900,217,1
20141229.090623,2900,22,572788,14,2899,317,2900,211,1
20141229.090624,2901,386,573174,372,2899,401,2901,533,1
20141229.090624,2900,4,573178,4,2899,397,2900,126,0
20141229.090625,2900,284,573462,250,2900,57,2901,455,0
20141229.090625,2900,120,573582,-100,2900,8,2901,466,0
20141229.090626,2900,42,573624,12,2899,455,2900,97,0
20141229.090626,2900,48,573672,-24,2899,387,2900,279,0
20141229.090626,2900,82,573754,4,2899,363,2900,381,0
20141229.090627,2899,36,573790,-20,2899,362,2900,647,0
20141229.090627,2900,14,573804,12,2899,356,2900,669,1
20141229.090628,2899,754,574558,-132,2898,1111,2899,102,0
20141229.090628,2899,132,574690,-62,2898,1010,2899,49,0
20141229.090629,2899,40,574730,-20,2898,1000,2899,187,0
20141229.09063,2899,28,574758,-20,2898,944,2899,327,0
20141229.09063,2898,12,574770,-4,2898,942,2899,365,0
20141229.090631,2898,42,574812,-32,2898,942,2899,356,0
20141229.090631,2898,42,574854,0,2898,978,2899,555,0
20141229.090632,2899,34,574888,-4,2898,992,2899,585,1
20141229.090632,2898,22,574910,-20,2898,1004,2899,593,0
20141229.090633,2898,58,574968,0,2898,975,2899,594,0
20141229.090633,2899,44,575012,-20,2898,974,2899,577,1
20141229.090633,2899,10,575022,0,2898,974,2899,572,1
20141229.090634,2898,60,575082,0,2898,944,2899,572,0
20141229.090635,2899,46,575128,-2,2898,988,2899,571,1
20141229.090635,2898,16,575144,-16,2898,985,2899,567,0
20141229.090636,2898,206,575350,-30,2898,1012,2899,466,0
20141229.090637,2898,40,575390,2,2898,1009,2899,429,0
20141229.090637,2899,22,575412,14,2898,1008,2899,422,1
20141229.090638,2899,172,575584,148,2898,999,2899,359,1
20141229.090638,2898,244,575828,134,2898,983,2899,293,0
20141229.090639,2899,488,576316,-372,2898,786,2899,279,1
20141229.090639,2899,22,576338,0,2898,779,2899,324,1
20141229.09064,2899,114,576452,112,2898,763,2899,338,1
20141229.09064,2899,222,576674,4,2898,783,2899,261,1
20141229.090641,2898,12,576686,0,2898,797,2899,272,0
20141229.090641,2898,8,576694,0,2898,794,2899,323,0
20141229.090642,2898,424,577118,-422,2898,584,2899,371,0
20141229.090642,2898,4,577122,-2,2898,582,2899,406,0
20141229.090643,2898,10,577132,-2,2898,577,2899,407,0
20141229.090643,2898,118,577250,-96,2898,524,2899,404,0
20141229.090644,2898,10,577260,0,2898,512,2899,406,0
20141229.090644,2898,20,577280,0,2898,502,2899,407,0
20141229.090645,2899,46,577326,14,2898,495,2899,396,1
20141229.090645,2898,12,577338,-6,2898,491,2899,395,0
20141229.090646,2899,196,577534,34,2898,492,2899,320,1
20141229.090646,2898,26,577560,-16,2898,487,2899,312,0
20141229.090647,2898,64,577624,28,2898,472,2899,302,0
20141229.090647,2898,12,577636,2,2898,468,2899,302,0
20141229.090648,2899,4,577640,4,2898,458,2899,310,1
20141229.090648,2898,18,577658,0,2898,466,2899,351,0
20141229.090649,2898,168,577826,-48,2898,412,2899,361,0
20141229.090649,2899,42,577868,42,2898,413,2899,346,1
20141229.09065,2899,14,577882,-2,2898,407,2899,371,1
20141229.090651,2898,2,577884,0,2898,406,2899,412,0
20141229.090651,2898,20,577904,-20,2898,396,2899,613,0
20141229.090652,2898,796,578700,-404,2897,762,2898,39,0
20141229.090652,2898,124,578824,-90,2897,420,2898,141,0
20141229.090653,2898,720,579544,534,2897,481,2898,5,0
20141229.090653,2897,88,579632,-78,2897,427,2898,26,0
20141229.090654,2897,10,579642,0,2897,422,2898,33,0
20141229.090655,2898,8,579650,-2,2897,419,2898,35,1
20141229.090655,2897,4,579654,-4,2897,447,2898,38,0
20141229.090655,2898,22,579676,-12,2897,444,2898,122,1
20141229.090656,2898,910,580586,-140,2896,407,2898,400,1
20141229.090657,2898,4,580590,2,2896,408,2898,369,1
20141229.090658,2897,16,580606,2,2896,401,2897,98,0
20141229.090658,2897,26,580632,18,2896,401,2897,89,0
20141229.090659,2897,12,580644,12,2896,402,2897,87,0
20141229.090659,2897,324,580968,-198,2896,427,2898,335,0
20141229.0907,2897,64,581032,-2,2897,133,2898,326,0
20141229.0907,2897,2,581034,0,2897,174,2898,336,0
20141229.090701,2897,2,581036,-2,2897,191,2898,336,0
20141229.090701,2897,6,581042,0,2897,191,2898,338,0
20141229.090701,2898,4,581046,-2,2897,194,2898,336,1
20141229.090702,2898,92,581138,-58,2897,194,2898,306,1
20141229.090703,2897,4,581142,0,2897,192,2898,311,0
20141229.090703,2898,30,581172,-28,2897,191,2898,300,1
20141229.090704,2898,10,581182,-2,2897,201,2898,297,1
20141229.090704,2897,16,581198,-6,2897,198,2898,297,0
20141229.090705,2897,116,581314,-110,2897,345,2898,289,0
20141229.090705,2897,18,581332,-18,2897,335,2898,290,0
20141229.090706,2898,2,581334,-2,2897,352,2898,288,1
20141229.090707,2898,32,581366,-12,2897,352,2898,275,1
20141229.090707,2898,10,581376,-2,2897,357,2898,272,1
20141229.090708,2898,8,581384,-2,2897,345,2898,272,1
20141229.090708,2897,20,581404,-2,2897,327,2898,241,0
20141229.090709,2897,4,581408,2,2897,327,2898,247,0
20141229.090709,2898,28,581436,22,2897,330,2898,236,1
20141229.09071,2897,14,581450,-10,2897,323,2898,247,0
20141229.09071,2898,26,581476,0,2897,313,2898,260,1
20141229.090711,2898,2,581478,2,2897,315,2898,266,1
20141229.090711,2897,16,581494,-4,2897,311,2898,263,0
20141229.090712,2897,12,581506,2,2897,309,2898,260,0
20141229.090712,2897,8,581514,-6,2897,330,2898,260,0
20141229.090713,2898,44,581558,24,2897,319,2898,350,1
20141229.090714,2897,30,581588,-18,2897,307,2898,347,0
20141229.090714,2897,44,581632,-2,2897,285,2898,367,0
20141229.090715,2897,206,581838,26,2897,174,2898,418,0
20141229.090715,2897,14,581852,-12,2897,167,2898,430,0
20141229.090716,2897,338,582190,-288,2896,688,2897,337,0
20141229.090716,2897,44,582234,-4,2896,678,2897,316,0
20141229.090717,2898,1582,583816,-814,2898,209,2899,2635,1
20141229.090718,2897,452,584268,-448,2897,63,2898,65,0
20141229.090718,2898,2,584270,0,2897,70,2898,345,1
20141229.090719,2897,188,584458,130,2897,211,2898,366,0
20141229.090719,2897,6,584464,0,2897,208,2898,373,0
20141229.09072,2898,144,584608,-78,2897,263,2898,352,1
20141229.09072,2898,144,584752,-120,2897,204,2898,345,1
20141229.090721,2897,2,584754,0,2897,191,2898,352,0
20141229.090722,2897,8,584762,8,2897,193,2898,460,0
20141229.090722,2898,66,584828,2,2897,162,2898,458,1
20141229.090723,2897,26,584854,-26,2897,147,2898,463,0
20141229.090723,2898,2,584856,2,2897,147,2898,464,1
20141229.090724,2897,404,585260,32,2896,791,2897,50,0
20141229.090724,2897,2,585262,0,2896,796,2897,49,0
20141229.090725,2896,140,585402,84,2896,788,2897,1,0
20141229.090726,2897,8,585410,2,2897,7,2898,540,1
20141229.090726,2897,20,585430,18,2897,7,2898,543,1
20141229.090727,2896,18,585448,-8,2896,797,2898,549,0
20141229.090727,2896,4,585452,2,2896,806,2898,549,0
20141229.090728,2896,52,585504,10,2896,784,2897,4,0
20141229.090728,2896,12,585516,0,2896,789,2897,22,0
20141229.090729,2897,4,585520,-2,2896,789,2897,52,1
20141229.090729,2896,56,585576,-12,2896,768,2897,56,0
20141229.09073,2896,4,585580,-2,2896,776,2897,61,0
20141229.09073,2897,26,585606,-22,2896,766,2897,59,1
20141229.090731,2897,156,585762,-90,2897,938,2898,579,1
20141229.090731,2897,4,585766,0,2897,936,2898,579,1
20141229.090732,2897,8,585774,-6,2897,932,2898,577,1
20141229.090733,2898,26,585800,-2,2897,1326,2898,408,1
20141229.090733,2897,94,585894,-92,2897,1288,2898,400,0
20141229.090734,2897,14,585908,-6,2897,1501,2898,403,0
20141229.090734,2897,48,585956,0,2897,1499,2898,383,0
20141229.090735,2898,4,585960,2,2897,1499,2898,383,1
20141229.090735,2897,102,586062,-102,2897,1549,2898,430,0
20141229.090736,2897,16,586078,-10,2897,1542,2898,439,0
20141229.090737,2897,22,586100,-22,2897,1734,2898,586,0
20141229.090737,2897,24,586124,2,2897,2229,2898,625,0
20141229.090738,2898,112,586236,12,2897,2230,2898,628,1
20141229.090738,2897,12,586248,-12,2897,2225,2898,634,0
20141229.090739,2897,28,586276,-26,2897,2241,2898,640,0
20141229.090739,2897,2,586278,0,2897,2241,2898,647,0
20141229.09074,2898,172,586450,-12,2897,2229,2898,767,1
20141229.09074,2898,40,586490,14,2897,2230,2898,789,1
20141229.090741,2897,74,586564,-72,2897,2193,2898,843,0
20141229.090742,2897,12,586576,-12,2897,2189,2898,847,0
20141229.090742,2897,4,586580,0,2897,1787,2898,847,0
20141229.090743,2898,3386,589966,26,2898,416,2899,4737,1
20141229.090743,2898,836,590802,-118,2897,893,2899,4739,1
20141229.090744,2898,68,590870,2,2897,770,2898,128,1
20141229.090744,2898,4,590874,0,2897,769,2898,343,1
20141229.090745,2898,62,590936,-60,2897,795,2898,421,1
20141229.090745,2897,206,591142,0,2897,692,2898,454,0
20141229.090746,2897,760,591902,-574,2897,313,2898,2455,0
20141229.090746,2898,284,592186,72,2897,157,2898,4465,1
20141229.090747,2897,152,592338,-48,2897,82,2898,4468,0
20141229.090747,2898,42,592380,18,2897,221,2898,4450,1
20141229.090748,2897,2,592382,-2,2897,230,2898,440,0
20141229.090748,2897,12,592394,-10,2897,242,2898,437,0
20141229.090749,2897,26,592420,-22,2897,309,2898,697,0
20141229.09075,2897,50,592470,-6,2897,422,2898,696,0
20141229.09075,2897,6,592476,-2,2897,421,2898,695,0
20141229.090751,2898,80,592556,54,2897,257,2898,694,1
20141229.090751,2898,18,592574,18,2897,259,2898,688,1
20141229.090752,2897,2,592576,2,2897,278,2898,688,0
20141229.090752,2897,14,592590,14,2897,377,2898,682,0
20141229.090753,2897,4,592594,4,2897,375,2898,682,0
20141229.090753,2898,4,592598,4,2897,411,2898,690,1
20141229.090754,2897,8,592606,4,2897,408,2898,692,0
20141229.090754,2897,2,592608,0,2897,408,2898,692,0
20141229.090755,2898,716,593324,412,2897,151,2898,648,1
20141229.090756,2897,162,593486,38,2897,73,2898,675,0
20141229.090756,2897,4,593490,0,2897,75,2898,695,0
20141229.090757,2897,150,593640,62,2896,1018,2897,194,0
20141229.090757,2897,2,593642,2,2896,987,2897,195,0
20141229.090758,2897,4,593646,2,2896,1044,2897,194,0
20141229.090758,2897,438,594084,-62,2897,546,2898,770,0
20141229.090759,2898,2,594086,2,2897,557,2898,777,1
20141229.090759,2897,4,594090,0,2897,555,2898,777,0
20141229.0908,2898,416,594506,-358,2897,555,2898,571,1
20141229.090801,2898,12,594518,-4,2897,561,2898,568,1
20141229.090801,2897,26,594544,0,2897,578,2898,568,0
20141229.090802,2897,12,594556,0,2897,575,2898,567,0
20141229.090803,2897,96,594652,-58,2897,578,2898,529,0
20141229.090804,2897,2,594654,0,2897,640,2898,544,0
20141229.090805,2897,144,594798,-12,2897,569,2898,547,0
20141229.090805,2897,20,594818,0,2897,560,2898,547,0
20141229.090805,2897,116,594934,-112,2897,459,2898,553,0
20141229.090806,2897,20,594954,-20,2897,954,2898,562,0
20141229.090806,2897,42,594996,-2,2897,933,2898,562,0
20141229.090807,2898,10,595006,0,2897,937,2898,564,1
20141229.090808,2898,22,595028,0,2897,937,2898,554,1
20141229.090808,2898,14,595042,0,2897,933,2898,560,1
20141229.090809,2897,12,595054,-10,2897,933,2898,561,0
20141229.090809,2898,14,595068,0,2897,988,2898,561,1
20141229.09081,2897,4,595072,-2,2897,986,2898,562,0
20141229.09081,2897,468,595540,-114,2897,980,2898,336,0
20141229.090811,2897,4,595544,-2,2897,987,2898,330,0
20141229.090811,2898,664,596208,-124,2898,835,2899,4357,1
20141229.090812,2898,42,596250,-2,2898,814,2899,3770,1
20141229.090812,2898,6,596256,-4,2898,813,2899,3770,1
20141229.090813,2898,64,596320,38,2898,809,2899,3749,1
20141229.090813,2898,8,596328,0,2898,805,2899,3811,1
20141229.090814,2898,70,596398,-62,2898,89,2899,3840,1
20141229.090815,2898,242,596640,58,2898,53,2899,3852,1
20141229.090816,2899,98,596738,14,2898,98,2899,3841,1
20141229.090816,2898,26,596764,4,2898,89,2899,3845,0
20141229.090817,2898,36,596800,-2,2898,107,2899,3835,0
20141229.090817,2898,414,597214,284,2897,1221,2898,195,0
20141229.090818,2898,202,597416,-12,2897,1140,2898,112,0
20141229.090818,2898,12,597428,-12,2897,1122,2898,113,0
20141229.090819,2898,264,597692,-206,2898,577,2899,3796,0
20141229.090819,2898,2,597694,-2,2898,96,2899,3857,0
20141229.09082,2898,6,597700,2,2898,166,2899,3875,0
20141229.09082,2898,20,597720,2,2898,162,2899,3877,0
20141229.090821,2898,212,597932,-154,2898,64,2899,3880,0
20141229.090821,2899,198,598130,122,2898,56,2899,3800,1
20141229.090822,2898,128,598258,-66,2897,1148,2898,17,0
20141229.090822,2898,32,598290,30,2897,1047,2898,38,0
20141229.090823,2898,44,598334,-2,2897,1045,2898,84,0
20141229.090823,2898,6,598340,4,2897,1045,2898,92,0
20141229.090824,2898,6,598346,4,2897,1047,2898,138,0
20141229.090824,2898,2,598348,2,2897,1048,2898,100,0
20141229.090825,2898,2,598350,2,2897,1049,2898,130,0
20141229.090826,2898,202,598552,-140,2897,1048,2898,30,0
20141229.090826,2898,60,598612,0,2898,3,2899,4092,0
20141229.090827,2898,18,598630,-14,2898,80,2899,4093,0
20141229.090827,2899,2,598632,0,2898,126,2899,4100,1
20141229.090828,2898,2,598634,-2,2898,126,2899,4097,0
20141229.090828,2898,264,598898,32,2897,1178,2898,87,0
20141229.090829,2898,8,598906,-2,2897,1115,2898,77,0
20141229.090829,2898,6,598912,0,2897,1069,2898,127,0
20141229.09083,2898,22,598934,0,2897,1076,2898,120,0
20141229.09083,2898,24,598958,-6,2897,1076,2898,125,0
20141229.090831,2898,14,598972,8,2897,1076,2898,119,0
20141229.090831,2897,66,599038,58,2897,1073,2898,111,0
20141229.090832,2898,406,599444,-318,2897,1095,2898,119,1
20141229.090832,2898,888,600332,-196,2898,7,2899,4064,1
20141229.090833,2898,684,601016,-110,2897,1136,2898,24,1
20141229.090833,2898,50,601066,50,2898,198,2899,4089,1
20141229.090834,2898,614,601680,14,2898,14,2899,3999,1
20141229.090834,2898,36,601716,24,2898,200,2899,4000,1
20141229.090835,2898,22,601738,-10,2898,205,2899,3984,1
20141229.090835,2898,416,602154,-400,2898,217,2899,3986,1
20141229.090836,2898,108,602262,-2,2898,173,2899,3986,1
20141229.090836,2898,2,602264,0,2898,172,2899,3987,1
20141229.090837,2898,346,602610,-242,2898,167,2899,4025,1
20141229.090837,2898,78,602688,-52,2898,146,2899,4007,1
20141229.090838,2898,26,602714,-4,2898,160,2899,4005,1
20141229.090838,2898,46,602760,-32,2898,142,2899,4003,1
20141229.090839,2899,1610,604370,666,2898,141,2899,3204,1
20141229.090839,2898,208,604578,-112,2898,50,2899,3197,0
20141229.09084,2898,14,604592,14,2898,47,2899,3197,0
20141229.09084,2898,12,604604,10,2898,124,2899,3196,0
20141229.090841,2899,28,604632,-4,2898,232,2899,3199,1
20141229.090841,2899,28,604660,-24,2898,499,2899,3184,1
20141229.090842,2898,2,604662,2,2898,499,2899,3184,0
20141229.090842,2898,14,604676,2,2898,498,2899,3181,0
20141229.090843,2898,10,604686,0,2898,620,2899,3176,0
20141229.090843,2898,16,604702,-2,2898,614,2899,3169,0
20141229.090844,2899,8,604710,0,2898,732,2899,3165,1
20141229.090845,2898,28,604738,2,2898,722,2899,3166,0
20141229.090845,2898,2,604740,0,2898,722,2899,3234,0
20141229.090846,2899,10,604750,0,2898,724,2899,3227,1
20141229.090846,2898,14,604764,2,2898,718,2899,3226,0
20141229.090847,2898,1318,606082,700,2898,82,2899,3228,0
20141229.090847,2898,128,606210,6,2898,18,2899,3261,0
20141229.090848,2899,30,606240,-10,2898,15,2899,3252,1
20141229.090848,2898,36,606276,-4,2897,1138,2898,205,0
20141229.09085,2898,26,606302,-6,2897,1136,2898,521,0
20141229.090851,2898,6,606308,-4,2897,1137,2898,519,0
20141229.090851,2898,2,606310,0,2897,1137,2898,520,0
20141229.090852,2897,8,606318,-6,2897,1135,2898,539,0
20141229.090853,2898,16,606334,-16,2897,1135,2898,531,1
20141229.090854,2897,2,606336,0,2897,1145,2898,641,0
20141229.090854,2898,202,606538,-202,2897,1154,2898,543,1
20141229.090855,2898,568,607106,-82,2897,1156,2898,263,1
20141229.090855,2898,626,607732,270,2898,131,2899,3278,1
20141229.090856,2898,82,607814,-18,2898,230,2899,3282,1
20141229.090856,2898,16,607830,16,2898,341,2899,3280,1
20141229.090857,2898,6,607836,4,2898,349,2899,3260,1
20141229.090858,2898,80,607916,20,2898,311,2899,3260,1
20141229.090859,2899,30,607946,-18,2898,308,2899,3258,1
20141229.090859,2898,72,608018,-14,2898,302,2899,3230,0
20141229.0909,2898,4,608022,0,2898,300,2899,3230,0
20141229.0909,2898,72,608094,-40,2898,285,2899,3210,0
20141229.090901,2898,16,608110,12,2898,292,2899,3210,0
20141229.090902,2899,42,608152,-26,2898,293,2899,3192,1
20141229.090902,2899,10,608162,0,2898,293,2899,3187,1
20141229.090903,2898,4,608166,0,2898,291,2899,3191,0
20141229.090903,2899,16,608182,-10,2898,289,2899,3185,1
20141229.090904,2899,16,608198,4,2898,287,2899,3176,1
20141229.090904,2898,50,608248,-22,2898,315,2899,3155,0
20141229.090905,2899,12,608260,-12,2898,377,2899,3149,1
20141229.090905,2898,18,608278,18,2898,368,2899,3148,0
20141229.090906,2898,6,608284,2,2898,367,2899,3151,0
20141229.090906,2899,18,608302,-16,2898,367,2899,3163,1
20141229.090907,2899,20,608322,0,2898,367,2899,3153,1
20141229.090907,2899,14,608336,0,2898,366,2899,3156,1
20141229.090908,2898,6,608342,6,2898,567,2899,3156,0
20141229.090909,2899,12,608354,0,2898,568,2899,3152,1
20141229.090909,2898,24,608378,2,2898,568,2899,3146,0
20141229.09091,2898,26,608404,26,2898,555,2899,3147,0
20141229.090911,2899,142,608546,-138,2898,555,2899,3082,1
20141229.090911,2898,2,608548,2,2898,556,2899,3083,0
20141229.090912,2898,70,608618,70,2898,522,2899,3083,0
20141229.090912,2898,32,608650,10,2898,514,2899,3123,0
20141229.090913,2899,2,608652,0,2898,515,2899,3122,1
20141229.090913,2899,4,608656,-4,2898,532,2899,3120,1
20141229.090914,2899,2,608658,0,2898,532,2899,3121,1
20141229.090914,2898,84,608742,84,2898,492,2899,3121,0
20141229.090915,2898,24,608766,18,2898,477,2899,3119,0
20141229.090915,2898,22,608788,-6,2898,467,2899,3141,0
20141229.090916,2898,4,608792,-4,2898,466,2899,3141,0
20141229.090916,2898,1090,609882,-1016,2898,441,2899,2622,0
20141229.090917,2898,2514,612396,-28,2898,448,2899,1348,0
20141229.090917,2899,2694,615090,788,2899,62,2900,5677,1
20141229.090918,2899,1254,616344,-456,2898,611,2899,19,1
20141229.090919,2899,66,616410,-32,2898,613,2900,5231,1
20141229.090919,2899,22,616432,-14,2898,611,2899,55,1
20141229.09092,2899,400,616832,2,2898,614,2899,158,1
20141229.09092,2899,10,616842,-2,2898,602,2899,153,1
20141229.090921,2898,24,616866,-4,2898,591,2899,158,0
20141229.090921,2899,2,616868,0,2898,592,2899,160,1
20141229.090922,2899,132,617000,-16,2898,660,2899,99,1
20141229.090923,2899,114,617114,-6,2898,692,2899,125,1
20141229.090923,2899,28,617142,0,2898,689,2899,204,1
20141229.090924,2899,94,617236,36,2898,663,2899,186,1
20141229.090924,2899,22,617258,-2,2898,663,2899,176,1
20141229.090925,2900,3008,620266,-1400,2898,673,2900,4074,1
20141229.090925,2900,2052,622318,-2004,2899,106,2900,2951,1
20141229.090926,2900,18,622336,-10,2899,276,2900,2880,1
20141229.090926,2900,1186,623522,-674,2899,330,2900,2288,1
20141229.090927,2900,6,623528,-2,2899,328,2900,2287,1
20141229.090927,2899,130,623658,-124,2899,237,2900,2228,0
20141229.090928,2899,60,623718,-48,2899,211,2900,2225,0
20141229.090928,2900,794,624512,-124,2899,227,2900,1828,1
20141229.090929,2899,270,624782,-120,2899,200,2900,1707,0
20141229.090929,2900,2,624784,0,2899,200,2900,1706,1
20141229.09093,2900,20,624804,-2,2899,240,2900,1698,1
20141229.09093,2899,24,624828,0,2899,255,2900,1703,0
20141229.090931,2900,44,624872,0,2899,258,2900,1684,1
20141229.090931,2900,458,625330,-34,2899,293,2900,1476,1
20141229.090932,2900,46,625376,-44,2899,294,2900,1483,1
20141229.090932,2900,38,625414,-2,2899,295,2900,1469,1
20141229.090933,2900,12,625426,-12,2899,409,2900,1463,1
20141229.090933,2900,2,625428,-2,2899,436,2900,1465,1
20141229.090934,2900,12,625440,-4,2899,401,2900,1461,1
20141229.090934,2900,14,625454,10,2899,392,2900,1462,1
20141229.090935,2900,80,625534,0,2899,303,2900,1433,1
20141229.090936,2900,2478,628012,-144,2899,307,2900,195,1
20141229.090936,2900,404,628416,142,2900,63,2901,671,1
20141229.090937,2899,550,628966,82,2899,615,2900,108,0
20141229.090937,2899,66,629032,10,2899,613,2900,170,0
20141229.090938,2900,54,629086,-28,2899,599,2900,418,1
20141229.090938,2899,4,629090,0,2899,578,2900,422,0
20141229.090939,2900,126,629216,-8,2899,595,2900,497,1
20141229.090939,2899,18,629234,16,2899,560,2900,500,0
20141229.09094,2900,2,629236,2,2899,562,2900,502,1
20141229.090941,2899,16,629252,16,2899,545,2900,512,0
20141229.090941,2899,6,629258,6,2899,545,2900,515,0
20141229.090941,2900,120,629378,120,2899,569,2900,455,1
20141229.090942,2900,968,630346,306,2900,115,2901,657,1
20141229.090943,2901,50,630396,44,2900,114,2901,561,1
20141229.090944,2901,112,630508,62,2900,253,2901,526,1
20141229.090944,2900,24,630532,-16,2900,350,2901,516,0
20141229.090945,2900,2,630534,2,2900,364,2901,543,0
20141229.090945,2900,4,630538,4,2900,572,2901,543,0
20141229.090946,2901,114,630652,6,2900,474,2901,503,1
20141229.090946,2901,162,630814,16,2900,494,2901,424,1
20141229.090946,2901,28,630842,28,2900,491,2901,410,1
20141229.090947,2901,270,631112,100,2900,493,2901,302,1
20141229.090948,2901,3790,634902,-2490,2901,238,2902,40,1
20141229.090948,2902,444,635346,-160,2902,22,2903,461,1
20141229.090949,2902,188,635534,-84,2901,288,2902,55,1
20141229.090949,2902,56,635590,-40,2901,309,2902,1238,1
20141229.09095,2901,906,636496,-20,2900,633,2901,31,0
20141229.09095,2901,18,636514,6,2900,647,2901,119,0
20141229.09095,2901,62,636576,34,2900,598,2901,194,0
20141229.090951,2901,2,636578,2,2900,564,2901,595,0
20141229.090952,2901,96,636674,16,2900,457,2901,624,0
20141229.090952,2901,16,636690,16,2900,334,2901,615,0
20141229.090953,2900,162,636852,-26,2900,274,2901,582,0
20141229.090953,2900,610,637462,-278,2899,665,2900,701,0
20141229.090954,2899,12,637474,6,2899,661,2900,718,0
20141229.090954,2900,24,637498,-8,2899,658,2900,703,1
20141229.090955,2900,214,637712,-10,2899,666,2900,581,1
20141229.090955,2900,20,637732,-16,2899,669,2900,571,1
20141229.090956,2900,1182,638914,-1174,2900,464,2901,471,1
20141229.090956,2901,18,638932,8,2900,465,2901,406,1
20141229.090957,2900,84,639016,-4,2900,508,2901,406,0
20141229.090957,2900,2,639018,0,2900,551,2901,397,0
20141229.090958,2900,12,639030,0,2900,645,2901,297,0
20141229.090958,2900,56,639086,12,2900,627,2901,277,0
20141229.090959,2901,6,639092,2,2900,576,2901,260,1
20141229.090959,2901,34,639126,2,2900,1602,2901,242,1
20141229.091,2900,14,639140,-2,2900,4614,2901,263,0
20141229.091,2901,628,639768,278,2901,281,2902,434,1
20141229.091001,2902,908,640676,-44,2901,67,2902,283,1
20141229.091001,2902,638,641314,44,2901,85,2902,268,1
20141229.091002,2901,550,641864,376,2901,50,2902,180,0
20141229.091002,2901,1044,642908,-480,2900,4777,2901,486,0
20141229.091003,2900,26,642934,-8,2900,4608,2901,479,0
20141229.091003,2901,22,642956,-20,2900,4672,2901,483,1
20141229.091004,2901,148,643104,-140,2900,4693,2901,417,1
20141229.091004,2901,814,643918,24,2900,4703,2902,406,1
20141229.091005,2902,70,643988,22,2901,171,2902,400,1
20141229.091005,2901,24,644012,24,2901,351,2902,450,0
20141229.091006,2901,8,644020,8,2901,373,2902,428,0
20141229.091006,2901,34,644054,18,2901,287,2902,439,0
20141229.091007,2902,20,644074,6,2901,359,2902,439,1
20141229.091007,2902,128,644202,114,2901,305,2902,393,1
20141229.091008,2901,276,644478,100,2901,269,2902,348,0
20141229.091008,2902,32,644510,10,2901,291,2902,332,1
20141229.091009,2901,8,644518,-2,2901,397,2902,320,0
20141229.09101,2902,86,644604,-62,2901,396,2902,287,1
20141229.09101,2901,46,644650,-26,2901,396,2902,295,0
20141229.091011,2901,48,644698,-32,2901,397,2902,269,0
20141229.091011,2902,32,644730,0,2901,399,2902,260,1
20141229.091012,2901,640,645370,-430,2901,356,2902,1,0
20141229.091012,2902,2,645372,0,2902,3,2903,637,1
20141229.091012,2901,12,645384,-2,2901,420,2902,7,0
20141229.091013,2902,24,645408,-4,2901,479,2902,50,1
20141229.091014,2902,46,645454,-8,2901,451,2902,123,1
20141229.091014,2902,294,645748,208,2902,258,2903,649,1
20141229.091014,2902,274,646022,268,2902,125,2903,676,1
20141229.091015,2902,722,646744,-430,2902,42,2903,453,1
20141229.091016,2903,1068,647812,-546,2903,560,2904,1085,1
20141229.091016,2903,788,648600,-702,2903,830,2904,1041,1
20141229.091017,2904,64,648664,-2,2903,843,2904,1048,1
20141229.091017,2904,754,649418,190,2903,833,2904,669,1
20141229.091018,2904,178,649596,-102,2903,988,2904,579,1
20141229.091018,2904,50,649646,-4,2903,949,2904,574,1
20141229.091019,2904,76,649722,-74,2903,922,2904,562,1
20141229.091019,2904,116,649838,-14,2903,921,2904,504,1
20141229.09102,2903,198,650036,-12,2903,832,2904,490,0
20141229.09102,2904,142,650178,-44,2903,783,2904,479,1
20141229.091021,2903,748,650926,78,2903,777,2904,306,0
20141229.091021,2903,72,650998,-6,2903,745,2904,303,0
20141229.091022,2904,2,651000,-2,2903,745,2904,376,1
20141229.091022,2904,14,651014,-6,2903,792,2904,425,1
20141229.091023,2903,112,651126,-4,2903,889,2904,383,0
20141229.091023,2903,26,651152,2,2903,891,2904,382,0
20141229.091024,2903,594,651746,444,2903,869,2904,130,0
20141229.091024,2904,596,652342,206,2904,84,2905,503,1
20141229.091025,2904,190,652532,144,2903,911,2905,527,1
20141229.091025,2903,102,652634,-2,2903,881,2904,292,0
20141229.091026,2904,122,652756,-6,2903,882,2904,249,1
20141229.091026,2904,4,652760,0,2903,883,2904,392,1
20141229.091027,2904,248,653008,-136,2903,879,2904,403,1
20141229.091027,2904,160,653168,-156,2903,871,2904,347,1
20141229.091028,2904,192,653360,-102,2903,977,2904,251,1
20141229.091028,2904,14,653374,-8,2903,971,2904,259,1
20141229.091029,2904,526,653900,86,2904,64,2905,585,1
20141229.091029,2905,36,653936,-24,2904,162,2905,555,1
20141229.09103,2905,728,654664,-394,2904,109,2905,253,1
20141229.09103,2905,44,654708,-22,2904,182,2905,234,1
20141229.091031,2905,134,654842,48,2904,416,2905,174,1
20141229.091031,2905,300,655142,-12,2904,432,2905,123,1
20141229.091032,2905,260,655402,148,2905,377,2906,595,1
20141229.091032,2905,298,655700,162,2905,332,2906,379,1
20141229.091033,2906,64,655764,32,2905,357,2906,343,1
20141229.091033,2906,432,656196,138,2905,467,2906,130,1
20141229.091034,2905,82,656278,40,2905,551,2906,93,0
20141229.091034,2907,228,656506,190,2906,117,2907,349,1
20141229.091035,2906,70,656576,-4,2906,87,2907,350,0
20141229.091035,2906,308,656884,-54,2906,39,2907,364,0
20141229.091036,2906,212,657096,8,2905,469,2906,80,0
20141229.091036,2906,258,657354,188,2905,393,2906,103,0
20141229.091037,2906,26,657380,-10,2905,384,2906,386,0
20141229.091037,2906,48,657428,22,2905,374,2906,379,0
20141229.091038,2906,652,658080,500,2905,451,2906,68,0
20141229.091038,2906,166,658246,92,2906,48,2907,356,0
20141229.091039,2906,198,658444,172,2905,483,2906,27,0
20141229.091039,2906,52,658496,38,2905,512,2906,1,0
20141229.09104,2906,50,658546,34,2905,499,2906,4,0
20141229.09104,2906,34,658580,16,2906,31,2907,306,0
20141229.091041,2906,74,658654,-6,2905,472,2906,754,0
20141229.091042,2905,40,658694,12,2905,360,2906,770,0
20141229.091042,2906,746,659440,112,2905,58,2906,719,1
20141229.091042,2904,128,659568,-4,2904,641,2905,27,0
20141229.091043,2905,64,659632,54,2904,648,2905,77,1
20141229.091044,2904,24,659656,0,2904,651,2905,78,0
20141229.091044,2905,16,659672,16,2904,651,2905,78,1
20141229.091045,2905,26,659698,16,2904,651,2905,73,1
20141229.091045,2905,26,659724,26,2904,651,2905,146,1
20141229.091046,2905,28,659752,-2,2904,670,2905,136,1
20141229.091046,2905,10,659762,6,2904,674,2905,133,1
20141229.091047,2904,286,660048,226,2904,781,2905,1,0
20141229.091047,2905,6,660054,4,2904,770,2905,71,1
20141229.091048,2905,14,660068,6,2904,768,2905,103,1
20141229.091048,2904,8,660076,2,2904,772,2905,105,0
20141229.091048,2905,68,660144,-18,2904,775,2905,78,1
20141229.091049,2905,46,660190,-12,2904,775,2905,89,1
20141229.09105,2905,8,660198,0,2904,774,2905,409,1
20141229.09105,2905,2,660200,0,2904,618,2905,409,1
20141229.091051,2905,8,660208,-2,2904,465,2905,503,1
20141229.091051,2904,938,661146,266,2903,1345,2904,1025,0
20141229.091052,2903,56,661202,14,2903,1034,2904,292,0
20141229.091052,2904,60,661262,-16,2903,1116,2904,315,1
20141229.091052,2903,8,661270,-8,2903,1113,2904,315,0
20141229.091053,2904,98,661368,-56,2903,1126,2904,344,1
20141229.091054,2904,38,661406,-12,2903,1122,2904,238,1
20141229.091054,2904,8,661414,-4,2903,1130,2904,226,1
20141229.091055,2904,86,661500,-26,2903,1118,2904,194,1
20141229.091055,2904,4,661504,-2,2903,1119,2904,94,1
20141229.091056,2905,252,661756,-106,2904,131,2905,694,1
20141229.091056,2904,14,661770,10,2904,159,2905,690,0
20141229.091057,2904,40,661810,-4,2904,474,2905,668,0
20141229.091057,2905,10,661820,0,2904,478,2905,663,1
20141229.091058,2904,14,661834,6,2904,504,2905,664,0
20141229.091058,2904,16,661850,2,2904,497,2905,663,0
20141229.091059,2905,16,661866,12,2904,450,2905,664,1
20141229.091059,2904,6,661872,6,2904,448,2905,664,0
20141229.0911,2904,916,662788,296,2903,1012,2904,169,0
20141229.0911,2904,378,663166,4,2904,60,2905,780,0
20141229.091101,2904,258,663424,-50,2903,1011,2904,6,0
20141229.091101,2904,24,663448,-10,2904,108,2905,741,0
20141229.091102,2904,16,663464,-6,2904,103,2905,789,0
20141229.091102,2904,10,663474,-8,2904,101,2905,779,0
20141229.091103,2904,22,663496,-22,2904,120,2905,785,0
20141229.091103,2904,38,663534,12,2904,116,2905,773,0
20141229.091104,2904,244,663778,38,2903,907,2904,893,0
20141229.091104,2905,154,663932,0,2903,907,2905,782,1
20141229.091105,2904,6,663938,0,2903,907,2904,7,0
20141229.091105,2904,44,663982,8,2904,67,2905,747,0
20141229.091106,2904,58,664040,-44,2904,154,2905,830,0
20141229.091106,2904,16,664056,-10,2904,285,2905,787,0
20141229.091107,2904,52,664108,0,2904,317,2905,789,0
20141229.091107,2904,8,664116,-2,2904,554,2905,791,0
20141229.091108,2904,314,664430,-26,2904,642,2905,953,0
20141229.091108,2905,304,664734,2,2904,501,2905,956,1
20141229.091109,2905,1976,666710,1640,2905,444,2906,802,1
20141229.091109,2905,44,666754,20,2905,579,2906,647,1
20141229.09111,2905,14,666768,10,2905,459,2906,647,1
20141229.09111,2905,238,667006,-136,2905,559,2906,529,1
20141229.091111,2905,482,667488,0,2905,560,2906,290,1
20141229.091111,2906,712,668200,76,2906,8,2907,454,1
20141229.091112,2905,96,668296,10,2905,579,2907,499,0
20141229.091112,2906,112,668408,2,2905,570,2906,2,1
20141229.091113,2906,6,668414,-2,2906,23,2907,453,1
20141229.091113,2906,512,668926,506,2905,391,2906,4,1
20141229.091114,2905,18,668944,8,2905,389,2906,55,0
20141229.091114,2905,502,669446,472,2905,175,2906,128,0
20141229.091115,2906,28,669474,0,2905,193,2906,256,1
20141229.091115,2905,394,669868,138,2904,739,2905,230,0
20141229.091116,2905,10,669878,6,2904,772,2905,1033,0
20141229.091117,2905,22,669900,-18,2904,748,2905,1092,0
20141229.091117,2905,4,669904,0,2904,747,2905,1346,0
20141229.091118,2905,58,669962,22,2904,759,2905,1272,0
20141229.091118,2905,6,669968,0,2904,743,2905,1281,0
20141229.091119,2905,62,670030,6,2904,743,2905,1252,0
20141229.09112,2904,2,670032,-2,2904,743,2905,278,0
20141229.09112,2904,60,670092,32,2904,749,2905,326,0
20141229.091121,2904,16,670108,6,2904,508,2905,330,0
20141229.091121,2904,12,670120,-8,2904,502,2905,504,0
20141229.091122,2905,10,670130,4,2904,501,2905,500,1
20141229.091122,2905,70,670200,0,2904,440,2905,488,1
20141229.091123,2905,52,670252,40,2904,439,2905,465,1
20141229.091123,2904,136,670388,132,2904,439,2905,384,0
20141229.091124,2904,516,670904,-218,2904,185,2905,385,0
20141229.091124,2905,32,670936,32,2904,1183,2905,619,1
20141229.091125,2904,20,670956,4,2904,4194,2905,618,0
20141229.091125,2905,20,670976,16,2904,5198,2905,870,1
20141229.091126,2905,540,671516,360,2904,5134,2905,547,1
20141229.091126,2904,1174,672690,348,2903,961,2904,9,0
20141229.091126,2904,60,672750,0,2904,62,2905,582,0
20141229.091127,2903,2062,674812,-1144,2902,215,2903,313,0
20141229.091128,2903,156,674968,40,2902,194,2903,258,0
20141229.091128,2902,154,675122,-14,2902,187,2903,239,0
20141229.091129,2902,196,675318,-74,2902,166,2903,194,0
20141229.091129,2903,20,675338,8,2902,215,2903,237,1
20141229.09113,2903,2,675340,2,2902,246,2903,224,1
20141229.09113,2903,56,675396,-16,2902,311,2903,258,1
20141229.091131,2903,524,675920,340,2903,741,2904,84,1
20141229.091131,2902,32,675952,0,2903,9,2904,41,0
20141229.091132,2904,32,675984,0,2903,141,2904,96,1
20141229.091132,2903,60,676044,22,2903,320,2904,78,0
20141229.091133,2903,142,676186,18,2903,356,2904,18,0
20141229.091133,2903,40,676226,36,2903,368,2905,922,0
20141229.091134,2903,14,676240,-12,2903,371,2905,1068,0
20141229.091134,2903,54,676294,-42,2903,345,2904,40,0
20141229.091134,2903,90,676384,-86,2903,311,2904,40,0
20141229.091135,2903,18,676402,-2,2903,358,2904,36,0
20141229.091136,2904,122,676524,-22,2904,450,2905,1077,1
20141229.091136,2904,4,676528,0,2903,140,2905,1088,1
20141229.091137,2904,48,676576,40,2903,154,2905,1389,1
20141229.091137,2904,8,676584,2,2903,161,2905,1470,1
20141229.091137,2904,22,676606,18,2903,161,2905,1550,1
20141229.091138,2905,204,676810,204,2903,168,2905,1291,1
20141229.091139,2905,68,676878,12,2903,218,2905,1240,1
20141229.09114,2905,4,676882,2,2903,218,2905,1238,1
20141229.09114,2904,4,676886,4,2903,234,2905,1239,0
20141229.091141,2904,6,676892,6,2903,244,2905,1240,0
20141229.091141,2905,24,676916,2,2903,244,2905,1234,1
20141229.091142,2904,60,676976,12,2903,505,2905,1230,0
20141229.091142,2904,1868,678844,1168,2903,149,2904,115,0
20141229.091143,2903,32,678876,-10,2903,232,2904,209,0
20141229.091143,2903,2,678878,0,2903,181,2904,243,0
20141229.091144,2903,2,678880,0,2903,182,2904,269,0
20141229.091144,2903,20,678900,6,2903,86,2904,280,0
20141229.091145,2904,10,678910,0,2903,80,2904,316,1
20141229.091145,2903,22,678932,0,2903,72,2904,363,0
20141229.091146,2903,26,678958,2,2903,62,2904,365,0
20141229.091146,2903,4,678962,4,2903,90,2904,366,0
20141229.091147,2905,770,679732,-78,2903,101,2905,1245,1
20141229.091147,2904,104,679836,22,2904,47,2905,1226,0
20141229.091148,2904,110,679946,-66,2903,275,2905,1263,0
20141229.091149,2905,46,679992,2,2903,287,2905,1259,1
20141229.091149,2905,88,680080,54,2903,285,2905,1217,1
20141229.09115,2905,28,680108,2,2904,1,2905,1214,1
20141229.091151,2905,132,680240,-6,2904,48,2905,1243,1
20141229.091151,2904,30,680270,-6,2904,53,2905,1231,0
20141229.091152,2904,42,680312,4,2904,63,2905,1214,0
20141229.091152,2905,80,680392,20,2904,157,2905,1228,1
20141229.091153,2904,104,680496,98,2904,155,2905,1185,0
20141229.091153,2904,214,680710,-10,2904,78,2905,1184,0
20141229.091154,2904,28,680738,24,2904,90,2905,1172,0
20141229.091154,2904,38,680776,-18,2904,72,2905,1172,0
20141229.091155,2905,158,680934,-48,2903,328,2904,1,1
20141229.091155,2905,146,681080,94,2903,190,2905,1176,1
20141229.091156,2904,44,681124,12,2903,293,2904,83,0
20141229.091156,2904,42,681166,6,2903,294,2904,155,0
20141229.091157,2904,48,681214,4,2903,246,2904,137,0
20141229.091157,2904,38,681252,0,2903,241,2904,155,0
20141229.091158,2904,18,681270,2,2903,244,2904,143,0
20141229.091158,2904,70,681340,44,2903,201,2904,110,0
20141229.091159,2904,46,681386,0,2903,279,2904,32,0
20141229.091159,2905,80,681466,50,2904,3,2905,1390,1
20141229.0912,2905,32,681498,0,2904,51,2905,1367,1
20141229.0912,2904,128,681626,-100,2904,55,2905,1329,0
20141229.091201,2905,22,681648,-4,2904,87,2905,1308,1
20141229.091201,2905,30,681678,-10,2904,508,2905,1215,1
20141229.091202,2905,84,681762,-30,2904,557,2905,1178,1
20141229.091202,2905,24,681786,0,2904,557,2905,1167,1
20141229.091203,2906,2374,684160,1892,2905,241,2906,746,1
20141229.091204,2906,292,684452,-128,2905,687,2906,604,1
20141229.091204,2905,38,684490,4,2905,709,2906,596,0
20141229.091204,2906,122,684612,98,2905,695,2906,540,1
20141229.091205,2906,48,684660,16,2905,533,2906,540,1
20141229.091206,2905,32,684692,10,2905,501,2906,529,0
20141229.091206,2906,30,684722,10,2905,422,2906,518,1
20141229.091207,2905,32,684754,18,2905,279,2906,520,0
20141229.091207,2905,6,684760,0,2905,254,2906,520,0
20141229.091208,2905,272,685032,-180,2904,622,2906,556,0
20141229.091209,2905,126,685158,76,2904,609,2905,14,0
20141229.09121,2905,32,685190,32,2905,98,2906,620,0
20141229.09121,2905,4,685194,0,2905,1221,2906,609,0
20141229.09121,2906,10,685204,6,2905,225,2906,554,1
20141229.091211,2906,8,685212,6,2905,257,2906,554,1
20141229.091212,2906,410,685622,-2,2905,370,2906,354,1
20141229.091212,2905,8,685630,-2,2905,421,2906,360,0
20141229.091213,2906,24,685654,20,2905,430,2906,358,1
20141229.091213,2906,34,685688,24,2905,426,2906,368,1
20141229.091214,2905,52,685740,44,2905,354,2906,376,0
20141229.091214,2905,2,685742,0,2905,347,2906,381,0
20141229.091215,2905,8,685750,8,2905,334,2906,325,0
20141229.091215,2906,52,685802,0,2905,310,2906,345,1
20141229.091216,2905,2,685804,2,2905,309,2906,348,0
20141229.091216,2906,56,685860,56,2905,284,2906,354,1
20141229.091216,2906,6,685866,6,2905,284,2906,366,1
20141229.091217,2905,20,685886,2,2905,275,2906,362,0
20141229.091217,2905,46,685932,26,2905,275,2906,340,0
20141229.091218,2905,232,686164,18,2905,164,2906,337,0
20141229.091219,2906,8,686172,-2,2905,164,2906,347,1
20141229.091219,2905,4,686176,2,2905,163,2906,346,0
20141229.091219,2905,300,686476,-162,2905,16,2906,346,0
20141229.09122,2905,276,686752,180,2904,699,2905,10,0
20141229.091221,2906,42,686794,6,2905,24,2906,445,1
20141229.091221,2905,50,686844,26,2905,50,2906,446,0
20141229.091222,2905,146,686990,-2,2904,224,2905,174,0
20141229.091222,2905,280,687270,-124,2904,264,2906,330,0
20141229.091222,2905,26,687296,-18,2904,275,2905,57,0
20141229.091223,2905,186,687482,50,2904,274,2905,180,0
20141229.091224,2905,202,687684,-96,2904,263,2905,479,0
20141229.091224,2905,130,687814,-96,2904,223,2905,511,0
20141229.091225,2904,252,688066,38,2904,132,2905,462,0
20141229.091225,2905,142,688208,130,2904,71,2905,441,1
20141229.091226,2904,46,688254,38,2904,51,2905,466,0
20141229.091226,2904,8,688262,0,2904,97,2905,481,0
20141229.091227,2905,156,688418,112,2904,175,2905,524,1
20141229.091227,2904,14,688432,-4,2904,196,2905,540,0
20141229.091228,2904,8,688440,-8,2904,212,2905,480,0
20141229.091228,2905,28,688468,28,2904,214,2905,468,1
20141229.091229,2905,4,688472,4,2904,215,2905,467,1
20141229.091229,2904,6,688478,2,2904,216,2905,471,0
20141229.09123,2904,700,689178,338,2904,184,2905,127,0
20141229.09123,2905,100,689278,100,2904,384,2905,123,1
20141229.091231,2905,254,689532,126,2905,2,2906,468,1
20141229.091232,2906,34,689566,4,2905,96,2906,463,1
20141229.091232,2905,6,689572,2,2905,95,2906,515,0
20141229.091233,2906,518,690090,250,2905,241,2906,273,1
20141229.091233,2906,116,690206,80,2905,215,2906,228,1
20141229.091234,2905,14,690220,0,2905,223,2906,230,0
20141229.091234,2906,106,690326,100,2905,174,2906,244,1
20141229.091235,2906,100,690426,12,2905,214,2906,236,1
20141229.091235,2905,84,690510,38,2905,180,2906,225,0
20141229.091236,2906,108,690618,-46,2905,134,2906,233,1
20141229.091236,2905,166,690784,-46,2905,30,2906,265,0
20141229.091237,2906,10,690794,2,2905,1,2906,273,1
20141229.091237,2905,32,690826,-28,2905,38,2906,288,0
20141229.091238,2905,18,690844,-12,2905,141,2906,376,0
20141229.091238,2906,638,691482,352,2905,293,2906,122,1
20141229.091239,2905,6,691488,2,2905,414,2906,130,0
20141229.091239,2906,14,691502,8,2905,418,2906,135,1
20141229.09124,2906,286,691788,192,2905,532,2906,3,1
20141229.09124,2906,34,691822,-6,2905,448,2906,84,1
20141229.091241,2906,548,692370,22,2906,5,2907,415,1
20141229.091241,2906,36,692406,10,2906,32,2907,416,1
20141229.091242,2906,74,692480,-12,2905,476,2907,426,1
20141229.091242,2907,6,692486,4,2905,365,2907,424,1
20141229.091243,2906,2,692488,-2,2906,21,2907,429,0
20141229.091244,2907,574,693062,300,2906,145,2907,140,1
20141229.091244,2906,52,693114,48,2906,134,2907,147,0
20141229.091245,2906,58,693172,10,2906,152,2907,260,0
20141229.091246,2907,444,693616,-20,2906,189,2908,1077,1
20141229.091247,2907,18,693634,18,2907,1,2908,1083,1
20141229.091247,2907,20,693654,0,2907,40,2908,1078,1
20141229.091247,2907,122,693776,-58,2906,439,2907,1042,1
20141229.091248,2907,46,693822,-22,2906,301,2907,1132,1
20141229.091248,2907,122,693944,0,2906,303,2907,1092,1
20141229.091249,2907,74,694018,6,2906,332,2907,1116,1
20141229.09125,2907,868,694886,-94,2906,380,2907,713,1
20141229.09125,2907,8,694894,-2,2906,359,2907,1027,1
20141229.091251,2906,40,694934,10,2906,306,2907,1043,0
20141229.091252,2907,20,694954,-20,2906,317,2907,1147,1
20141229.091252,2906,6,694960,-2,2906,316,2907,1145,0
20141229.091253,2906,654,695614,-114,2906,461,2907,756,0
20141229.091253,2906,214,695828,2,2906,346,2907,756,0
20141229.091254,2906,4,695832,-4,2906,455,2907,759,0
20141229.091255,2907,8,695840,-8,2906,468,2907,755,1
20141229.091255,2906,2,695842,0,2906,471,2907,755,0
20141229.091255,2906,30,695872,-28,2906,452,2907,758,0
20141229.091256,2907,846,696718,294,2906,496,2907,325,1
20141229.091257,2907,612,697330,486,2906,190,2907,331,1
20141229.091257,2906,6,697336,6,2906,187,2907,357,0
20141229.091258,2906,20,697356,20,2906,221,2907,357,0
20141229.091258,2906,734,698090,68,2905,754,2906,138,0
20141229.091259,2906,644,698734,360,2906,166,2907,227,0
20141229.091259,2907,4,698738,0,2906,210,2907,209,1
20141229.0913,2907,232,698970,44,2906,348,2907,159,1
20141229.0913,2907,326,699296,38,2907,85,2908,1135,1
20141229.091301,2907,2,699298,0,2907,87,2908,1113,1
20141229.091301,2907,14,699312,14,2907,151,2908,1114,1
20141229.091302,2907,8,699320,4,2907,124,2908,1115,1
20141229.091302,2907,308,699628,-10,2906,554,2907,124,1
20141229.091303,2907,332,699960,38,2906,412,2907,140,1
20141229.091303,2906,2,699962,0,2906,412,2907,144,0
20141229.091304,2907,20,699982,6,2906,416,2907,139,1
20141229.091304,2907,52,700034,20,2906,447,2907,149,1
20141229.091305,2906,66,700100,0,2906,409,2907,269,0
20141229.091305,2907,26,700126,-22,2906,409,2907,257,1
20141229.091306,2907,12,700138,0,2906,351,2907,308,1
20141229.091306,2907,704,700842,252,2907,111,2908,1148,1
20141229.091307,2907,216,701058,-100,2907,1,2908,1156,1
20141229.091307,2907,272,701330,20,2906,515,2907,25,1
20141229.091308,2907,26,701356,26,2906,535,2907,98,1
20141229.091308,2907,212,701568,204,2906,477,2907,176,1
20141229.091309,2908,366,701934,334,2907,170,2908,1155,1
20141229.091309,2907,526,702460,-88,2906,480,2907,13,0
20141229.09131,2907,128,702588,98,2907,46,2908,1154,0
20141229.09131,2907,120,702708,-86,2907,31,2908,1145,0
20141229.091311,2908,20,702728,20,2907,25,2908,1143,1
20141229.091312,2907,24,702752,24,2907,210,2908,1163,0
20141229.091312,2908,10,702762,6,2907,209,2908,1158,1
20141229.091313,2908,12,702774,10,2907,779,2908,1136,1
20141229.091313,2908,40,702814,14,2907,810,2908,1101,1
20141229.091314,2908,54,702868,34,2907,797,2908,1084,1
20141229.091314,2907,10,702878,6,2907,793,2908,1085,0
20141229.091315,2908,34,702912,14,2907,754,2908,1052,1
20141229.091315,2907,14,702926,4,2907,754,2908,1048,0
20141229.091316,2908,6,702932,0,2907,752,2908,1045,1
20141229.091316,2907,12,702944,0,2907,742,2908,1045,0
20141229.091317,2907,2,702946,-2,2907,722,2908,1045,0
20141229.091317,2908,18,702964,12,2907,707,2908,1038,1
20141229.091317,2907,4,702968,-2,2907,712,2908,1037,0
20141229.091318,2908,4,702972,4,2907,739,2908,1039,1
20141229.091319,2907,26,702998,18,2907,1329,2908,1031,0
20141229.091319,2907,404,703402,-18,2907,1071,2908,1036,0
20141229.09132,2908,18,703420,6,2907,1067,2908,1032,1
20141229.09132,2908,12,703432,6,2907,1066,2908,1028,1
20141229.091321,2907,52,703484,8,2907,1005,2908,1027,0
20141229.091321,2907,10,703494,0,2907,1005,2908,1026,0
20141229.091321,2908,2,703496,2,2907,1005,2908,1025,1
20141229.091322,2908,2,703498,0,2907,1005,2908,1024,1
20141229.091323,2908,14,703512,6,2907,1004,2908,1019,1
20141229.091324,2908,28,703540,12,2907,1085,2908,1041,1
20141229.091324,2907,14,703554,-8,2907,1072,2908,1051,0
20141229.091325,2907,16,703570,6,2907,1070,2908,1045,0
20141229.091325,2908,14,703584,14,2907,1116,2908,1038,1
20141229.091326,2908,2,703586,0,2907,1116,2908,1045,1
20141229.091326,2908,202,703788,202,2907,1056,2908,968,1
20141229.091327,2907,14,703802,-4,2907,1062,2908,968,0
20141229.091327,2908,30,703832,28,2907,658,2908,1001,1
20141229.091328,2907,8,703840,6,2907,177,2908,1011,0
20141229.091328,2907,710,704550,374,2906,548,2907,334,0
20141229.091329,2906,36,704586,-6,2906,458,2907,600,0
20141229.091329,2907,56,704642,-52,2906,398,2907,572,1
20141229.09133,2907,26,704668,-18,2906,397,2907,617,1
20141229.09133,2907,72,704740,48,2906,398,2907,535,1
20141229.091331,2907,14,704754,12,2906,337,2907,630,1
20141229.091331,2906,82,704836,80,2906,336,2907,616,0
20141229.091332,2906,40,704876,2,2906,318,2907,620,0
20141229.091332,2907,12,704888,0,2906,318,2907,614,1
20141229.091333,2906,438,705326,54,2906,147,2907,577,0
20141229.091333,2906,418,705744,-88,2906,14,2907,652,0
20141229.091334,2906,50,705794,2,2906,45,2907,555,0
20141229.091334,2907,272,706066,96,2906,101,2907,522,1
20141229.091335,2906,10,706076,0,2906,100,2907,585,0
20141229.091335,2906,116,706192,-32,2906,57,2907,598,0
20141229.091336,2906,116,706308,22,2905,725,2906,654,0
20141229.091336,2905,98,706406,98,2905,612,2906,679,0
20141229.091337,2906,122,706528,84,2905,542,2906,755,1
20141229.091337,2905,44,706572,-18,2905,512,2906,767,0
20141229.091338,2906,116,706688,28,2905,507,2906,726,1
20141229.091338,2905,84,706772,82,2905,510,2906,688,0
20141229.091339,2906,232,707004,224,2905,531,2906,599,1
20141229.091339,2905,4,707008,2,2905,540,2906,616,0
20141229.09134,2905,18,707026,18,2905,522,2906,619,0
20141229.09134,2905,84,707110,82,2905,459,2906,621,0
20141229.091341,2905,4,707114,2,2905,439,2906,659,0
20141229.091341,2905,34,707148,0,2905,423,2906,659,0
20141229.091342,2905,804,707952,694,2905,367,2906,349,0
20141229.091342,2906,170,708122,40,2905,515,2906,306,1
20141229.091343,2905,430,708552,274,2905,480,2906,113,0
20141229.091343,2906,20,708572,2,2905,639,2906,89,1
20141229.091344,2906,184,708756,158,2906,143,2907,642,1
20141229.091345,2906,62,708818,30,2906,197,2907,654,1
20141229.091345,2907,10,708828,4,2906,216,2907,657,1
20141229.091346,2907,656,709484,504,2906,224,2907,330,1
20141229.091346,2906,2,709486,0,2906,337,2907,337,0
20141229.091347,2907,8,709494,4,2906,334,2907,338,1
20141229.091347,2906,4,709498,2,2906,456,2907,339,0
20141229.091348,2907,6,709504,-4,2906,444,2907,348,1
20141229.091349,2907,48,709552,0,2906,453,2907,335,1
20141229.091349,2906,26,709578,-24,2906,455,2907,345,0
20141229.091349,2907,12,709590,0,2906,439,2907,345,1
20141229.09135,2906,956,710546,-386,2905,635,2906,196,0
20141229.091351,2906,558,711104,-222,2905,631,2906,18,0
20141229.091351,2906,38,711142,18,2906,303,2907,392,0
20141229.091352,2907,12,711154,0,2906,384,2907,366,1
20141229.091352,2906,4,711158,-4,2906,332,2907,372,0
20141229.091353,2907,52,711210,2,2906,311,2907,433,1
20141229.091354,2906,48,711258,-48,2906,839,2907,438,0
20141229.091354,2906,42,711300,0,2906,816,2907,430,0
20141229.091355,2906,26,711326,-4,2906,813,2907,425,0
20141229.091355,2906,8,711334,0,2906,835,2907,426,0
20141229.091356,2906,4,711338,-2,2906,838,2907,437,0
20141229.091356,2906,2,711340,0,2906,856,2907,379,0
20141229.091357,2906,8,711348,-4,2906,895,2907,379,0
20141229.091357,2907,20,711368,-12,2906,894,2907,370,1
20141229.091358,2906,12,711380,-10,2906,882,2907,380,0
20141229.091359,2906,202,711582,100,2906,765,2907,392,0
20141229.091359,2907,50,711632,38,2906,751,2907,389,1
20141229.0914,2907,1240,712872,708,2907,148,2908,1059,1
20141229.091401,2907,26,712898,-18,2907,106,2908,1056,1
20141229.091402,2907,212,713110,-188,2907,21,2908,1056,1
20141229.091402,2907,500,713610,-102,2906,852,2907,1,1
20141229.091403,2907,12,713622,10,2906,850,2907,66,1
20141229.091403,2907,230,713852,202,2907,66,2908,1066,1
20141229.091404,2907,248,714100,-112,2907,46,2908,1056,1
20141229.091404,2907,298,714398,104,2907,48,2908,1071,1
20141229.091405,2907,214,714612,-176,2906,767,2907,147,1
20141229.091406,2907,500,715112,294,2907,65,2908,1066,1
20141229.091406,2908,12,715124,-2,2907,163,2908,1027,1
20141229.091407,2907,2,715126,0,2907,186,2908,1022,0
20141229.091407,2907,10,715136,-2,2907,243,2908,1022,0
20141229.091408,2907,46,715182,-4,2907,289,2908,1021,0
20141229.091408,2907,16,715198,-8,2907,291,2908,1031,0
20141229.091409,2908,6,715204,-2,2907,579,2908,1029,1
20141229.091409,2907,290,715494,34,2907,462,2908,1029,0
20141229.09141,2908,2,715496,-2,2907,460,2908,1028,1
20141229.09141,2907,68,715564,4,2907,439,2908,1020,0
20141229.091411,2907,12,715576,4,2907,401,2908,1014,0
20141229.091411,2907,48,715624,36,2907,384,2908,1011,0
20141229.091412,2907,6,715630,2,2907,383,2908,1030,0
20141229.091412,2907,218,715848,142,2907,67,2908,1044,0
20141229.091413,2907,60,715908,0,2906,773,2907,212,0
20141229.091413,2907,8,715916,8,2906,697,2907,524,0
20141229.091414,2907,106,716022,2,2906,686,2907,483,0
20141229.091414,2907,2,716024,2,2906,652,2907,492,0
20141229.091415,2906,202,716226,-16,2906,531,2907,492,0
20141229.091415,2907,4,716230,4,2906,536,2907,517,1
20141229.091416,2906,66,716296,2,2906,503,2907,518,0
20141229.091416,2907,64,716360,20,2906,495,2907,529,1
20141229.091417,2907,44,716404,42,2906,477,2907,573,1
20141229.091417,2907,2,716406,0,2906,476,2907,572,1
20141229.091418,2906,2,716408,-2,2906,524,2907,574,0
20141229.091418,2907,2,716410,0,2906,553,2907,573,1
20141229.091419,2907,4,716414,2,2906,554,2907,571,1
20141229.091419,2907,4,716418,4,2906,555,2907,614,1
20141229.09142,2906,142,716560,120,2906,488,2907,555,0
20141229.09142,2906,18,716578,0,2906,428,2907,555,0
20141229.091421,2906,260,716838,198,2906,416,2907,439,0
20141229.091422,2907,44,716882,34,2906,486,2907,520,1
20141229.091422,2906,42,716924,0,2906,315,2907,525,0
20141229.091422,2907,2,716926,0,2906,327,2907,524,1
20141229.091423,2906,46,716972,30,2906,348,2907,637,0
20141229.091424,2906,46,717018,-4,2906,389,2907,639,0
20141229.091424,2906,86,717104,80,2906,350,2907,635,0
20141229.091425,2906,24,717128,2,2906,342,2907,635,0
20141229.091425,2906,154,717282,70,2905,662,2907,747,0
20141229.091426,2906,98,717380,92,2905,662,2907,746,0
20141229.091426,2906,50,717430,44,2905,752,2906,2,0
20141229.091427,2905,112,717542,62,2905,875,2906,3,0
20141229.091427,2906,154,717696,84,2905,898,2907,744,1
20141229.091428,2905,120,717816,62,2905,747,2907,856,0
20141229.091429,2906,6,717822,2,2906,11,2907,869,1
20141229.091429,2906,28,717850,-22,2905,802,2906,46,1
20141229.09143,2906,296,718146,32,2905,853,2906,171,1
20141229.09143,2906,344,718490,262,2906,2,2907,898,1
20141229.091431,2906,26,718516,14,2905,751,2907,895,1
20141229.091431,2905,42,718558,38,2905,845,2906,12,0
20141229.091432,2905,52,718610,48,2905,733,2906,2,0
20141229.091432,2906,164,718774,158,2905,921,2906,3,1
20141229.091433,2905,76,718850,-62,2905,1033,2906,13,0
20141229.091433,2906,8,718858,4,2905,926,2906,12,1
20141229.091434,2906,154,719012,-20,2905,829,2906,10,1
20141229.091434,2905,60,719072,54,2905,797,2906,88,0
20141229.091434,2906,204,719276,174,2905,364,2907,965,1
20141229.091435,2906,42,719318,2,2906,29,2907,956,1
20141229.091436,2906,314,719632,126,2905,838,2906,58,1
20141229.091436,2906,46,719678,-10,2905,836,2906,287,1
20141229.091437,2905,72,719750,34,2905,825,2906,386,0
20141229.091437,2906,106,719856,54,2905,834,2906,343,1
20141229.091438,2906,22,719878,-10,2905,829,2906,340,1
20141229.091438,2905,136,720014,116,2905,822,2906,285,0
20141229.091438,2905,16,720030,12,2905,820,2906,279,0
20141229.091439,2905,592,720622,490,2905,529,2906,18,0
20141229.09144,2906,62,720684,10,2906,127,2907,631,1
20141229.09144,2906,28,720712,0,2906,99,2907,636,1
20141229.091441,2906,118,720830,-108,2906,117,2907,771,1
20141229.091441,2906,274,721104,248,2906,224,2907,765,1
20141229.091442,2906,74,721178,-60,2906,199,2907,765,1
20141229.091442,2906,6,721184,-6,2906,262,2907,760,1
20141229.091443,2907,632,721816,-170,2906,270,2907,447,1
20141229.091443,2906,592,722408,338,2905,275,2906,708,0
20141229.091444,2906,12,722420,-2,2905,478,2906,707,0
20141229.091445,2906,20,722440,20,2905,479,2906,703,0
20141229.091445,2906,12,722452,0,2905,478,2906,699,0
20141229.091446,2906,10,722462,2,2905,483,2906,797,0
20141229.091447,2905,24,722486,18,2905,483,2906,807,0
20141229.091447,2906,30,722516,0,2905,503,2906,794,1
20141229.091448,2905,4,722520,0,2905,553,2906,796,0
20141229.091448,2906,24,722544,24,2905,558,2906,786,1
20141229.091449,2906,4,722548,4,2905,552,2906,784,1
20141229.091449,2906,4,722552,4,2905,552,2906,782,1
20141229.09145,2906,18,722570,-2,2905,546,2906,798,1
20141229.091451,2906,26,722596,-16,2905,495,2906,797,1
20141229.091451,2906,152,722748,82,2905,504,2906,744,1
20141229.091452,2906,126,722874,126,2905,507,2906,681,1
20141229.091453,2905,22,722896,-14,2905,496,2906,679,0
20141229.091453,2906,36,722932,18,2905,494,2906,672,1
20141229.091454,2905,2,722934,0,2905,497,2906,672,0
20141229.091454,2905,6,722940,-6,2905,475,2906,724,0
20141229.091455,2905,10,722950,-10,2905,479,2906,724,0
20141229.091455,2905,134,723084,16,2905,467,2906,715,0
20141229.091456,2905,22,723106,14,2905,281,2906,706,0
20141229.091456,2906,8,723114,2,2905,256,2906,714,1
20141229.091456,2905,14,723128,0,2905,240,2906,723,0
20141229.091457,2906,96,723224,84,2905,229,2906,763,1
20141229.091458,2906,32,723256,22,2905,213,2906,777,1
20141229.091458,2906,30,723286,30,2905,218,2906,716,1
20141229.091459,2905,28,723314,2,2905,234,2906,716,0
20141229.091459,2905,96,723410,-32,2905,194,2906,711,0
20141229.0915,2906,64,723474,12,2905,179,2906,694,1
20141229.0915,2905,1070,724544,692,2905,129,2906,202,0
20141229.091501,2905,594,725138,-304,2905,28,2906,169,0
20141229.091501,2905,136,725274,-54,2905,146,2906,236,0
20141229.091502,2906,52,725326,16,2905,186,2906,273,1
20141229.091502,2906,224,725550,114,2905,289,2906,150,1
20141229.091503,2906,268,725818,108,2906,51,2907,687,1
20141229.091503,2906,70,725888,-10,2906,130,2907,660,1
20141229.091504,2906,24,725912,-4,2906,129,2907,659,1
20141229.091504,2906,10,725922,-8,2906,175,2907,658,1
20141229.091505,2907,76,725998,-2,2906,191,2907,624,1
20141229.091505,2906,86,726084,32,2906,170,2907,601,0
20141229.091506,2906,150,726234,130,2906,146,2907,528,0
20141229.091506,2906,2,726236,2,2906,188,2907,529,0
20141229.091507,2907,74,726310,2,2906,239,2907,497,1
20141229.091507,2907,114,726424,-14,2906,218,2907,451,1
20141229.091508,2906,2,726426,0,2906,234,2907,471,0
20141229.091508,2906,8,726434,-2,2906,247,2907,469,0
20141229.091509,2907,126,726560,-106,2906,194,2907,435,1
20141229.091509,2906,372,726932,-156,2905,792,2906,331,0
20141229.09151,2906,166,727098,0,2905,631,2906,275,0
20141229.09151,2906,22,727120,0,2905,677,2906,271,0
20141229.091511,2906,146,727266,-146,2905,676,2906,198,0
20141229.091511,2906,80,727346,-80,2905,682,2906,162,0
20141229.091512,2906,744,728090,-394,2906,335,2907,474,0
20141229.091512,2906,72,728162,22,2906,309,2907,467,0
20141229.091513,2906,30,728192,10,2906,297,2907,463,0
20141229.091513,2907,14,728206,10,2906,310,2907,464,1
20141229.091514,2906,8,728214,4,2906,291,2907,461,0
20141229.091514,2906,68,728282,48,2906,288,2907,430,0
20141229.091515,2906,20,728302,14,2906,297,2907,441,0
20141229.091516,2906,8,728310,0,2906,297,2907,442,0
20141229.091517,2907,48,728358,6,2906,224,2907,471,1
20141229.091517,2906,6,728364,6,2906,210,2907,476,0
20141229.091518,2906,4,728368,0,2906,211,2907,479,0
20141229.091518,2906,64,728432,0,2906,239,2907,495,0
20141229.091519,2906,482,728914,0,2905,777,2906,101,0
20141229.09152,2905,2,728916,0,2905,651,2906,164,0
20141229.09152,2905,2,728918,0,2905,595,2906,165,0
20141229.091521,2905,26,728944,-4,2905,560,2906,168,0
20141229.091522,2905,2,728946,0,2905,835,2906,227,0
20141229.091523,2906,552,729498,-126,2905,712,2906,16,1
20141229.091523,2906,2,729500,-2,2905,727,2906,16,1
20141229.091524,2906,162,729662,24,2906,73,2907,565,1
20141229.091524,2906,154,729816,126,2905,550,2907,569,1
20141229.091525,2906,28,729844,0,2905,737,2906,134,1
20141229.091525,2905,4,729848,-2,2905,461,2906,135,0
20141229.091526,2906,52,729900,0,2905,454,2906,113,1
20141229.091526,2906,4,729904,0,2905,454,2906,149,1
20141229.091526,2906,8,729912,-6,2905,459,2906,151,1
20141229.091527,2905,4,729916,-4,2905,485,2906,175,0
20141229.091527,2906,4,729920,0,2905,491,2906,173,1
20141229.091528,2906,6,729926,0,2905,490,2906,189,1
20141229.091529,2905,2,729928,0,2905,486,2906,190,0
20141229.091529,2905,10,729938,0,2905,476,2906,196,0
20141229.09153,2905,10,729948,-10,2905,469,2906,196,0
20141229.091531,2906,74,730022,0,2905,452,2906,185,1
20141229.091531,2905,8,730030,0,2905,422,2906,183,0
20141229.091532,2906,16,730046,-2,2905,424,2906,187,1
20141229.091533,2906,384,730430,102,2906,190,2907,605,1
20141229.091533,2907,4,730434,0,2906,191,2907,557,1
20141229.091534,2906,8,730442,8,2906,187,2907,560,0
20141229.091534,2906,90,730532,-2,2906,167,2907,557,0
20141229.091535,2906,2,730534,0,2906,166,2907,557,0
20141229.091535,2906,4,730538,4,2906,168,2907,557,0
20141229.091536,2906,106,730644,100,2906,202,2907,560,0
20141229.091536,2907,426,731070,348,2906,1,2907,560,1
20141229.091537,2906,24,731094,8,2905,424,2906,339,0
20141229.091537,2905,6,731100,2,2905,431,2906,360,0
20141229.091538,2905,200,731300,-110,2905,333,2906,390,0
20141229.091539,2905,20,731320,20,2905,325,2906,370,0
20141229.091539,2906,6,731326,4,2905,326,2906,367,1
20141229.09154,2905,12,731338,12,2905,325,2906,367,0
20141229.09154,2906,4,731342,2,2905,324,2906,366,1
20141229.091541,2905,110,731452,10,2905,270,2906,368,0
20141229.091542,2906,558,732010,106,2905,66,2906,324,1
20141229.091543,2906,18,732028,16,2905,55,2906,414,1
20141229.091544,2906,4,732032,4,2905,55,2906,432,1
20141229.091545,2905,114,732146,-18,2904,695,2905,2,0
20141229.091545,2905,6,732152,-6,2905,1,2906,554,0
20141229.091546,2906,12,732164,0,2905,246,2906,440,1
20141229.091546,2906,62,732226,-4,2905,245,2906,421,1
20141229.091547,2905,4,732230,0,2905,243,2906,341,0
20141229.091547,2905,42,732272,-8,2905,222,2906,335,0
20141229.091547,2905,2,732274,0,2905,221,2906,335,0
20141229.091548,2906,90,732364,0,2905,428,2906,377,1
20141229.091549,2905,2,732366,0,2905,427,2906,379,0
20141229.091549,2905,4,732370,0,2905,443,2906,380,0
20141229.09155,2905,2,732372,0,2905,442,2906,524,0
20141229.09155,2905,40,732412,-12,2905,439,2906,505,0
20141229.09155,2905,6,732418,-6,2905,436,2906,500,0
20141229.091551,2905,46,732464,-44,2905,356,2906,511,0
20141229.091552,2906,84,732548,-68,2905,406,2906,474,1
20141229.091552,2905,4,732552,-2,2905,405,2906,625,0
20141229.091553,2905,62,732614,-60,2905,404,2906,609,0
20141229.091553,2906,4,732618,0,2905,404,2906,608,1
20141229.091554,2906,12,732630,-6,2905,403,2906,458,1
20141229.091554,2905,404,733034,-270,2905,201,2906,458,0
20141229.091555,2905,46,733080,14,2905,191,2906,461,0
20141229.091555,2905,44,733124,4,2905,168,2906,529,0
20141229.091556,2905,376,733500,-116,2904,561,2905,45,0
20141229.091556,2905,130,733630,130,2905,5,2906,697,0
20141229.091557,2905,128,733758,-106,2904,560,2905,53,0
20141229.091558,2905,2,733760,0,2904,561,2905,134,0
20141229.091558,2905,4,733764,0,2904,561,2905,133,0
20141229.091559,2904,4,733768,0,2904,563,2905,133,0
20141229.091559,2904,2,733770,2,2904,563,2905,134,0
20141229.0916,2904,82,733852,0,2904,547,2905,136,0
20141229.091601,2905,78,733930,14,2904,546,2905,119,1
20141229.091601,2904,2,733932,0,2904,520,2905,135,0
20141229.091602,2904,18,733950,14,2904,514,2905,128,0
20141229.091602,2905,22,733972,20,2904,517,2905,184,1
20141229.091603,2904,22,733994,2,2904,505,2905,185,0
20141229.091603,2905,24,734018,16,2904,501,2905,118,1
20141229.091604,2905,6,734024,6,2904,503,2905,113,1
20141229.091605,2904,50,734074,4,2904,478,2905,117,0
20141229.091605,2904,4,734078,0,2904,477,2905,118,0
20141229.091606,2904,2,734080,2,2904,479,2905,118,0
20141229.091606,2905,34,734114,14,2904,474,2905,501,1
20141229.091607,2904,50,734164,20,2904,467,2905,510,0
20141229.091607,2904,410,734574,-158,2904,265,2905,506,0
20141229.091608,2904,30,734604,-2,2904,242,2905,526,0
20141229.091608,2904,172,734776,-134,2904,156,2905,577,0
20141229.091609,2904,312,735088,92,2903,514,2904,102,0
20141229.09161,2903,2,735090,0,2903,465,2904,109,0
20141229.09161,2904,60,735150,-6,2903,443,2904,125,1
20141229.091611,2904,4,735154,0,2903,443,2904,251,1
20141229.091612,2903,4,735158,2,2903,441,2904,274,0
20141229.091612,2903,8,735166,-4,2903,440,2904,304,0
20141229.091612,2903,120,735286,2,2903,514,2904,97,0
20141229.091613,2903,920,736206,-424,2902,582,2903,125,0
20141229.091614,2903,6,736212,-6,2902,560,2903,122,0
20141229.091614,2903,20,736232,-20,2902,596,2903,117,0
20141229.091615,2903,4,736236,-2,2902,595,2903,119,0
20141229.091615,2902,66,736302,-58,2902,622,2903,112,0
20141229.091616,2903,104,736406,-58,2902,575,2903,111,1
20141229.091616,2902,2,736408,0,2902,576,2903,113,0
20141229.091617,2903,114,736522,-44,2902,521,2903,92,1
20141229.091617,2903,12,736534,-4,2902,560,2903,90,1
20141229.091618,2903,12,736546,-4,2902,579,2903,90,1
20141229.091618,2903,150,736696,-124,2902,577,2903,17,1
20141229.091619,2904,120,736816,-72,2903,57,2904,238,1
20141229.091619,2903,88,736904,-84,2903,94,2904,218,0
20141229.091619,2904,68,736972,-66,2903,165,2904,216,1
20141229.09162,2903,200,737172,-170,2903,417,2904,146,0
20141229.091621,2903,12,737184,-4,2903,454,2904,116,0
20141229.091621,2903,32,737216,-10,2903,420,2904,58,0
20141229.091621,2903,8,737224,-4,2903,417,2904,57,0
20141229.091622,2903,48,737272,-28,2903,483,2904,27,0
20141229.091623,2903,6,737278,-2,2903,485,2904,32,0
20141229.091623,2903,12,737290,-12,2903,484,2904,51,0
20141229.091624,2903,30,737320,-26,2903,463,2904,53,0
20141229.091625,2903,20,737340,-20,2903,453,2904,56,0
20141229.091625,2903,4,737344,-2,2903,453,2904,59,0
20141229.091626,2903,60,737404,20,2903,430,2904,68,0
20141229.091626,2904,18,737422,4,2903,435,2904,65,1
20141229.091627,2903,2,737424,2,2903,435,2904,89,0
20141229.091627,2903,4,737428,2,2903,434,2904,130,0
20141229.091628,2903,4,737432,2,2903,407,2904,155,0
20141229.091629,2903,32,737464,0,2903,385,2904,193,0
20141229.091629,2903,14,737478,10,2903,346,2904,247,0
20141229.09163,2903,6,737484,2,2903,344,2904,251,0
20141229.09163,2903,2,737486,2,2903,353,2904,267,0
20141229.091631,2903,4,737490,2,2903,287,2904,268,0
20141229.091631,2903,4,737494,0,2903,285,2904,275,0
20141229.091632,2903,18,737512,2,2903,276,2904,290,0
20141229.091632,2904,64,737576,-8,2903,81,2904,259,1
20141229.091633,2903,166,737742,90,2903,12,2904,259,0
20141229.091633,2903,26,737768,0,2902,766,2903,19,0
20141229.091634,2903,4,737772,4,2902,772,2903,17,0
20141229.091634,2903,36,737808,30,2903,92,2904,469,0
20141229.091635,2903,8,737816,0,2903,138,2904,355,0
20141229.091635,2903,26,737842,16,2903,207,2904,365,0
20141229.091636,2904,172,738014,80,2903,213,2904,271,1
20141229.091636,2903,4,738018,0,2903,265,2904,246,0
20141229.091637,2903,574,738592,-158,2902,780,2904,250,0
20141229.091638,2904,20,738612,0,2903,26,2904,375,1
20141229.091638,2903,10,738622,0,2903,27,2904,377,0
20141229.091638,2903,14,738636,0,2903,24,2904,386,0
20141229.091639,2903,40,738676,22,2903,43,2904,396,0
20141229.09164,2903,4,738680,0,2903,51,2904,396,0
20141229.09164,2904,672,739352,86,2903,8,2904,357,1
20141229.091641,2903,190,739542,-10,2903,155,2904,287,0
20141229.091642,2903,2,739544,0,2903,220,2904,211,0
20141229.091642,2903,8,739552,8,2903,227,2904,190,0
20141229.091643,2903,10,739562,6,2903,277,2904,195,0
20141229.091643,2905,672,740234,290,2904,1,2905,461,1
20141229.091644,2904,120,740354,110,2904,122,2905,295,0
20141229.091644,2904,10,740364,-10,2904,158,2905,296,0
20141229.091645,2904,30,740394,-2,2904,132,2905,283,0
20141229.091645,2904,2,740396,0,2904,140,2905,285,0
20141229.091645,2904,4,740400,-4,2904,138,2905,286,0
20141229.091646,2905,210,740610,-34,2904,13,2905,291,1
20141229.091647,2904,190,740800,-108,2904,3,2905,405,0
20141229.091647,2904,82,740882,40,2903,547,2904,62,0
20141229.091648,2904,24,740906,4,2903,531,2904,115,0
20141229.091648,2904,4,740910,0,2903,485,2904,113,0
20141229.091649,2904,22,740932,-2,2903,486,2904,103,0
20141229.09165,2904,8,740940,0,2903,498,2904,109,0
20141229.09165,2904,220,741160,-176,2904,2,2905,429,0
20141229.091651,2903,22,741182,4,2903,407,2904,399,0
20141229.091652,2904,22,741204,0,2903,367,2904,407,1
20141229.091652,2904,8,741212,0,2903,368,2904,474,1
20141229.091653,2904,472,741684,472,2903,377,2904,175,1
20141229.091653,2904,322,742006,-10,2904,85,2905,412,1
20141229.091654,2904,2,742008,2,2904,157,2905,327,1
20141229.091654,2904,18,742026,10,2904,240,2905,327,1
20141229.091655,2904,82,742108,0,2904,206,2905,364,1
20141229.091655,2904,494,742602,224,2903,485,2905,429,1
20141229.091656,2904,10,742612,0,2904,46,2905,328,1
20141229.091656,2904,4,742616,-4,2904,44,2905,344,1
20141229.091657,2904,2,742618,0,2904,108,2905,335,1
20141229.091657,2905,684,743302,500,2905,1,2906,601,1
20141229.091658,2904,148,743450,-28,2904,513,2905,4,0
20141229.091658,2905,8,743458,4,2904,299,2906,601,1
20141229.091659,2905,124,743582,96,2904,284,2906,602,1
20141229.091659,2905,10,743592,10,2905,3,2906,617,1
20141229.0917,2905,424,744016,26,2905,230,2906,318,1
20141229.0917,2906,320,744336,132,2905,236,2906,196,1
20141229.091701,2906,4,744340,4,2905,266,2906,197,1
20141229.091701,2906,130,744470,110,2905,630,2906,125,1
20141229.091702,2906,426,744896,76,2906,108,2907,513,1
20141229.091702,2906,2,744898,2,2906,130,2907,513,1
20141229.091703,2906,8,744906,0,2906,146,2907,513,1
20141229.091704,2906,48,744954,48,2906,256,2907,512,1
20141229.091705,2906,6,744960,6,2906,254,2907,513,1
20141229.091705,2906,142,745102,40,2906,183,2907,513,1
20141229.091706,2906,6,745108,-2,2906,190,2907,512,1
20141229.091707,2906,156,745264,-2,2906,148,2907,471,1
20141229.091708,2906,6,745270,-4,2906,137,2907,477,1
20141229.091709,2906,2,745272,0,2906,136,2907,481,1
20141229.091709,2906,8,745280,-8,2906,133,2907,488,1
20141229.09171,2906,46,745326,-14,2906,107,2907,497,1
20141229.09171,2906,214,745540,90,2905,1191,2906,102,1
20141229.09171,2906,2,745542,-2,2905,1190,2906,104,1
20141229.091711,2906,4,745546,2,2905,1172,2906,132,1
20141229.091712,2906,506,746052,220,2905,330,2907,571,1
20141229.091712,2906,140,746192,130,2906,183,2907,570,1
20141229.091713,2906,42,746234,-38,2906,269,2907,571,1
20141229.091713,2907,108,746342,-8,2906,277,2907,570,1
20141229.091714,2906,12,746354,-12,2906,609,2907,571,0
20141229.091714,2906,4,746358,-2,2906,614,2907,571,0
20141229.091714,2906,44,746402,-38,2906,591,2907,571,0
20141229.091715,2907,164,746566,-8,2906,741,2907,519,1
20141229.091716,2906,42,746608,0,2906,736,2907,547,0
20141229.091716,2906,112,746720,-20,2906,682,2907,552,0
20141229.091717,2906,10,746730,-10,2906,683,2907,553,0
20141229.091717,2906,2,746732,-2,2906,683,2907,553,0
20141229.091718,2906,12,746744,0,2906,710,2907,560,0
20141229.091719,2907,22,746766,-2,2906,620,2907,596,1
20141229.09172,2906,40,746806,0,2906,560,2907,595,0
20141229.09172,2906,8,746814,-4,2906,556,2907,596,0
20141229.091721,2906,4,746818,0,2906,556,2907,643,0
20141229.091721,2907,2,746820,0,2906,556,2907,644,1
20141229.091722,2906,2,746822,-2,2906,556,2907,644,0
20141229.091722,2907,40,746862,0,2906,557,2907,634,1
20141229.091724,2906,250,747112,-40,2906,430,2907,669,0
20141229.091725,2906,392,747504,182,2905,406,2906,1,0
20141229.091726,2905,22,747526,2,2905,370,2906,133,0
20141229.091726,2906,34,747560,4,2905,347,2906,324,1
20141229.091727,2906,200,747760,-176,2905,268,2906,339,1
20141229.091727,2906,20,747780,20,2905,264,2906,378,1
20141229.091728,2906,2,747782,2,2905,264,2906,381,1
20141229.091728,2906,950,748732,302,2906,121,2907,654,1
20141229.091729,2906,2,748734,-2,2906,121,2907,655,1
20141229.091729,2907,10,748744,4,2906,121,2907,663,1
20141229.09173,2906,222,748966,-14,2905,319,2907,668,0
20141229.091731,2906,10,748976,-2,2905,478,2906,82,0
20141229.091733,2906,2,748978,-2,2905,627,2906,116,0
20141229.091734,2905,64,749042,42,2905,625,2906,86,0
20141229.091734,2906,38,749080,8,2905,630,2906,68,1
20141229.091735,2906,244,749324,16,2906,182,2907,710,1
20141229.091736,2906,6,749330,0,2906,260,2907,710,1
20141229.091736,2906,4,749334,0,2906,259,2907,711,1
20141229.091737,2906,566,749900,-142,2905,856,2906,199,1
20141229.091737,2906,8,749908,0,2905,805,2906,196,1
20141229.091738,2906,6,749914,0,2905,805,2906,196,1
20141229.091738,2905,12,749926,-8,2905,804,2906,193,0
20141229.091738,2906,2,749928,-2,2905,753,2906,197,1
20141229.091739,2906,2,749930,0,2905,752,2906,198,1
20141229.09174,2906,100,750030,0,2905,701,2906,151,1
20141229.091741,2905,40,750070,-2,2905,615,2906,327,0
20141229.091742,2906,2,750072,-2,2905,452,2906,836,1
20141229.091743,2906,6,750078,-4,2905,453,2906,912,1
20141229.091743,2906,8,750086,-8,2905,453,2906,908,1
20141229.091744,2906,2,750088,0,2905,452,2906,911,1
20141229.091744,2905,54,750142,0,2905,477,2906,909,0
20141229.091746,2905,2,750144,2,2905,475,2906,941,0
20141229.091746,2905,38,750182,20,2905,419,2906,960,0
20141229.091747,2905,2,750184,-2,2905,418,2906,1058,0
20141229.091748,2906,22,750206,-16,2905,411,2906,1058,1
20141229.091748,2905,324,750530,210,2905,415,2906,909,0
20141229.091749,2905,14,750544,0,2905,434,2906,826,0
20141229.091749,2905,10,750554,0,2905,429,2906,826,0
20141229.09175,2905,118,750672,-4,2905,430,2906,779,0
20141229.091751,2905,2,750674,-2,2905,440,2906,779,0
20141229.091751,2905,4,750678,0,2905,438,2906,779,0
20141229.091752,2906,16,750694,-16,2905,439,2906,837,1
20141229.091753,2906,200,750894,0,2905,440,2906,778,1
20141229.091753,2905,12,750906,-6,2905,435,2906,381,0
20141229.091754,2906,4,750910,0,2905,434,2906,386,1
20141229.091754,2906,214,751124,166,2905,458,2906,197,1
20141229.091755,2905,4,751128,-2,2905,500,2906,196,0
20141229.091755,2906,150,751278,72,2905,500,2906,121,1
20141229.091756,2905,6,751284,-4,2905,496,2906,123,0
20141229.091756,2905,204,751488,60,2905,460,2906,50,0
20141229.091757,2905,112,751600,-6,2905,509,2906,1,0
20141229.091758,2906,4,751604,2,2906,155,2907,1172,1
20141229.091759,2906,6,751610,0,2906,152,2907,1105,1
20141229.091759,2906,4,751614,0,2906,151,2907,1105,1
20141229.0918,2906,88,751702,0,2906,118,2907,1116,1
20141229.0918,2906,16,751718,-4,2906,170,2907,1116,1
20141229.091801,2906,6,751724,0,2906,167,2907,1126,1
20141229.091801,2906,22,751746,-20,2906,156,2907,1120,1
20141229.091802,2906,36,751782,14,2906,140,2907,1108,1
20141229.091802,2906,10,751792,0,2906,136,2907,1107,1
20141229.091803,2906,40,751832,-38,2906,116,2907,1107,1
20141229.091803,2907,204,752036,72,2906,16,2907,1106,1
20141229.091804,2906,32,752068,28,2905,974,2906,230,0
20141229.091804,2905,6,752074,0,2905,971,2906,233,0
20141229.091805,2906,8,752082,-2,2905,971,2906,241,1
20141229.091805,2905,10,752092,0,2905,965,2906,243,0
20141229.091806,2906,16,752108,0,2905,975,2906,240,1
20141229.091807,2905,30,752138,30,2905,959,2906,233,0
20141229.091808,2905,122,752260,100,2905,899,2906,251,0
20141229.091808,2906,16,752276,0,2905,897,2906,244,1
20141229.091809,2905,106,752382,-18,2905,846,2906,243,0
20141229.091809,2905,100,752482,98,2905,805,2906,253,0
20141229.09181,2906,6,752488,6,2905,795,2906,270,1
20141229.091811,2905,42,752530,42,2905,773,2906,285,0
20141229.091811,2905,208,752738,6,2905,706,2906,300,0
20141229.091813,2906,6,752744,6,2905,616,2906,385,1
20141229.091814,2905,4,752748,0,2905,353,2906,395,0
20141229.091815,2905,2,752750,2,2905,262,2906,397,0
20141229.091816,2905,8,752758,4,2905,261,2906,401,0
20141229.091816,2905,16,752774,14,2905,252,2906,406,0
20141229.091816,2905,2,752776,2,2905,248,2906,410,0
20141229.091817,2906,2,752778,2,2905,248,2906,417,1
20141229.091818,2905,50,752828,2,2905,182,2906,432,0
20141229.091818,2906,4,752832,4,2905,181,2906,432,1
20141229.091819,2905,40,752872,36,2905,162,2906,432,0
20141229.09182,2906,2,752874,0,2905,162,2906,443,1
20141229.09182,2906,4,752878,2,2905,163,2906,453,1
20141229.09182,2905,2,752880,0,2905,162,2906,453,0
20141229.091821,2905,2,752882,2,2905,161,2906,456,0
20141229.091822,2905,28,752910,2,2905,529,2906,449,0
20141229.091824,2905,14,752924,12,2905,490,2906,454,0
20141229.091824,2905,100,753024,-54,2905,434,2906,457,0
20141229.091825,2905,918,753942,690,2904,415,2905,193,0
20141229.091825,2905,6,753948,0,2904,397,2905,190,0
20141229.091826,2905,6,753954,0,2904,363,2905,215,0
20141229.091826,2905,16,753970,16,2904,363,2905,218,0
20141229.091827,2904,8,753978,8,2904,279,2905,230,0
20141229.091828,2904,150,754128,-88,2904,203,2905,236,0
20141229.091828,2904,434,754562,266,2903,514,2904,69,0
20141229.091829,2904,306,754868,-16,2904,395,2905,300,0
20141229.091829,2904,40,754908,-10,2904,375,2905,297,0
20141229.09183,2904,4,754912,0,2904,255,2905,511,0
20141229.091831,2904,404,755316,-2,2904,53,2905,511,0
20141229.091831,2904,120,755436,12,2903,506,2904,297,0
20141229.091832,2903,124,755560,-86,2903,494,2904,247,0
20141229.091832,2904,2,755562,-2,2903,502,2904,251,1
20141229.091833,2904,8,755570,-4,2903,542,2904,408,1
20141229.091833,2903,368,755938,300,2903,363,2904,359,0
20141229.091834,2903,4,755942,0,2903,443,2904,359,0
20141229.091834,2903,176,756118,86,2903,343,2904,364,0
20141229.091835,2903,22,756140,-20,2903,260,2904,396,0
20141229.091835,2903,4,756144,-2,2903,258,2904,397,0
20141229.091836,2904,136,756280,-92,2903,216,2904,387,1
20141229.091837,2903,8,756288,0,2903,214,2904,387,0
20141229.091837,2903,102,756390,92,2903,163,2904,387,0
20141229.091838,2903,28,756418,-16,2903,154,2904,386,0
20141229.091838,2904,786,757204,70,2903,386,2904,2,1
20141229.091839,2904,18,757222,-8,2904,91,2905,307,1
20141229.091839,2904,8,757230,-8,2904,92,2905,301,1
20141229.09184,2904,22,757252,-22,2904,162,2905,306,1
20141229.09184,2904,18,757270,-4,2904,259,2905,326,1
20141229.091841,2904,10,757280,-6,2904,204,2905,326,1
20141229.091841,2905,662,757942,-468,2905,173,2906,535,1
20141229.091842,2905,32,757974,-14,2905,179,2906,534,1
20141229.091842,2905,96,758070,-60,2905,115,2906,538,1
20141229.091843,2905,232,758302,6,2904,322,2906,611,1
20141229.091843,2905,70,758372,-24,2904,332,2906,611,1
20141229.091844,2905,46,758418,0,2905,267,2906,665,1
20141229.091845,2905,58,758476,0,2904,319,2906,709,1
20141229.091845,2905,58,758534,4,2904,333,2906,706,1
20141229.091846,2905,134,758668,100,2904,333,2906,706,1
20141229.091846,2905,2,758670,2,2904,348,2906,718,1
20141229.091847,2905,106,758776,106,2904,352,2906,722,1
20141229.091847,2905,138,758914,128,2904,353,2906,723,1
20141229.091848,2905,8,758922,8,2904,348,2906,738,1
20141229.091848,2905,4,758926,0,2904,349,2906,738,1
20141229.091849,2905,18,758944,0,2904,373,2906,739,1
20141229.09185,2905,20,758964,20,2904,384,2906,739,1
20141229.09185,2905,4,758968,0,2904,406,2906,801,1
20141229.091851,2905,10,758978,10,2904,407,2906,803,1
20141229.091851,2905,36,759014,24,2904,407,2906,800,1
20141229.091851,2905,90,759104,0,2904,408,2906,798,1
20141229.091852,2906,2,759106,0,2904,408,2906,797,1
20141229.091853,2905,2,759108,0,2904,394,2906,810,0
20141229.091854,2905,258,759366,94,2905,83,2906,825,0
20141229.091855,2905,12,759378,-2,2904,593,2906,824,0
20141229.091855,2905,48,759426,34,2904,687,2906,824,0
20141229.091856,2905,16,759442,-10,2904,876,2906,892,0
20141229.091856,2905,80,759522,16,2904,855,2905,5,0
20141229.091857,2905,14,759536,0,2905,500,2906,895,0
20141229.091857,2905,10,759546,-10,2905,477,2906,836,0
20141229.091858,2905,32,759578,-4,2905,460,2906,876,0
20141229.091859,2905,10,759588,4,2905,516,2906,874,0
20141229.091859,2905,112,759700,108,2905,467,2906,875,0
20141229.0919,2906,86,759786,48,2904,517,2906,876,1
20141229.0919,2905,52,759838,0,2904,532,2906,887,0
20141229.091901,2905,6,759844,6,2904,532,2906,886,0
20141229.091901,2905,50,759894,50,2904,532,2906,895,0
20141229.091902,2905,14,759908,10,2904,532,2906,896,0
20141229.091903,2905,20,759928,4,2904,537,2906,907,0
20141229.091903,2905,4,759932,2,2904,537,2906,908,0
20141229.091903,2905,6,759938,0,2904,537,2906,908,0
20141229.091904,2905,36,759974,16,2904,536,2906,912,0
20141229.091905,2906,2,759976,2,2904,536,2906,913,1
20141229.091905,2905,2,759978,2,2904,536,2906,913,0
20141229.091906,2905,8,759986,4,2904,536,2906,915,0
20141229.091907,2905,2,759988,2,2904,770,2905,10,0
20141229.091907,2905,24,760012,-20,2905,1,2906,1040,0
20141229.091908,2905,10,760022,-6,2905,71,2906,968,0
20141229.091908,2905,6,760028,0,2905,71,2906,1016,0
20141229.091909,2905,2,760030,-2,2905,70,2906,1024,0
20141229.091909,2905,6,760036,-4,2905,67,2906,1013,0
20141229.09191,2906,20,760056,20,2905,86,2906,1016,1
20141229.09191,2905,12,760068,2,2905,82,2906,1025,0
20141229.091911,2905,24,760092,0,2905,75,2906,1024,0
20141229.091911,2905,26,760118,-2,2905,72,2906,1120,0
20141229.091912,2905,8,760126,0,2905,68,2906,1122,0
20141229.091913,2905,2,760128,0,2905,117,2906,1143,0
20141229.091913,2905,26,760154,0,2905,127,2906,1143,0
20141229.091914,2905,10,760164,0,2905,128,2906,1140,0
20141229.091915,2905,20,760184,-2,2905,118,2906,1142,0
20141229.091915,2905,10,760194,0,2905,113,2906,1151,0
20141229.091916,2905,50,760244,-2,2905,88,2906,1150,0
20141229.091916,2905,28,760272,-14,2905,60,2906,1147,0
20141229.091917,2905,2,760274,0,2905,59,2906,1147,0
20141229.091917,2905,118,760392,-30,2904,576,2905,114,0
20141229.091919,2905,2,760394,-2,2904,491,2905,1706,0
20141229.091921,2904,58,760452,2,2904,452,2905,1821,0
20141229.091922,2904,748,761200,338,2904,78,2905,1831,0
20141229.091923,2904,128,761328,62,2904,48,2905,1831,0
20141229.091923,2904,20,761348,2,2904,38,2905,1832,0
20141229.091924,2904,2,761350,0,2904,37,2905,1834,0
20141229.091924,2904,96,761446,-22,2903,752,2904,73,0
20141229.091925,2904,6,761452,0,2903,693,2904,123,0
20141229.091925,2903,22,761474,-22,2903,682,2904,123,0
20141229.091926,2904,18,761492,-4,2903,613,2904,180,1
20141229.091927,2904,206,761698,-124,2903,593,2904,85,1
20141229.091927,2903,46,761744,24,2903,591,2904,65,0
20141229.091928,2903,6,761750,6,2903,591,2904,75,0
20141229.091929,2904,20,761770,0,2903,608,2904,80,1
20141229.091929,2904,2,761772,0,2903,616,2904,79,1
20141229.09193,2904,166,761938,-142,2904,49,2905,1323,1
20141229.09193,2904,6,761944,-6,2904,46,2905,1278,1
20141229.091931,2904,54,761998,-40,2904,21,2905,1358,1
20141229.091931,2904,28,762026,-28,2904,19,2905,1346,1
20141229.091932,2904,12,762038,-10,2904,33,2905,1343,1
20141229.091932,2904,20,762058,-20,2904,25,2905,1293,1
20141229.091933,2904,22,762080,-18,2904,15,2905,1294,1
20141229.091933,2904,30,762110,16,2903,613,2904,96,1
20141229.091934,2904,102,762212,-90,2903,573,2904,99,1
20141229.091935,2904,244,762456,6,2903,570,2905,1386,1
20141229.091935,2904,12,762468,-2,2904,147,2905,1321,1
20141229.091936,2904,54,762522,-38,2904,121,2905,1316,1
20141229.091936,2904,160,762682,118,2904,44,2905,1317,1
20141229.091937,2904,90,762772,-6,2903,539,2904,157,1
20141229.091937,2904,2,762774,0,2903,545,2904,160,1
20141229.091939,2904,8,762782,-4,2903,544,2904,171,1
20141229.091939,2904,20,762802,-16,2903,544,2904,164,1
20141229.09194,2904,40,762842,0,2903,556,2904,160,1
20141229.091941,2904,2,762844,-2,2903,551,2904,274,1
20141229.091942,2903,6,762850,2,2903,551,2904,275,0
20141229.091942,2903,4,762854,0,2903,550,2904,295,0
20141229.091943,2903,2,762856,0,2903,550,2904,338,0
20141229.091943,2903,20,762876,10,2903,540,2904,421,0
20141229.091944,2903,2,762878,-2,2903,339,2904,422,0
20141229.091945,2903,86,762964,-58,2903,290,2904,466,0
20141229.091946,2903,296,763260,2,2903,142,2904,476,0
20141229.091946,2903,134,763394,102,2903,75,2904,475,0
20141229.091946,2903,154,763548,50,2902,989,2903,341,0
20141229.091947,2902,2,763550,0,2902,958,2903,533,0
20141229.091948,2902,32,763582,28,2902,955,2903,539,0
20141229.091949,2902,8,763590,0,2902,951,2903,543,0
20141229.091949,2902,8,763598,6,2902,945,2903,543,0
20141229.091949,2903,2,763600,0,2902,1015,2903,544,1
20141229.09195,2902,52,763652,10,2902,987,2903,545,0
20141229.09195,2902,2,763654,2,2902,987,2903,561,0
20141229.091951,2903,620,764274,472,2902,968,2903,290,1
20141229.091952,2902,20,764294,20,2902,950,2903,290,0
20141229.091952,2903,12,764306,4,2902,929,2903,317,1
20141229.091954,2902,6,764312,-6,2902,871,2903,324,0
20141229.091955,2903,28,764340,4,2902,856,2903,347,1
20141229.091955,2902,16,764356,10,2902,844,2903,347,0
20141229.091956,2902,24,764380,2,2902,841,2903,344,0
20141229.091956,2903,2,764382,2,2902,839,2903,351,1
20141229.091957,2903,2,764384,0,2902,841,2903,362,1
20141229.091958,2902,32,764416,-2,2902,808,2903,463,0
20141229.091958,2902,14,764430,-2,2902,784,2903,464,0
20141229.091959,2902,10,764440,0,2902,788,2903,501,0
20141229.091959,2903,6,764446,0,2902,787,2903,503,1
20141229.092,2902,72,764518,2,2902,768,2903,506,0
20141229.092,2903,1124,765642,120,2903,86,2904,512,1
20141229.092001,2903,10,765652,-6,2903,135,2904,512,1
20141229.092001,2904,18,765670,0,2903,161,2904,429,1
20141229.092002,2903,32,765702,-6,2903,242,2904,425,0
20141229.092003,2904,20,765722,-20,2903,256,2904,421,1
20141229.092004,2903,30,765752,-8,2903,257,2904,431,0
20141229.092004,2903,8,765760,0,2903,254,2904,431,0
20141229.092005,2903,58,765818,-52,2903,257,2904,428,0
20141229.092005,2903,18,765836,4,2903,228,2904,436,0
20141229.092006,2903,202,766038,-52,2903,134,2904,441,0
20141229.092006,2903,10,766048,-2,2903,129,2904,450,0
20141229.092007,2903,262,766310,-248,2902,792,2903,461,0
20141229.092007,2903,20,766330,0,2902,793,2903,455,0
20141229.092008,2903,12,766342,-8,2902,794,2903,450,0
20141229.092008,2903,36,766378,20,2902,784,2903,464,0
20141229.092009,2903,90,766468,-62,2902,778,2903,443,0
20141229.09201,2903,6,766474,4,2902,756,2903,442,0
20141229.092011,2902,2,766476,2,2902,776,2903,451,0
20141229.092011,2902,50,766526,0,2902,781,2903,451,0
20141229.092012,2903,22,766548,6,2902,780,2903,459,1
20141229.092013,2902,240,766788,-52,2902,659,2903,460,0
20141229.092013,2903,4,766792,-4,2902,660,2903,466,1
20141229.092014,2903,14,766806,-2,2902,657,2903,466,1
20141229.092016,2902,314,767120,-182,2902,530,2903,488,0
20141229.092016,2903,22,767142,2,2902,525,2903,485,1
20141229.092016,2903,52,767194,-12,2902,520,2903,466,1
20141229.092017,2902,40,767234,4,2902,600,2903,476,0
20141229.092017,2902,4,767238,-4,2902,598,2903,476,0
20141229.092018,2902,24,767262,-20,2902,589,2903,475,0
20141229.092019,2902,24,767286,0,2902,578,2903,476,0
20141229.09202,2902,16,767302,0,2902,612,2903,475,0
20141229.09202,2902,16,767318,-16,2902,662,2903,477,0
20141229.092021,2903,46,767364,-40,2902,639,2903,516,1
20141229.092021,2903,2,767366,-2,2902,704,2903,524,1
20141229.092022,2902,2,767368,-2,2902,714,2903,524,0
20141229.092022,2902,2,767370,-2,2902,718,2903,524,0
20141229.092022,2902,2,767372,0,2902,717,2903,525,0
20141229.092023,2903,4,767376,0,2902,718,2903,525,1
20141229.092024,2902,24,767400,-18,2902,709,2903,526,0
20141229.092024,2903,4,767404,-4,2902,708,2903,525,1
20141229.092025,2903,64,767468,0,2902,685,2903,520,1
20141229.092025,2902,2,767470,-2,2902,700,2903,650,0
20141229.092026,2902,2,767472,0,2902,699,2903,653,0
20141229.092028,2902,20,767492,-2,2902,698,2903,658,0
20141229.092028,2903,12,767504,0,2902,718,2903,653,1
20141229.092029,2902,200,767704,-172,2902,622,2903,653,0
20141229.09203,2903,4,767708,0,2902,681,2903,645,1
20141229.09203,2902,48,767756,-42,2902,664,2903,658,0
20141229.092031,2903,30,767786,-30,2902,658,2903,649,1
20141229.092032,2903,168,767954,-8,2902,663,2903,568,1
20141229.092032,2903,2,767956,0,2902,687,2903,559,1
20141229.092033,2902,2,767958,-2,2902,685,2903,559,0
20141229.092033,2902,20,767978,0,2902,648,2903,559,0
20141229.092034,2902,2,767980,0,2902,647,2903,560,0
20141229.092034,2902,16,767996,-4,2902,644,2903,556,0
20141229.092035,2902,4,768000,-4,2902,642,2903,556,0
20141229.092035,2902,202,768202,-160,2902,542,2903,556,0
20141229.092037,2902,14,768216,2,2902,537,2903,565,0
20141229.092037,2902,8,768224,8,2902,553,2903,565,0
20141229.092038,2902,20,768244,0,2902,549,2903,566,0
20141229.092038,2903,4,768248,2,2902,547,2903,564,1
20141229.092038,2902,4,768252,2,2902,550,2903,564,0
20141229.092039,2902,4,768256,-2,2902,548,2903,561,0
20141229.092039,2903,2,768258,-2,2902,548,2903,560,1
20141229.09204,2902,14,768272,-12,2902,543,2903,561,0
20141229.09204,2902,1144,769416,376,2901,1213,2902,352,0
20141229.092041,2902,16,769432,14,2901,1202,2902,344,0
20141229.092042,2902,596,770028,-88,2902,104,2903,581,0
20141229.092042,2903,20,770048,0,2902,113,2903,571,1
20141229.092042,2902,64,770112,-2,2902,233,2903,550,0
20141229.092043,2902,6,770118,-6,2902,656,2903,549,0
20141229.092043,2902,6,770124,-6,2902,657,2903,553,0
20141229.092044,2902,106,770230,-6,2902,624,2903,553,0
20141229.092045,2902,70,770300,-8,2902,602,2903,550,0
20141229.092045,2902,26,770326,-10,2902,589,2903,551,0
20141229.092046,2902,26,770352,-16,2902,618,2903,553,0
20141229.092047,2902,10,770362,-8,2902,637,2903,559,0
20141229.092047,2903,2,770364,0,2902,637,2903,558,1
20141229.092049,2902,22,770386,-20,2902,648,2903,569,0
20141229.092049,2903,2,770388,0,2902,659,2903,587,1
20141229.09205,2902,26,770414,-20,2902,657,2903,592,0
20141229.09205,2902,2,770416,0,2902,651,2903,595,0
20141229.092051,2902,20,770436,-20,2902,637,2903,601,0
20141229.092051,2902,2,770438,-2,2902,639,2903,595,0
20141229.092052,2902,8,770446,-8,2902,642,2903,599,0
20141229.092052,2902,20,770466,0,2902,632,2903,600,0
20141229.092053,2902,6,770472,0,2902,631,2903,601,0
20141229.092053,2902,4,770476,0,2902,630,2903,600,0
20141229.092053,2902,156,770632,-156,2902,628,2903,525,0
20141229.092054,2903,1590,772222,-360,2903,190,2904,643,1
20141229.092055,2903,84,772306,0,2903,149,2904,586,1
20141229.092056,2904,376,772682,-78,2903,41,2904,494,1
20141229.092056,2903,100,772782,6,2902,560,2903,30,0
20141229.092057,2903,6,772788,-4,2902,603,2903,44,0
20141229.092057,2903,2,772790,-2,2902,603,2903,43,0
20141229.092058,2902,4,772794,-2,2902,683,2903,42,0
20141229.092058,2903,94,772888,-32,2903,68,2904,625,1
20141229.092059,2904,2,772890,2,2903,69,2904,624,1
20141229.092059,2903,94,772984,-2,2903,24,2904,622,0
20141229.0921,2903,16,773000,-4,2903,16,2904,622,0
20141229.0921,2903,112,773112,-100,2902,693,2903,1,0
20141229.092101,2903,106,773218,48,2903,2,2904,633,0
20141229.092101,2903,8,773226,2,2903,61,2904,629,0
20141229.092102,2903,20,773246,0,2903,252,2904,592,0
20141229.092102,2903,4,773250,0,2903,278,2904,591,0
20141229.092104,2903,82,773332,-6,2903,243,2904,644,0
20141229.092104,2903,102,773434,-80,2903,196,2904,646,0
20141229.092106,2903,10,773444,0,2903,236,2904,675,0
20141229.092106,2903,2,773446,0,2903,235,2904,675,0
20141229.092107,2903,334,773780,-290,2903,83,2904,679,0
20141229.092107,2903,378,774158,-56,2902,574,2903,78,0
20141229.092108,2903,44,774202,-44,2902,525,2903,76,0
20141229.092109,2902,224,774426,-220,2902,412,2903,124,0
20141229.092109,2903,80,774506,-80,2902,393,2903,85,1
20141229.09211,2903,218,774724,14,2902,394,2903,1,1
20141229.09211,2903,68,774792,26,2902,415,2903,21,1
20141229.09211,2903,46,774838,40,2903,23,2904,702,1
20141229.092111,2903,130,774968,-38,2902,395,2903,205,1
20141229.092112,2903,2,774970,2,2902,416,2903,116,1
20141229.092112,2903,294,775264,2,2902,430,2903,1,1
20141229.092113,2903,6,775270,-4,2903,347,2904,681,1
20141229.092114,2903,4,775274,-2,2903,351,2904,696,1
20141229.092115,2904,62,775336,0,2903,487,2904,750,1
20141229.092116,2903,12,775348,0,2903,481,2904,750,0
20141229.092118,2903,44,775392,30,2903,300,2904,737,0
20141229.09212,2903,4,775396,4,2903,305,2904,713,0
20141229.09212,2903,20,775416,4,2903,295,2904,713,0
20141229.092121,2903,2,775418,0,2903,294,2904,713,0
20141229.092122,2904,10,775428,0,2903,311,2904,709,1
20141229.092123,2903,2,775430,0,2903,327,2904,710,0
20141229.092123,2903,4,775434,2,2903,326,2904,711,0
20141229.092124,2903,4,775438,2,2903,327,2904,715,0
20141229.092125,2903,704,776142,376,2902,745,2903,46,0
20141229.092125,2902,130,776272,-4,2902,740,2903,87,0
20141229.092126,2903,2,776274,0,2902,740,2903,87,1
20141229.092126,2903,6,776280,-4,2902,741,2903,84,1
20141229.092127,2903,64,776344,-62,2902,741,2903,93,1
20141229.092127,2903,32,776376,-30,2902,533,2903,87,1
20141229.092128,2903,8,776384,-6,2902,526,2903,85,1
20141229.092128,2902,4,776388,-2,2902,525,2903,87,0
20141229.092129,2903,4,776392,0,2902,527,2903,94,1
20141229.09213,2902,48,776440,-4,2902,527,2903,78,0
20141229.09213,2903,6,776446,-2,2902,526,2903,78,1
20141229.092131,2902,4,776450,0,2902,526,2903,82,0
20141229.092132,2902,602,777052,244,2902,452,2903,91,0
20141229.092132,2902,8,777060,0,2902,447,2903,160,0
20141229.092133,2903,8,777068,0,2902,428,2903,176,1
20141229.092133,2903,4,777072,2,2902,427,2903,191,1
20141229.092134,2903,10,777082,-4,2902,427,2903,203,1
20141229.092136,2902,20,777102,0,2902,432,2903,333,0
20141229.092137,2902,14,777116,2,2902,425,2903,338,0
20141229.092137,2902,2,777118,2,2902,424,2903,404,0
20141229.092138,2902,6,777124,0,2902,636,2903,336,0
20141229.092138,2902,14,777138,-4,2902,629,2903,333,0
20141229.092139,2902,4,777142,2,2902,634,2903,347,0
20141229.092139,2903,6,777148,6,2902,634,2903,331,1
20141229.09214,2903,14,777162,8,2902,633,2903,325,1
20141229.092141,2902,112,777274,-80,2902,578,2903,332,0
20141229.092141,2903,414,777688,-26,2902,388,2903,326,1
20141229.092142,2902,24,777712,4,2902,408,2903,316,0
20141229.092142,2903,52,777764,-20,2902,408,2903,290,1
20141229.092143,2902,2,777766,2,2902,407,2903,295,0
20141229.092144,2903,18,777784,16,2902,412,2903,489,1
20141229.092146,2903,10,777794,0,2902,414,2903,508,1
20141229.092147,2902,70,777864,60,2902,381,2903,530,0
20141229.092148,2902,12,777876,12,2902,375,2903,530,0
20141229.092148,2902,76,777952,72,2902,340,2903,526,0
20141229.092149,2903,8,777960,6,2902,337,2903,526,1
20141229.09215,2902,26,777986,0,2902,375,2903,562,0
20141229.09215,2903,4,777990,-4,2902,375,2903,560,1
20141229.092151,2902,4,777994,2,2902,373,2903,560,0
20141229.092152,2903,42,778036,-16,2902,394,2903,603,1
20141229.092152,2903,10,778046,2,2902,395,2903,597,1
20141229.092153,2902,4,778050,2,2902,395,2903,596,0
20141229.092153,2902,2,778052,0,2902,394,2903,596,0
20141229.092154,2903,22,778074,-2,2902,405,2903,585,1
20141229.092154,2902,6,778080,-4,2902,404,2903,583,0
20141229.092155,2903,2,778082,-2,2902,427,2903,583,1
20141229.092156,2902,92,778174,-52,2902,393,2903,603,0
20141229.092157,2902,6,778180,6,2902,391,2903,591,0
20141229.092157,2902,40,778220,36,2902,379,2903,591,0
20141229.092157,2902,12,778232,8,2902,374,2903,590,0
20141229.092158,2902,4,778236,0,2902,393,2903,591,0
20141229.092159,2902,28,778264,-4,2902,409,2903,591,0
20141229.0922,2902,4,778268,4,2902,408,2903,591,0
20141229.0922,2902,604,778872,504,2902,108,2903,596,0
20141229.092201,2902,122,778994,10,2902,49,2903,631,0
20141229.092201,2902,86,779080,-2,2902,31,2903,632,0
20141229.092202,2902,2,779082,0,2902,127,2903,622,0
20141229.092202,2902,22,779104,2,2902,120,2903,622,0
20141229.092203,2903,8,779112,0,2902,119,2903,624,1
20141229.092204,2902,18,779130,0,2902,112,2903,616,0
20141229.092204,2902,10,779140,2,2902,111,2903,616,0
20141229.092205,2902,6,779146,6,2902,109,2903,617,0
20141229.092206,2902,62,779208,10,2902,99,2903,597,0
20141229.092207,2903,16,779224,-16,2902,106,2903,574,1
20141229.092207,2902,2,779226,2,2902,105,2903,574,0
20141229.092208,2903,10,779236,0,2902,109,2903,568,1
20141229.092209,2902,34,779270,0,2902,93,2903,571,0
20141229.092209,2902,6,779276,6,2902,95,2903,571,0
20141229.092209,2902,8,779284,2,2902,112,2903,576,0
20141229.09221,2902,2,779286,2,2902,111,2903,576,0
20141229.092211,2902,26,779312,22,2902,220,2903,576,0
20141229.092211,2902,4,779316,4,2902,226,2903,578,0
20141229.092212,2902,34,779350,0,2902,342,2903,582,0
20141229.092212,2902,2,779352,0,2902,348,2903,582,0
20141229.092213,2902,10,779362,10,2902,348,2903,582,0
20141229.092214,2903,1166,780528,-572,2903,2,2904,795,1
20141229.092215,2903,102,780630,-10,2902,450,2904,481,1
20141229.092215,2903,2,780632,0,2902,471,2904,481,1
20141229.092216,2903,2,780634,-2,2903,7,2904,478,1
20141229.092217,2903,18,780652,-2,2903,58,2904,501,1
20141229.092218,2903,42,780694,24,2903,178,2904,497,1
20141229.092219,2903,10,780704,6,2903,173,2904,497,1
20141229.09222,2903,40,780744,0,2903,159,2904,497,1
20141229.09222,2903,10,780754,0,2903,151,2904,530,1
20141229.092221,2903,10,780764,-4,2903,180,2904,529,1
20141229.092222,2903,26,780790,-20,2903,180,2904,523,1
20141229.092222,2903,30,780820,30,2903,167,2904,523,1
20141229.092223,2903,4,780824,4,2903,165,2904,523,1
20141229.092223,2903,20,780844,0,2903,156,2904,522,1
20141229.092224,2903,8,780852,2,2903,196,2904,544,1
20141229.092224,2903,2,780854,2,2903,238,2904,545,1
20141229.092225,2903,2,780856,0,2903,237,2904,545,1
20141229.092225,2903,52,780908,-4,2903,211,2904,545,1
20141229.092226,2903,2,780910,-2,2903,210,2904,545,1
20141229.092226,2903,12,780922,12,2903,204,2904,546,1
20141229.092227,2904,24,780946,-10,2903,204,2904,542,1
20141229.092228,2903,4,780950,2,2903,202,2904,542,0
20141229.092228,2903,6,780956,6,2903,199,2904,543,0
20141229.092229,2903,4,780960,4,2903,197,2904,550,0
20141229.092229,2903,2,780962,2,2903,196,2904,553,0
20141229.09223,2903,444,781406,-70,2902,693,2903,132,0
20141229.09223,2903,370,781776,-314,2903,178,2904,600,0
20141229.092231,2903,40,781816,-30,2903,227,2904,599,0
20141229.092232,2903,6,781822,-4,2903,234,2904,649,0
20141229.092233,2903,8,781830,-8,2903,202,2904,652,0
20141229.092233,2903,8,781838,-8,2903,198,2904,652,0
20141229.092233,2903,52,781890,-50,2903,173,2904,652,0
20141229.092234,2904,48,781938,10,2903,372,2904,639,1
20141229.092235,2903,86,782024,0,2903,333,2904,642,0
20141229.092236,2904,2,782026,2,2903,357,2904,637,1
20141229.092237,2904,18,782044,0,2903,367,2904,629,1
20141229.092237,2903,12,782056,0,2903,363,2904,623,0
20141229.09224,2904,10,782066,0,2903,370,2904,649,1
20141229.092241,2903,400,782466,366,2903,211,2904,661,0
20141229.092241,2904,80,782546,72,2903,213,2904,621,1
20141229.092242,2904,54,782600,20,2903,200,2904,611,1
20141229.092243,2904,2,782602,0,2903,202,2904,625,1
20141229.092244,2903,4,782606,4,2903,201,2904,654,0
20141229.092246,2903,10,782616,0,2903,237,2904,703,0
20141229.092247,2904,2,782618,0,2903,239,2904,702,1
20141229.092247,2904,20,782638,20,2903,242,2904,693,1
20141229.092248,2903,8,782646,8,2903,241,2904,692,0
20141229.092249,2903,10,782656,10,2903,236,2904,692,0
20141229.092249,2904,4,782660,4,2903,236,2904,701,1
20141229.09225,2904,10,782670,0,2903,236,2904,696,1
20141229.09225,2903,4,782674,4,2903,268,2904,696,0
20141229.092251,2904,4,782678,4,2903,289,2904,694,1
20141229.092251,2904,2,782680,2,2903,289,2904,693,1
20141229.092252,2904,18,782698,0,2903,289,2904,685,1
20141229.092252,2903,12,782710,2,2903,284,2904,684,0
20141229.092253,2903,4,782714,4,2903,283,2904,693,0
20141229.092253,2903,4,782718,2,2903,297,2904,693,0
20141229.092255,2903,4,782722,0,2903,330,2904,693,0
20141229.092256,2904,4,782726,0,2903,331,2904,693,1
20141229.092256,2903,2,782728,0,2903,330,2904,693,0
20141229.092258,2904,2,782730,2,2903,331,2904,693,1
20141229.092258,2903,44,782774,4,2903,312,2904,692,0
20141229.092259,2904,4,782778,2,2903,311,2904,691,1
20141229.092259,2904,6,782784,2,2903,311,2904,688,1
20141229.0923,2904,6,782790,0,2903,313,2904,685,1
20141229.092301,2904,48,782838,36,2903,317,2904,641,1
20141229.092302,2904,168,783006,126,2903,317,2904,559,1
20141229.092302,2903,4,783010,2,2903,324,2904,562,0
20141229.092303,2904,2,783012,0,2903,324,2904,563,1
20141229.092304,2904,4,783016,4,2903,363,2904,561,1
20141229.092305,2904,2,783018,2,2903,564,2904,563,1
20141229.092305,2904,552,783570,142,2903,564,2904,285,1
20141229.092306,2904,574,784144,6,2904,436,2905,1763,1
20141229.092308,2904,10,784154,-8,2904,639,2905,1645,1
20141229.092308,2905,2,784156,0,2904,642,2905,1644,1
20141229.092309,2905,28,784184,0,2904,642,2905,1630,1
20141229.092309,2905,2,784186,-2,2904,643,2905,1629,1
20141229.09231,2905,2402,786588,-26,2904,663,2905,427,1
20141229.092311,2905,852,787440,-276,2905,167,2906,809,1
20141229.092311,2906,118,787558,26,2905,155,2906,627,1
20141229.092311,2906,16,787574,0,2905,155,2906,619,1
20141229.092312,2905,4,787578,0,2905,154,2906,618,0
20141229.092313,2906,12,787590,4,2905,153,2906,606,1
20141229.092313,2905,6,787596,-4,2905,155,2906,603,0
20141229.092314,2905,2,787598,-2,2905,222,2906,586,0
20141229.092314,2905,728,788326,566,2904,667,2905,135,0
20141229.092315,2905,92,788418,44,2904,642,2905,111,0
20141229.092316,2905,22,788440,22,2904,644,2905,104,0
20141229.092317,2905,24,788464,20,2904,650,2905,98,0
20141229.092318,2904,44,788508,4,2904,634,2905,120,0
20141229.092319,2905,40,788548,-24,2904,641,2905,107,1
20141229.092319,2905,2,788550,0,2904,641,2905,156,1
20141229.09232,2905,14,788564,-2,2904,641,2905,151,1
20141229.09232,2905,4,788568,0,2904,652,2905,155,1
20141229.092321,2905,6,788574,0,2904,653,2905,153,1
20141229.092321,2904,2,788576,0,2904,642,2905,153,0
20141229.092322,2905,12,788588,-12,2904,723,2905,150,1
20141229.092322,2905,2,788590,0,2904,735,2905,153,1
20141229.092323,2904,14,788604,-2,2904,754,2905,149,0
20141229.092323,2904,10,788614,-10,2904,758,2905,146,0
20141229.092324,2905,26,788640,-2,2904,792,2905,145,1
20141229.092324,2905,10,788650,-8,2904,802,2905,141,1
20141229.092325,2905,24,788674,0,2904,802,2905,132,1
20141229.092325,2905,14,788688,-2,2904,823,2905,126,1
20141229.092326,2905,12,788700,6,2904,874,2905,123,1
20141229.092327,2905,68,788768,-56,2904,874,2905,88,1
20141229.092327,2905,34,788802,12,2904,876,2905,73,1
20141229.092328,2905,112,788914,96,2904,877,2905,20,1
20141229.092328,2905,290,789204,30,2905,6,2906,753,1
20141229.092329,2905,72,789276,-10,2905,11,2906,781,1
20141229.092329,2904,24,789300,-2,2904,890,2905,63,0
20141229.09233,2905,40,789340,-20,2904,865,2905,47,1
20141229.09233,2904,12,789352,-2,2904,863,2905,45,0
20141229.092331,2905,6,789358,-4,2904,895,2905,44,1
20141229.092332,2905,82,789440,4,2904,895,2905,56,1
20141229.092332,2905,82,789522,72,2904,894,2905,27,1
20141229.092333,2905,2,789524,2,2904,894,2905,26,1
20141229.092334,2905,10,789534,2,2904,908,2905,31,1
20141229.092335,2904,22,789556,0,2904,902,2905,34,0
20141229.092336,2905,88,789644,-44,2905,9,2906,889,1
20141229.092336,2905,122,789766,-12,2904,1060,2905,2,1
20141229.092337,2905,142,789908,124,2905,2,2906,778,1
20141229.092337,2905,58,789966,-18,2904,1009,2905,78,1
20141229.092338,2905,156,790122,0,2905,188,2906,720,1
20141229.092338,2905,4,790126,0,2905,184,2906,692,1
20141229.092339,2905,62,790188,14,2905,156,2906,692,1
20141229.092339,2906,4,790192,0,2905,159,2906,717,1
20141229.09234,2905,76,790268,4,2905,122,2906,716,0
20141229.09234,2906,6,790274,4,2905,121,2906,717,1
20141229.092341,2906,18,790292,4,2905,124,2906,699,1
20141229.092341,2905,118,790410,96,2905,123,2906,654,0
20141229.092342,2905,6,790416,0,2905,162,2906,674,0
20141229.092343,2906,30,790446,2,2905,196,2906,677,1
20141229.092344,2905,28,790474,10,2905,349,2906,606,0
20141229.092345,2906,186,790660,164,2905,390,2906,573,1
20141229.092345,2906,162,790822,130,2905,395,2906,494,1
20141229.092346,2905,84,790906,70,2905,393,2906,457,0
20141229.092346,2905,630,791536,-288,2905,82,2906,480,0
20141229.092347,2906,10,791546,-8,2905,143,2906,479,1
20141229.092347,2905,90,791636,-52,2905,137,2906,529,0
20141229.092348,2905,120,791756,88,2905,121,2906,471,0
20141229.092348,2905,2,791758,-2,2905,127,2906,471,0
20141229.092349,2905,16,791774,4,2905,179,2906,475,0
20141229.092349,2906,68,791842,-28,2905,140,2906,471,1
20141229.09235,2905,420,792262,100,2904,1030,2906,462,0
20141229.09235,2905,16,792278,8,2904,914,2905,153,0
20141229.092351,2905,26,792304,-4,2904,912,2905,144,0
20141229.092351,2905,6,792310,-6,2904,906,2905,174,0
20141229.092352,2905,24,792334,0,2904,971,2905,165,0
20141229.092353,2905,22,792356,-2,2904,971,2905,154,0
20141229.092353,2905,20,792376,0,2904,971,2905,149,0
20141229.092354,2905,14,792390,-10,2904,973,2905,143,0
20141229.092355,2904,2,792392,0,2904,973,2905,202,0
20141229.092355,2905,2,792394,0,2904,982,2905,201,1
20141229.092356,2904,34,792428,-4,2904,980,2905,187,0
20141229.092358,2905,2,792430,0,2904,1069,2905,157,1
20141229.092358,2905,20,792450,0,2904,1070,2905,147,1
20141229.092359,2905,298,792748,12,2905,454,2906,618,1
20141229.092359,2905,6,792754,2,2905,505,2906,466,1
20141229.0924,2905,10,792764,4,2905,600,2906,427,1
20141229.092401,2906,8,792772,-6,2905,685,2906,423,1
20141229.092402,2905,4,792776,2,2905,686,2906,425,0
20141229.092402,2905,20,792796,20,2905,628,2906,431,0
20141229.092403,2905,2,792798,2,2905,631,2906,434,0
20141229.092404,2906,2,792800,-2,2905,633,2906,579,1
20141229.092404,2905,20,792820,0,2905,582,2906,580,0
20141229.092405,2905,56,792876,32,2905,548,2906,568,0
20141229.092405,2905,6,792882,6,2905,587,2906,601,0
20141229.092406,2905,14,792896,12,2905,685,2906,597,0
20141229.092407,2905,10,792906,0,2905,689,2906,597,0
20141229.092407,2905,2,792908,0,2905,720,2906,597,0
20141229.092408,2905,10,792918,10,2905,715,2906,598,0
20141229.092408,2905,20,792938,0,2905,705,2906,599,0
20141229.092409,2905,2,792940,2,2905,704,2906,599,0
20141229.092409,2906,4,792944,0,2905,704,2906,620,1
20141229.09241,2905,2,792946,0,2905,703,2906,621,0
20141229.09241,2905,22,792968,-2,2905,693,2906,609,0
20141229.092411,2906,2,792970,0,2905,707,2906,608,1
20141229.092411,2906,598,793568,312,2905,716,2906,324,1
20141229.092412,2906,6,793574,2,2905,723,2906,321,1
20141229.092413,2905,2,793576,2,2905,801,2906,320,0
20141229.092415,2906,2,793578,0,2905,778,2906,487,1
20141229.092416,2905,2,793580,2,2905,769,2906,523,0
20141229.092416,2906,4,793584,0,2905,768,2906,521,1
20141229.092417,2906,24,793608,12,2905,766,2906,505,1
20141229.092418,2905,8,793616,0,2905,762,2906,522,0
20141229.092418,2906,2,793618,0,2905,762,2906,566,1
20141229.092419,2905,8,793626,2,2905,762,2906,699,0
20141229.092419,2905,6,793632,0,2905,786,2906,725,0
20141229.092421,2905,10,793642,2,2905,781,2906,685,0
20141229.092421,2905,4,793646,4,2905,779,2906,685,0
20141229.092421,2905,6,793652,0,2905,776,2906,682,0
20141229.092423,2905,6,793658,0,2905,846,2906,756,0
20141229.092423,2905,2,793660,2,2905,845,2906,755,0
20141229.092423,2905,6,793666,0,2905,847,2906,753,0
20141229.092424,2905,6,793672,0,2905,835,2906,811,0
20141229.092425,2906,14,793686,12,2905,830,2906,827,1
20141229.092426,2905,6,793692,0,2905,835,2906,850,0
20141229.092426,2905,6,793698,0,2905,832,2906,922,0
20141229.092427,2906,18,793716,4,2905,832,2906,918,1
20141229.092428,2905,6,793722,0,2905,829,2906,915,0
20141229.092428,2905,4,793726,0,2905,829,2906,917,0
20141229.092429,2905,4,793730,0,2905,827,2906,913,0
20141229.092429,2905,14,793744,0,2905,824,2906,913,0
20141229.09243,2905,8,793752,2,2905,866,2906,917,0
20141229.092431,2905,26,793778,0,2905,853,2906,914,0
20141229.092432,2905,2,793780,0,2905,853,2906,914,0
20141229.092432,2905,6,793786,0,2905,850,2906,1161,0
20141229.092433,2905,8,793794,0,2905,832,2906,1127,0
20141229.092434,2905,8,793802,0,2905,828,2906,1155,0
20141229.092435,2905,70,793872,24,2905,822,2906,1125,0
20141229.092436,2906,42,793914,18,2905,803,2906,1070,1
20141229.092436,2905,10,793924,0,2905,797,2906,1070,0
20141229.092436,2905,58,793982,40,2905,768,2906,1068,0
20141229.092437,2905,24,794006,0,2905,756,2906,1068,0
20141229.092437,2905,338,794344,0,2905,588,2906,1078,0
20141229.092438,2905,1174,795518,-238,2904,1120,2905,117,0
20141229.092439,2904,6,795524,-6,2904,837,2905,571,0
20141229.092439,2905,690,796214,100,2904,847,2905,237,1
20141229.09244,2904,6,796220,-6,2904,842,2905,245,0
20141229.09244,2905,2,796222,2,2904,841,2905,257,1
20141229.09244,2904,6,796228,-6,2904,838,2905,257,0
20141229.092441,2905,32,796260,0,2904,823,2905,264,1
20141229.092442,2905,20,796280,12,2904,821,2905,265,1
20141229.092442,2904,10,796290,-10,2904,816,2905,265,0
20141229.092443,2905,2,796292,0,2904,860,2905,265,1
20141229.092444,2904,2,796294,0,2904,859,2905,275,0
20141229.092445,2904,42,796336,-42,2904,841,2905,291,0
20141229.092446,2904,4,796340,2,2904,842,2905,291,0
20141229.092447,2905,10,796350,10,2904,843,2905,308,1
20141229.092447,2904,4,796354,-2,2904,795,2905,322,0
20141229.092448,2904,2,796356,-2,2904,793,2905,326,0
20141229.092448,2905,8,796364,4,2904,793,2905,325,1
20141229.092449,2905,2,796366,2,2904,783,2905,325,1
20141229.092449,2905,88,796454,88,2904,794,2905,282,1
20141229.092449,2905,2,796456,2,2904,794,2905,281,1
20141229.09245,2904,4,796460,-4,2904,802,2905,281,0
20141229.092452,2904,72,796532,-72,2904,792,2905,281,0
20141229.092452,2904,2,796534,-2,2904,872,2905,281,0
20141229.092453,2904,2,796536,0,2904,871,2905,281,0
20141229.092454,2904,24,796560,-22,2904,859,2905,292,0
20141229.092454,2904,2,796562,-2,2904,858,2905,294,0
20141229.092455,2904,24,796586,0,2904,847,2905,294,0
20141229.092456,2904,8,796594,-8,2904,846,2905,297,0
20141229.092457,2904,2,796596,-2,2904,845,2905,297,0
20141229.092458,2905,22,796618,-18,2904,855,2905,398,1
20141229.092459,2904,2,796620,0,2904,859,2905,399,0
20141229.0925,2904,266,796886,262,2904,854,2905,267,0
20141229.0925,2905,28,796914,16,2904,859,2905,254,1
20141229.0925,2905,308,797222,48,2905,51,2906,1081,1
20141229.092501,2905,218,797440,116,2905,54,2906,975,1
20141229.092502,2905,142,797582,-8,2905,12,2906,1073,1
20141229.092502,2904,90,797672,-6,2904,896,2905,6,0
20141229.092503,2905,20,797692,4,2905,48,2906,1094,1
20141229.092503,2905,66,797758,-38,2905,16,2906,977,1
20141229.092504,2905,22,797780,-22,2905,20,2906,986,1
20141229.092504,2904,56,797836,-16,2904,935,2905,5,0
20141229.092505,2905,8,797844,0,2904,935,2905,5,1
20141229.092505,2904,6,797850,0,2904,933,2905,6,0
20141229.092506,2904,22,797872,-20,2904,912,2905,24,0
20141229.092507,2905,12,797884,2,2904,909,2905,18,1
20141229.092508,2904,2,797886,0,2904,908,2905,28,0
20141229.092508,2905,58,797944,-52,2905,129,2906,979,1
20141229.092508,2905,8,797952,-4,2905,142,2906,977,1
20141229.092509,2905,30,797982,-4,2905,130,2906,961,1
20141229.092509,2905,4,797986,-4,2905,128,2906,960,1
20141229.092511,2905,10,797996,-6,2905,124,2906,947,1
20141229.092511,2905,270,798266,-178,2904,927,2905,54,1
20141229.092512,2905,2,798268,2,2904,928,2905,58,1
20141229.092513,2904,18,798286,-10,2904,922,2905,56,0
20141229.092513,2906,192,798478,-72,2905,49,2906,932,1
20141229.092514,2905,6,798484,-6,2905,181,2906,933,0
20141229.092515,2905,6,798490,-6,2905,204,2906,938,0
20141229.092516,2906,42,798532,2,2905,213,2906,933,1
20141229.092516,2905,66,798598,8,2905,195,2906,926,0
20141229.092517,2905,2,798600,0,2905,194,2906,926,0
20141229.092517,2905,8,798608,8,2905,190,2906,926,0
20141229.092518,2905,4,798612,0,2905,189,2906,926,0
20141229.092518,2905,6,798618,0,2905,187,2906,920,0
20141229.092519,2905,2,798620,2,2905,273,2906,921,0
20141229.09252,2905,36,798656,20,2905,299,2906,900,0
20141229.09252,2905,6,798662,0,2905,296,2906,891,0
20141229.092521,2906,66,798728,0,2905,296,2906,861,1
20141229.092521,2905,8,798736,2,2905,292,2906,848,0
20141229.092522,2905,10,798746,4,2905,291,2906,876,0
20141229.092523,2905,2,798748,2,2905,290,2906,877,0
20141229.092523,2905,10,798758,4,2905,317,2906,849,0
20141229.092524,2905,2,798760,2,2905,316,2906,848,0
20141229.092524,2905,8,798768,0,2905,375,2906,838,0
20141229.092525,2905,24,798792,24,2905,364,2906,836,0
20141229.092525,2905,10,798802,2,2905,359,2906,834,0
20141229.092526,2905,6,798808,0,2905,366,2906,832,0
20141229.092527,2905,6,798814,0,2905,365,2906,821,0
20141229.092528,2905,20,798834,0,2905,356,2906,797,0
20141229.092528,2906,18,798852,-2,2905,352,2906,786,1
20141229.092529,2905,8,798860,2,2905,383,2906,796,0
20141229.09253,2905,2,798862,2,2905,383,2906,796,0
20141229.09253,2905,6,798868,0,2905,398,2906,797,0
20141229.092531,2905,6,798874,0,2905,395,2906,795,0
20141229.092533,2905,6,798880,0,2905,392,2906,798,0
20141229.092534,2905,26,798906,20,2905,379,2906,798,0
20141229.092535,2905,28,798934,2,2905,375,2906,799,0
20141229.092536,2906,4,798938,0,2905,418,2906,808,1
20141229.092536,2905,2,798940,0,2905,417,2906,810,0
20141229.092537,2905,8,798948,2,2905,413,2906,806,0
20141229.092537,2905,4,798952,0,2905,411,2906,804,0
20141229.092538,2905,2,798954,0,2905,407,2906,802,0
20141229.092538,2905,8,798962,0,2905,402,2906,803,0
20141229.09254,2906,4,798966,-4,2905,438,2906,801,1
20141229.09254,2906,32,798998,26,2905,423,2906,840,1
20141229.092541,2905,2,799000,0,2905,423,2906,960,0
20141229.092541,2905,338,799338,198,2905,112,2906,981,0
20141229.092542,2905,228,799566,-36,2904,928,2905,202,0
20141229.092542,2905,68,799634,-48,2904,929,2905,162,0
20141229.092543,2904,114,799748,106,2904,928,2905,107,0
20141229.092543,2904,10,799758,0,2904,907,2905,251,0
20141229.092546,2904,2,799760,-2,2904,905,2905,324,0
20141229.092546,2904,40,799800,-4,2904,888,2905,321,0
20141229.092547,2904,6,799806,-6,2904,940,2905,435,0
20141229.092548,2905,24,799830,12,2904,937,2905,423,1
20141229.092549,2905,4,799834,4,2904,937,2905,441,1
20141229.09255,2904,8,799842,-6,2904,933,2905,438,0
20141229.09255,2904,2,799844,0,2904,932,2905,439,0
20141229.092551,2905,12,799856,-4,2904,928,2905,437,1
20141229.092551,2904,12,799868,0,2904,927,2905,472,0
20141229.092552,2905,40,799908,40,2904,927,2905,456,1
20141229.092553,2905,14,799922,6,2904,966,2905,441,1
20141229.092553,2905,12,799934,2,2904,963,2905,434,1
20141229.092554,2905,50,799984,0,2904,962,2905,412,1
20141229.092554,2905,4,799988,4,2904,962,2905,410,1
20141229.092555,2905,22,800010,22,2904,963,2905,397,1
20141229.092556,2905,2,800012,2,2904,963,2905,407,1
20141229.092556,2905,10,800022,8,2904,962,2905,403,1
20141229.092557,2905,114,800136,12,2904,905,2905,351,1
20141229.092558,2904,34,800170,-2,2904,904,2905,331,0
20141229.092558,2905,4,800174,-4,2904,903,2905,333,1
20141229.0926,2905,110,800284,0,2904,903,2905,318,1
20141229.0926,2905,6,800290,0,2904,904,2905,383,1
20141229.092601,2904,2,800292,0,2904,904,2905,383,0
20141229.092601,2904,2,800294,-2,2904,903,2905,384,0
20141229.092604,2904,2,800296,-2,2904,912,2905,428,0
20141229.092604,2904,4,800300,-4,2904,912,2905,427,0
20141229.092605,2904,2,800302,-2,2904,965,2905,429,0
20141229.092606,2904,6,800308,-6,2904,962,2905,469,0
20141229.092606,2905,2,800310,0,2904,964,2905,468,1
20141229.092607,2904,12,800322,-6,2904,953,2905,465,0
20141229.092607,2904,4,800326,-4,2904,952,2905,475,0
20141229.092608,2904,2,800328,0,2904,953,2905,475,0
20141229.092608,2904,2,800330,-2,2904,952,2905,508,0
20141229.092613,2904,2,800332,0,2904,951,2905,550,0
20141229.092613,2905,2,800334,0,2904,951,2905,553,1
20141229.092615,2904,52,800386,4,2904,946,2905,532,0
20141229.092617,2905,2,800388,0,2904,964,2905,509,1
20141229.092618,2904,10,800398,0,2904,959,2905,536,0
20141229.092619,2904,6,800404,-6,2904,956,2905,537,0
20141229.09262,2904,4,800408,-2,2904,953,2905,531,0
20141229.09262,2904,2,800410,-2,2904,952,2905,532,0
20141229.092622,2904,2,800412,-2,2904,952,2905,688,0
20141229.092622,2904,2,800414,-2,2904,951,2905,728,0
20141229.092623,2904,2,800416,-2,2904,950,2905,726,0
20141229.092623,2904,6,800422,-6,2904,948,2905,754,0
20141229.092624,2904,4,800426,-4,2904,946,2905,753,0
20141229.092624,2904,4,800430,-4,2904,934,2905,752,0
20141229.092625,2904,6,800436,-6,2904,931,2905,849,0
20141229.092626,2904,12,800448,-12,2904,925,2905,849,0
20141229.092626,2904,20,800468,-10,2904,915,2905,846,0
20141229.092627,2904,106,800574,24,2904,862,2905,850,0
20141229.092627,2904,24,800598,0,2904,843,2905,857,0
20141229.092628,2904,2,800600,2,2904,843,2905,859,0
20141229.092629,2904,2,800602,0,2904,842,2905,909,0
20141229.092629,2904,2,800604,0,2904,841,2905,909,0
20141229.09263,2904,2,800606,2,2904,840,2905,909,0
20141229.092631,2905,2,800608,2,2904,840,2905,908,1
20141229.092632,2904,6,800614,6,2904,838,2905,908,0
20141229.092632,2904,16,800630,0,2904,830,2905,911,0
20141229.092632,2904,2,800632,2,2904,829,2905,913,0
20141229.092633,2904,6,800638,4,2904,828,2905,913,0
20141229.092634,2904,2,800640,2,2904,827,2905,913,0
20141229.092634,2904,82,800722,70,2904,791,2905,909,0
20141229.092635,2904,6,800728,0,2904,788,2905,910,0
20141229.092635,2904,506,801234,440,2904,535,2905,911,0
20141229.092636,2904,4,801238,0,2904,532,2905,911,0
20141229.092636,2904,1064,802302,336,2903,656,2904,15,0
20141229.092637,2904,66,802368,60,2903,590,2904,78,0
20141229.092639,2904,2,802370,0,2903,596,2904,79,0
20141229.092639,2903,2,802372,2,2903,595,2904,171,0
20141229.09264,2904,2,802374,0,2903,595,2904,171,1
20141229.092641,2904,2,802376,2,2903,595,2904,178,1
20141229.092642,2903,12,802388,12,2903,589,2904,253,0
20141229.092642,2903,6,802394,0,2903,586,2904,292,0
20141229.092643,2903,4,802398,0,2903,676,2904,295,0
20141229.092645,2903,22,802420,22,2903,663,2904,326,0
20141229.092645,2904,2,802422,2,2903,663,2904,325,1
20141229.092646,2903,4,802426,2,2903,662,2904,416,0
20141229.092647,2903,2,802428,2,2903,662,2904,417,0
20141229.092649,2903,20,802448,0,2903,606,2904,499,0
20141229.09265,2903,4,802452,2,2903,605,2904,478,0
20141229.09265,2903,2,802454,0,2903,604,2904,478,0
20141229.092651,2903,2,802456,0,2903,604,2904,494,0
20141229.092652,2904,32,802488,16,2903,604,2904,478,1
20141229.092652,2903,400,802888,92,2903,404,2904,478,0
20141229.092654,2903,2,802890,-2,2903,396,2904,487,0
20141229.092654,2904,8,802898,0,2903,417,2904,483,1
20141229.092655,2903,8,802906,0,2903,393,2904,488,0
20141229.092655,2903,2,802908,-2,2903,392,2904,482,0
20141229.092656,2903,14,802922,-8,2903,418,2904,488,0
20141229.092656,2904,2,802924,2,2903,418,2904,487,1
20141229.092656,2903,2,802926,0,2903,417,2904,488,0
20141229.092657,2903,66,802992,8,2903,398,2904,485,0
20141229.092658,2903,4,802996,-4,2903,406,2904,486,0
20141229.0927,2903,2,802998,0,2903,405,2904,491,0
20141229.0927,2904,4,803002,2,2903,405,2904,489,1
20141229.092701,2903,16,803018,-2,2903,411,2904,488,0
20141229.092702,2903,16,803034,-6,2903,410,2904,514,0
20141229.092704,2903,32,803066,2,2903,446,2904,517,0
20141229.092704,2903,20,803086,-4,2903,436,2904,516,0
20141229.092705,2904,4,803090,0,2903,466,2904,516,1
20141229.092706,2904,2,803092,0,2903,471,2904,537,1
20141229.092706,2903,22,803114,-16,2903,471,2904,529,0
20141229.092707,2904,20,803134,4,2903,469,2904,521,1
20141229.092708,2903,2,803136,0,2903,468,2904,572,0
20141229.092708,2904,6,803142,0,2903,466,2904,581,1
20141229.092709,2903,186,803328,122,2903,373,2904,591,0
20141229.092709,2903,6,803334,-6,2903,371,2904,590,0
20141229.09271,2903,2,803336,2,2903,364,2904,599,0
20141229.09271,2903,2,803338,0,2903,363,2904,597,0
20141229.092711,2903,6,803344,-2,2903,360,2904,594,0
20141229.092713,2904,32,803376,-20,2903,345,2904,597,1
20141229.092713,2903,4,803380,-2,2903,343,2904,582,0
20141229.092714,2903,22,803402,-18,2903,333,2904,595,0
20141229.092714,2903,64,803466,26,2903,302,2904,594,0
20141229.092715,2903,8,803474,-8,2903,351,2904,597,0
20141229.092715,2903,22,803496,-20,2903,341,2904,611,0
20141229.092716,2903,22,803518,-20,2903,331,2904,617,0
20141229.092716,2903,10,803528,-10,2903,336,2904,614,0
20141229.092717,2903,2,803530,0,2903,336,2904,598,0
20141229.092718,2903,6,803536,-6,2903,334,2904,626,0
20141229.092719,2903,2,803538,-2,2903,335,2904,676,0
20141229.092719,2903,6,803544,0,2903,368,2904,674,0
20141229.09272,2904,12,803556,-6,2903,364,2904,664,1
20141229.09272,2903,20,803576,-6,2903,355,2904,672,0
20141229.092721,2903,6,803582,-6,2903,352,2904,669,0
20141229.092721,2903,2,803584,0,2903,351,2904,673,0
20141229.092721,2904,16,803600,-12,2903,351,2904,673,1
20141229.092722,2904,30,803630,6,2903,347,2904,652,1
20141229.092723,2903,56,803686,-56,2903,319,2904,659,0
20141229.092724,2903,6,803692,-6,2903,339,2904,654,0
20141229.092724,2903,2,803694,0,2903,338,2904,660,0
20141229.092725,2903,6,803700,-6,2903,336,2904,651,0
20141229.092726,2904,38,803738,-4,2903,318,2904,657,1
20141229.092726,2904,4,803742,2,2903,317,2904,655,1
20141229.092727,2903,22,803764,-6,2903,307,2904,651,0
20141229.092727,2904,2,803766,2,2903,357,2904,603,1
20141229.092728,2903,10,803776,-10,2903,353,2904,607,0
20141229.092729,2903,14,803790,-6,2903,347,2904,604,0
20141229.092729,2903,2,803792,0,2903,346,2904,579,0
20141229.09273,2903,20,803812,2,2903,336,2904,577,0
20141229.092731,2903,76,803888,-26,2903,298,2904,587,0
20141229.092731,2904,12,803900,0,2903,299,2904,581,1
20141229.092732,2903,6,803906,-6,2903,296,2904,592,0
20141229.092733,2903,6,803912,-2,2903,293,2904,592,0
20141229.092734,2903,6,803918,0,2903,290,2904,592,0
20141229.092734,2903,62,803980,12,2903,264,2904,592,0
20141229.092735,2903,6,803986,-6,2903,261,2904,593,0
20141229.092735,2903,2,803988,-2,2903,260,2904,592,0
20141229.092736,2903,10,803998,-10,2903,255,2904,601,0
20141229.092736,2903,82,804080,40,2903,215,2904,602,0
20141229.092737,2904,130,804210,-48,2903,168,2904,577,1
20141229.092737,2903,18,804228,14,2903,167,2904,568,0
20141229.092737,2903,142,804370,-78,2903,96,2904,499,0
20141229.092738,2903,8,804378,-6,2903,93,2904,504,0
20141229.092738,2903,26,804404,0,2903,159,2904,509,0
20141229.092739,2903,34,804438,-26,2903,142,2904,509,0
20141229.092739,2903,4,804442,0,2903,175,2904,459,0
20141229.09274,2903,6,804448,-4,2903,172,2904,459,0
20141229.092741,2903,8,804456,-8,2903,168,2904,467,0
20141229.092741,2903,4,804460,0,2903,369,2904,460,0
20141229.092742,2903,6,804466,-6,2903,368,2904,480,0
20141229.092742,2903,96,804562,-80,2903,371,2904,481,0
20141229.092743,2903,6,804568,-6,2903,369,2904,504,0
20141229.092743,2903,42,804610,-2,2903,348,2904,504,0
20141229.092744,2903,852,805462,-308,2903,372,2904,84,0
20141229.092745,2904,194,805656,-40,2904,249,2905,810,1
20141229.092745,2904,4,805660,-4,2904,247,2905,802,1
20141229.092746,2904,30,805690,-8,2904,234,2905,784,1
20141229.092746,2904,2,805692,-2,2904,233,2905,783,1
20141229.092747,2904,10,805702,-6,2904,230,2905,782,1
20141229.092748,2904,4,805706,-4,2904,228,2905,780,1
20141229.092748,2904,36,805742,-16,2904,210,2905,784,1
20141229.092749,2904,14,805756,-8,2904,154,2905,791,1
20141229.09275,2904,6,805762,-6,2904,153,2905,788,1
20141229.092751,2904,46,805808,14,2904,138,2905,781,1
20141229.092752,2904,140,805948,-78,2904,69,2905,789,1
20141229.092752,2905,86,806034,4,2904,48,2905,787,1
20141229.092753,2904,70,806104,-4,2904,13,2905,734,0
20141229.092753,2904,28,806132,-26,2903,345,2904,102,0
20141229.092754,2903,6,806138,-6,2903,342,2904,150,0
20141229.092754,2904,4,806142,0,2903,341,2904,149,1
20141229.092755,2903,2,806144,-2,2903,340,2904,150,0
20141229.092756,2904,4,806148,0,2903,357,2904,161,1
20141229.092757,2904,2,806150,2,2903,357,2904,163,1
20141229.092757,2904,2,806152,0,2903,357,2904,162,1
20141229.092759,2903,8,806160,8,2903,413,2904,164,0
20141229.0928,2904,4,806164,4,2903,417,2904,166,1
20141229.092801,2904,8,806172,8,2903,418,2904,163,1
20141229.092802,2903,60,806232,-56,2903,388,2904,165,0
20141229.092803,2903,8,806240,0,2903,386,2904,165,0
20141229.092805,2904,2,806242,0,2903,392,2904,204,1
20141229.092807,2903,6,806248,-6,2903,395,2904,204,0
20141229.092807,2904,2,806250,2,2903,395,2904,204,1
20141229.092808,2903,2,806252,0,2903,394,2904,205,0
20141229.092809,2903,10,806262,0,2903,393,2904,276,0
20141229.092809,2904,78,806340,-4,2903,355,2904,279,1
20141229.09281,2903,44,806384,-36,2903,831,2904,275,0
20141229.092811,2903,2,806386,-2,2903,829,2904,274,0
20141229.092811,2904,4,806390,-2,2903,829,2904,283,1
20141229.092812,2903,6,806396,4,2903,828,2904,281,0
20141229.092812,2903,8,806404,0,2903,824,2904,280,0
20141229.092813,2903,2,806406,-2,2903,824,2904,280,0
20141229.092814,2903,4,806410,-2,2903,826,2904,285,0
20141229.092818,2904,2,806412,2,2903,867,2904,287,1
20141229.092819,2904,12,806424,8,2903,866,2904,303,1
20141229.09282,2904,54,806478,54,2903,867,2904,276,1
20141229.092821,2903,2,806480,0,2903,865,2904,277,0
20141229.092822,2903,10,806490,0,2903,860,2904,277,0
20141229.092823,2903,14,806504,-12,2903,873,2904,279,0
20141229.092823,2904,4,806508,4,2903,983,2904,277,1
20141229.092826,2903,46,806554,34,2903,966,2904,264,0
20141229.092827,2903,4,806558,0,2903,965,2904,264,0
20141229.092828,2903,4,806562,-4,2903,978,2904,264,0
20141229.092831,2903,8,806570,0,2903,971,2904,250,0
20141229.092831,2904,2,806572,2,2903,971,2904,249,1
20141229.092832,2903,10,806582,2,2903,966,2904,259,0
20141229.092832,2904,14,806596,-10,2903,960,2904,257,1
20141229.092833,2904,6,806602,2,2903,960,2904,264,1
20141229.092834,2903,8,806610,0,2903,956,2904,284,0
20141229.092834,2903,2,806612,-2,2903,956,2904,294,0
20141229.092835,2903,6,806618,2,2903,954,2904,304,0
20141229.092837,2903,20,806638,10,2903,951,2904,309,0
20141229.092837,2904,2,806640,0,2903,950,2904,311,1
20141229.092838,2903,2,806642,0,2903,954,2904,311,0
20141229.092838,2903,6,806648,4,2903,953,2904,309,0
20141229.092839,2904,2,806650,2,2903,953,2904,307,1
20141229.092839,2904,2,806652,2,2903,953,2904,306,1
20141229.09284,2904,2,806654,2,2903,953,2904,305,1
20141229.092843,2904,2,806656,2,2903,924,2904,305,1
20141229.092844,2904,56,806712,-36,2903,905,2904,295,1
20141229.092844,2904,2,806714,0,2903,907,2904,294,1
20141229.092848,2903,2,806716,0,2903,886,2904,294,0
20141229.092848,2904,18,806734,0,2903,882,2904,289,1
20141229.092849,2904,10,806744,-10,2903,882,2904,303,1
20141229.09285,2903,8,806752,-2,2903,881,2904,299,0
20141229.092851,2904,6,806758,-6,2903,879,2904,299,1
20141229.092851,2903,2,806760,-2,2903,883,2904,299,0
20141229.092852,2904,350,807110,64,2903,830,2904,122,1
20141229.092853,2904,10,807120,0,2903,825,2904,143,1
20141229.092854,2904,86,807206,-32,2903,840,2904,103,1
20141229.092855,2904,4,807210,4,2903,833,2904,101,1
20141229.092857,2904,2,807212,0,2903,838,2904,105,1
20141229.092858,2903,54,807266,-36,2903,818,2904,108,0
20141229.092859,2904,12,807278,10,2903,818,2904,102,1
20141229.0929,2904,10,807288,-6,2903,821,2904,91,1
20141229.0929,2904,8,807296,0,2903,821,2904,88,1
20141229.092901,2904,176,807472,-128,2904,314,2905,963,1
20141229.092901,2904,66,807538,-4,2904,337,2905,853,1
20141229.092902,2904,4,807542,-4,2904,335,2905,853,1
20141229.092902,2904,2,807544,-2,2904,334,2905,853,1
20141229.092904,2904,6,807550,-6,2904,332,2905,852,1
20141229.092904,2904,4,807554,-4,2904,328,2905,852,1
20141229.092905,2904,12,807566,-4,2904,327,2905,848,1
20141229.092906,2904,8,807574,-6,2904,327,2905,849,1
20141229.092907,2904,6,807580,-6,2904,324,2905,849,1
20141229.092908,2904,10,807590,-6,2904,321,2905,849,1
20141229.092908,2904,6,807596,-6,2904,318,2905,849,1
20141229.092909,2904,6,807602,-6,2904,315,2905,850,1
20141229.09291,2904,4,807606,-2,2904,315,2905,850,1
20141229.092911,2904,6,807612,-6,2904,308,2905,850,1
20141229.092911,2905,4,807616,4,2904,308,2905,848,1
20141229.092911,2905,20,807636,18,2904,307,2905,840,1
20141229.092912,2904,14,807650,-6,2904,304,2905,836,0
20141229.092913,2904,2,807652,0,2904,318,2905,836,0
20141229.092914,2904,10,807662,-10,2904,315,2905,836,0
20141229.092914,2904,8,807670,-6,2904,311,2905,836,0
20141229.092915,2904,20,807690,0,2904,307,2905,836,0
20141229.092916,2904,6,807696,-6,2904,334,2905,836,0
20141229.092917,2904,2,807698,-2,2904,333,2905,836,0
20141229.092917,2904,10,807708,0,2904,328,2905,836,0
20141229.092918,2904,6,807714,-6,2904,325,2905,836,0
20141229.09292,2904,14,807728,2,2904,323,2905,832,0
20141229.092921,2904,36,807764,-16,2904,310,2905,828,0
20141229.092922,2904,196,807960,-104,2904,308,2905,734,0
20141229.092923,2904,46,808006,-6,2904,313,2905,715,0
20141229.092924,2904,10,808016,-10,2904,323,2905,716,0
20141229.092925,2904,8,808024,-4,2904,338,2905,817,0
20141229.092925,2905,12,808036,10,2904,337,2905,814,1
20141229.092926,2904,6,808042,-6,2904,334,2905,815,0
20141229.092927,2904,10,808052,-10,2904,330,2905,815,0
20141229.092928,2904,6,808058,-6,2904,327,2905,815,0
20141229.092929,2904,6,808064,-6,2904,324,2905,815,0
20141229.09293,2905,26,808090,14,2904,324,2905,805,1
20141229.092931,2904,6,808096,-6,2904,336,2905,808,0
20141229.092932,2904,8,808104,-4,2904,333,2905,817,0
20141229.092933,2904,8,808112,-6,2904,329,2905,817,0
20141229.092934,2904,12,808124,-4,2904,326,2905,815,0
20141229.092935,2904,6,808130,-6,2904,325,2905,819,0
20141229.092936,2904,6,808136,-6,2904,322,2905,819,0
20141229.092936,2905,8,808144,0,2904,322,2905,815,1
20141229.092937,2904,6,808150,-6,2904,319,2905,806,0
20141229.092938,2904,42,808192,-42,2904,299,2905,810,0
20141229.092939,2904,6,808198,-4,2904,296,2905,785,0
20141229.09294,2904,6,808204,-4,2904,293,2905,791,0
20141229.092941,2904,28,808232,-6,2904,282,2905,509,0
20141229.092942,2905,60,808292,-16,2904,279,2905,484,1
20141229.092943,2904,6,808298,-6,2904,280,2905,493,0
20141229.092944,2904,6,808304,-6,2904,277,2905,487,0
20141229.092945,2904,4,808308,-2,2904,275,2905,487,0
20141229.092945,2904,6,808314,-6,2904,272,2905,487,0
20141229.092946,2905,18,808332,0,2904,270,2905,481,1
20141229.092946,2904,6,808338,-6,2904,269,2905,501,0
20141229.092947,2904,6,808344,-6,2904,272,2905,501,0
20141229.092948,2904,6,808350,-6,2904,269,2905,501,0
20141229.092949,2904,6,808356,-6,2904,286,2905,512,0
20141229.09295,2904,4,808360,-4,2904,284,2905,530,0
20141229.09295,2904,2,808362,-2,2904,283,2905,512,0
20141229.092951,2904,2,808364,-2,2904,283,2905,513,0
20141229.092955,2905,8,808372,0,2904,281,2905,505,1
20141229.092955,2905,2,808374,0,2904,281,2905,504,1
20141229.092956,2905,16,808390,0,2904,281,2905,506,1
20141229.092956,2905,20,808410,0,2904,281,2905,495,1
20141229.092957,2905,4,808414,0,2904,281,2905,494,1
20141229.092958,2905,6,808420,0,2904,283,2905,493,1
20141229.092958,2905,42,808462,2,2904,300,2905,472,1
20141229.092959,2905,4,808466,0,2904,283,2905,471,1
20141229.093,2905,2,808468,2,2904,283,2905,470,1
20141229.093,2905,868,809336,500,2904,293,2905,38,1
20141229.093001,2906,408,809744,184,2905,105,2906,995,1
20141229.093001,2906,80,809824,-12,2905,237,2906,963,1
20141229.093002,2906,72,809896,0,2905,246,2906,930,1
20141229.093002,2906,10,809906,-2,2905,291,2906,911,1
20141229.093003,2905,8,809914,0,2905,375,2906,910,0
20141229.093003,2905,1014,810928,4,2905,242,2906,603,0
20141229.093004,2906,8,810936,0,2905,259,2906,603,1
20141229.093005,2906,1274,812210,454,2906,15,2907,522,1
20141229.093005,2907,58,812268,0,2906,8,2907,500,1
20141229.093006,2906,16,812284,4,2906,8,2907,493,0
20141229.093007,2906,238,812522,-112,2906,63,2907,501,0
20141229.093008,2906,8,812530,2,2906,113,2907,491,0
20141229.093009,2907,14,812544,14,2906,58,2907,484,1
20141229.093009,2907,30,812574,20,2906,56,2907,483,1
20141229.09301,2907,6,812580,4,2906,55,2907,481,1
20141229.09301,2907,26,812606,-2,2906,55,2907,473,1
20141229.093011,2906,20,812626,14,2906,56,2907,477,0
20141229.093011,2907,2,812628,2,2906,56,2907,472,1
20141229.093012,2906,12,812640,2,2906,56,2907,472,0
20141229.093012,2906,126,812766,-6,2905,521,2906,39,0
20141229.093012,2906,10,812776,-10,2905,581,2906,35,0
20141229.093013,2906,78,812854,-68,2906,48,2907,568,0
20141229.093014,2906,4,812858,2,2906,49,2907,568,0
20141229.093014,2906,170,813028,168,2905,469,2906,330,0
20141229.093015,2906,4,813032,4,2905,446,2906,329,0
20141229.093015,2906,114,813146,80,2905,438,2906,281,0
20141229.093016,2906,6,813152,6,2905,3440,2906,278,0
20141229.093016,2906,582,813734,552,2906,17,2907,545,0
20141229.093017,2907,14,813748,0,2906,15,2907,543,1
20141229.093017,2906,8,813756,2,2906,96,2907,544,0
20141229.093018,2906,6,813762,2,2906,121,2907,545,0
20141229.093018,2907,52,813814,-20,2906,164,2907,521,1
20141229.093019,2906,14,813828,0,2906,167,2907,515,0
20141229.093019,2907,40,813868,0,2906,151,2907,500,1
20141229.09302,2906,78,813946,-10,2906,148,2907,465,0
20141229.09302,2906,30,813976,-4,2906,147,2907,452,0
20141229.093021,2906,56,814032,50,2906,122,2907,451,0
20141229.093022,2906,12,814044,0,2906,116,2907,563,0
20141229.093022,2906,262,814306,-22,2905,5462,2906,59,0
20141229.093023,2906,32,814338,12,2905,5460,2906,97,0
20141229.093024,2906,28,814366,14,2905,5457,2906,89,0
20141229.093024,2906,2,814368,0,2905,5457,2906,88,0
20141229.093025,2905,6,814374,-6,2905,5454,2906,91,0
20141229.093025,2906,4,814378,0,2905,5454,2906,92,1
20141229.093026,2906,48,814426,36,2905,5451,2906,71,1
20141229.093027,2905,6,814432,0,2905,5449,2906,77,0
20141229.093028,2906,62,814494,10,2905,5440,2906,83,1
20141229.093028,2905,224,814718,34,2905,5443,2906,32,0
20141229.093029,2906,132,814850,-8,2906,49,2907,680,1
20141229.093029,2905,112,814962,8,2905,428,2906,41,0
20141229.09303,2906,66,815028,40,2905,400,2906,684,1
20141229.09303,2905,6,815034,0,2905,1444,2906,745,0
20141229.093031,2906,4,815038,4,2905,4452,2906,743,1
20141229.093032,2905,6,815044,0,2905,5447,2906,636,0
20141229.093032,2905,6,815050,0,2905,5445,2906,636,0
20141229.093033,2906,200,815250,2,2905,5445,2906,537,1
20141229.093033,2905,134,815384,-28,2905,5442,2906,488,0
20141229.093034,2906,4,815388,0,2905,5442,2906,501,1
20141229.093035,2905,6,815394,0,2905,5439,2906,502,0
20141229.093035,2906,6,815400,0,2905,5438,2906,512,1
20141229.093036,2906,8,815408,0,2905,5435,2906,512,1
20141229.093037,2906,152,815560,28,2906,1002,2907,780,1
20141229.093038,2906,6,815566,-6,2906,1001,2907,619,1
20141229.093038,2906,16,815582,-16,2906,993,2907,619,1
20141229.093039,2906,8,815590,-6,2906,1000,2907,618,1
20141229.093039,2906,2,815592,0,2906,999,2907,618,1
20141229.09304,2906,16,815608,-14,2906,993,2907,618,1
20141229.09304,2906,10,815618,-2,2906,988,2907,618,1
20141229.093041,2906,12,815630,-6,2906,986,2907,620,1
20141229.093041,2906,6,815636,-6,2906,983,2907,620,1
20141229.093042,2907,18,815654,-12,2906,977,2907,617,1
20141229.093043,2906,206,815860,-6,2906,878,2907,617,0
20141229.093043,2906,6,815866,-6,2906,875,2907,635,0
20141229.093045,2906,8,815874,-6,2906,871,2907,696,0
20141229.093045,2907,44,815918,-2,2906,850,2907,695,1
20141229.093045,2906,26,815944,-6,2906,847,2907,690,0
20141229.093046,2906,4,815948,0,2906,845,2907,691,0
20141229.093047,2907,8,815956,-6,2906,842,2907,690,1
20141229.093047,2906,32,815988,8,2906,839,2907,680,0
20141229.093048,2907,42,816030,-10,2906,852,2907,659,1
20141229.093049,2906,8,816038,-8,2906,848,2907,651,0
20141229.093049,2906,62,816100,0,2906,817,2907,651,0
20141229.09305,2907,44,816144,-32,2906,813,2907,634,1
20141229.093051,2907,8,816152,-6,2906,810,2907,634,1
20141229.093051,2907,44,816196,-10,2906,811,2907,624,1
20141229.093052,2906,8,816204,-8,2906,807,2907,623,0
20141229.093053,2906,6,816210,-6,2906,1010,2907,626,0
20141229.093053,2906,24,816234,0,2906,1008,2907,616,0
20141229.093054,2906,8,816242,-6,2906,1004,2907,616,0
20141229.093054,2906,10,816252,0,2906,1000,2907,616,0
20141229.093055,2907,8,816260,-8,2906,997,2907,615,1
20141229.093056,2907,18,816278,-12,2906,1036,2907,609,1
20141229.093057,2906,10,816288,-8,2906,1032,2907,610,0
20141229.093057,2906,2,816290,-2,2906,1034,2907,610,0
20141229.093058,2907,34,816324,16,2906,1132,2907,597,1
20141229.093059,2907,80,816404,40,2906,1131,2907,561,1
20141229.093059,2906,10,816414,-4,2906,1128,2907,559,0
20141229.0931,2907,10,816424,10,2906,1129,2907,554,1
20141229.0931,2906,16,816440,-4,2906,1126,2907,548,0
20141229.093101,2907,2,816442,0,2906,1246,2907,557,1
20141229.093101,2906,2,816444,-2,2906,1245,2907,557,0
20141229.093102,2907,12,816456,-4,2906,1244,2907,654,1
20141229.093102,2907,36,816492,36,2906,1244,2907,636,1
20141229.093103,2906,408,816900,-8,2906,1040,2907,636,0
20141229.093104,2907,66,816966,36,2906,1037,2907,611,1
20141229.093105,2907,2,816968,-2,2906,1037,2907,610,1
20141229.093105,2906,6,816974,-6,2906,1035,2907,614,0
20141229.093106,2907,132,817106,-72,2906,1067,2907,552,1
20141229.093107,2907,376,817482,90,2906,1070,2907,367,1
20141229.093107,2907,210,817692,34,2906,1090,2907,264,1
20141229.093108,2907,540,818232,118,2907,253,2908,1844,1
20141229.093109,2907,50,818282,2,2907,337,2908,1798,1
20141229.093109,2907,28,818310,2,2907,399,2908,1696,1
20141229.09311,2908,12,818322,0,2907,397,2908,1640,1
20141229.09311,2907,234,818556,188,2907,412,2908,1525,0
20141229.093111,2907,24,818580,-12,2907,560,2908,1502,0
20141229.093111,2908,120,818700,100,2907,554,2908,1446,1
20141229.093112,2907,6,818706,2,2907,556,2908,1428,0
20141229.093112,2907,10,818716,-8,2907,551,2908,1367,0
20141229.093113,2908,22,818738,12,2907,629,2908,1358,1
20141229.093113,2908,2,818740,2,2907,629,2908,1350,1
20141229.093114,2908,50,818790,-12,2907,632,2908,1325,1
20141229.093114,2907,50,818840,32,2907,632,2908,1300,0
20141229.093115,2908,12,818852,12,2907,634,2908,1298,1
20141229.093115,2908,60,818912,0,2907,634,2908,1268,1
20141229.093116,2908,20,818932,-2,2907,630,2908,1254,1
20141229.093117,2908,4,818936,4,2907,630,2908,1252,1
20141229.093117,2907,26,818962,10,2907,623,2908,1247,0
20141229.093118,2907,10,818972,-4,2907,624,2908,1245,0
20141229.093119,2907,6,818978,0,2907,623,2908,1244,0
20141229.09312,2907,46,819024,34,2907,622,2908,1220,0
20141229.09312,2907,2,819026,-2,2907,636,2908,1220,0
20141229.093121,2908,6,819032,6,2907,576,2908,1221,1
20141229.093121,2908,20,819052,-6,2907,573,2908,1249,1
20141229.093122,2907,104,819156,-74,2907,473,2908,1239,0
20141229.093122,2907,60,819216,54,2907,469,2908,1210,0
20141229.093123,2908,4,819220,4,2907,571,2908,1194,1
20141229.093123,2908,56,819276,38,2907,569,2908,1164,1
20141229.093124,2908,14,819290,12,2907,659,2908,1158,1
20141229.093124,2908,54,819344,46,2907,655,2908,1115,1
20141229.093125,2908,12,819356,-4,2907,653,2908,1109,1
20141229.093125,2908,22,819378,-4,2907,480,2908,1082,1
20141229.093126,2908,8,819386,2,2907,478,2908,1067,1
20141229.093126,2907,28,819414,0,2907,469,2908,1043,0
20141229.093127,2908,16,819430,6,2907,463,2908,1047,1
20141229.093127,2907,40,819470,0,2907,493,2908,1009,0
20141229.093128,2908,4,819474,2,2907,493,2908,966,1
20141229.093128,2907,126,819600,68,2907,490,2908,884,0
20141229.093129,2908,392,819992,128,2907,490,2908,678,1
20141229.09313,2908,30,820022,-8,2907,568,2908,480,1
20141229.09313,2908,426,820448,200,2907,567,2908,147,1
20141229.093131,2908,126,820574,74,2907,669,2908,87,1
20141229.093131,2908,44,820618,18,2907,668,2908,66,1
20141229.093132,2908,366,820984,96,2907,666,2908,57,1
20141229.093132,2908,226,821210,-160,2907,665,2908,433,1
20141229.093133,2908,306,821516,-2,2907,662,2908,365,1
20141229.093133,2908,48,821564,-16,2907,604,2908,533,1
20141229.093134,2908,214,821778,-4,2907,507,2908,429,1
20141229.093134,2908,450,822228,-306,2907,528,2908,265,1
20141229.093134,2908,276,822504,270,2907,524,2908,126,1
20141229.093135,2908,254,822758,184,2908,1412,2909,1627,1
20141229.093136,2908,10,822768,-8,2908,1276,2909,1538,1
20141229.093136,2908,108,822876,-42,2908,391,2909,1494,1
20141229.093137,2909,114,822990,-72,2908,425,2909,1391,1
20141229.093137,2909,62,823052,6,2908,510,2909,1355,1
20141229.093138,2909,56,823108,4,2908,644,2909,1329,1
20141229.093138,2908,18,823126,4,2908,675,2909,1323,0
20141229.093138,2909,4,823130,2,2908,677,2909,1321,1
20141229.093139,2908,116,823246,58,2908,695,2909,1266,0
20141229.09314,2909,10,823256,0,2908,699,2909,1263,1
20141229.09314,2908,44,823300,-18,2908,695,2909,1248,0
20141229.093141,2909,2074,825374,-292,2908,708,2909,217,1
20141229.093142,2910,532,825906,-180,2909,599,2910,3158,1
20141229.093142,2910,652,826558,-168,2909,715,2910,2795,1
20141229.093143,2910,420,826978,0,2909,687,2910,2572,1
20141229.093143,2910,76,827054,16,2909,762,2910,2267,1
20141229.093144,2910,22,827076,10,2909,760,2910,2258,1
20141229.093144,2909,2082,829158,66,2909,763,2910,1221,0
20141229.093145,2910,94,829252,58,2909,769,2910,1174,1
20141229.093145,2909,10,829262,-6,2909,767,2910,1168,0
20141229.093146,2911,2338,831600,-184,2910,284,2911,1606,1
20141229.093146,2910,166,831766,22,2910,385,2911,1538,0
20141229.093147,2910,102,831868,44,2910,381,2911,1492,0
20141229.093147,2911,156,832024,-22,2910,469,2911,1418,1
20141229.093148,2911,134,832158,80,2910,448,2911,1384,1
20141229.093148,2911,376,832534,20,2910,455,2911,1201,1
20141229.093149,2911,72,832606,72,2910,451,2911,1143,1
20141229.093149,2911,346,832952,250,2910,418,2911,997,1
20141229.09315,2911,2,832954,2,2910,422,2911,1047,1
20141229.09315,2910,256,833210,74,2910,340,2911,1030,0
20141229.093151,2910,750,833960,-38,2909,685,2910,2,0
20141229.093151,2910,50,834010,-16,2909,682,2910,144,0
20141229.093152,2910,532,834542,-270,2909,683,2910,344,0
20141229.093152,2910,160,834702,114,2909,681,2910,569,0
20141229.093153,2909,28,834730,0,2909,694,2910,568,0
20141229.093154,2909,82,834812,-70,2909,656,2910,576,0
20141229.093154,2910,64,834876,4,2909,638,2910,672,1
20141229.093155,2909,8,834884,-4,2909,635,2910,718,0
20141229.093155,2910,24,834908,24,2909,635,2910,706,1
20141229.093155,2910,14,834922,0,2909,632,2910,746,1
20141229.093156,2909,390,835312,210,2909,560,2910,735,0
20141229.093157,2909,104,835416,0,2909,551,2910,694,0
20141229.093157,2909,38,835454,-4,2909,485,2910,682,0
20141229.093158,2910,36,835490,2,2909,486,2910,786,1
20141229.093158,2909,16,835506,-8,2909,482,2910,798,0
20141229.093159,2910,16,835522,-4,2909,544,2910,791,1
20141229.093159,2909,6,835528,-6,2909,541,2910,807,0
20141229.0932,2909,22,835550,-2,2909,534,2910,812,0
20141229.0932,2910,200,835750,-4,2909,531,2910,630,1
20141229.093201,2910,110,835860,110,2909,532,2910,577,1
20141229.093201,2909,32,835892,-6,2909,547,2910,570,0
20141229.093202,2910,266,836158,28,2909,461,2910,538,1
20141229.093202,2909,320,836478,-216,2909,460,2910,389,0
20141229.093203,2910,722,837200,652,2909,496,2910,28,1
20141229.093203,2910,122,837322,-66,2910,119,2911,957,1
20141229.093204,2910,148,837470,10,2910,366,2911,942,1
20141229.093204,2910,94,837564,0,2910,402,2911,877,1
20141229.093205,2910,54,837618,-6,2910,385,2911,843,1
20141229.093205,2910,138,837756,38,2910,328,2911,776,1
20141229.093206,2910,212,837968,-6,2910,216,2911,777,1
20141229.093206,2911,42,838010,-26,2910,209,2911,789,1
20141229.093207,2910,28,838038,-8,2910,197,2911,784,0
20141229.093207,2910,20,838058,8,2910,116,2911,794,0
20141229.093208,2909,482,838540,0,2909,701,2910,85,0
20141229.093208,2910,274,838814,-68,2910,117,2911,807,1
20141229.093209,2910,36,838850,4,2910,95,2911,889,1
20141229.093209,2910,284,839134,4,2910,63,2911,940,1
20141229.09321,2910,276,839410,10,2909,928,2910,121,1
20141229.09321,2910,132,839542,48,2910,189,2911,742,1
20141229.093211,2911,92,839634,56,2910,224,2911,641,1
20141229.093211,2910,16,839650,14,2910,220,2911,638,0
20141229.093212,2910,100,839750,94,2910,378,2911,556,0
20141229.093212,2911,158,839908,34,2910,371,2911,494,1
20141229.093213,2911,234,840142,232,2910,365,2911,381,1
20141229.093213,2911,328,840470,-60,2910,378,2911,230,1
20141229.093214,2911,28,840498,-2,2910,438,2911,224,1
20141229.093214,2910,4,840502,2,2910,486,2911,240,0
20141229.093215,2910,14,840516,6,2910,359,2911,240,0
20141229.093215,2911,492,841008,322,2911,801,2912,1059,1
20141229.093216,2911,72,841080,18,2910,468,2911,123,1
20141229.093217,2911,372,841452,102,2911,130,2912,1010,1
20141229.093217,2911,34,841486,2,2911,116,2912,1022,1
20141229.093217,2911,260,841746,12,2910,489,2911,162,1
20141229.093218,2910,18,841764,0,2910,487,2911,366,0
20141229.093219,2911,58,841822,-6,2910,493,2911,437,1
20141229.093219,2910,16,841838,-2,2910,491,2911,437,0
20141229.09322,2911,190,842028,-46,2910,492,2911,444,1
20141229.09322,2911,54,842082,-24,2910,489,2911,419,1
20141229.093221,2910,8,842090,0,2910,514,2911,476,0
20141229.093221,2911,164,842254,0,2910,517,2911,397,1
20141229.093221,2911,202,842456,-2,2910,540,2911,297,1
20141229.093222,2910,20,842476,-10,2910,545,2911,244,0
20141229.093223,2911,126,842602,108,2910,620,2911,207,1
20141229.093224,2910,60,842662,-32,2910,619,2911,189,0
20141229.093224,2911,70,842732,0,2910,618,2911,157,1
20141229.093225,2911,90,842822,12,2910,623,2911,118,1
20141229.093225,2911,362,843184,136,2911,183,2912,975,1
20141229.093226,2911,12,843196,4,2911,446,2912,931,1
20141229.093226,2911,38,843234,32,2911,456,2912,912,1
20141229.093227,2911,8,843242,2,2911,462,2912,958,1
20141229.093228,2912,672,843914,-20,2911,254,2912,872,1
20141229.093229,2912,98,844012,8,2911,264,2912,831,1
20141229.093229,2912,70,844082,6,2911,344,2912,832,1
20141229.09323,2912,50,844132,0,2911,336,2912,832,1
20141229.09323,2912,426,844558,-186,2911,343,2912,580,1
20141229.093231,2912,1116,845674,-832,2912,100,2913,931,1
20141229.093231,2913,200,845874,10,2912,129,2913,949,1
20141229.093232,2912,150,846024,100,2912,291,2913,881,0
20141229.093232,2913,100,846124,-10,2912,413,2913,821,1
20141229.093233,2913,44,846168,-16,2912,411,2913,804,1
20141229.093233,2913,82,846250,-62,2912,408,2913,831,1
20141229.093234,2912,48,846298,-24,2912,394,2913,813,0
20141229.093234,2912,12,846310,10,2912,393,2913,834,0
20141229.093235,2912,146,846456,98,2912,386,2913,752,0
20141229.093235,2913,24,846480,24,2912,386,2913,750,1
20141229.093236,2913,20,846500,2,2912,419,2913,753,1
20141229.093236,2913,74,846574,6,2912,419,2913,727,1
20141229.093237,2912,210,846784,0,2912,317,2913,717,0
20141229.093237,2913,62,846846,60,2912,356,2913,708,1
20141229.093238,2912,116,846962,108,2912,445,2913,681,0
20141229.093238,2912,108,847070,4,2912,405,2913,680,0
20141229.093239,2912,16,847086,6,2912,444,2913,732,0
20141229.093239,2913,232,847318,134,2912,413,2913,640,1
20141229.09324,2912,50,847368,0,2912,396,2913,677,0
20141229.09324,2912,20,847388,-12,2912,387,2913,677,0
20141229.093241,2913,8,847396,2,2912,385,2913,687,1
20141229.093241,2912,18,847414,-4,2912,380,2913,743,0
20141229.093242,2913,74,847488,48,2912,346,2913,715,1
20141229.093243,2913,12,847500,12,2912,353,2913,709,1
20141229.093243,2913,18,847518,12,2912,361,2913,763,1
20141229.093244,2913,20,847538,14,2912,362,2913,912,1
20141229.093244,2913,96,847634,62,2912,347,2913,974,1
20141229.093245,2913,18,847652,6,2912,342,2913,1121,1
20141229.093246,2912,562,848214,26,2912,79,2913,1232,0
20141229.093246,2912,164,848378,-14,2911,513,2912,258,0
20141229.093247,2912,234,848612,-106,2911,533,2912,333,0
20141229.093247,2912,4,848616,-4,2911,533,2912,364,0
20141229.093248,2912,72,848688,0,2911,533,2912,346,0
20141229.093248,2912,60,848748,16,2911,553,2912,393,0
20141229.093249,2912,42,848790,4,2911,552,2912,396,0
20141229.093249,2912,68,848858,20,2911,532,2912,394,0
20141229.09325,2912,10,848868,2,2911,534,2912,382,0
20141229.09325,2912,270,849138,18,2911,540,2912,245,0
20141229.093251,2912,44,849182,-20,2911,528,2912,265,0
20141229.093251,2911,6,849188,-4,2911,526,2912,264,0
20141229.093252,2912,68,849256,2,2911,659,2912,247,1
20141229.093252,2912,16,849272,0,2911,663,2912,244,1
20141229.093253,2911,16,849288,-2,2911,671,2912,244,0
20141229.093253,2912,4,849292,0,2911,671,2912,254,1
20141229.093254,2912,48,849340,-2,2911,669,2912,294,1
20141229.093254,2911,54,849394,-52,2911,642,2912,310,0
20141229.093255,2912,20,849414,2,2911,621,2912,303,1
20141229.093255,2911,826,850240,-362,2911,209,2912,547,0
20141229.093256,2910,458,850698,62,2910,650,2911,88,0
20141229.093256,2911,8,850706,0,2910,660,2911,85,1
20141229.093257,2911,186,850892,-184,2910,661,2911,34,1
20141229.093257,2911,118,851010,-48,2911,144,2912,872,1
20141229.093258,2911,398,851408,-184,2910,651,2911,195,1
20141229.093258,2910,4,851412,0,2910,648,2911,201,0
20141229.093259,2911,104,851516,-100,2910,681,2911,150,1
20141229.093259,2911,46,851562,30,2910,681,2911,137,1
20141229.0933,2911,24,851586,20,2910,705,2911,125,1
20141229.0933,2911,36,851622,26,2910,703,2911,126,1
20141229.093301,2910,6,851628,4,2910,702,2911,352,0
20141229.093301,2911,172,851800,-4,2910,705,2911,271,1
20141229.093302,2911,14,851814,6,2910,705,2911,271,1
20141229.093302,2911,134,851948,-78,2910,699,2911,229,1
20141229.093303,2911,106,852054,0,2910,709,2911,181,1
20141229.093303,2911,102,852156,40,2910,708,2911,160,1
20141229.093304,2911,36,852192,4,2910,695,2911,155,1
20141229.093304,2911,16,852208,-12,2910,695,2911,202,1
20141229.093305,2911,232,852440,-194,2910,729,2911,108,1
20141229.093306,2911,110,852550,68,2910,725,2911,81,1
20141229.093306,2911,108,852658,-2,2910,726,2911,53,1
20141229.093307,2911,60,852718,12,2910,718,2911,35,1
20141229.093307,2911,4,852722,4,2910,751,2911,38,1
20141229.093308,2911,108,852830,86,2911,54,2912,1009,1
20141229.093308,2912,114,852944,10,2910,789,2912,999,1
20141229.093309,2912,8,852952,8,2911,1,2912,958,1
20141229.093309,2911,4,852956,2,2910,789,2911,53,0
20141229.09331,2911,250,853206,-70,2911,59,2912,970,0
20141229.09331,2911,6,853212,0,2911,56,2912,957,0
20141229.093311,2911,98,853310,26,2911,109,2912,827,0
20141229.093312,2912,20,853330,8,2911,267,2912,815,1
20141229.093312,2912,4,853334,0,2911,285,2912,757,1
20141229.093313,2911,2,853336,-2,2911,285,2912,711,0
20141229.093313,2912,140,853476,-46,2911,231,2912,428,1
20141229.093314,2911,282,853758,122,2911,91,2912,424,0
20141229.093315,2911,14,853772,0,2911,92,2912,402,0
20141229.093315,2911,192,853964,160,2911,74,2912,391,0
20141229.093316,2911,30,853994,28,2911,244,2912,266,0
20141229.093317,2912,22,854016,2,2911,256,2912,233,1
20141229.093317,2911,14,854030,2,2911,305,2912,241,0
20141229.093318,2911,10,854040,8,2911,332,2912,239,0
20141229.093318,2911,44,854084,40,2911,339,2912,218,0
20141229.093319,2912,246,854330,36,2911,380,2912,98,1
20141229.093319,2912,22,854352,-10,2911,381,2912,89,1
20141229.09332,2912,184,854536,100,2912,1003,2913,788,1
20141229.09332,2912,2,854538,2,2912,1020,2913,789,1
20141229.093321,2912,4,854542,0,2912,1018,2913,788,1
20141229.093321,2913,56,854598,6,2912,997,2913,751,1
20141229.093322,2912,744,855342,738,2912,22,2913,749,0
20141229.093323,2912,52,855394,-14,2911,442,2912,114,0
20141229.093323,2912,4,855398,4,2911,442,2912,122,0
20141229.093324,2911,80,855478,0,2911,402,2912,127,0
20141229.093324,2911,2,855480,0,2911,401,2912,128,0
20141229.093325,2912,242,855722,104,2912,66,2913,924,1
20141229.093325,2912,224,855946,-90,2911,5421,2912,33,1
20141229.093326,2911,54,856000,0,2911,407,2912,61,0
20141229.093326,2912,4,856004,-4,2911,407,2912,127,1
20141229.093327,2912,10,856014,0,2911,417,2912,177,1
20141229.093327,2912,12,856026,0,2911,437,2912,184,1
20141229.093328,2911,10,856036,10,2911,428,2912,223,0
20141229.093329,2912,104,856140,12,2911,426,2912,201,1
20141229.093329,2912,10,856150,10,2911,427,2912,200,1
20141229.09333,2912,6,856156,4,2911,429,2912,198,1
20141229.09333,2911,202,856358,200,2911,338,2912,206,0
20141229.093331,2912,2,856360,2,2911,343,2912,217,1
20141229.093331,2912,232,856592,72,2911,349,2912,152,1
20141229.093332,2912,386,856978,48,2912,82,2913,794,1
20141229.093332,2913,408,857386,256,2912,91,2913,588,1
20141229.093333,2912,2,857388,2,2912,93,2913,588,0
20141229.093333,2913,600,857988,6,2912,119,2913,362,1
20141229.093334,2912,8,857996,-6,2912,121,2913,349,0
20141229.093334,2912,18,858014,2,2912,113,2913,350,0
20141229.093335,2912,416,858430,192,2912,180,2913,187,0
20141229.093335,2912,4,858434,0,2912,218,2913,314,0
20141229.093336,2912,406,858840,274,2912,218,2913,128,0
20141229.093336,2913,80,858920,26,2912,235,2913,99,1
20141229.093337,2912,152,859072,52,2912,202,2913,80,0
20141229.093338,2913,466,859538,308,2912,220,2913,1055,1
20141229.093338,2912,74,859612,0,2912,164,2913,1077,0
20141229.093339,2912,114,859726,-10,2912,110,2913,1003,0
20141229.093339,2912,478,860204,426,2912,117,2913,779,0
20141229.09334,2912,80,860284,52,2912,102,2913,774,0
20141229.093341,2912,432,860716,414,2912,90,2913,584,0
20141229.093341,2912,46,860762,14,2912,80,2913,584,0
20141229.093341,2912,52,860814,32,2912,59,2913,576,0
20141229.093342,2912,174,860988,110,2911,463,2912,110,0
20141229.093343,2912,258,861246,-162,2912,891,2913,803,0
20141229.093343,2913,6,861252,2,2912,960,2913,639,1
20141229.093344,2912,20,861272,0,2912,960,2913,589,0
20141229.093344,2912,40,861312,0,2912,954,2913,487,0
20141229.093345,2912,2,861314,-2,2912,983,2913,478,0
20141229.093345,2912,2,861316,-2,2912,983,2913,506,0
20141229.093346,2913,404,861720,404,2912,1021,2913,307,1
20141229.093346,2913,4,861724,0,2912,1027,2913,298,1
20141229.093347,2912,26,861750,0,2912,1014,2913,307,0
20141229.093347,2912,474,862224,418,2912,1022,2913,74,0
20141229.093348,2914,260,862484,224,2913,535,2914,2222,1
20141229.093348,2914,110,862594,38,2913,577,2914,2149,1
20141229.093349,2914,178,862772,18,2913,586,2914,2060,1
20141229.093349,2913,98,862870,34,2913,571,2914,1933,0
20141229.09335,2914,12,862882,2,2913,610,2914,1930,1
20141229.09335,2913,22,862904,12,2913,601,2914,1919,0
20141229.093351,2913,10,862914,6,2913,756,2914,1918,0
20141229.093351,2913,12,862926,0,2913,751,2914,1916,0
20141229.093352,2913,72,862998,4,2913,715,2914,1903,0
20141229.093352,2913,12,863010,10,2913,751,2914,1937,0
20141229.093353,2913,46,863056,0,2913,620,2914,1686,0
20141229.093354,2914,18,863074,16,2913,647,2914,1731,1
20141229.093354,2914,14,863088,4,2913,647,2914,1778,1
20141229.093355,2913,8,863096,8,2913,692,2914,1581,0
20141229.093355,2914,2,863098,2,2913,702,2914,1580,1
20141229.093356,2913,206,863304,164,2913,686,2914,1498,0
20141229.093357,2914,42,863346,20,2913,689,2914,1478,1
20141229.093357,2914,4,863350,4,2913,691,2914,1528,1
20141229.093358,2914,14,863364,12,2913,692,2914,1521,1
20141229.093358,2914,24,863388,8,2913,694,2914,1519,1
20141229.093359,2913,24,863412,22,2913,754,2914,1519,0
20141229.093359,2914,40,863452,-4,2913,721,2914,1541,1
20141229.0934,2913,6,863458,4,2913,721,2914,1542,0
20141229.0934,2913,2,863460,0,2913,726,2914,1547,0
20141229.093401,2914,206,863666,162,2913,622,2914,1544,1
20141229.093401,2913,1290,864956,318,2912,1064,2913,293,0
20141229.093402,2913,158,865114,22,2912,966,2913,527,0
20141229.093402,2912,136,865250,100,2912,949,2913,542,0
20141229.093403,2912,2,865252,-2,2912,948,2913,596,0
20141229.093403,2913,2,865254,2,2912,948,2913,623,1
20141229.093404,2913,288,865542,130,2912,945,2913,542,1
20141229.093404,2913,74,865616,10,2912,935,2913,520,1
20141229.093405,2913,4,865620,0,2912,935,2913,520,1
20141229.093405,2913,96,865716,-60,2912,909,2913,504,1
20141229.093406,2912,20,865736,0,2912,899,2913,470,0
20141229.093406,2913,14,865750,12,2912,899,2913,465,1
20141229.093407,2913,976,866726,392,2913,115,2914,1686,1
20141229.093407,2913,140,866866,122,2913,1049,2914,1680,1
20141229.093408,2913,10,866876,6,2913,1155,2914,1540,1
20141229.093408,2913,12,866888,0,2913,1151,2914,1538,1
20141229.093409,2913,72,866960,48,2913,1115,2914,1553,1
20141229.093409,2914,40,867000,26,2913,1096,2914,1554,1
20141229.09341,2913,4,867004,2,2913,1596,2914,1570,0
20141229.09341,2913,2,867006,2,2913,1595,2914,1570,0
20141229.093411,2913,6,867012,4,2913,1594,2914,1569,0
20141229.093411,2913,4,867016,4,2913,1594,2914,1569,0
20141229.093412,2914,82,867098,6,2913,1556,2914,1578,1
20141229.093413,2913,98,867196,-70,2913,1512,2914,1687,0
20141229.093413,2913,34,867230,20,2913,1497,2914,1663,0
20141229.093414,2913,12,867242,12,2913,1616,2914,1549,0
20141229.093414,2913,12,867254,12,2913,1698,2914,1550,0
20141229.093414,2913,66,867320,2,2913,1667,2914,1548,0
20141229.093415,2913,24,867344,6,2913,1694,2914,1540,0
20141229.093416,2913,10,867354,6,2913,1689,2914,1538,0
20141229.093417,2913,12,867366,8,2913,1670,2914,1547,0
20141229.093417,2913,8,867374,8,2913,1665,2914,1550,0
20141229.093417,2913,68,867442,2,2913,1651,2914,1551,0
20141229.093418,2913,164,867606,164,2913,1545,2914,1551,0
20141229.093418,2913,148,867754,148,2913,1307,2914,1556,0
20141229.093419,2913,120,867874,112,2913,1251,2914,1557,0
20141229.09342,2913,104,867978,104,2913,1199,2914,1580,0
20141229.09342,2914,688,868666,546,2913,1309,2914,1227,1
20141229.093421,2914,6,868672,6,2913,1240,2914,1225,1
20141229.093421,2914,2076,870748,-132,2913,1258,2914,187,1
20141229.093422,2914,418,871166,198,2914,413,2915,2034,1
20141229.093422,2914,14,871180,8,2914,579,2915,1977,1
20141229.093423,2914,44,871224,-32,2914,562,2915,1982,1
20141229.093424,2915,2,871226,-2,2914,586,2915,1956,1
20141229.093424,2915,232,871458,-122,2914,599,2915,1842,1
20141229.093425,2915,590,872048,238,2914,534,2915,1614,1
20141229.093425,2915,152,872200,152,2914,534,2915,1537,1
20141229.093426,2915,176,872376,140,2914,701,2915,1467,1
20141229.093426,2914,6,872382,2,2914,693,2915,1468,0
20141229.093427,2914,104,872486,62,2914,660,2915,1456,0
20141229.093427,2915,2,872488,2,2914,662,2915,1458,1
20141229.093428,2915,22,872510,8,2914,660,2915,1458,1
20141229.093428,2914,1602,874112,1578,2914,600,2915,664,0
20141229.093429,2915,6,874118,6,2914,579,2915,662,1
20141229.093429,2915,676,874794,-252,2914,589,2915,351,1
20141229.09343,2914,700,875494,202,2914,580,2916,1661,0
20141229.09343,2915,10,875504,-6,2915,101,2916,1574,1
20141229.093431,2915,1138,876642,988,2915,159,2916,969,1
20141229.093431,2915,4,876646,4,2915,221,2916,967,1
20141229.093432,2915,32,876678,8,2915,238,2916,953,1
20141229.093432,2915,32,876710,20,2915,230,2916,953,1
20141229.093433,2916,20,876730,0,2915,230,2916,943,1
20141229.093434,2916,1132,877862,1008,2915,271,2916,384,1
20141229.093434,2915,62,877924,26,2915,249,2916,385,0
20141229.093435,2916,64,877988,-46,2915,312,2916,409,1
20141229.093435,2916,42,878030,8,2915,317,2916,498,1
20141229.093436,2915,14,878044,4,2915,314,2916,495,0
20141229.093436,2916,1048,879092,378,2915,379,2917,662,1
20141229.093437,2916,130,879222,-6,2916,24,2917,443,1
20141229.093438,2916,86,879308,30,2915,373,2917,414,1
20141229.093438,2916,60,879368,-4,2916,67,2917,482,1
20141229.093439,2917,10,879378,10,2916,141,2917,479,1
20141229.093439,2916,60,879438,-2,2916,165,2917,471,0
20141229.093439,2916,208,879646,142,2916,65,2917,490,0
20141229.09344,2916,176,879822,112,2915,387,2916,57,0
20141229.093441,2916,68,879890,-30,2915,393,2916,45,0
20141229.093441,2916,234,880124,150,2915,389,2916,199,0
20141229.093442,2915,200,880324,40,2915,383,2916,209,0
20141229.093443,2916,44,880368,-2,2915,428,2916,211,1
20141229.093443,2916,110,880478,102,2915,386,2916,158,1
20141229.093444,2916,172,880650,130,2915,378,2916,95,1
20141229.093444,2915,62,880712,46,2915,364,2916,105,0
20141229.093444,2915,12,880724,10,2915,361,2916,201,0
20141229.093445,2916,78,880802,74,2915,342,2916,391,1
20141229.093446,2916,36,880838,6,2915,341,2916,496,1
20141229.093446,2915,120,880958,-22,2915,330,2916,448,0
20141229.093447,2916,26,880984,8,2915,369,2916,446,1
20141229.093447,2915,58,881042,-6,2915,376,2916,344,0
20141229.093448,2915,66,881108,62,2915,375,2916,316,0
20141229.093448,2916,6,881114,4,2915,378,2916,383,1
20141229.093449,2916,1838,882952,1120,2915,1,2916,471,1
20141229.093449,2915,10,882962,0,2915,53,2916,395,0
20141229.09345,2916,66,883028,-8,2915,139,2916,265,1
20141229.09345,2916,30,883058,10,2915,180,2916,262,1
20141229.093451,2915,78,883136,14,2915,251,2916,246,0
20141229.093451,2916,512,883648,394,2916,347,2917,761,1
20141229.093452,2916,108,883756,16,2916,297,2917,676,1
20141229.093452,2916,14,883770,12,2916,329,2917,708,1
20141229.093453,2916,76,883846,10,2916,320,2917,705,1
20141229.093453,2917,84,883930,80,2916,296,2917,619,1
20141229.093454,2917,44,883974,18,2916,308,2917,616,1
20141229.093455,2916,22,883996,10,2916,302,2917,611,0
20141229.093455,2916,4,884000,2,2916,416,2917,623,0
20141229.093456,2916,14,884014,6,2916,421,2917,630,0
20141229.093456,2917,10,884024,10,2916,421,2917,629,1
20141229.093457,2917,158,884182,156,2916,355,2917,647,1
20141229.093458,2917,400,884582,232,2916,175,2917,639,1
20141229.093458,2917,684,885266,4,2915,578,2916,5,1
20141229.093459,2916,88,885354,8,2915,559,2916,27,0
20141229.093459,2916,98,885452,92,2915,558,2916,89,0
20141229.0935,2916,2,885454,0,2915,559,2916,93,0
20141229.093501,2916,158,885612,58,2915,560,2916,76,0
20141229.093501,2916,390,886002,-60,2915,580,2916,5,0
20141229.093502,2917,384,886386,-40,2915,581,2917,717,1
20141229.093502,2916,236,886622,42,2916,21,2917,633,0
20141229.093503,2916,276,886898,166,2916,146,2917,706,0
20141229.093503,2916,338,887236,284,2916,35,2917,699,0
20141229.093504,2916,126,887362,-74,2915,518,2916,26,0
20141229.093504,2916,26,887388,22,2915,521,2916,367,0
20141229.093505,2916,20,887408,20,2915,500,2916,463,0
20141229.093505,2916,30,887438,-6,2915,499,2916,488,0
20141229.093506,2916,14,887452,-4,2915,505,2916,857,0
20141229.093506,2915,10,887462,-6,2915,498,2916,946,0
20141229.093507,2916,16,887478,0,2915,478,2916,1048,1
20141229.093507,2915,978,888456,516,2914,779,2915,105,0
20141229.093508,2915,20,888476,0,2914,768,2915,161,0
20141229.093508,2916,1000,889476,690,2915,1,2916,849,1
20141229.093509,2916,166,889642,-84,2915,114,2916,742,1
20141229.093509,2915,4,889646,-4,2915,123,2916,748,0
20141229.09351,2916,304,889950,-48,2915,105,2916,618,1
20141229.09351,2915,14,889964,-4,2915,133,2916,356,0
20141229.093511,2915,4,889968,2,2915,182,2916,2361,0
20141229.093511,2915,56,890024,-6,2915,156,2916,4380,0
20141229.093512,2915,534,890558,-158,2915,6,2916,486,0
20141229.093512,2916,24,890582,20,2915,273,2916,370,1
20141229.093513,2916,18,890600,10,2915,597,2916,406,1
20141229.093513,2915,14,890614,12,2915,614,2916,408,0
20141229.093514,2915,8,890622,2,2915,610,2916,407,0
20141229.093514,2915,24,890646,22,2915,608,2916,386,0
20141229.093515,2915,24,890670,2,2915,599,2916,347,0
20141229.093515,2915,2,890672,2,2915,600,2916,367,0
20141229.093516,2915,46,890718,44,2915,600,2916,374,0
20141229.093516,2915,20,890738,10,2915,590,2916,376,0
20141229.093517,2915,2,890740,2,2915,494,2916,373,0
20141229.093517,2915,86,890826,40,2915,463,2916,363,0
20141229.093518,2915,6,890832,4,2915,364,2916,367,0
20141229.093519,2916,100,890932,0,2915,347,2916,343,1
20141229.093519,2915,160,891092,-160,2915,268,2916,343,0
20141229.09352,2916,754,891846,-204,2916,627,2917,558,1
20141229.09352,2916,258,892104,-240,2916,499,2917,558,1
20141229.093521,2916,92,892196,-90,2916,464,2917,545,1
20141229.093522,2916,44,892240,-14,2916,473,2917,542,1
20141229.093522,2916,4,892244,0,2916,474,2917,722,1
20141229.093523,2916,20,892264,-20,2916,464,2917,722,1
20141229.093523,2917,60,892324,-44,2916,435,2917,807,1
20141229.093523,2916,92,892416,-88,2916,389,2917,785,0
20141229.093524,2916,16,892432,-12,2916,382,2917,609,0
20141229.093525,2916,788,893220,-98,2915,1059,2916,5,0
20141229.093525,2916,50,893270,24,2916,5,2917,4617,0
20141229.093526,2915,16,893286,-14,2915,1044,2917,4693,0
20141229.093526,2916,74,893360,64,2916,65,2917,4649,1
20141229.093527,2916,138,893498,108,2915,1085,2916,89,1
20141229.093527,2915,2158,895656,1180,2915,135,2916,197,0
20141229.093527,2915,14,895670,-2,2915,655,2916,259,0
20141229.093528,2916,574,896244,-180,2916,235,2917,705,1
20141229.093529,2916,110,896354,-10,2916,626,2917,704,1
20141229.093529,2916,10,896364,-4,2916,623,2917,761,1
20141229.09353,2916,24,896388,-10,2916,571,2917,765,1
20141229.09353,2916,84,896472,0,2916,549,2917,829,1
20141229.093531,2916,32,896504,-26,2916,533,2917,777,1
20141229.093531,2916,88,896592,-66,2916,489,2917,777,1
20141229.093531,2917,4,896596,0,2916,489,2917,775,1
20141229.093532,2916,122,896718,-98,2916,437,2917,781,0
20141229.093533,2917,4,896722,0,2916,437,2917,803,1
20141229.093534,2916,26,896748,-8,2916,434,2917,795,0
20141229.093534,2916,110,896858,0,2916,386,2917,788,0
20141229.093535,2916,62,896920,-26,2916,361,2917,844,0
20141229.093535,2916,36,896956,-22,2916,345,2917,875,0
20141229.093536,2916,4,896960,-2,2916,343,2917,866,0
20141229.093536,2916,216,897176,-216,2916,236,2917,885,0
20141229.093537,2916,472,897648,4,2915,638,2916,877,0
20141229.093537,2916,26,897674,2,2915,638,2916,1145,0
20141229.093538,2916,32,897706,16,2915,623,2916,1280,0
20141229.093538,2916,38,897744,30,2915,623,2916,1264,0
20141229.093539,2916,50,897794,44,2915,619,2916,1259,0
20141229.093539,2916,28,897822,22,2915,617,2916,1247,0
20141229.09354,2916,380,898202,380,2915,619,2916,1067,0
20141229.09354,2916,2,898204,2,2915,627,2916,1066,0
20141229.093541,2916,126,898330,118,2915,616,2916,1029,0
20141229.093541,2915,52,898382,2,2915,601,2916,1017,0
20141229.093542,2915,4,898386,4,2915,600,2916,975,0
20141229.093542,2915,18,898404,8,2915,595,2916,972,0
20141229.093543,2915,6,898410,0,2915,593,2916,970,0
20141229.093543,2915,6,898416,0,2915,590,2916,975,0
20141229.093544,2916,6,898422,4,2915,590,2916,977,1
20141229.093544,2915,6,898428,0,2915,587,2916,974,0
20141229.093545,2915,12,898440,10,2915,596,2916,975,0
20141229.093545,2915,18,898458,10,2915,594,2916,968,0
20141229.093546,2915,18,898476,4,2915,585,2916,969,0
20141229.093547,2916,54,898530,42,2915,611,2916,952,1
20141229.093548,2915,18,898548,10,2915,602,2916,950,0
20141229.093548,2916,8,898556,6,2915,602,2916,963,1
20141229.093548,2915,32,898588,20,2915,588,2916,958,0
20141229.093549,2916,18,898606,14,2915,601,2916,997,1
20141229.09355,2916,32,898638,24,2915,588,2916,1033,1
20141229.09355,2916,22,898660,22,2915,603,2916,1032,1
20141229.093551,2915,28,898688,2,2915,609,2916,1037,0
20141229.093551,2916,16,898704,2,2915,607,2916,1033,1
20141229.093552,2915,16,898720,2,2915,605,2916,1023,0
20141229.093552,2915,52,898772,42,2915,579,2916,1038,0
20141229.093553,2915,432,899204,24,2915,373,2916,1028,0
20141229.093554,2915,808,900012,222,2914,897,2915,26,0
20141229.093554,2914,6,900018,2,2914,903,2915,129,0
20141229.093554,2914,8,900026,0,2914,899,2915,128,0
20141229.093555,2914,76,900102,10,2914,864,2915,138,0
20141229.093556,2914,8,900110,0,2914,860,2915,143,0
20141229.093556,2914,18,900128,10,2914,858,2915,138,0
20141229.093557,2914,32,900160,20,2914,847,2915,174,0
20141229.093558,2914,10,900170,4,2914,843,2915,180,0
20141229.093558,2915,42,900212,38,2914,843,2915,180,1
20141229.093558,2914,10,900222,0,2914,838,2915,201,0
20141229.093559,2914,152,900374,-40,2914,774,2915,275,0
20141229.0936,2914,16,900390,-10,2914,767,2915,320,0
20141229.093601,2914,42,900432,-24,2914,746,2915,373,0
20141229.093601,2915,12,900444,10,2914,745,2915,369,1
20141229.093602,2914,78,900522,6,2914,710,2915,392,0
20141229.093602,2914,28,900550,14,2914,787,2915,386,0
20141229.093603,2914,2,900552,0,2914,888,2915,401,0
20141229.093604,2914,10,900562,4,2914,884,2915,401,0
20141229.093604,2914,2,900564,0,2914,883,2915,408,0
20141229.093605,2914,22,900586,12,2914,789,2915,409,0
20141229.093605,2915,78,900664,78,2914,728,2915,402,1
20141229.093606,2914,10,900674,2,2914,723,2915,545,0
20141229.093606,2914,6,900680,0,2914,721,2915,564,0
20141229.093607,2914,24,900704,2,2914,707,2915,566,0
20141229.093607,2915,6,900710,2,2914,722,2915,544,1
20141229.093608,2914,16,900726,4,2914,701,2915,542,0
20141229.093609,2914,16,900742,6,2914,703,2915,599,0
20141229.09361,2914,2,900744,0,2914,702,2915,589,0
20141229.09361,2914,10,900754,2,2914,697,2915,589,0
20141229.09361,2914,20,900774,0,2914,727,2915,601,0
20141229.093611,2914,2,900776,0,2914,725,2915,601,0
20141229.093612,2914,22,900798,16,2914,715,2915,597,0
20141229.093612,2914,14,900812,4,2914,708,2915,602,0
20141229.093613,2914,12,900824,2,2914,702,2915,613,0
20141229.093613,2914,6,900830,0,2914,701,2915,625,0
20141229.093615,2914,18,900848,2,2914,705,2915,625,0
20141229.093615,2914,10,900858,10,2914,711,2915,617,0
20141229.093616,2914,12,900870,0,2914,705,2915,617,0
20141229.093616,2914,14,900884,0,2914,699,2915,617,0
20141229.093617,2914,2,900886,0,2914,719,2915,618,0
20141229.093617,2914,16,900902,0,2914,715,2915,616,0
20141229.093618,2914,6,900908,0,2914,712,2915,616,0
20141229.093618,2915,2,900910,2,2914,713,2915,615,1
20141229.093619,2914,8,900918,2,2914,683,2915,618,0
20141229.09362,2914,14,900932,2,2914,676,2915,639,0
20141229.09362,2914,6,900938,6,2914,665,2915,654,0
20141229.093621,2915,86,901024,30,2914,625,2915,657,1
20141229.093622,2914,8,901032,-6,2914,621,2915,683,0
20141229.093622,2914,2,901034,0,2914,623,2915,694,0
20141229.093623,2914,200,901234,78,2914,522,2915,704,0
20141229.093623,2914,6,901240,0,2914,539,2915,701,0
20141229.093624,2914,10,901250,4,2914,534,2915,696,0
20141229.093625,2915,22,901272,4,2914,526,2915,738,1
20141229.093625,2914,26,901298,0,2914,513,2915,734,0
20141229.093626,2914,16,901314,-14,2914,505,2915,735,0
20141229.093627,2914,4,901318,-4,2914,503,2915,780,0
20141229.093627,2915,16,901334,4,2914,461,2915,772,1
20141229.093628,2914,2,901336,0,2914,460,2915,796,0
20141229.093628,2914,22,901358,-12,2914,594,2915,738,0
20141229.093629,2914,2,901360,-2,2914,597,2915,740,0
20141229.093629,2914,36,901396,-26,2914,581,2915,736,0
20141229.09363,2914,8,901404,-8,2914,586,2915,836,0
20141229.093631,2914,2,901406,-2,2914,612,2915,837,0
20141229.093632,2914,16,901422,-8,2914,604,2915,839,0
20141229.093632,2914,4,901426,4,2914,602,2915,784,0
20141229.093632,2914,10,901436,4,2914,599,2915,784,0
20141229.093633,2914,4,901440,2,2914,597,2915,786,0
20141229.093633,2914,216,901656,12,2914,493,2915,740,0
20141229.093634,2914,2,901658,0,2914,492,2915,740,0
20141229.093634,2914,28,901686,-8,2914,478,2915,742,0
20141229.093635,2914,22,901708,0,2914,467,2915,742,0
20141229.093636,2914,12,901720,-6,2914,461,2915,743,0
20141229.093636,2914,52,901772,-8,2914,437,2915,803,0
20141229.093636,2914,28,901800,22,2914,423,2915,803,0
20141229.093637,2914,32,901832,2,2914,407,2915,1804,0
20141229.093638,2914,814,902646,504,2913,573,2914,136,0
20141229.093638,2913,12,902658,-2,2913,510,2914,291,0
20141229.093639,2913,2,902660,0,2913,509,2914,300,0
20141229.093639,2913,54,902714,-2,2913,484,2914,307,0
20141229.09364,2914,10,902724,-4,2913,516,2914,313,1
20141229.093641,2913,8,902732,2,2913,518,2914,310,0
20141229.093641,2913,42,902774,2,2913,499,2914,320,0
20141229.093642,2914,4,902778,0,2913,506,2914,320,1
20141229.093642,2913,38,902816,20,2913,492,2914,345,0
20141229.093642,2913,240,903056,-100,2913,372,2914,350,0
20141229.093643,2914,152,903208,24,2913,298,2914,292,1
20141229.093644,2913,22,903230,-10,2913,295,2914,292,0
20141229.093645,2913,16,903246,8,2913,287,2914,1349,0
20141229.093645,2913,6,903252,0,2913,283,2914,3357,0
20141229.093646,2913,82,903334,-42,2913,242,2914,3367,0
20141229.093646,2913,68,903402,-68,2913,208,2914,356,0
20141229.093647,2913,6,903408,-6,2913,270,2914,396,0
20141229.093647,2913,126,903534,-116,2913,419,2914,406,0
20141229.093648,2913,90,903624,-88,2913,458,2914,408,0
20141229.093648,2913,8,903632,-8,2913,454,2914,408,0
20141229.093649,2914,2,903634,0,2913,455,2914,412,1
20141229.093649,2913,16,903650,-16,2913,449,2914,417,0
20141229.09365,2914,22,903672,0,2913,448,2914,358,1
20141229.09365,2913,12,903684,-8,2913,442,2914,359,0
20141229.093651,2914,144,903828,-88,2913,393,2914,390,1
20141229.093651,2913,12,903840,2,2913,388,2914,390,0
20141229.093652,2913,454,904294,-282,2913,185,2914,368,0
20141229.093652,2913,54,904348,-54,2913,158,2914,439,0
20141229.093653,2913,14,904362,-10,2913,75,2914,442,0
20141229.093653,2913,50,904412,-6,2913,130,2914,447,0
20141229.093654,2913,22,904434,-18,2913,121,2914,448,0
20141229.093655,2913,116,904550,2,2913,193,2914,448,0
20141229.093655,2913,14,904564,2,2913,186,2914,455,0
20141229.093656,2913,4,904568,2,2913,793,2914,456,0
20141229.093656,2913,16,904584,2,2913,786,2914,457,0
20141229.093656,2913,8,904592,2,2913,782,2914,457,0
20141229.093657,2913,30,904622,-4,2913,769,2914,455,0
20141229.093658,2913,432,905054,-376,2913,565,2914,447,0
20141229.093658,2913,10,905064,-10,2913,566,2914,456,0
20141229.093659,2913,4,905068,0,2913,219,2914,471,0
20141229.093659,2913,8,905076,-8,2913,216,2914,478,0
20141229.0937,2913,202,905278,-2,2913,115,2914,523,0
20141229.0937,2913,50,905328,-10,2913,90,2914,574,0
20141229.093701,2913,184,905512,-160,2913,59,2914,567,0
20141229.093701,2913,12,905524,2,2913,53,2914,564,0
20141229.093702,2912,112,905636,100,2912,1148,2913,232,0
20141229.093702,2912,26,905662,-26,2912,1143,2913,366,0
20141229.093702,2912,26,905688,-26,2912,1131,2913,388,0
20141229.093703,2912,30,905718,-30,2912,1116,2913,419,0
20141229.093704,2912,74,905792,-62,2912,1083,2913,418,0
20141229.093704,2912,8,905800,-6,2912,1056,2913,428,0
20141229.093705,2912,8,905808,4,2912,1055,2913,432,0
20141229.093706,2912,130,905938,-124,2912,993,2913,434,0
20141229.093706,2912,60,905998,-60,2912,964,2913,444,0
20141229.093707,2912,20,906018,-18,2912,954,2913,451,0
20141229.093707,2912,4,906022,-4,2912,952,2913,451,0
20141229.093708,2912,80,906102,2,2912,916,2913,449,0
20141229.093708,2912,40,906142,-40,2912,896,2913,450,0
20141229.093709,2912,28,906170,-28,2912,888,2913,450,0
20141229.093709,2913,2,906172,2,2912,880,2913,450,1
20141229.09371,2912,6,906178,-6,2912,877,2913,451,0
20141229.09371,2912,4,906182,0,2912,876,2913,457,0
20141229.093711,2913,28,906210,-16,2912,964,2913,462,1
20141229.093711,2913,6,906216,4,2912,972,2913,491,1
20141229.093713,2912,72,906288,-72,2912,936,2913,543,0
20141229.093713,2912,6,906294,-2,2912,933,2913,430,0
20141229.093713,2912,6,906300,-6,2912,930,2913,441,0
20141229.093714,2912,18,906318,0,2912,929,2913,433,0
20141229.093715,2913,2,906320,2,2912,929,2913,434,1
20141229.093715,2912,68,906388,-6,2912,951,2913,435,0
20141229.093716,2912,2,906390,-2,2912,956,2913,539,0
20141229.093716,2912,28,906418,-28,2912,942,2913,541,0
20141229.093717,2912,12,906430,-8,2912,937,2913,560,0
20141229.093717,2913,2,906432,2,2912,937,2913,560,1
20141229.093718,2912,2,906434,0,2912,963,2913,560,0
20141229.093718,2912,4,906438,-4,2912,961,2913,560,0
20141229.093719,2912,34,906472,-2,2912,946,2913,568,0
20141229.093719,2912,12,906484,-6,2912,940,2913,570,0
20141229.093719,2912,28,906512,-26,2912,926,2913,571,0
20141229.09372,2912,34,906546,-34,2912,910,2913,581,0
20141229.09372,2912,26,906572,-6,2912,900,2913,581,0
20141229.093721,2913,18,906590,2,2912,901,2913,596,1
20141229.093722,2912,8,906598,-6,2912,898,2913,615,0
20141229.093722,2913,14,906612,-4,2912,895,2913,612,1
20141229.093723,2912,10,906622,-8,2912,890,2913,614,0
20141229.093723,2912,8,906630,-8,2912,886,2913,618,0
20141229.093724,2912,8,906638,-6,2912,882,2913,618,0
20141229.093724,2912,24,906662,-16,2912,872,2913,617,0
20141229.093725,2912,16,906678,4,2912,868,2913,613,0
20141229.093725,2913,10,906688,-10,2912,868,2913,609,1
20141229.093726,2912,10,906698,-8,2912,873,2913,611,0
20141229.093726,2912,4,906702,-2,2912,871,2913,620,0
20141229.093727,2913,24,906726,-8,2912,861,2913,619,1
20141229.093727,2913,8,906734,-8,2912,861,2913,614,1
20141229.093728,2912,408,907142,0,2912,659,2913,611,0
20141229.093728,2912,22,907164,-14,2912,652,2913,609,0
20141229.093729,2912,22,907186,-6,2912,642,2913,609,0
20141229.093729,2912,26,907212,4,2912,630,2913,617,0
20141229.09373,2912,14,907226,6,2912,624,2913,605,0
20141229.09373,2912,14,907240,2,2912,622,2913,613,0
20141229.093731,2912,14,907254,0,2912,616,2913,616,0
20141229.093731,2912,20,907274,-10,2912,612,2913,610,0
20141229.093732,2912,18,907292,4,2912,603,2913,611,0
20141229.093732,2912,6,907298,0,2912,620,2913,611,0
20141229.093733,2912,20,907318,12,2912,610,2913,611,0
20141229.093733,2913,56,907374,-4,2912,585,2913,609,1
20141229.093734,2913,8,907382,-4,2912,585,2913,604,1
20141229.093734,2912,1180,908562,246,2911,584,2912,627,0
20141229.093735,2912,232,908794,184,2911,578,2912,522,0
20141229.093736,2911,6,908800,0,2911,560,2912,553,0
20141229.093736,2912,154,908954,60,2911,488,2912,567,1
20141229.093737,2911,10,908964,-10,2911,488,2912,569,0
20141229.093737,2912,8,908972,4,2911,486,2912,599,1
20141229.093738,2912,10,908982,-2,2911,483,2912,600,1
20141229.093738,2912,12,908994,8,2911,509,2912,595,1
20141229.093739,2912,24,909018,2,2911,509,2912,615,1
20141229.093739,2911,110,909128,0,2911,508,2912,584,0
20141229.09374,2911,2,909130,0,2911,591,2912,586,0
20141229.09374,2911,64,909194,-28,2911,560,2912,588,0
20141229.093741,2912,8,909202,0,2911,560,2912,589,1
20141229.093741,2911,18,909220,-10,2911,551,2912,590,0
20141229.093742,2911,20,909240,-10,2911,541,2912,590,0
20141229.093742,2911,12,909252,4,2911,535,2912,591,0
20141229.093743,2911,64,909316,-14,2911,511,2912,592,0
20141229.093743,2911,6,909322,-6,2911,428,2912,593,0
20141229.093744,2912,40,909362,-16,2911,419,2912,588,1
20141229.093745,2911,34,909396,-2,2911,404,2912,587,0
20141229.093745,2911,34,909430,10,2911,387,2912,589,0
20141229.093746,2911,12,909442,6,2911,389,2912,590,0
20141229.093746,2911,26,909468,26,2911,381,2912,609,0
20141229.093747,2911,72,909540,2,2911,356,2912,600,0
20141229.093747,2911,6,909546,6,2911,354,2912,610,0
20141229.093748,2911,8,909554,0,2911,356,2912,609,0
20141229.093748,2911,24,909578,20,2911,344,2912,641,0
20141229.093749,2911,22,909600,0,2911,334,2912,642,0
20141229.093749,2911,6,909606,2,2911,334,2912,644,0
20141229.09375,2911,62,909668,4,2911,304,2912,644,0
20141229.093751,2911,10,909678,0,2911,307,2912,649,0
20141229.093751,2911,20,909698,0,2911,298,2912,650,0
20141229.093752,2911,20,909718,-2,2911,294,2912,651,0
20141229.093752,2911,26,909744,-26,2911,281,2912,651,0
20141229.093753,2911,14,909758,-12,2911,275,2912,652,0
20141229.093753,2911,4,909762,-2,2911,276,2912,651,0
20141229.093754,2911,12,909774,-6,2911,282,2912,650,0
20141229.093754,2911,74,909848,-56,2911,252,2912,658,0
20141229.093755,2911,8,909856,-6,2911,250,2912,660,0
20141229.093755,2911,2,909858,-2,2911,255,2912,660,0
20141229.093756,2911,26,909884,-26,2911,243,2912,660,0
20141229.093756,2911,44,909928,-42,2911,221,2912,659,0
20141229.093757,2911,10,909938,-8,2911,216,2912,644,0
20141229.093757,2911,10,909948,-8,2911,207,2912,646,0
20141229.093758,2911,6,909954,-6,2911,204,2912,646,0
20141229.093758,2911,24,909978,-24,2911,192,2912,648,0
20141229.093759,2911,38,910016,-36,2911,193,2912,648,0
20141229.093759,2911,50,910066,-26,2911,171,2912,655,0
20141229.0938,2911,22,910088,0,2911,207,2912,652,0
20141229.0938,2911,8,910096,4,2911,459,2912,652,0
20141229.093801,2912,74,910170,-32,2911,429,2912,650,1
20141229.093801,2911,252,910422,-138,2911,394,2912,650,0
20141229.093802,2911,12,910434,-8,2911,412,2912,652,0
20141229.093802,2911,2,910436,-2,2911,411,2912,652,0
20141229.093803,2911,64,910500,-56,2911,413,2912,650,0
20141229.093804,2911,44,910544,42,2911,415,2912,632,0
20141229.093804,2911,6,910550,-6,2911,412,2912,643,0
20141229.093804,2912,30,910580,24,2911,399,2912,644,1
20141229.093805,2911,46,910626,0,2911,376,2912,644,0
20141229.093806,2911,26,910652,26,2911,369,2912,640,0
20141229.093806,2911,26,910678,20,2911,356,2912,641,0
20141229.093807,2911,4,910682,0,2911,355,2912,644,0
20141229.093807,2911,12,910694,4,2911,350,2912,644,0
20141229.093808,2912,2,910696,2,2911,351,2912,643,1
20141229.093808,2911,8,910704,0,2911,347,2912,647,0
20141229.093809,2911,2,910706,2,2911,350,2912,704,0
20141229.093809,2911,46,910752,0,2911,356,2912,701,0
20141229.09381,2911,14,910766,2,2911,356,2912,641,0
20141229.093811,2911,8,910774,0,2911,352,2912,626,0
20141229.093811,2911,2,910776,0,2911,352,2912,626,0
20141229.093812,2911,8,910784,2,2911,348,2912,626,0
20141229.093812,2911,8,910792,8,2911,349,2912,626,0
20141229.093812,2911,2,910794,0,2911,349,2912,626,0
20141229.093813,2911,18,910812,2,2911,342,2912,626,0
20141229.093813,2911,14,910826,0,2911,335,2912,626,0
20141229.093814,2911,2,910828,2,2911,340,2912,623,0
20141229.093814,2911,6,910834,0,2911,337,2912,623,0
20141229.093815,2911,446,911280,338,2911,124,2912,626,0
20141229.093815,2911,4,911284,4,2911,124,2912,711,0
20141229.093816,2911,16,911300,10,2911,136,2912,750,0
20141229.093816,2911,6,911306,-2,2911,150,2912,750,0
20141229.093817,2911,16,911322,0,2911,144,2912,755,0
20141229.093818,2911,120,911442,-46,2911,90,2912,762,0
20141229.093818,2911,16,911458,-2,2911,82,2912,781,0
20141229.093819,2911,4,911462,-4,2911,80,2912,781,0
20141229.09382,2911,2,911464,-2,2911,219,2912,771,0
20141229.09382,2911,10,911474,-8,2911,214,2912,733,0
20141229.093821,2911,4,911478,-4,2911,237,2912,734,0
20141229.093821,2911,4,911482,0,2911,306,2912,621,0
20141229.093822,2911,126,911608,-20,2911,267,2912,605,0
20141229.093822,2911,2,911610,0,2911,267,2912,605,0
20141229.093823,2911,18,911628,0,2911,610,2912,605,0
20141229.093824,2911,8,911636,-6,2911,608,2912,604,0
20141229.093824,2911,306,911942,-16,2911,458,2912,601,0
20141229.093825,2911,12,911954,-8,2911,483,2912,622,0
20141229.093825,2911,10,911964,-10,2911,478,2912,624,0
20141229.093826,2911,2,911966,0,2911,478,2912,624,0
20141229.093826,2911,60,912026,54,2911,458,2912,631,0
20141229.093827,2911,2,912028,2,2911,471,2912,631,0
20141229.093828,2911,2,912030,0,2911,476,2912,653,0
20141229.093828,2912,2,912032,0,2911,526,2912,653,1
20141229.093829,2912,2,912034,0,2911,530,2912,652,1
20141229.093829,2911,2,912036,0,2911,529,2912,652,0
20141229.09383,2911,4,912040,0,2911,528,2912,653,0
20141229.09383,2911,10,912050,10,2911,524,2912,654,0
20141229.093831,2912,6,912056,0,2911,523,2912,652,1
20141229.093832,2912,4,912060,4,2911,524,2912,650,1
20141229.093833,2911,4,912064,4,2911,532,2912,5683,0
20141229.093834,2911,42,912106,42,2911,729,2912,5665,0
20141229.093835,2911,12,912118,12,2911,730,2912,5665,0
20141229.093835,2912,6,912124,2,2911,729,2912,5663,1
20141229.093836,2912,64,912188,-18,2911,711,2912,3657,1
20141229.093837,2911,30,912218,-6,2911,708,2912,3657,0
20141229.093837,2912,24,912242,2,2911,696,2912,2651,1
20141229.093838,2912,10,912252,4,2911,694,2912,2677,1
20141229.093838,2912,14,912266,8,2911,711,2912,2672,1
20141229.093839,2911,4,912270,-4,2911,709,2912,2772,0
20141229.09384,2911,28,912298,-2,2911,697,2912,769,0
20141229.093841,2912,6,912304,0,2911,716,2912,763,1
20141229.093842,2911,2,912306,-2,2911,716,2912,763,0
20141229.093842,2912,18,912324,-12,2911,712,2912,759,1
20141229.093843,2912,20,912344,20,2911,670,2912,748,1
20141229.093844,2912,2,912346,2,2911,670,2912,744,1
20141229.093845,2912,22,912368,0,2911,671,2912,735,1
20141229.093845,2911,2,912370,-2,2911,676,2912,781,0
20141229.093846,2912,2,912372,2,2911,676,2912,780,1
20141229.093846,2911,20,912392,-20,2911,668,2912,781,0
20141229.093847,2911,2,912394,-2,2911,669,2912,783,0
20141229.09385,2912,22,912416,-20,2911,566,2912,804,1
20141229.093851,2912,80,912496,0,2911,548,2912,784,1
20141229.093852,2912,10,912506,6,2911,547,2912,925,1
20141229.093854,2912,4,912510,0,2911,547,2912,926,1
20141229.093856,2911,4,912514,0,2911,498,2912,1198,0
20141229.093856,2911,2,912516,-2,2911,499,2912,1201,0
20141229.093858,2912,2,912518,0,2911,499,2912,1198,1
20141229.093859,2912,106,912624,10,2911,442,2912,1198,1
20141229.093859,2911,22,912646,-2,2911,430,2912,1228,0
20141229.0939,2912,2,912648,0,2911,430,2912,1228,1
20141229.0939,2911,2,912650,-2,2911,430,2912,1228,0
20141229.093901,2912,4,912654,2,2911,437,2912,1227,1
20141229.093901,2912,2,912656,2,2911,437,2912,1226,1
20141229.093902,2911,44,912700,0,2911,419,2912,1226,0
20141229.093903,2912,668,913368,356,2911,407,2912,894,1
20141229.093904,2911,4,913372,-2,2911,407,2912,897,0
20141229.093904,2912,338,913710,204,2911,407,2912,750,1
20141229.093905,2912,24,913734,4,2911,397,2912,748,1
20141229.093906,2912,2,913736,0,2911,437,2912,747,1
20141229.093906,2911,6,913742,-6,2911,442,2912,749,0
20141229.093907,2912,20,913762,20,2911,452,2912,702,1
20141229.093907,2912,34,913796,8,2911,452,2912,679,1
20141229.093908,2912,2,913798,2,2911,473,2912,670,1
20141229.093908,2912,40,913838,34,2911,475,2912,519,1
20141229.093909,2911,8,913846,-2,2911,475,2912,280,0
20141229.093909,2912,30,913876,6,2911,477,2912,265,1
20141229.09391,2912,236,914112,-180,2911,481,2912,156,1
20141229.09391,2912,420,914532,-136,2911,581,2912,78,1
20141229.093911,2912,158,914690,2,2912,2,2913,912,1
20141229.093911,2912,2,914692,-2,2912,84,2913,910,1
20141229.093912,2912,4,914696,0,2912,88,2913,910,1
20141229.093912,2912,2,914698,0,2912,90,2913,910,1
20141229.093913,2912,4,914702,0,2912,138,2913,900,1
20141229.093913,2913,4,914706,-2,2912,153,2913,899,1
20141229.093914,2912,428,915134,-186,2911,627,2912,239,0
20141229.093915,2912,6,915140,0,2911,519,2912,454,0
20141229.093915,2912,4,915144,-2,2911,518,2912,553,0
20141229.093916,2912,16,915160,-2,2911,638,2912,507,0
20141229.093916,2912,132,915292,0,2911,638,2912,452,0
20141229.093917,2911,6,915298,-4,2911,639,2912,453,0
20141229.093918,2912,4,915302,-2,2911,639,2912,513,1
20141229.093919,2912,4,915306,0,2911,529,2912,706,1
20141229.093919,2912,6,915312,-4,2911,529,2912,710,1
20141229.093921,2912,8,915320,0,2911,514,2912,702,1
20141229.093922,2912,34,915354,-16,2911,515,2912,714,1
20141229.093923,2912,10,915364,0,2911,514,2912,874,1
20141229.093923,2911,46,915410,-2,2911,499,2912,850,0
20141229.093925,2912,2,915412,0,2911,532,2912,855,1
20141229.093926,2912,10,915422,-10,2911,533,2912,851,1
20141229.093927,2911,6,915428,-2,2911,532,2912,850,0
20141229.093927,2912,18,915446,-18,2911,528,2912,845,1
20141229.093928,2912,36,915482,-24,2911,532,2912,831,1
20141229.093929,2911,10,915492,-10,2911,507,2912,903,0
20141229.09393,2911,16,915508,14,2911,509,2912,896,0
20141229.09393,2911,48,915556,32,2911,505,2912,876,0
20141229.093931,2912,4,915560,4,2911,507,2912,899,1
20141229.093931,2911,2,915562,-2,2911,538,2912,899,0
20141229.093932,2911,46,915608,-2,2911,535,2912,854,0
20141229.093932,2911,2,915610,0,2911,535,2912,854,0
20141229.093932,2912,1662,917272,-1454,2911,553,2912,27,1
20141229.093933,2912,160,917432,96,2912,151,2913,881,1
20141229.093934,2912,4,917436,-4,2912,154,2913,920,1
20141229.093934,2912,18,917454,-6,2912,93,2913,916,1
20141229.093934,2912,156,917610,-156,2912,19,2913,916,1
20141229.093935,2912,40,917650,4,2911,578,2912,179,1
20141229.093936,2912,2,917652,2,2911,578,2912,238,1
20141229.093936,2912,6,917658,6,2911,778,2912,176,1
20141229.093937,2912,358,918016,346,2912,514,2913,1032,1
20141229.093938,2913,406,918422,-144,2912,594,2913,681,1
20141229.093939,2912,4,918426,2,2912,601,2913,682,0
20141229.093939,2912,2,918428,0,2912,601,2913,683,0
20141229.09394,2913,20,918448,12,2912,601,2913,688,1
20141229.093941,2912,20,918468,20,2912,591,2913,722,0
20141229.093942,2912,18,918486,6,2912,586,2913,721,0
20141229.093943,2913,6,918492,-6,2912,585,2913,723,1
20141229.093943,2912,150,918642,100,2912,587,2913,654,0
20141229.093944,2913,4,918646,2,2912,610,2913,656,1
20141229.093945,2913,36,918682,22,2912,602,2913,724,1
20141229.093946,2912,2,918684,0,2912,603,2913,727,0
20141229.093947,2913,10,918694,0,2912,604,2913,724,1
20141229.093947,2913,24,918718,-18,2912,633,2913,714,1
20141229.093948,2913,2,918720,0,2912,633,2913,717,1
20141229.093948,2912,4,918724,2,2912,632,2913,716,0
20141229.09395,2913,6,918730,4,2912,655,2913,732,1
20141229.093951,2913,12,918742,10,2912,652,2913,732,1
20141229.093951,2913,202,918944,2,2912,553,2913,731,1
20141229.093952,2913,32,918976,14,2912,555,2913,716,1
20141229.093952,2912,10,918986,6,2912,570,2913,712,0
20141229.093953,2913,12,918998,6,2912,569,2913,708,1
20141229.093954,2913,4,919002,0,2912,573,2913,706,1
20141229.093955,2913,2,919004,2,2912,579,2913,711,1
20141229.093956,2913,540,919544,256,2912,569,2913,451,1
20141229.093957,2913,4,919548,4,2912,569,2913,407,1
20141229.093958,2913,42,919590,-12,2912,569,2913,394,1
20141229.093959,2913,8,919598,0,2912,572,2913,391,1
20141229.094,2912,30,919628,22,2912,568,2913,382,0
20141229.094,2912,4,919632,0,2912,569,2913,383,0
20141229.094001,2913,48,919680,0,2912,572,2913,362,1
20141229.094001,2913,22,919702,14,2912,572,2913,363,1
20141229.094002,2913,32,919734,2,2912,571,2913,358,1
20141229.094003,2912,24,919758,0,2912,577,2913,361,0
20141229.094004,2913,64,919822,8,2912,569,2913,353,1
20141229.094005,2913,12,919834,12,2912,573,2913,355,1
20141229.094006,2913,68,919902,-16,2912,555,2913,347,1
20141229.094007,2913,58,919960,-40,2912,565,2914,536,1
20141229.094008,2912,2,919962,2,2912,636,2913,320,0
20141229.094008,2913,2,919964,0,2912,636,2913,309,1
20141229.094009,2913,24,919988,-2,2912,646,2913,267,1
20141229.094009,2913,26,920014,0,2912,636,2914,531,1
20141229.09401,2913,2,920016,-2,2912,586,2914,541,1
20141229.094011,2913,20,920036,-8,2913,200,2914,658,1
20141229.094011,2913,18,920054,-16,2913,243,2914,622,1
20141229.094012,2913,218,920272,-154,2913,135,2914,693,1
20141229.094012,2913,40,920312,0,2913,211,2914,657,1
20141229.094013,2914,12,920324,0,2913,247,2914,659,1
20141229.094013,2913,2,920326,2,2913,246,2914,644,0
20141229.094014,2913,6,920332,0,2913,255,2914,642,0
20141229.094015,2914,14,920346,-6,2913,256,2914,639,1
20141229.094017,2913,6,920352,2,2913,266,2914,663,0
20141229.094018,2913,20,920372,0,2913,324,2914,674,0
20141229.09402,2914,4,920376,-4,2913,338,2914,676,1
20141229.094021,2914,34,920410,0,2913,350,2914,681,1
20141229.094021,2913,2,920412,2,2913,349,2914,680,0
20141229.094023,2913,42,920454,2,2913,347,2914,662,0
20141229.094024,2913,2,920456,2,2913,359,2914,683,0
20141229.094025,2914,8,920464,0,2913,358,2914,686,1
20141229.094025,2914,52,920516,-2,2913,359,2914,697,1
20141229.094026,2914,26,920542,24,2913,347,2914,695,1
20141229.094026,2914,14,920556,8,2913,350,2914,688,1
20141229.094027,2913,4,920560,0,2913,350,2914,688,0
20141229.094028,2913,2,920562,0,2913,349,2914,691,0
20141229.094028,2914,40,920602,40,2913,351,2914,668,1
20141229.094029,2913,2,920604,0,2913,352,2914,667,0
20141229.094029,2913,22,920626,2,2913,341,2914,668,0
20141229.09403,2914,8,920634,8,2913,341,2914,665,1
20141229.09403,2914,4,920638,4,2913,341,2914,663,1
20141229.094031,2913,10,920648,0,2913,337,2914,675,0
20141229.094031,2914,4,920652,0,2913,338,2914,675,1
20141229.094033,2913,2,920654,0,2913,342,2914,660,0
20141229.094034,2913,2,920656,0,2913,341,2914,661,0
20141229.094036,2913,2,920658,-2,2913,341,2914,698,0
20141229.094037,2914,78,920736,-2,2913,324,2914,743,1
20141229.094037,2913,2,920738,0,2913,323,2914,743,0
20141229.094038,2914,120,920858,20,2913,323,2914,687,1
20141229.094039,2914,2,920860,0,2913,323,2914,686,1
20141229.09404,2914,6,920866,6,2913,357,2914,683,1
20141229.094044,2913,6,920872,4,2913,333,2914,686,0
20141229.094044,2914,24,920896,0,2913,333,2914,674,1
20141229.094045,2914,10,920906,10,2913,365,2914,669,1
20141229.094047,2913,6,920912,2,2913,366,2914,670,0
20141229.094048,2914,416,921328,256,2913,366,2914,462,1
20141229.094048,2914,10,921338,0,2913,367,2914,458,1
20141229.094049,2914,136,921474,118,2913,367,2914,350,1
20141229.09405,2914,268,921742,142,2913,377,2915,1682,1
20141229.09405,2913,2,921744,2,2913,376,2915,1679,0
20141229.094051,2914,10,921754,10,2913,366,2914,233,1
20141229.094051,2913,40,921794,0,2913,346,2914,234,0
20141229.094053,2914,24,921818,20,2913,375,2914,269,1
20141229.094054,2914,846,922664,352,2912,1224,2913,2,1
20141229.094054,2913,122,922786,22,2913,100,2914,644,0
20141229.094056,2914,20,922806,-12,2913,132,2914,712,1
20141229.094057,2913,16,922822,-10,2913,126,2914,787,0
20141229.094057,2913,20,922842,-20,2913,116,2914,786,0
20141229.094058,2913,6,922848,-6,2913,124,2914,777,0
20141229.094058,2914,8,922856,0,2913,124,2914,777,1
20141229.094058,2913,4,922860,-2,2913,122,2914,778,0
20141229.094059,2913,20,922880,-20,2913,113,2914,771,0
20141229.0941,2913,232,923112,66,2912,1273,2914,627,0
20141229.0941,2913,26,923138,0,2912,1273,2914,630,0
20141229.094101,2913,10,923148,6,2912,1282,2913,246,0
20141229.094101,2912,2,923150,0,2912,1281,2913,291,0
20141229.094103,2913,6,923156,6,2912,1268,2913,326,1
20141229.094103,2913,40,923196,30,2912,1273,2913,308,1
20141229.094104,2913,40,923236,40,2912,1273,2913,304,1
20141229.094106,2913,56,923292,38,2912,1190,2913,323,1
20141229.094106,2912,2,923294,0,2912,1187,2913,323,0
20141229.094107,2912,8,923302,6,2912,1183,2913,322,0
20141229.094109,2912,44,923346,44,2912,1162,2913,357,0
20141229.09411,2912,4,923350,0,2912,1161,2913,367,0
20141229.094111,2912,26,923376,26,2912,1158,2913,358,0
20141229.094111,2913,34,923410,20,2912,1159,2913,346,1
20141229.094112,2912,12,923422,8,2912,1159,2913,347,0
20141229.094113,2913,2,923424,2,2912,1159,2913,347,1
20141229.094115,2913,4,923428,-4,2912,1159,2913,351,1
20141229.094116,2912,42,923470,2,2912,1138,2913,352,0
20141229.094117,2913,20,923490,0,2912,1138,2913,342,1
20141229.094117,2912,4,923494,0,2912,1137,2913,342,0
20141229.094118,2913,20,923514,0,2912,1137,2913,333,1
20141229.094119,2912,6,923520,2,2912,1135,2913,332,0
20141229.094119,2913,6,923526,0,2912,1135,2913,329,1
20141229.09412,2913,2,923528,0,2912,1133,2913,334,1
20141229.094121,2912,20,923548,20,2912,1122,2913,333,0
20141229.094123,2912,2,923550,0,2912,1107,2913,333,0
20141229.094124,2913,6,923556,-4,2912,1108,2913,371,1
20141229.094125,2912,4,923560,4,2912,1106,2913,376,0
20141229.094126,2913,28,923588,12,2912,1096,2913,381,1
20141229.094128,2913,1022,924610,316,2912,1105,2913,1,1
20141229.094128,2913,8,924618,-2,2913,121,2914,535,1
20141229.094128,2913,56,924674,44,2913,97,2914,553,1
20141229.094129,2914,20,924694,10,2913,187,2914,544,1
20141229.09413,2913,1014,925708,624,2913,262,2914,27,0
20141229.09413,2913,24,925732,22,2913,382,2914,120,0
20141229.094131,2914,230,925962,100,2913,387,2915,1900,1
20141229.094131,2913,4,925966,2,2913,444,2915,1905,0
20141229.094132,2913,20,925986,20,2913,434,2915,1905,0
20141229.094133,2913,2,925988,0,2913,433,2915,1906,0
20141229.094134,2915,1002,926990,580,2913,444,2915,1381,1
20141229.094134,2913,2,926992,0,2913,423,2915,1384,0
20141229.094135,2915,8,927000,-4,2913,422,2915,1380,1
20141229.094136,2915,1000,928000,0,2913,422,2915,875,1
20141229.094136,2915,6,928006,-6,2913,447,2915,875,1
20141229.094137,2914,4,928010,-2,2914,163,2915,874,0
20141229.094137,2914,166,928176,-124,2914,188,2915,854,0
20141229.094139,2915,10,928186,-10,2914,313,2915,884,1
20141229.094139,2914,144,928330,2,2914,241,2915,885,0
20141229.09414,2915,2,928332,0,2914,238,2915,855,1
20141229.094141,2914,100,928432,-80,2914,189,2915,874,0
20141229.094142,2914,262,928694,0,2914,184,2915,738,0
20141229.094143,2914,210,928904,-104,2914,137,2915,686,0
20141229.094144,2914,10,928914,0,2914,133,2915,692,0
20141229.094145,2915,16,928930,-14,2914,126,2915,701,1
20141229.094145,2914,2,928932,-2,2914,125,2915,701,0
20141229.094146,2914,60,928992,-56,2914,99,2915,682,0
20141229.094147,2914,10,929002,0,2914,177,2915,680,0
20141229.094147,2914,284,929286,-4,2914,177,2915,551,0
20141229.094148,2914,52,929338,-6,2914,170,2915,538,0
20141229.094149,2914,2,929340,0,2914,171,2915,568,0
20141229.094149,2914,80,929420,24,2914,144,2915,556,0
20141229.09415,2914,68,929488,66,2914,143,2915,525,0
20141229.094151,2914,10,929498,0,2914,135,2915,549,0
20141229.094153,2915,440,929938,262,2914,145,2915,377,1
20141229.094153,2914,2,929940,0,2914,169,2915,377,0
20141229.094154,2914,60,930000,12,2914,150,2915,367,0
20141229.094154,2915,4,930004,0,2914,165,2915,373,1
20141229.094155,2915,192,930196,-4,2914,156,2915,291,1
20141229.094156,2914,10,930206,10,2914,151,2915,298,0
20141229.094157,2915,42,930248,38,2914,154,2915,301,1
20141229.094158,2914,4,930252,0,2914,160,2915,325,0
20141229.094159,2915,152,930404,6,2914,151,2915,459,1
20141229.094159,2914,40,930444,20,2914,142,2915,452,0
20141229.0942,2914,2,930446,2,2914,149,2915,455,0
20141229.0942,2914,12,930458,12,2914,148,2915,454,0
20141229.094201,2915,20,930478,0,2914,138,2915,444,1
20141229.094201,2914,24,930502,24,2914,126,2915,444,0
20141229.094202,2915,138,930640,136,2914,129,2915,376,1
20141229.094202,2914,4,930644,2,2914,212,2915,376,0
20141229.094203,2914,4,930648,0,2914,242,2915,377,0
20141229.094203,2914,12,930660,0,2914,236,2915,406,0
20141229.094204,2914,18,930678,8,2914,234,2915,399,0
20141229.094204,2914,18,930696,12,2914,226,2915,396,0
20141229.094205,2914,40,930736,26,2914,220,2915,382,0
20141229.094205,2914,42,930778,24,2914,232,2915,416,0
20141229.094206,2914,6,930784,0,2914,229,2915,413,0
20141229.094206,2914,2,930786,2,2914,229,2915,413,0
20141229.094207,2914,8,930794,2,2914,225,2915,415,0
20141229.094207,2914,12,930806,12,2914,219,2915,422,0
20141229.094208,2914,6,930812,0,2914,216,2915,435,0
20141229.094208,2915,24,930836,24,2914,221,2915,424,1
20141229.094209,2915,8,930844,8,2914,219,2915,424,1
20141229.094209,2914,6,930850,0,2914,216,2915,421,0
20141229.09421,2914,24,930874,10,2914,245,2915,422,0
20141229.094211,2915,28,930902,2,2914,249,2915,411,1
20141229.094211,2914,8,930910,-8,2914,245,2915,408,0
20141229.094212,2915,14,930924,-2,2914,238,2915,409,1
20141229.094212,2914,6,930930,-6,2914,235,2915,409,0
20141229.094213,2915,38,930968,10,2914,235,2915,392,1
20141229.094214,2914,8,930976,-4,2914,234,2915,381,0
20141229.094215,2915,14,930990,10,2914,234,2915,407,1
20141229.094216,2915,8,930998,-4,2914,231,2915,405,1
20141229.094216,2915,4,931002,4,2914,245,2915,404,1
20141229.094217,2914,6,931008,0,2914,246,2915,402,0
20141229.094217,2915,28,931036,24,2914,245,2915,389,1
20141229.094218,2914,4,931040,4,2914,243,2915,390,0
20141229.094219,2914,46,931086,40,2914,237,2915,361,0
20141229.09422,2915,74,931160,74,2914,236,2915,435,1
20141229.094221,2915,10,931170,4,2914,233,2915,442,1
20141229.094221,2915,2,931172,2,2914,243,2915,443,1
20141229.094222,2914,8,931180,2,2914,239,2915,451,0
20141229.094223,2914,4,931184,4,2914,240,2915,451,0
20141229.094223,2914,20,931204,20,2914,277,2915,443,0
20141229.094224,2914,26,931230,-10,2914,264,2915,444,0
20141229.094224,2914,10,931240,0,2914,268,2915,435,0
20141229.094226,2914,86,931326,22,2914,255,2915,424,0
20141229.094227,2915,40,931366,22,2914,241,2915,428,1
20141229.094227,2914,14,931380,14,2914,240,2915,422,0
20141229.094228,2914,128,931508,-4,2914,176,2915,433,0
20141229.094228,2914,404,931912,184,2914,234,2915,549,0
20141229.094229,2914,10,931922,4,2914,299,2915,435,0
20141229.094229,2914,2,931924,0,2914,298,2915,438,0
20141229.09423,2914,6,931930,0,2914,300,2915,437,0
20141229.094231,2914,26,931956,0,2914,287,2915,437,0
20141229.094231,2914,2,931958,2,2914,287,2915,439,0
20141229.094232,2914,6,931964,0,2914,286,2915,439,0
20141229.094233,2914,12,931976,4,2914,279,2915,452,0
20141229.094234,2914,14,931990,8,2914,272,2915,454,0
20141229.094234,2915,14,932004,14,2914,272,2915,449,1
20141229.094235,2914,8,932012,2,2914,268,2915,453,0
20141229.094236,2914,6,932018,0,2914,270,2915,454,0
20141229.094237,2914,14,932032,6,2914,259,2915,457,0
20141229.094237,2914,2,932034,0,2914,259,2915,472,0
20141229.094238,2914,6,932040,0,2914,256,2915,474,0
20141229.094239,2914,6,932046,0,2914,253,2915,480,0
20141229.094239,2914,8,932054,2,2914,249,2915,482,0
20141229.09424,2914,12,932066,10,2914,245,2915,481,0
20141229.094241,2914,2,932068,0,2914,244,2915,544,0
20141229.094241,2914,16,932084,12,2914,236,2915,543,0
20141229.094241,2914,2,932086,0,2914,235,2915,542,0
20141229.094242,2914,8,932094,2,2914,232,2915,500,0
20141229.094243,2915,8,932102,2,2914,229,2915,496,1
20141229.094243,2914,8,932110,2,2914,225,2915,495,0
20141229.094244,2914,38,932148,32,2914,223,2915,478,0
20141229.094245,2914,6,932154,0,2914,221,2915,479,0
20141229.094245,2915,8,932162,0,2914,262,2915,492,1
20141229.094246,2914,108,932270,98,2914,212,2915,475,0
20141229.094246,2914,110,932380,110,2914,157,2915,476,0
20141229.094247,2914,208,932588,68,2914,53,2915,474,0
20141229.094247,2914,106,932694,2,2913,544,2914,3,0
20141229.094248,2914,8,932702,0,2913,541,2914,8,0
20141229.094248,2913,18,932720,14,2913,533,2914,62,0
20141229.094249,2913,8,932728,0,2913,532,2914,60,0
20141229.094249,2913,10,932738,0,2913,511,2914,61,0
20141229.094251,2913,2,932740,2,2913,764,2914,106,0
20141229.094252,2913,2,932742,2,2913,764,2914,136,0
20141229.094253,2914,272,933014,-24,2914,43,2915,739,1
20141229.094253,2914,4,933018,-4,2914,92,2915,727,1
20141229.094254,2914,184,933202,42,2914,3,2915,734,1
20141229.094254,2913,32,933234,20,2913,785,2914,171,0
20141229.094255,2914,2,933236,2,2913,775,2914,173,1
20141229.094255,2913,12,933248,10,2913,769,2914,202,0
20141229.094256,2914,8,933256,4,2913,768,2914,202,1
20141229.094256,2913,2,933258,2,2913,766,2914,219,0
20141229.094257,2913,2,933260,-2,2913,765,2914,222,0
20141229.094258,2913,2,933262,-2,2913,775,2914,225,0
20141229.094259,2914,28,933290,28,2913,775,2914,211,1
20141229.0943,2913,10,933300,-10,2913,765,2914,242,0
20141229.0943,2914,4,933304,0,2913,767,2914,225,1
20141229.094301,2913,2,933306,-2,2913,766,2914,223,0
20141229.094301,2914,16,933322,16,2913,771,2914,227,1
20141229.094302,2913,4,933326,-2,2913,764,2914,239,0
20141229.094303,2913,12,933338,-6,2913,759,2914,240,0
20141229.094303,2914,8,933346,8,2913,759,2914,243,1
20141229.094303,2913,20,933366,-20,2913,749,2914,243,0
20141229.094305,2913,2,933368,-2,2913,748,2914,256,0
20141229.094305,2913,2,933370,-2,2913,747,2914,255,0
20141229.094306,2913,6,933376,-4,2913,729,2914,254,0
20141229.094306,2913,4,933380,-4,2913,727,2914,278,0
20141229.094307,2913,2,933382,-2,2913,704,2914,286,0
20141229.094307,2913,4,933386,-4,2913,702,2914,303,0
20141229.094308,2913,4,933390,-4,2913,700,2914,349,0
20141229.094308,2913,4,933394,-4,2913,698,2914,354,0
20141229.094309,2913,12,933406,-12,2913,692,2914,460,0
20141229.094309,2913,2,933408,-2,2913,691,2914,861,0
20141229.09431,2913,2,933410,-2,2913,682,2914,866,0
20141229.09431,2913,6,933416,-4,2913,679,2914,876,0
20141229.094311,2913,2,933418,-2,2913,678,2914,878,0
20141229.094311,2913,6,933424,-6,2913,676,2914,881,0
20141229.094312,2913,2,933426,0,2913,675,2914,901,0
20141229.094312,2913,6,933432,-6,2913,672,2914,903,0
20141229.094313,2914,8,933440,8,2913,672,2914,905,1
20141229.094314,2913,6,933446,-6,2913,669,2914,903,0
20141229.094314,2914,10,933456,2,2913,924,2914,868,1
20141229.094315,2913,6,933462,-6,2913,921,2914,866,0
20141229.094315,2913,12,933474,0,2913,915,2914,868,0
20141229.094316,2913,8,933482,-8,2913,911,2914,865,0
20141229.094316,2913,2,933484,-2,2913,910,2914,870,0
20141229.094317,2913,6,933490,-6,2913,907,2914,869,0
20141229.094317,2913,8,933498,-8,2913,903,2914,867,0
20141229.094318,2913,2,933500,0,2913,902,2914,870,0
20141229.094319,2913,6,933506,-4,2913,899,2914,868,0
20141229.09432,2913,4,933510,-4,2913,898,2914,870,0
20141229.094321,2913,12,933522,0,2913,892,2914,870,0
20141229.094321,2913,24,933546,-8,2913,880,2914,864,0
20141229.094323,2913,10,933556,0,2913,876,2914,866,0
20141229.094324,2914,30,933586,28,2913,873,2914,855,1
20141229.094325,2913,4,933590,2,2913,871,2914,869,0
20141229.094325,2913,46,933636,0,2913,849,2914,865,0
20141229.094326,2913,1698,935334,1406,2912,1018,2913,197,0
20141229.094326,2912,90,935424,-6,2912,1010,2913,156,0
20141229.094327,2913,4,935428,-4,2912,1009,2913,169,1
20141229.094327,2912,6,935434,-6,2912,1006,2913,1182,0
20141229.094328,2912,2,935436,-2,2912,990,2913,4225,0
20141229.094328,2912,30,935466,-20,2912,977,2913,4440,0
20141229.094329,2912,10,935476,-10,2912,972,2913,3459,0
20141229.094329,2912,20,935496,0,2912,962,2913,460,0
20141229.09433,2912,50,935546,-10,2912,937,2913,412,0
20141229.09433,2912,8,935554,-6,2912,933,2913,418,0
20141229.094331,2912,24,935578,-12,2912,921,2913,679,0
20141229.094331,2912,26,935604,-14,2912,908,2913,739,0
20141229.094332,2913,10,935614,0,2912,908,2913,746,1
20141229.094332,2912,26,935640,-2,2912,895,2913,747,0
20141229.094333,2912,16,935656,-6,2912,888,2913,748,0
20141229.094333,2912,12,935668,-6,2912,882,2913,749,0
20141229.094334,2912,6,935674,2,2912,876,2913,760,0
20141229.094334,2912,20,935694,12,2912,866,2913,763,0
20141229.094335,2912,860,936554,-820,2912,436,2913,799,0
20141229.094335,2912,580,937134,-258,2912,147,2913,889,0
20141229.094336,2912,296,937430,-88,2911,531,2912,356,0
20141229.094336,2911,8,937438,-4,2911,527,2912,414,0
20141229.094337,2912,24,937462,0,2911,624,2912,399,1
20141229.094337,2911,206,937668,198,2911,621,2912,292,0
20141229.094338,2912,582,938250,-66,2912,667,2913,919,1
20141229.094338,2912,6,938256,-6,2912,664,2913,919,1
20141229.094339,2912,6,938262,0,2912,696,2913,919,1
20141229.094339,2912,214,938476,-154,2912,607,2913,821,1
20141229.09434,2912,300,938776,-276,2912,457,2913,759,1
20141229.09434,2912,12,938788,-12,2912,451,2913,758,1
20141229.094341,2912,2,938790,-2,2912,460,2913,760,1
20141229.094341,2912,38,938828,-26,2912,442,2913,760,1
20141229.094342,2912,2,938830,0,2912,442,2913,760,1
20141229.094343,2912,26,938856,-12,2912,429,2913,760,1
20141229.094343,2912,4,938860,0,2912,427,2913,761,1
20141229.094343,2912,6,938866,-6,2912,434,2913,762,1
20141229.094344,2912,10,938876,-2,2912,430,2913,762,1
20141229.094344,2912,10,938886,-8,2912,927,2913,762,1
20141229.094345,2912,4,938890,0,2912,925,2913,763,1
20141229.094346,2912,6,938896,-6,2912,922,2913,766,1
20141229.094346,2912,28,938924,-22,2912,909,2913,766,1
20141229.094347,2912,30,938954,-10,2912,897,2913,768,1
20141229.094348,2912,8,938962,-8,2912,893,2913,768,1
20141229.094348,2912,26,938988,-26,2912,880,2913,773,1
20141229.094349,2913,1666,940654,166,2913,317,2914,224,1
20141229.094349,2913,16,940670,0,2913,309,2914,218,1
20141229.09435,2913,10,940680,0,2913,400,2914,267,1
20141229.09435,2913,20,940700,0,2913,390,2914,285,1
20141229.094351,2914,2,940702,-2,2913,419,2914,285,1
20141229.094351,2913,6,940708,0,2913,416,2914,286,0
20141229.094352,2913,8,940716,2,2913,412,2914,326,0
20141229.094353,2913,48,940764,2,2913,411,2914,411,0
20141229.094354,2913,6,940770,6,2913,412,2914,403,0
20141229.094354,2913,6,940776,0,2913,409,2914,403,0
20141229.094355,2913,6,940782,0,2913,406,2914,404,0
20141229.094356,2913,8,940790,2,2913,401,2914,405,0
20141229.094357,2913,8,940798,0,2913,397,2914,2415,0
20141229.094358,2913,162,940960,2,2913,308,2914,3416,0
20141229.094358,2913,192,941152,10,2913,212,2914,6343,0
20141229.094359,2913,8,941160,0,2913,246,2914,6344,0
20141229.094359,2913,24,941184,2,2913,264,2914,6335,0
20141229.0944,2913,14,941198,12,2913,290,2914,6348,0
20141229.0944,2913,40,941238,12,2913,270,2914,6347,0
20141229.094401,2913,26,941264,6,2913,265,2914,4339,0
20141229.094401,2913,28,941292,22,2913,251,2914,2340,0
20141229.094402,2913,16,941308,-4,2913,251,2914,2340,0
20141229.094402,2913,50,941358,-8,2913,229,2914,1304,0
20141229.094403,2913,6,941364,-6,2913,229,2914,303,0
20141229.094403,2913,48,941412,-12,2913,217,2914,305,0
20141229.094404,2913,6,941418,-6,2913,323,2914,320,0
20141229.094405,2914,4,941422,0,2913,322,2914,320,1
20141229.094406,2913,18,941440,-6,2913,313,2914,321,0
20141229.094406,2913,8,941448,-6,2913,311,2914,321,0
20141229.094407,2913,6,941454,-6,2913,308,2914,322,0
20141229.094408,2913,6,941460,-6,2913,305,2914,322,0
20141229.094408,2914,2,941462,-2,2913,303,2914,321,1
20141229.094409,2913,18,941480,-10,2913,292,2914,326,0
20141229.09441,2913,6,941486,-6,2913,285,2914,344,0
20141229.094413,2913,400,941886,-298,2913,83,2914,373,0
20141229.094414,2913,2,941888,0,2913,49,2914,396,0
20141229.094414,2913,2,941890,2,2913,45,2914,397,0
20141229.094415,2913,8,941898,4,2913,57,2914,391,0
20141229.094416,2913,4,941902,0,2913,59,2914,391,0
20141229.094417,2913,10,941912,-4,2913,116,2914,387,0
20141229.094417,2913,20,941932,20,2913,106,2914,387,0
20141229.094418,2913,2,941934,2,2913,106,2914,387,0
20141229.094418,2913,2,941936,2,2913,106,2914,387,0
20141229.094421,2913,204,942140,-2,2913,5,2914,397,0
20141229.094421,2913,54,942194,-36,2913,119,2914,433,0
20141229.094422,2913,206,942400,-204,2913,17,2914,421,0
20141229.094422,2913,6,942406,-4,2913,15,2914,425,0
20141229.094423,2913,20,942426,-20,2913,5,2914,425,0
20141229.094423,2913,2,942428,0,2913,4,2914,428,0
20141229.094424,2913,8,942436,-2,2912,1031,2913,26,0
20141229.094424,2913,56,942492,-4,2913,106,2914,486,0
20141229.094425,2913,4,942496,0,2913,156,2914,401,0
20141229.094425,2913,2,942498,0,2913,155,2914,402,0
20141229.094426,2913,6,942504,0,2913,152,2914,409,0
20141229.094427,2913,2,942506,0,2913,152,2914,409,0
20141229.094427,2913,2,942508,2,2913,151,2914,410,0
20141229.094428,2913,4,942512,4,2913,149,2914,418,0
20141229.094428,2913,4,942516,0,2913,148,2914,418,0
20141229.094429,2914,2,942518,-2,2913,151,2914,416,1
20141229.09443,2913,10,942528,10,2913,146,2914,421,0
20141229.094431,2913,22,942550,22,2913,135,2914,421,0
20141229.094434,2914,4,942554,-4,2913,136,2914,423,1
20141229.094434,2914,20,942574,0,2913,166,2914,414,1
20141229.094436,2913,108,942682,2,2913,117,2914,412,0
20141229.094437,2914,2,942684,2,2913,116,2914,412,1
20141229.094437,2914,128,942812,-4,2913,116,2914,354,1
20141229.094438,2913,244,943056,-150,2912,1534,2913,346,0
20141229.094438,2913,694,943750,-386,2913,381,2914,454,0
20141229.094439,2913,2,943752,0,2913,486,2914,355,0
20141229.094441,2913,10,943762,0,2913,482,2914,357,0
20141229.094442,2913,2,943764,-2,2913,482,2914,357,0
20141229.094442,2914,2,943766,2,2913,506,2914,334,1
20141229.094443,2914,372,944138,-34,2913,511,2914,148,1
20141229.094443,2914,296,944434,-4,2914,38,2915,647,1
20141229.094444,2914,6,944440,-4,2914,149,2915,657,1
20141229.094444,2914,10,944450,-2,2914,207,2915,607,1
20141229.094445,2914,10,944460,-2,2914,203,2915,575,1
20141229.094445,2914,4,944464,-4,2914,212,2915,577,1
20141229.094446,2914,8,944472,-6,2914,208,2915,604,1
20141229.094447,2914,22,944494,-18,2914,198,2915,603,1
20141229.094447,2914,6,944500,-2,2914,196,2915,591,1
20141229.094448,2913,404,944904,-270,2913,530,2914,154,0
20141229.094449,2914,10,944914,-8,2913,530,2914,200,1
20141229.094449,2914,12,944926,-10,2913,530,2914,245,1
20141229.094451,2913,42,944968,0,2913,510,2914,246,0
20141229.094451,2914,100,945068,-100,2913,515,2914,158,1
20141229.094452,2914,2,945070,0,2913,516,2914,167,1
20141229.094454,2914,10,945080,0,2913,378,2914,182,1
20141229.094456,2914,10,945090,0,2913,381,2914,178,1
20141229.094456,2914,24,945114,0,2913,440,2914,166,1
20141229.094456,2914,20,945134,0,2913,441,2914,156,1
20141229.094457,2913,14,945148,2,2913,457,2914,157,0
20141229.094457,2913,36,945184,10,2913,455,2914,141,0
20141229.094458,2914,8,945192,6,2913,453,2914,142,1
20141229.094458,2913,4,945196,4,2913,451,2914,142,0
20141229.094459,2913,2,945198,2,2913,450,2914,142,0
20141229.094459,2913,6,945204,6,2913,448,2914,142,0
20141229.0945,2913,24,945228,4,2913,447,2914,133,0
20141229.0945,2913,4,945232,4,2913,445,2914,135,0
20141229.094501,2914,1086,946318,508,2914,43,2915,594,1
20141229.094501,2915,180,946498,170,2914,18,2915,585,1
20141229.094502,2914,190,946688,138,2914,6,2915,593,0
20141229.094502,2913,34,946722,6,2913,391,2914,130,0
20141229.094503,2914,270,946992,-150,2914,92,2915,579,1
20141229.094503,2914,8,947000,4,2914,129,2915,584,1
20141229.094504,2914,8,947008,6,2914,127,2915,584,1
20141229.094505,2914,34,947042,32,2914,125,2915,572,1
20141229.094505,2915,16,947058,16,2914,120,2915,569,1
20141229.094506,2914,48,947106,48,2914,97,2915,570,0
20141229.094506,2915,58,947164,58,2914,92,2915,558,1
20141229.094507,2914,22,947186,2,2914,81,2915,558,0
20141229.094507,2914,10,947196,10,2914,128,2915,568,0
20141229.094508,2914,4,947200,4,2914,126,2915,548,0
20141229.094508,2914,258,947458,194,2913,475,2914,181,0
20141229.094509,2914,14,947472,4,2913,472,2914,176,0
20141229.094509,2913,6,947478,6,2913,471,2914,173,0
20141229.09451,2913,2,947480,2,2913,471,2914,173,0
20141229.09451,2914,30,947510,2,2913,435,2914,159,1
20141229.094511,2914,6,947516,6,2913,438,2914,158,1
20141229.094511,2913,4,947520,4,2913,438,2914,157,0
20141229.094512,2913,88,947608,88,2913,435,2914,66,0
20141229.094512,2914,6,947614,6,2913,434,2914,64,1
20141229.094513,2913,6,947620,6,2913,431,2914,96,0
20141229.094513,2914,310,947930,-30,2914,101,2915,646,1
20141229.094514,2914,138,948068,-4,2914,34,2915,745,1
20141229.094514,2914,30,948098,28,2914,19,2915,744,1
20141229.094515,2914,40,948138,16,2913,466,2915,761,1
20141229.094515,2913,12,948150,6,2913,445,2914,88,0
20141229.094516,2913,4,948154,4,2913,435,2914,93,0
20141229.094517,2914,8,948162,8,2913,488,2914,93,1
20141229.094517,2913,24,948186,24,2913,486,2914,83,0
20141229.094517,2913,4,948190,4,2913,484,2914,83,0
20141229.094518,2913,4,948194,4,2913,483,2914,83,0
20141229.094519,2913,4,948198,4,2913,482,2914,83,0
20141229.094519,2913,6,948204,6,2913,481,2914,82,0
20141229.094519,2913,14,948218,4,2913,464,2914,82,0
20141229.09452,2913,8,948226,6,2913,454,2914,92,0
20141229.094521,2913,4,948230,4,2913,452,2914,94,0
20141229.094521,2913,4,948234,4,2913,450,2914,94,0
20141229.094521,2913,2,948236,2,2913,455,2914,94,0
20141229.094522,2913,6,948242,6,2913,454,2914,95,0
20141229.094522,2913,4,948246,4,2913,452,2914,95,0
20141229.094523,2913,2,948248,2,2913,441,2914,96,0
20141229.094523,2913,4,948252,4,2913,440,2914,97,0
20141229.094524,2913,4,948256,4,2913,437,2914,194,0
20141229.094525,2914,26,948282,18,2913,414,2914,247,1
20141229.094525,2913,4,948286,4,2913,348,2914,251,0
20141229.094525,2913,2,948288,2,2913,347,2914,270,0
20141229.094526,2913,74,948362,-32,2913,370,2914,278,0
20141229.094527,2913,100,948462,-42,2913,369,2914,239,0
20141229.094527,2913,6,948468,0,2913,407,2914,240,0
20141229.094527,2913,2,948470,0,2913,372,2914,240,0
20141229.094528,2914,512,948982,-134,2914,247,2915,876,1
20141229.094529,2914,32,949014,-28,2914,231,2915,711,1
20141229.094529,2914,12,949026,-4,2914,225,2915,729,1
20141229.094529,2914,130,949156,-124,2914,170,2915,769,1
20141229.09453,2914,108,949264,-106,2914,116,2915,776,1
20141229.094531,2914,6,949270,0,2914,114,2915,776,1
20141229.094531,2914,50,949320,-8,2914,89,2915,773,1
20141229.094532,2914,28,949348,-20,2914,75,2915,773,1
20141229.094532,2914,12,949360,-8,2914,69,2915,750,1
20141229.094533,2914,2,949362,0,2914,68,2915,750,1
20141229.094533,2914,12,949374,-6,2914,62,2915,753,1
20141229.094534,2914,82,949456,0,2914,21,2915,762,1
20141229.094534,2914,28,949484,-2,2914,8,2915,692,1
20141229.094535,2914,6,949490,2,2914,5,2915,691,1
20141229.094535,2914,8,949498,2,2914,1,2915,716,1
20141229.094536,2914,2,949500,0,2913,546,2914,38,1
20141229.094536,2913,154,949654,-136,2913,487,2914,13,0
20141229.094537,2914,34,949688,-4,2914,37,2915,668,1
20141229.094537,2914,2,949690,2,2914,52,2915,653,1
20141229.094538,2914,6,949696,0,2914,154,2915,654,1
20141229.094539,2914,12,949708,12,2914,167,2915,655,1
20141229.094539,2914,6,949714,6,2914,163,2915,660,1
20141229.094539,2914,4,949718,2,2914,168,2915,660,1
20141229.09454,2914,6,949724,6,2914,166,2915,660,1
20141229.09454,2914,30,949754,30,2914,161,2915,660,1
20141229.094541,2914,6,949760,6,2914,158,2915,663,1
20141229.094542,2915,4,949764,4,2914,167,2915,662,1
20141229.094542,2914,4,949768,2,2914,163,2915,662,0
20141229.094543,2914,126,949894,-48,2914,117,2915,654,0
20141229.094543,2914,6,949900,0,2914,112,2915,654,0
20141229.094544,2915,12,949912,4,2914,109,2915,649,1
20141229.094544,2914,4,949916,0,2914,107,2915,649,0
20141229.094545,2914,90,950006,8,2914,82,2915,631,0
20141229.094546,2914,12,950018,0,2914,77,2915,631,0
20141229.094546,2914,16,950034,-14,2914,68,2915,641,0
20141229.094546,2914,8,950042,6,2914,64,2915,641,0
20141229.094547,2914,20,950062,4,2914,50,2915,624,0
20141229.094548,2914,2,950064,2,2914,49,2915,630,0
20141229.094548,2914,2,950066,2,2914,48,2915,632,0
20141229.094549,2915,34,950100,32,2914,50,2915,617,1
20141229.094549,2914,4,950104,4,2914,48,2915,618,0
20141229.09455,2915,42,950146,42,2914,42,2915,599,1
20141229.094551,2914,4,950150,4,2914,180,2915,599,0
20141229.094551,2914,2,950152,2,2914,179,2915,600,0
20141229.094552,2914,4,950156,4,2914,177,2915,599,0
20141229.094552,2915,42,950198,-22,2914,176,2915,579,1
20141229.094553,2914,40,950238,32,2914,179,2915,564,0
20141229.094553,2914,2,950240,2,2914,178,2915,569,0
20141229.094554,2914,4,950244,4,2914,185,2915,569,0
20141229.094554,2914,6,950250,2,2914,182,2915,569,0
20141229.094556,2915,42,950292,26,2914,190,2915,549,1
20141229.094556,2914,2,950294,0,2914,198,2915,549,0
20141229.094556,2914,2,950296,0,2914,197,2915,553,0
20141229.094557,2914,4,950300,0,2914,193,2915,554,0
20141229.094558,2914,4,950304,0,2914,232,2915,555,0
20141229.094558,2914,2,950306,-2,2914,231,2915,555,0
20141229.094558,2915,10,950316,0,2914,228,2915,554,1
20141229.094559,2914,2,950318,0,2914,228,2915,555,0
20141229.0946,2914,4,950322,0,2914,229,2915,555,0
20141229.0946,2914,2,950324,0,2914,228,2915,555,0
20141229.0946,2915,46,950370,16,2914,230,2915,534,1
20141229.094601,2914,22,950392,18,2914,214,2915,525,0
20141229.094601,2914,4,950396,0,2914,212,2915,581,0
20141229.094602,2914,6,950402,-2,2914,319,2915,527,0
20141229.094603,2914,204,950606,-200,2914,220,2915,527,0
20141229.094603,2914,12,950618,8,2914,210,2915,523,0
20141229.094604,2914,2,950620,2,2914,214,2915,524,0
20141229.094604,2914,2,950622,2,2914,213,2915,524,0
20141229.094605,2915,6,950628,0,2914,212,2915,522,1
20141229.094605,2914,2,950630,0,2914,211,2915,522,0
20141229.094606,2914,4,950634,0,2914,210,2915,522,0
20141229.094606,2914,4,950638,0,2914,208,2915,522,0
20141229.094607,2914,82,950720,70,2914,205,2915,484,0
20141229.094608,2914,2,950722,0,2914,133,2915,484,0
20141229.094608,2914,6,950728,6,2914,91,2915,603,0
20141229.094609,2914,10,950738,8,2914,86,2915,603,0
20141229.094609,2914,10,950748,6,2914,84,2915,602,0
20141229.09461,2914,26,950774,24,2914,71,2915,602,0
20141229.09461,2914,38,950812,0,2914,64,2915,598,0
20141229.094611,2914,4,950816,4,2914,64,2915,598,0
20141229.094611,2914,2,950818,2,2914,63,2915,598,0
20141229.094612,2914,10,950828,4,2914,59,2915,599,0
20141229.094612,2914,8,950836,2,2914,60,2915,596,0
20141229.094613,2914,4,950840,4,2914,59,2915,596,0
20141229.094613,2914,116,950956,84,2914,3,2915,593,0
20141229.094614,2914,4,950960,4,2914,3,2915,594,0
20141229.094614,2914,10,950970,4,2913,552,2914,3,0
20141229.094615,2914,16,950986,-6,2914,3,2915,633,0
20141229.094615,2914,4,950990,0,2914,1,2915,638,0
20141229.094616,2914,8,950998,2,2914,140,2915,488,0
20141229.094617,2914,6,951004,-4,2914,62,2915,642,0
20141229.094618,2914,8,951012,-8,2914,60,2915,639,0
20141229.094619,2914,14,951026,-12,2914,53,2915,682,0
20141229.09462,2914,56,951082,0,2914,25,2915,682,0
20141229.09462,2915,52,951134,0,2914,19,2915,682,1
20141229.094621,2914,10,951144,-6,2914,16,2915,670,0
20141229.094621,2914,4,951148,2,2914,14,2915,691,0
20141229.094622,2914,54,951202,-16,2913,434,2915,594,0
20141229.094623,2914,20,951222,-2,2913,532,2914,1,0
20141229.094623,2914,2,951224,0,2914,54,2915,537,0
20141229.094624,2914,22,951246,-16,2914,43,2915,541,0
20141229.094625,2914,6,951252,-6,2914,61,2915,539,0
20141229.094626,2914,6,951258,-6,2914,59,2915,545,0
20141229.094627,2914,6,951264,-6,2914,56,2915,542,0
20141229.094628,2914,58,951322,32,2914,48,2915,520,0
20141229.094629,2914,12,951334,2,2914,21,2915,569,0
20141229.09463,2914,8,951342,2,2914,17,2915,514,0
20141229.094631,2914,6,951348,0,2914,26,2915,512,0
20141229.094631,2914,2,951350,2,2914,25,2915,512,0
20141229.094632,2914,6,951356,0,2914,23,2915,509,0
20141229.094633,2914,10,951366,0,2914,25,2915,506,0
20141229.094633,2914,6,951372,4,2914,22,2915,506,0
20141229.094634,2914,8,951380,0,2914,18,2915,521,0
20141229.094634,2914,16,951396,16,2914,11,2915,521,0
20141229.094635,2914,6,951402,0,2914,13,2915,1071,0
20141229.094635,2914,2,951404,2,2914,12,2915,1076,0
20141229.094636,2914,8,951412,2,2914,8,2915,1076,0
20141229.094636,2914,4,951416,2,2914,6,2915,1076,0
20141229.094637,2914,10,951426,-6,2914,2,2915,1071,0
20141229.094638,2913,6,951432,-2,2913,555,2914,82,0
20141229.094638,2914,166,951598,-72,2913,565,2915,664,1
20141229.094639,2914,18,951616,0,2914,99,2915,565,1
20141229.09464,2914,40,951656,40,2914,79,2915,555,1
20141229.09464,2914,6,951662,0,2914,76,2915,552,1
20141229.094641,2914,12,951674,6,2914,90,2915,659,1
20141229.094642,2914,24,951698,0,2914,28,2915,657,1
20141229.094642,2914,2,951700,0,2914,27,2915,656,1
20141229.094643,2914,48,951748,-30,2914,105,2915,498,1
20141229.094643,2914,4,951752,-2,2914,2,2915,652,1
20141229.094643,2915,20,951772,0,2914,2,2915,642,1
20141229.094644,2914,30,951802,14,2913,587,2915,691,0
20141229.094645,2913,6,951808,0,2913,584,2915,688,0
20141229.094646,2914,18,951826,4,2914,53,2915,574,1
20141229.094646,2914,12,951838,-12,2914,47,2915,574,1
20141229.094647,2914,6,951844,-6,2914,45,2915,571,1
20141229.094647,2915,2,951846,2,2914,45,2915,566,1
20141229.094648,2915,10,951856,-2,2914,42,2915,564,1
20141229.094649,2915,30,951886,-8,2914,67,2915,570,1
20141229.094649,2914,40,951926,-40,2914,47,2915,560,0
20141229.09465,2914,16,951942,-6,2914,39,2915,568,0
20141229.094651,2914,6,951948,6,2914,45,2915,557,0
20141229.094652,2915,2,951950,2,2914,49,2915,556,1
20141229.094652,2914,4,951954,4,2914,49,2915,556,0
20141229.094653,2914,2,951956,0,2914,48,2915,556,0
20141229.094654,2914,2,951958,2,2914,48,2915,559,0
20141229.094655,2915,14,951972,0,2914,47,2915,593,1
20141229.094656,2914,4,951976,4,2914,64,2915,591,0
20141229.094657,2914,4,951980,4,2914,64,2915,588,0
20141229.094658,2914,4,951984,0,2914,62,2915,588,0
20141229.094659,2914,126,952110,88,2913,697,2914,140,0
20141229.094659,2914,162,952272,60,2913,682,2914,64,0
20141229.094659,2914,160,952432,118,2914,41,2915,748,0
20141229.0947,2914,2,952434,0,2914,41,2915,606,0
20141229.094701,2915,6,952440,6,2914,42,2915,605,1
20141229.094702,2914,2,952442,0,2914,71,2915,610,0
20141229.094703,2914,6,952448,6,2914,69,2915,609,0
20141229.094705,2914,2,952450,2,2914,73,2915,604,0
20141229.094705,2915,32,952482,30,2914,73,2915,596,1
20141229.094706,2914,22,952504,22,2914,91,2915,594,0
20141229.094706,2914,2,952506,0,2914,90,2915,599,0
20141229.094707,2914,4,952510,4,2914,139,2915,589,0
20141229.094708,2914,8,952518,0,2914,156,2915,589,0
20141229.094708,2914,4,952522,4,2914,155,2915,651,0
20141229.094709,2914,2,952524,2,2914,156,2915,652,0
20141229.09471,2915,2,952526,0,2914,136,2915,651,1
20141229.09471,2914,10,952536,8,2914,131,2915,651,0
20141229.094711,2914,6,952542,0,2914,229,2915,651,0
20141229.094712,2914,50,952592,-8,2914,245,2915,629,0
20141229.094713,2914,24,952616,24,2914,233,2915,617,0
20141229.094713,2915,44,952660,38,2914,233,2915,597,1
20141229.094714,2915,848,953508,562,2915,577,2916,858,1
20141229.094714,2915,6,953514,-4,2914,490,2915,96,1
20141229.094715,2915,194,953708,-170,2915,68,2916,859,1
20141229.094716,2916,4,953712,0,2915,99,2916,855,1
20141229.094716,2916,56,953768,-56,2915,99,2916,828,1
20141229.094717,2915,218,953986,-22,2914,291,2915,540,0
20141229.094717,2915,44,954030,-42,2914,270,2915,545,0
20141229.094718,2915,28,954058,-22,2914,270,2915,538,0
20141229.094719,2915,136,954194,26,2914,281,2916,642,0
20141229.09472,2914,6,954200,0,2914,311,2915,493,0
20141229.094721,2915,4,954204,2,2914,336,2915,49,1
20141229.094721,2915,100,954304,-64,2915,101,2916,919,1
20141229.094722,2915,18,954322,-10,2915,99,2916,909,1
20141229.094722,2915,68,954390,40,2915,66,2916,917,1
20141229.094723,2915,138,954528,-2,2914,449,2915,500,1
20141229.094723,2915,8,954536,-6,2914,376,2915,512,1
20141229.094723,2915,40,954576,0,2914,376,2915,493,1
20141229.094724,2914,18,954594,0,2914,317,2915,508,0
20141229.094725,2915,66,954660,0,2914,319,2915,502,1
20141229.094725,2915,16,954676,-16,2914,324,2915,494,1
20141229.094726,2915,26,954702,-2,2914,316,2915,409,1
20141229.094727,2915,852,955554,-424,2915,636,2916,756,1
20141229.094728,2915,10,955564,-8,2915,645,2916,748,1
20141229.094729,2915,10,955574,-6,2915,670,2916,768,1
20141229.094729,2915,12,955586,10,2915,656,2916,767,1
20141229.09473,2915,184,955770,16,2915,565,2916,1557,1
20141229.09473,2915,18,955788,0,2915,565,2916,1569,1
20141229.094731,2915,12,955800,4,2915,561,2916,1565,1
20141229.094732,2915,6,955806,0,2915,584,2916,1030,1
20141229.094732,2916,4,955810,2,2915,582,2916,1031,1
20141229.094733,2915,6,955816,0,2915,579,2916,1030,0
20141229.094733,2916,2,955818,-2,2915,579,2916,1029,1
20141229.094734,2915,6,955824,0,2915,583,2916,1022,0
20141229.094735,2915,8,955832,0,2915,582,2916,1020,0
20141229.094735,2916,2,955834,0,2915,582,2916,1019,1
20141229.094736,2915,8,955842,2,2915,578,2916,1030,0
20141229.094736,2915,6,955848,2,2915,577,2916,1038,0
20141229.094737,2916,142,955990,-128,2915,580,2916,954,1
20141229.094738,2915,6,955996,0,2915,577,2916,950,0
20141229.094738,2916,40,956036,40,2915,577,2916,931,1
20141229.094739,2916,50,956086,4,2915,573,2916,559,1
20141229.094739,2915,2,956088,2,2915,572,2916,559,0
20141229.09474,2916,394,956482,300,2915,416,2916,516,1
20141229.094741,2916,8,956490,2,2915,415,2916,568,1
20141229.094742,2916,32,956522,24,2915,413,2916,555,1
20141229.094742,2916,6,956528,4,2915,414,2916,553,1
20141229.094743,2916,10,956538,0,2915,426,2916,558,1
20141229.094743,2916,2,956540,2,2915,426,2916,572,1
20141229.094744,2916,18,956558,12,2915,425,2916,569,1
20141229.094744,2916,2,956560,2,2915,426,2916,568,1
20141229.094745,2915,26,956586,6,2915,446,2916,559,0
20141229.094745,2916,12,956598,2,2915,448,2916,555,1
20141229.094745,2915,8,956606,2,2915,3478,2916,554,0
20141229.094746,2916,962,957568,346,2915,4495,2916,80,1
20141229.094747,2916,176,957744,160,2916,377,2917,1274,1
20141229.094747,2916,12,957756,10,2916,387,2917,1270,1
20141229.094748,2916,802,958558,-102,2915,4522,2916,133,1
20141229.094748,2916,2,958560,-2,2915,4512,2916,208,1
20141229.094749,2916,62,958622,-22,2915,4509,2916,188,1
20141229.094749,2916,12,958634,0,2915,585,2916,201,1
20141229.09475,2916,18,958652,-2,2915,579,2916,213,1
20141229.09475,2915,4,958656,0,2915,577,2916,214,0
20141229.094751,2916,94,958750,-6,2915,595,2916,322,1
20141229.094752,2915,160,958910,148,2915,518,2916,321,0
20141229.094752,2916,36,958946,-8,2915,504,2916,316,1
20141229.094753,2915,86,959032,0,2915,503,2916,291,0
20141229.094754,2916,136,959168,-68,2915,502,2916,134,1
20141229.094754,2916,22,959190,20,2915,503,2916,98,1
20141229.094755,2916,8,959198,2,2915,500,2916,86,1
20141229.094755,2915,94,959292,-2,2915,511,2916,143,0
20141229.094756,2915,2,959294,2,2915,510,2916,143,0
20141229.094757,2916,48,959342,2,2915,511,2916,139,1
20141229.094758,2916,8,959350,2,2915,512,2916,152,1
20141229.094758,2916,2,959352,2,2915,512,2916,351,1
20141229.094759,2916,8,959360,2,2915,509,2916,365,1
20141229.094759,2916,2,959362,2,2915,499,2916,444,1
20141229.0948,2916,10,959372,4,2915,505,2916,446,1
20141229.0948,2915,4,959376,4,2915,505,2916,481,0
20141229.094801,2916,168,959544,-116,2915,511,2916,410,1
20141229.094801,2916,120,959664,-8,2915,511,2916,352,1
20141229.094802,2915,158,959822,152,2915,432,2916,359,0
20141229.094802,2916,200,960022,200,2915,516,2916,259,1
20141229.094803,2916,310,960332,298,2915,522,2916,111,1
20141229.094803,2916,2,960334,2,2915,529,2916,110,1
20141229.094804,2916,230,960564,208,2916,77,2917,1463,1
20141229.094804,2915,182,960746,0,2915,494,2916,87,0
20141229.094805,2916,166,960912,0,2915,482,2916,73,1
20141229.094806,2916,10,960922,0,2915,479,2916,71,1
20141229.094806,2916,20,960942,0,2915,479,2916,61,1
20141229.094807,2915,14,960956,0,2915,473,2916,60,0
20141229.094807,2916,2,960958,0,2915,475,2916,80,1
20141229.094808,2915,6,960964,0,2915,474,2916,85,0
20141229.094809,2916,398,961362,142,2916,118,2917,1335,1
20141229.094809,2916,238,961600,-10,2915,480,2916,102,1
20141229.09481,2915,40,961640,-30,2915,477,2916,139,0
20141229.094811,2915,6,961646,0,2915,479,2916,141,0
20141229.094811,2915,2,961648,2,2915,478,2916,142,0
20141229.094812,2915,6,961654,0,2915,525,2916,142,0
20141229.094812,2916,226,961880,50,2915,520,2916,134,1
20141229.094813,2915,72,961952,70,2915,510,2916,105,0
20141229.094813,2915,6,961958,0,2915,509,2916,107,0
20141229.094814,2916,202,962160,202,2915,508,2916,8,1
20141229.094815,2916,26,962186,14,2916,145,2917,1420,1
20141229.094815,2916,394,962580,-102,2915,504,2916,261,1
20141229.094816,2915,6,962586,0,2915,502,2916,273,0
20141229.094816,2915,2,962588,2,2915,501,2916,272,0
20141229.094817,2915,8,962596,2,2915,508,2916,277,0
20141229.094817,2916,4,962600,-4,2915,493,2916,291,1
20141229.094818,2916,2,962602,-2,2915,493,2916,290,1
20141229.094819,2916,10,962612,-2,2915,489,2916,294,1
20141229.094819,2915,2,962614,2,2915,488,2916,295,0
20141229.094819,2915,6,962620,0,2915,485,2916,295,0
20141229.09482,2916,4,962624,-2,2915,485,2916,300,1
20141229.094821,2915,32,962656,-26,2915,473,2916,315,0
20141229.094823,2915,10,962666,6,2915,468,2916,571,0
20141229.094823,2915,6,962672,0,2915,453,2916,571,0
20141229.094824,2915,2,962674,0,2915,447,2916,573,0
20141229.094825,2915,20,962694,2,2915,437,2916,610,0
20141229.094825,2915,6,962700,-6,2915,432,2916,610,0
20141229.094826,2916,12,962712,0,2915,447,2916,609,1
20141229.094827,2915,6,962718,-6,2915,449,2916,632,0
20141229.094828,2916,2,962720,0,2915,449,2916,638,1
20141229.094829,2915,6,962726,0,2915,458,2916,640,0
20141229.094829,2915,16,962742,10,2915,450,2916,642,0
20141229.09483,2915,2,962744,-2,2915,464,2916,642,0
20141229.094831,2915,12,962756,-8,2915,460,2916,650,0
20141229.094831,2915,406,963162,190,2915,257,2916,653,0
20141229.094832,2915,6,963168,-4,2915,407,2916,654,0
20141229.094832,2915,8,963176,2,2915,404,2916,658,0
20141229.094833,2915,4,963180,2,2915,402,2916,718,0
20141229.094834,2915,8,963188,0,2915,397,2916,729,0
20141229.094834,2915,82,963270,-22,2915,356,2916,730,0
20141229.094835,2915,6,963276,0,2915,303,2916,731,0
20141229.094835,2915,10,963286,0,2915,299,2916,730,0
20141229.094836,2915,602,963888,246,2914,904,2915,219,0
20141229.094837,2914,42,963930,36,2914,909,2915,222,0
20141229.094837,2914,2,963932,2,2914,908,2915,226,0
20141229.094838,2915,120,964052,114,2914,892,2915,188,1
20141229.094839,2914,6,964058,0,2914,882,2915,596,0
20141229.09484,2914,10,964068,4,2914,877,2915,597,0
20141229.09484,2915,4,964072,4,2914,877,2915,595,1
20141229.09484,2914,6,964078,0,2914,874,2915,595,0
20141229.094841,2914,2,964080,2,2914,878,2915,202,0
20141229.094842,2914,8,964088,2,2914,874,2915,202,0
20141229.094842,2914,12,964100,12,2914,870,2915,206,0
20141229.094843,2915,48,964148,42,2914,865,2915,187,1
20141229.094844,2914,6,964154,0,2914,862,2915,187,0
20141229.094844,2914,2,964156,2,2914,861,2915,187,0
20141229.094845,2914,6,964162,0,2914,859,2915,191,0
20141229.094845,2914,6,964168,0,2914,856,2915,191,0
20141229.094846,2914,6,964174,0,2914,856,2915,218,0
20141229.094847,2915,40,964214,20,2914,857,2915,203,1
20141229.094847,2914,18,964232,12,2914,854,2915,197,0
20141229.094848,2915,24,964256,24,2914,853,2915,186,1
20141229.094848,2915,270,964526,96,2914,860,2915,48,1
20141229.094849,2915,100,964626,-6,2915,78,2916,722,1
20141229.094849,2915,18,964644,12,2915,265,2916,665,1
20141229.09485,2915,4,964648,2,2915,313,2916,665,1
20141229.09485,2916,8,964656,-2,2915,311,2916,661,1
20141229.094851,2915,10,964666,10,2915,307,2916,660,0
20141229.094852,2915,8,964674,2,2915,303,2916,660,0
20141229.094852,2915,2,964676,2,2915,306,2916,660,0
20141229.094853,2915,8,964684,2,2915,304,2916,662,0
20141229.094853,2916,126,964810,16,2915,256,2916,652,1
20141229.094854,2916,20,964830,0,2915,256,2916,648,1
20141229.094854,2915,50,964880,2,2915,233,2916,650,0
20141229.094855,2915,2,964882,0,2915,232,2916,651,0
20141229.094855,2915,6,964888,0,2915,229,2916,651,0
20141229.094856,2915,6,964894,0,2915,229,2916,655,0
20141229.094857,2915,8,964902,-2,2915,226,2916,629,0
20141229.094858,2915,8,964910,-2,2915,243,2916,630,0
20141229.0949,2915,46,964956,14,2915,220,2916,631,0
20141229.0949,2915,6,964962,-6,2915,217,2916,631,0
20141229.0949,2915,8,964970,-8,2915,223,2916,659,0
20141229.094901,2916,8,964978,0,2915,222,2916,662,1
20141229.094902,2916,10,964988,-6,2915,219,2916,660,1
20141229.094902,2915,6,964994,0,2915,217,2916,660,0
20141229.094903,2915,10,965004,-10,2915,212,2916,662,0
20141229.094903,2915,8,965012,-6,2915,208,2916,665,0
20141229.094904,2915,40,965052,-38,2915,188,2916,666,0
20141229.094904,2915,8,965060,-8,2915,183,2916,768,0
20141229.094904,2915,6,965066,-6,2915,180,2916,768,0
20141229.094906,2915,8,965074,-6,2915,188,2916,769,0
20141229.094906,2916,328,965402,12,2915,289,2916,597,1
20141229.094907,2915,100,965502,-68,2915,261,2916,598,0
20141229.094908,2916,1202,966704,484,2916,299,2917,1199,1
20141229.094908,2916,14,966718,14,2916,268,2917,1204,1
20141229.094909,2916,50,966768,44,2916,242,2917,1205,1
20141229.094909,2916,4,966772,4,2916,240,2917,1205,1
20141229.09491,2916,8,966780,2,2916,246,2917,1205,1
20141229.09491,2916,6,966786,2,2916,243,2917,1205,1
20141229.094911,2916,6,966792,0,2916,240,2917,1205,1
20141229.094911,2917,602,967394,510,2916,239,2917,905,1
20141229.094912,2917,316,967710,62,2916,283,2917,749,1
20141229.094912,2917,56,967766,30,2916,247,2917,732,1
20141229.094913,2917,128,967894,28,2916,222,2917,682,1
20141229.094913,2917,8,967902,0,2916,222,2917,678,1
20141229.094913,2917,74,967976,38,2916,227,2917,641,1
20141229.094914,2917,1196,969172,902,2916,217,2917,54,1
20141229.094915,2917,110,969282,76,2917,152,2918,1176,1
20141229.094915,2918,298,969580,102,2917,7,2918,1167,1
20141229.094916,2918,160,969740,-12,2917,80,2918,1140,1
20141229.094916,2918,1272,971012,-276,2917,2,2918,617,1
20141229.094917,2918,116,971128,8,2917,24,2918,619,1
20141229.094917,2917,8,971136,-2,2917,150,2918,690,0
20141229.094918,2918,12,971148,-4,2917,147,2918,756,1
20141229.094918,2918,4,971152,4,2917,157,2918,744,1
20141229.094919,2918,42,971194,28,2917,470,2918,724,1
20141229.094919,2917,6,971200,-6,2917,469,2918,724,0
20141229.09492,2918,34,971234,32,2917,495,2918,708,1
20141229.09492,2918,96,971330,0,2917,490,2918,586,1
20141229.094921,2918,72,971402,20,2917,487,2918,560,1
20141229.094921,2918,74,971476,46,2917,481,2918,584,1
20141229.094922,2918,146,971622,122,2917,483,2918,592,1
20141229.094922,2917,18,971640,0,2917,477,2918,595,0
20141229.094923,2918,40,971680,40,2917,460,2918,575,1
20141229.094923,2918,304,971984,226,2917,417,2918,464,1
20141229.094924,2917,88,972072,18,2917,273,2918,434,0
20141229.094924,2917,212,972284,94,2917,142,2918,331,0
20141229.094925,2918,738,973022,24,2918,34,2919,2092,1
20141229.094925,2918,260,973282,40,2918,1011,2919,2088,1
20141229.094926,2918,4,973286,4,2918,1013,2919,2104,1
20141229.094926,2918,14,973300,-2,2918,1014,2919,2125,1
20141229.094927,2919,44,973344,-4,2918,1007,2919,2109,1
20141229.094927,2918,108,973452,-2,2918,1002,2919,2061,0
20141229.094928,2919,18,973470,6,2918,999,2919,2064,1
20141229.094928,2919,6,973476,4,2918,188,2919,2063,1
20141229.094929,2918,482,973958,228,2917,558,2918,17,0
20141229.094929,2918,12,973970,-4,2917,480,2918,82,0
20141229.09493,2918,6,973976,-4,2917,445,2918,80,0
20141229.09493,2918,24,974000,6,2917,456,2918,76,0
20141229.094931,2918,28,974028,-2,2917,446,2918,73,0
20141229.094931,2918,24,974052,0,2917,452,2918,66,0
20141229.094932,2919,212,974264,-38,2918,55,2919,2081,1
20141229.094933,2918,120,974384,20,2917,448,2918,139,0
20141229.094933,2918,88,974472,-70,2917,475,2918,95,0
20141229.094933,2917,1016,975488,628,2916,1228,2917,194,0
20141229.094934,2917,746,976234,192,2917,37,2918,186,0
20141229.094934,2918,14,976248,4,2917,221,2918,336,1
20141229.094935,2917,8,976256,2,2917,222,2918,571,0
20141229.094936,2917,6,976262,-4,2917,252,2918,610,0
20141229.094936,2917,4,976266,2,2917,259,2918,656,0
20141229.094937,2917,100,976366,48,2917,251,2918,675,0
20141229.094938,2918,1034,977400,-362,2917,257,2918,303,1
20141229.094938,2918,116,977516,80,2917,302,2918,304,1
20141229.094939,2918,12,977528,12,2917,323,2918,299,1
20141229.094939,2918,36,977564,6,2917,343,2918,190,1
20141229.09494,2917,4,977568,0,2917,460,2918,195,0
20141229.09494,2918,18,977586,14,2917,461,2918,188,1
20141229.094941,2918,24,977610,-10,2917,457,2918,257,1
20141229.094941,2918,30,977640,-14,2917,461,2918,249,1
20141229.094942,2918,60,977700,-16,2917,465,2918,204,1
20141229.094942,2918,14,977714,12,2917,525,2918,202,1
20141229.094943,2918,54,977768,6,2917,505,2918,194,1
20141229.094944,2918,6,977774,4,2917,504,2918,190,1
20141229.094945,2918,444,978218,370,2918,585,2919,2070,1
20141229.094945,2918,214,978432,202,2918,478,2919,2071,1
20141229.094946,2918,68,978500,4,2918,447,2919,2110,1
20141229.094946,2918,988,979488,438,2917,665,2918,114,1
20141229.094947,2918,202,979690,-22,2917,465,2918,24,1
20141229.094947,2917,186,979876,54,2917,561,2918,22,0
20141229.094947,2918,46,979922,-40,2917,561,2918,51,1
20141229.094948,2917,24,979946,2,2917,557,2918,49,0
20141229.094948,2918,24,979970,4,2917,557,2918,38,1
20141229.094949,2918,14,979984,-2,2917,555,2918,39,1
20141229.09495,2918,2,979986,2,2917,555,2918,94,1
20141229.09495,2917,2,979988,0,2917,558,2918,110,0
20141229.094951,2918,20,980008,20,2917,560,2918,272,1
20141229.094952,2918,2,980010,2,2917,515,2918,417,1
20141229.094953,2918,120,980130,70,2917,517,2918,357,1
20141229.094953,2918,270,980400,128,2917,388,2918,360,1
20141229.094954,2917,16,980416,10,2917,385,2918,389,0
20141229.094954,2917,12,980428,4,2917,375,2918,394,0
20141229.094955,2918,108,980536,-90,2917,325,2918,837,1
20141229.094955,2917,116,980652,98,2917,321,2918,811,0
20141229.094956,2917,40,980692,-40,2917,303,2918,811,0
20141229.094956,2917,14,980706,6,2917,296,2918,816,0
20141229.094957,2917,12,980718,10,2917,293,2918,823,0
20141229.094958,2917,292,981010,-8,2917,146,2918,839,0
20141229.094959,2917,294,981304,-138,2916,1130,2917,103,0
20141229.094959,2917,20,981324,20,2916,1152,2917,94,0
20141229.095,2917,226,981550,10,2916,1175,2917,5,0
20141229.095,2917,34,981584,20,2917,154,2918,1034,0
20141229.095,2917,14,981598,-2,2917,149,2918,986,0
20141229.095001,2918,4,981602,0,2917,265,2918,984,1
20141229.095001,2918,22,981624,22,2917,269,2918,973,1
20141229.095002,2917,116,981740,22,2917,272,2918,709,0
20141229.095003,2917,4,981744,-4,2917,286,2918,636,0
20141229.095004,2918,44,981788,16,2917,274,2918,627,1
20141229.095005,2918,8,981796,-4,2917,272,2918,647,1
20141229.095006,2917,8,981804,-8,2917,283,2918,651,0
20141229.095006,2917,6,981810,-6,2917,290,2918,652,0
20141229.095007,2917,10,981820,-10,2917,285,2918,652,0
20141229.095008,2917,26,981846,-6,2917,285,2918,652,0
20141229.095008,2917,10,981856,-6,2917,280,2918,656,0
20141229.095009,2917,2,981858,0,2917,279,2918,657,0
20141229.095009,2917,26,981884,-26,2917,265,2918,657,0
20141229.095009,2918,2,981886,2,2917,275,2918,672,1
20141229.09501,2917,8,981894,-6,2917,310,2918,690,0
20141229.095011,2917,6,981900,-6,2917,359,2918,710,0
20141229.095013,2917,6,981906,-6,2917,376,2918,715,0
20141229.095013,2917,6,981912,0,2917,363,2918,715,0
20141229.095014,2917,6,981918,-6,2917,360,2918,719,0
20141229.095014,2917,120,982038,0,2917,310,2918,712,0
20141229.095015,2918,14,982052,-6,2917,293,2918,712,1
20141229.095015,2917,10,982062,2,2917,188,2918,712,0
20141229.095016,2917,4,982066,4,2917,187,2918,762,0
20141229.095016,2917,402,982468,36,2916,386,2917,249,0
20141229.095017,2916,6,982474,0,2916,372,2917,307,0
20141229.095018,2917,38,982512,0,2916,375,2917,390,1
20141229.095018,2916,112,982624,106,2916,371,2917,352,0
20141229.095021,2916,50,982674,22,2916,1296,2917,253,0
20141229.095021,2917,4,982678,4,2916,1298,2917,251,1
20141229.095022,2916,8,982686,0,2916,1294,2917,255,0
20141229.095023,2916,46,982732,24,2916,1131,2917,237,0
20141229.095024,2916,8,982740,0,2916,1127,2917,258,0
20141229.095024,2917,146,982886,120,2916,1115,2917,190,1
20141229.095025,2917,240,983126,180,2916,1194,2917,80,1
20141229.095025,2917,162,983288,26,2916,1215,2918,773,1
20141229.095025,2916,2,983290,0,2916,1213,2917,3,0
20141229.095026,2917,20,983310,-2,2917,216,2918,761,1
20141229.095027,2917,20,983330,0,2917,315,2918,765,1
20141229.095028,2917,8,983338,-8,2917,317,2918,762,1
20141229.095029,2917,12,983350,-12,2917,329,2918,764,1
20141229.095029,2917,8,983358,-6,2917,324,2918,771,1
20141229.09503,2917,6,983364,0,2917,322,2918,777,1
20141229.09503,2917,2,983366,-2,2917,320,2918,777,1
20141229.095031,2917,214,983580,-208,2917,225,2918,777,1
20141229.095031,2917,2,983582,0,2917,224,2918,777,1
20141229.095032,2917,44,983626,-40,2917,198,2918,778,1
20141229.095033,2918,12,983638,-6,2917,193,2918,784,1
20141229.095033,2917,2,983640,-2,2917,197,2918,806,0
20141229.095034,2917,86,983726,44,2917,175,2918,881,0
20141229.095035,2918,6,983732,2,2917,108,2918,890,1
20141229.095035,2918,44,983776,-40,2917,76,2918,889,1
20141229.095035,2917,6,983782,-6,2917,73,2918,894,0
20141229.095036,2917,24,983806,-4,2917,62,2918,895,0
20141229.095036,2917,124,983930,-66,2916,1285,2917,2,0
20141229.095037,2917,46,983976,24,2917,2,2918,869,0
20141229.095037,2917,4,983980,0,2917,4,2918,870,0
20141229.095039,2917,4,983984,4,2917,18,2918,870,0
20141229.095039,2918,32,984016,10,2917,67,2918,863,1
20141229.09504,2917,174,984190,-110,2916,1243,2917,418,0
20141229.095041,2917,658,984848,0,2916,1235,2917,102,0
20141229.095041,2917,2,984850,0,2916,1249,2917,165,0
20141229.095042,2917,2,984852,-2,2916,1238,2917,198,0
20141229.095042,2917,2,984854,0,2916,1239,2917,197,0
20141229.095044,2916,4,984858,0,2916,1267,2917,199,0
20141229.095049,2916,30,984888,28,2916,1156,2917,626,0
20141229.09505,2917,42,984930,-42,2916,1140,2917,618,1
20141229.09505,2917,4,984934,-4,2916,1134,2917,617,1
20141229.095051,2916,24,984958,-2,2916,1122,2917,611,0
20141229.095051,2917,216,985174,62,2916,1124,2917,504,1
20141229.095052,2916,22,985196,18,2916,1126,2917,496,0
20141229.095052,2917,2,985198,2,2916,1126,2917,496,1
20141229.095053,2916,120,985318,-18,2916,1066,2917,497,0
20141229.095054,2916,2,985320,0,2916,1067,2917,505,0
20141229.095054,2916,4,985324,0,2916,1070,2917,509,0
20141229.095055,2916,6,985330,4,2916,1053,2917,512,0
20141229.095055,2917,10,985340,0,2916,1053,2917,507,1
20141229.095056,2917,26,985366,24,2916,1053,2917,496,1
20141229.095056,2916,6,985372,-4,2916,1050,2917,496,0
20141229.095056,2916,34,985406,8,2916,1037,2917,491,0
20141229.095057,2916,8,985414,-4,2916,1035,2917,500,0
20141229.095058,2916,6,985420,-6,2916,1031,2917,500,0
20141229.095059,2916,2,985422,-2,2916,1030,2917,501,0
20141229.095059,2917,16,985438,-6,2916,1032,2917,497,1
20141229.0951,2916,204,985642,-100,2916,925,2917,498,0
20141229.0951,2916,10,985652,-4,2916,926,2917,500,0
20141229.095101,2916,16,985668,8,2916,897,2917,496,0
20141229.095102,2916,6,985674,0,2916,898,2917,500,0
20141229.095103,2916,6,985680,0,2916,896,2917,503,0
20141229.095104,2916,120,985800,90,2916,834,2917,503,0
20141229.095104,2917,18,985818,12,2916,841,2917,501,1
20141229.095105,2917,4,985822,4,2916,838,2917,500,1
20141229.095105,2916,12,985834,2,2916,830,2917,691,0
20141229.095106,2916,2,985836,-2,2916,829,2917,693,0
20141229.095106,2916,8,985844,-8,2916,825,2917,699,0
20141229.095107,2916,34,985878,-6,2916,824,2917,684,0
20141229.095107,2916,6,985884,-6,2916,821,2917,686,0
20141229.095108,2916,2,985886,-2,2916,820,2917,686,0
20141229.095108,2916,4,985890,-4,2916,818,2917,704,0
20141229.095109,2916,2,985892,-2,2916,817,2917,705,0
20141229.095109,2916,6,985898,-4,2916,815,2917,703,0
20141229.09511,2916,6,985904,0,2916,833,2917,707,0
20141229.095111,2916,10,985914,10,2916,841,2917,707,0
20141229.095112,2917,1222,987136,1116,2916,838,2917,94,1
20141229.095112,2916,8,987144,6,2916,917,2917,92,0
20141229.095113,2917,188,987332,-12,2917,69,2918,1068,1
20141229.095113,2917,270,987602,-10,2916,945,2917,112,1
20141229.095114,2917,66,987668,14,2916,926,2917,143,1
20141229.095114,2917,28,987696,0,2916,928,2917,139,1
20141229.095115,2916,14,987710,-6,2916,924,2917,136,0
20141229.095115,2917,40,987750,0,2916,920,2917,122,1
20141229.095116,2917,8,987758,-6,2916,917,2917,122,1
20141229.095117,2916,6,987764,-6,2916,911,2917,122,0
20141229.095117,2916,16,987780,-2,2916,913,2917,116,0
20141229.095118,2916,8,987788,-6,2916,908,2917,115,0
20141229.095119,2917,10,987798,0,2916,936,2917,112,1
20141229.09512,2916,10,987808,-10,2916,930,2917,116,0
20141229.09512,2917,4,987812,-2,2916,926,2917,115,1
20141229.095121,2917,20,987832,-20,2916,926,2917,111,1
20141229.095121,2916,18,987850,-18,2916,896,2917,117,0
20141229.095122,2917,32,987882,-16,2916,896,2917,102,1
20141229.095123,2916,20,987902,4,2916,893,2917,96,0
20141229.095123,2917,2,987904,2,2916,893,2917,95,1
20141229.095124,2917,56,987960,56,2916,894,2917,98,1
20141229.095125,2916,28,987988,14,2916,859,2917,129,0
20141229.095126,2916,40,988028,14,2916,844,2917,129,0
20141229.095126,2917,404,988432,-158,2916,650,2917,130,1
20141229.095127,2916,82,988514,-20,2915,584,2917,229,0
20141229.095127,2916,8,988522,-2,2916,598,2917,266,0
20141229.095128,2916,30,988552,22,2916,613,2917,256,0
20141229.095128,2916,2,988554,2,2916,609,2917,257,0
20141229.095129,2916,2,988556,2,2916,608,2917,257,0
20141229.095129,2916,6,988562,0,2916,605,2917,269,0
20141229.09513,2916,44,988606,44,2916,578,2917,324,0
20141229.09513,2916,48,988654,30,2916,574,2917,308,0
20141229.095131,2916,6,988660,0,2916,573,2917,310,0
20141229.095131,2917,2,988662,0,2916,603,2917,307,1
20141229.095132,2916,4,988666,2,2916,602,2917,306,0
20141229.095132,2916,10,988676,0,2916,595,2917,523,0
20141229.095133,2916,8,988684,2,2916,591,2917,525,0
20141229.095134,2916,26,988710,-2,2915,571,2917,539,0
20141229.095135,2916,46,988756,-42,2916,576,2917,539,0
20141229.095135,2916,6,988762,0,2916,575,2917,537,0
20141229.095136,2916,10,988772,10,2916,570,2917,539,0
20141229.095136,2916,28,988800,-2,2916,564,2917,540,0
20141229.095137,2916,36,988836,20,2915,787,2917,550,0
20141229.095137,2916,6,988842,0,2916,557,2917,545,0
20141229.095138,2916,46,988888,22,2915,787,2917,555,0
20141229.095138,2916,50,988938,-20,2915,782,2917,555,0
20141229.095139,2916,6,988944,0,2916,553,2917,551,0
20141229.09514,2916,6,988950,0,2916,540,2917,553,0
20141229.09514,2916,14,988964,0,2916,533,2917,553,0
20141229.095141,2916,6,988970,0,2916,530,2917,553,0
20141229.095142,2916,18,988988,6,2916,522,2917,562,0
20141229.095142,2916,8,988996,6,2916,518,2917,562,0
20141229.095143,2916,16,989012,4,2916,511,2917,562,0
20141229.095143,2916,16,989028,0,2916,506,2917,562,0
20141229.095144,2916,40,989068,-2,2915,785,2917,573,0
20141229.095145,2916,20,989088,2,2915,785,2917,584,0
20141229.095146,2916,4,989092,2,2915,790,2917,586,0
20141229.095146,2916,6,989098,0,2915,790,2917,642,0
20141229.095147,2916,12,989110,-2,2916,459,2917,633,0
20141229.095147,2916,14,989124,-4,2915,790,2917,640,0
20141229.095148,2916,2,989126,0,2915,790,2917,641,0
20141229.095148,2916,6,989132,-2,2915,790,2917,641,0
20141229.095149,2916,2,989134,0,2915,790,2917,642,0
20141229.095149,2916,6,989140,0,2915,921,2917,715,0
20141229.09515,2916,68,989208,40,2915,880,2917,684,0
20141229.095151,2916,46,989254,-4,2916,31,2917,687,0
20141229.095151,2916,62,989316,-62,2915,917,2916,102,0
20141229.095152,2916,124,989440,2,2915,855,2916,41,0
20141229.095152,2915,6,989446,-6,2915,840,2916,43,0
20141229.095153,2915,20,989466,-2,2915,826,2916,138,0
20141229.095153,2915,14,989480,-14,2915,819,2916,182,0
20141229.095154,2916,10,989490,-6,2915,816,2916,186,1
20141229.095155,2916,376,989866,-256,2916,41,2917,857,1
20141229.095155,2915,170,990036,20,2915,840,2916,134,0
20141229.095156,2916,66,990102,54,2915,817,2916,108,1
20141229.095157,2916,2,990104,2,2915,816,2916,107,1
20141229.095158,2916,230,990334,118,2916,1,2917,728,1
20141229.095158,2915,6,990340,-6,2915,849,2917,728,0
20141229.095159,2916,14,990354,2,2916,13,2917,829,1
20141229.095159,2916,126,990480,0,2916,31,2917,699,1
20141229.095159,2916,6,990486,0,2916,31,2917,699,1
20141229.0952,2916,20,990506,14,2916,21,2917,699,1
20141229.095201,2916,16,990522,0,2916,15,2917,696,1
20141229.095201,2916,152,990674,6,2915,1056,2916,1,1
20141229.095202,2915,18,990692,-2,2916,2,2917,706,0
20141229.095203,2916,22,990714,6,2916,50,2917,607,1
20141229.095203,2916,8,990722,2,2916,96,2917,610,1
20141229.095204,2916,6,990728,0,2916,105,2917,609,1
20141229.095204,2916,10,990738,10,2916,121,2917,617,1
20141229.095205,2916,6,990744,0,2916,122,2917,616,1
20141229.095206,2916,20,990764,4,2916,112,2917,557,1
20141229.095206,2916,26,990790,20,2916,132,2917,557,1
20141229.095207,2916,20,990810,12,2916,117,2917,552,1
20141229.095207,2916,16,990826,-6,2916,124,2917,552,1
20141229.095208,2916,6,990832,-6,2916,135,2917,353,1
20141229.095208,2916,18,990850,-4,2916,161,2917,355,1
20141229.095209,2916,10,990860,-10,2916,156,2917,356,1
20141229.09521,2916,12,990872,0,2916,150,2917,359,1
20141229.09521,2916,6,990878,-6,2916,147,2917,357,1
20141229.095211,2916,8,990886,0,2916,171,2917,317,1
20141229.095211,2916,8,990894,-6,2916,173,2917,317,1
20141229.095212,2916,4,990898,-4,2916,202,2917,320,1
20141229.095212,2916,20,990918,-14,2916,198,2917,328,1
20141229.095213,2916,46,990964,-6,2916,176,2917,327,1
20141229.095214,2916,2,990966,2,2916,187,2917,332,1
20141229.095214,2916,6,990972,-2,2916,185,2917,332,1
20141229.095215,2916,8,990980,-2,2916,240,2917,328,1
20141229.095217,2916,10,990990,2,2916,269,2917,316,1
20141229.095217,2917,308,991298,302,2916,276,2917,165,1
20141229.095218,2916,122,991420,-28,2916,295,2917,105,0
20141229.095218,2917,250,991670,136,2917,60,2918,1224,1
20141229.095219,2916,50,991720,-4,2916,588,2917,365,0
20141229.09522,2916,8,991728,2,2916,511,2917,425,0
20141229.095221,2916,2,991730,0,2916,466,2917,430,0
20141229.095222,2916,6,991736,0,2916,468,2917,431,0
20141229.095224,2916,2,991738,2,2916,440,2917,441,0
20141229.095224,2916,6,991744,-2,2916,476,2917,442,0
20141229.095224,2916,2,991746,0,2916,525,2917,443,0
20141229.095225,2916,2,991748,2,2916,496,2917,444,0
20141229.095225,2916,20,991768,20,2916,486,2917,444,0
20141229.095226,2916,6,991774,0,2916,441,2917,446,0
20141229.095227,2916,2,991776,2,2916,447,2917,460,0
20141229.095227,2916,4,991780,2,2916,446,2917,476,0
20141229.095227,2917,2,991782,2,2916,424,2917,475,1
20141229.095228,2916,8,991790,2,2916,436,2917,477,0
20141229.095229,2917,10,991800,0,2916,435,2917,472,1
20141229.095229,2917,28,991828,22,2916,432,2917,464,1
20141229.09523,2917,414,992242,14,2916,439,2917,258,1
20141229.095231,2916,8,992250,2,2916,476,2917,251,0
20141229.095231,2916,4,992254,4,2916,475,2917,255,0
20141229.095232,2916,6,992260,0,2916,421,2917,274,0
20141229.095233,2916,8,992268,2,2916,418,2917,300,0
20141229.095233,2916,6,992274,0,2916,415,2917,383,0
20141229.095234,2917,2,992276,2,2916,414,2917,395,1
20141229.095234,2916,16,992292,6,2916,411,2917,391,0
20141229.095235,2916,2,992294,0,2916,418,2917,412,0
20141229.095236,2916,6,992300,-6,2916,416,2917,418,0
20141229.095236,2917,44,992344,44,2916,417,2917,396,1
20141229.095237,2916,6,992350,-6,2916,414,2917,396,0
20141229.095237,2917,4,992354,0,2916,413,2917,396,1
20141229.095238,2917,8,992362,-4,2916,410,2917,396,1
20141229.095239,2916,6,992368,-6,2916,413,2917,398,0
20141229.095239,2916,2,992370,0,2916,406,2917,399,0
20141229.09524,2917,12,992382,-6,2916,398,2917,448,1
20141229.09524,2917,2,992384,2,2916,399,2917,447,1
20141229.095241,2916,8,992392,-8,2916,396,2917,448,0
20141229.095241,2916,8,992400,-4,2916,392,2917,447,0
20141229.095242,2916,2,992402,2,2916,391,2917,447,0
20141229.095243,2917,18,992420,12,2916,389,2917,442,1
20141229.095243,2917,20,992440,20,2916,387,2917,432,1
20141229.095244,2916,6,992446,-2,2916,384,2917,433,0
20141229.095245,2916,10,992456,-4,2916,347,2917,433,0
20141229.095246,2916,6,992462,-6,2916,291,2917,635,0
20141229.095246,2916,6,992468,-6,2916,276,2917,674,0
20141229.095247,2916,14,992482,-14,2916,285,2917,721,0
20141229.095248,2916,28,992510,-4,2916,276,2917,727,0
20141229.095249,2916,6,992516,-6,2916,272,2917,727,0
20141229.095249,2916,4,992520,-4,2916,270,2917,723,0
20141229.09525,2916,10,992530,0,2916,265,2917,720,0
20141229.095251,2916,6,992536,0,2916,316,2917,711,0
20141229.095252,2916,6,992542,0,2916,313,2917,709,0
20141229.095253,2916,6,992548,-6,2916,311,2917,707,0
20141229.095253,2916,6,992554,-6,2916,308,2917,681,0
20141229.095254,2916,4,992558,-4,2916,306,2917,681,0
20141229.095254,2916,6,992564,-6,2916,303,2917,678,0
20141229.095255,2916,162,992726,124,2916,222,2917,674,0
20141229.095256,2916,8,992734,2,2916,219,2917,672,0
20141229.095256,2916,10,992744,0,2916,214,2917,677,0
20141229.095257,2916,8,992752,2,2916,210,2917,674,0
20141229.095257,2916,54,992806,24,2916,181,2917,674,0
20141229.095258,2916,10,992816,0,2916,204,2917,676,0
20141229.095258,2916,2,992818,0,2916,203,2917,677,0
20141229.095259,2916,10,992828,4,2916,198,2917,676,0
20141229.0953,2916,14,992842,4,2916,195,2917,691,0
20141229.095301,2916,6,992848,0,2916,212,2917,689,0
20141229.095301,2916,2,992850,2,2916,211,2917,688,0
20141229.095302,2916,36,992886,-10,2916,193,2917,732,0
20141229.095302,2916,100,992986,38,2916,193,2917,682,0
20141229.095303,2916,8,992994,-4,2916,190,2917,682,0
20141229.095303,2916,2,992996,2,2916,189,2917,682,0
20141229.095304,2916,444,993440,398,2915,1140,2916,374,0
20141229.095304,2916,118,993558,100,2915,1151,2916,319,0
20141229.095305,2915,6,993564,0,2915,1128,2916,324,0
20141229.095306,2916,210,993774,204,2915,1044,2916,240,1
20141229.095306,2915,6,993780,0,2915,1041,2916,240,0
20141229.095307,2915,6,993786,0,2915,1038,2916,258,0
20141229.095308,2916,106,993892,76,2915,1032,2916,233,1
20141229.095309,2916,194,994086,194,2915,1032,2916,136,1
20141229.09531,2915,10,994096,2,2915,1039,2916,86,0
20141229.09531,2916,2,994098,2,2915,1039,2916,85,1
20141229.095311,2915,6,994104,0,2915,1026,2916,104,0
20141229.095311,2915,2,994106,0,2915,1024,2916,185,0
20141229.095312,2915,8,994114,0,2915,1020,2916,185,0
20141229.095312,2916,30,994144,26,2915,1020,2916,172,1
20141229.095313,2915,6,994150,0,2915,1018,2916,157,0
20141229.095313,2915,6,994156,0,2915,1014,2916,159,0
20141229.095314,2915,10,994166,10,2915,1009,2916,159,0
20141229.095314,2915,6,994172,0,2915,1006,2916,159,0
20141229.095315,2916,4,994176,2,2915,1007,2916,159,1
20141229.095315,2915,6,994182,0,2915,1003,2916,160,0
20141229.095316,2916,2,994184,2,2915,1003,2916,160,1
20141229.095316,2915,106,994290,0,2915,950,2916,165,0
20141229.095317,2915,2,994292,2,2915,909,2916,166,0
20141229.095318,2915,6,994298,0,2915,906,2916,194,0
20141229.095318,2915,2,994300,0,2915,905,2916,194,0
20141229.095319,2916,10,994310,2,2915,901,2916,193,1
20141229.095319,2916,202,994512,56,2915,900,2916,93,1
20141229.09532,2915,6,994518,0,2915,1899,2916,94,0
20141229.09532,2915,2,994520,0,2915,1910,2916,94,0
20141229.095321,2915,2,994522,2,2915,1910,2916,94,0
20141229.095321,2915,6,994528,-2,2915,1922,2916,156,0
20141229.095322,2916,10,994538,-6,2915,1922,2916,149,1
20141229.095322,2916,4,994542,0,2915,1922,2916,149,1
20141229.095323,2915,6,994548,-2,2915,1920,2916,150,0
20141229.095323,2915,6,994554,-6,2915,1917,2916,147,0
20141229.095324,2916,2,994556,0,2915,1917,2916,147,1
20141229.095325,2915,2,994558,2,2915,1886,2916,305,0
20141229.095325,2915,6,994564,0,2915,1874,2916,322,0
20141229.095326,2916,26,994590,22,2915,1872,2916,325,1
20141229.095327,2915,6,994596,0,2915,1869,2916,325,0
20141229.095327,2915,100,994696,24,2915,1812,2916,325,0
20141229.095329,2915,2006,996702,196,2915,909,2916,331,0
20141229.095329,2916,624,997326,-414,2915,637,2916,321,1
20141229.09533,2915,12,997338,-4,2915,632,2916,312,0
20141229.09533,2915,204,997542,-200,2915,537,2916,322,0
20141229.095331,2915,2,997544,-2,2915,536,2916,322,0
20141229.095331,2915,6,997550,-6,2915,533,2916,322,0
20141229.095332,2916,22,997572,-2,2915,533,2916,315,1
20141229.095332,2915,18,997590,-18,2915,525,2916,315,0
20141229.095333,2915,6,997596,-6,2915,523,2916,314,0
20141229.095335,2915,6,997602,-6,2915,537,2916,304,0
20141229.095335,2915,1086,998688,224,2914,752,2915,610,0
20141229.095336,2915,102,998790,100,2914,750,2915,576,0
20141229.095337,2914,20,998810,20,2914,700,2915,571,0
20141229.095337,2914,2,998812,0,2914,699,2915,675,0
20141229.095338,2914,46,998858,10,2914,676,2915,675,0
20141229.095339,2915,26,998884,0,2914,669,2915,685,1
20141229.095339,2915,22,998906,12,2914,670,2915,679,1
20141229.09534,2914,10,998916,0,2914,665,2915,680,0
20141229.09534,2915,1414,1000330,-574,2915,445,2916,372,1
20141229.095341,2915,10,1000340,-6,2915,451,2916,348,1
20141229.095341,2915,20,1000360,0,2915,459,2916,357,1
20141229.095342,2915,56,1000416,-54,2915,382,2916,416,1
20141229.095342,2915,764,1001180,230,2914,860,2915,720,1
20141229.095343,2914,6,1001186,0,2914,693,2915,749,0
20141229.095343,2914,2,1001188,0,2914,692,2915,751,0
20141229.095344,2914,6,1001194,0,2914,689,2915,761,0
20141229.095345,2914,8,1001202,0,2914,685,2915,761,0
20141229.095345,2914,6,1001208,0,2914,683,2915,762,0
20141229.095346,2914,2,1001210,2,2914,681,2915,763,0
20141229.095347,2914,6,1001216,0,2914,678,2915,763,0
20141229.095347,2914,6,1001222,0,2914,701,2915,763,0
20141229.095348,2914,8,1001230,0,2914,697,2915,766,0
20141229.095349,2914,10,1001240,10,2914,693,2915,767,0
20141229.09535,2914,56,1001296,50,2914,691,2915,745,0
20141229.09535,2914,8,1001304,2,2914,688,2915,751,0
20141229.095351,2914,6,1001310,2,2914,686,2915,753,0
20141229.095351,2914,8,1001318,0,2914,683,2915,752,0
20141229.095353,2914,8,1001326,0,2914,683,2915,757,0
20141229.095354,2914,6,1001332,0,2914,685,2915,769,0
20141229.095355,2914,12,1001344,2,2914,661,2915,769,0
20141229.095355,2914,118,1001462,98,2914,607,2915,758,0
20141229.095356,2914,2,1001464,0,2914,607,2915,758,0
20141229.095356,2914,20,1001484,4,2914,597,2915,753,0
20141229.095357,2915,1514,1002998,-258,2915,303,2916,554,1
20141229.095358,2915,308,1003306,-2,2915,283,2916,420,1
20141229.095359,2915,6,1003312,-6,2915,292,2916,422,1
20141229.095359,2915,16,1003328,-14,2915,285,2916,421,1
20141229.095359,2915,18,1003346,-18,2915,277,2916,421,1
20141229.0954,2915,2,1003348,-2,2915,276,2916,421,1
20141229.095401,2915,12,1003360,-8,2915,270,2916,421,1
20141229.095401,2915,540,1003900,26,2914,762,2915,432,1
20141229.095402,2914,6,1003906,0,2914,603,2915,436,0
20141229.095402,2915,2,1003908,0,2914,603,2915,435,1
20141229.095402,2914,6,1003914,0,2914,682,2915,435,0
20141229.095404,2915,108,1004022,102,2914,691,2915,385,1
20141229.095405,2915,20,1004042,12,2914,682,2915,386,1
20141229.095405,2914,10,1004052,0,2914,679,2915,386,0
20141229.095406,2914,14,1004066,0,2914,672,2915,386,0
20141229.095406,2914,6,1004072,0,2914,669,2915,386,0
20141229.095407,2914,2,1004074,2,2914,668,2915,386,0
20141229.095407,2914,6,1004080,0,2914,665,2915,386,0
20141229.095408,2915,6,1004086,4,2914,671,2915,383,1
20141229.095409,2914,10,1004096,2,2914,667,2915,406,0
20141229.095409,2914,12,1004108,10,2914,666,2915,406,0
20141229.095411,2915,2,1004110,2,2914,671,2915,408,1
20141229.095411,2915,836,1004946,-256,2915,637,2916,442,1
20141229.095412,2915,2,1004948,0,2915,718,2916,442,1
20141229.095412,2915,20,1004968,0,2915,709,2916,442,1
20141229.095413,2915,108,1005076,0,2915,655,2916,422,1
20141229.095413,2915,8,1005084,-8,2915,656,2916,422,1
20141229.095414,2916,200,1005284,-98,2915,657,2916,272,1
20141229.095415,2915,4,1005288,-4,2915,655,2916,271,0
20141229.095416,2915,1312,1006600,280,2914,623,2915,448,0
20141229.095417,2914,2,1006602,2,2914,612,2915,501,0
20141229.095417,2914,1224,1007826,340,2913,1048,2915,510,0
20141229.095418,2914,2,1007828,-2,2913,964,2915,511,0
20141229.095419,2914,4,1007832,-4,2913,924,2914,1139,0
20141229.095419,2914,2,1007834,0,2913,696,2914,1251,0
20141229.09542,2913,2,1007836,0,2913,694,2914,1279,0
20141229.095421,2913,60,1007896,-4,2913,624,2914,1240,0
20141229.095421,2913,88,1007984,80,2913,580,2914,1252,0
20141229.095421,2913,118,1008102,-40,2913,523,2914,1251,0
20141229.095422,2913,20,1008122,-10,2913,489,2914,1266,0
20141229.095423,2913,56,1008178,0,2913,465,2914,1266,0
20141229.095424,2913,10,1008188,-8,2913,461,2914,1268,0
20141229.095424,2913,10,1008198,2,2913,457,2914,1268,0
20141229.095425,2913,2,1008200,2,2913,457,2914,1270,0
20141229.095425,2913,50,1008250,0,2913,432,2914,1270,0
20141229.095426,2913,24,1008274,8,2913,421,2914,1270,0
20141229.095426,2913,2,1008276,0,2913,419,2914,1270,0
20141229.095427,2914,2240,1010516,-210,2913,300,2914,273,1
20141229.095427,2913,556,1011072,-88,2913,296,2915,1826,0
20141229.095428,2913,12,1011084,0,2913,491,2915,1647,0
20141229.095428,2913,80,1011164,36,2913,574,2914,177,0
20141229.095429,2913,32,1011196,6,2913,498,2914,308,0
20141229.09543,2914,2,1011198,2,2913,478,2914,307,1
20141229.09543,2913,2,1011200,0,2913,480,2914,373,0
20141229.095431,2914,6,1011206,0,2913,503,2914,425,1
20141229.095432,2913,2,1011208,-2,2913,503,2914,425,0
20141229.095433,2913,138,1011346,136,2913,545,2914,357,0
20141229.095433,2913,4,1011350,-2,2913,541,2914,364,0
20141229.095434,2914,138,1011488,14,2913,537,2914,298,1
20141229.095435,2913,14,1011502,2,2913,531,2914,319,0
20141229.095435,2914,712,1012214,-264,2914,54,2915,1633,1
20141229.095436,2914,22,1012236,-16,2914,60,2915,642,1
20141229.095436,2914,4,1012240,0,2914,58,2915,632,1
20141229.095437,2914,56,1012296,-22,2914,156,2915,632,1
20141229.095437,2914,2,1012298,-2,2914,155,2915,632,1
20141229.095438,2914,20,1012318,-16,2914,163,2915,288,1
20141229.095439,2914,26,1012344,-4,2914,177,2915,4335,1
20141229.09544,2914,326,1012670,80,2913,539,2915,5342,1
20141229.09544,2914,62,1012732,32,2913,440,2914,172,1
20141229.095441,2913,20,1012752,10,2913,449,2914,197,0
20141229.095441,2914,14,1012766,10,2913,448,2914,194,1
20141229.095442,2913,2,1012768,2,2913,451,2914,195,0
20141229.095442,2913,20,1012788,-14,2913,443,2914,239,0
20141229.095443,2914,22,1012810,0,2913,454,2914,229,1
20141229.095443,2914,26,1012836,22,2913,467,2914,216,1
20141229.095444,2913,18,1012854,0,2913,474,2914,213,0
20141229.095445,2914,260,1013114,60,2913,481,2914,86,1
20141229.095445,2914,178,1013292,-92,2914,154,2915,445,1
20141229.095446,2914,46,1013338,-46,2914,132,2915,450,1
20141229.095446,2915,2,1013340,0,2914,211,2915,450,1
20141229.095447,2914,4,1013344,-2,2914,212,2915,453,0
20141229.095447,2914,72,1013416,0,2914,132,2915,654,0
20141229.095448,2914,16,1013432,0,2914,127,2915,653,0
20141229.095449,2914,20,1013452,0,2914,268,2915,674,0
20141229.095451,2914,20,1013472,0,2914,265,2915,679,0
20141229.095451,2914,12,1013484,-8,2914,259,2915,680,0
20141229.095452,2914,2,1013486,0,2914,258,2915,679,0
20141229.095454,2914,26,1013512,-2,2914,254,2915,660,0
20141229.095454,2914,12,1013524,0,2914,245,2915,661,0
20141229.095455,2914,2,1013526,2,2914,245,2915,661,0
20141229.095456,2914,490,1014016,404,2913,962,2914,857,0
20141229.095456,2914,4,1014020,2,2913,780,2914,858,0
20141229.095457,2914,6,1014026,2,2913,750,2914,866,0
20141229.095457,2914,36,1014062,8,2913,731,2914,853,0
20141229.095458,2914,1706,1015768,-16,2914,316,2915,674,0
20141229.095458,2914,24,1015792,-24,2914,306,2915,673,0
20141229.095459,2915,2,1015794,0,2914,255,2915,673,1
20141229.0955,2914,512,1016306,4,2913,527,2914,911,0
20141229.095502,2914,2,1016308,2,2913,518,2914,924,0
20141229.095504,2914,2,1016310,0,2913,520,2914,924,0
20141229.095506,2914,4,1016314,4,2913,525,2914,953,0
20141229.095506,2914,6,1016320,6,2913,526,2914,957,0
20141229.095507,2914,48,1016368,48,2913,526,2914,933,0
20141229.095508,2914,2,1016370,2,2913,526,2914,946,0
20141229.095508,2913,42,1016412,-42,2913,505,2914,947,0
20141229.095509,2913,10,1016422,-4,2913,501,2914,953,0
20141229.09551,2913,2,1016424,-2,2913,500,2914,955,0
20141229.095511,2913,2,1016426,-2,2913,500,2914,955,0
20141229.095512,2913,2,1016428,0,2913,498,2914,955,0
20141229.095513,2913,4,1016432,0,2913,495,2914,956,0
20141229.095513,2913,2,1016434,0,2913,494,2914,956,0
20141229.095514,2913,50,1016484,30,2913,469,2914,956,0
20141229.095514,2913,2,1016486,0,2913,469,2914,960,0
20141229.095515,2914,6,1016492,0,2913,468,2914,959,1
20141229.095516,2914,2,1016494,2,2913,465,2914,958,1
20141229.095516,2913,2,1016496,-2,2913,464,2914,958,0
20141229.095517,2913,8,1016504,0,2913,456,2914,959,0
20141229.095518,2913,2,1016506,0,2913,457,2914,966,0
20141229.09552,2914,4,1016510,4,2913,459,2914,965,1
20141229.09552,2914,2,1016512,2,2913,469,2914,985,1
20141229.095521,2914,6,1016518,4,2913,468,2914,983,1
20141229.095521,2914,2,1016520,2,2913,478,2914,982,1
20141229.095522,2913,4,1016524,0,2913,562,2914,978,0
20141229.095523,2914,4,1016528,0,2913,562,2914,984,1
20141229.095524,2913,304,1016832,-194,2913,412,2914,991,0
20141229.095525,2913,140,1016972,40,2913,464,2914,971,0
20141229.095526,2913,42,1017014,-32,2913,444,2914,971,0
20141229.095526,2913,4,1017018,0,2913,442,2914,971,0
20141229.095527,2913,302,1017320,0,2913,443,2914,901,0
20141229.095527,2913,126,1017446,-124,2913,379,2914,838,0
20141229.095528,2913,2,1017448,0,2913,378,2914,838,0
20141229.095528,2913,14,1017462,-2,2913,372,2914,841,0
20141229.095529,2913,2,1017464,0,2913,371,2914,841,0
20141229.095529,2913,742,1018206,400,2912,1034,2913,631,0
20141229.09553,2912,12,1018218,0,2912,873,2913,781,0
20141229.09553,2912,28,1018246,-18,2912,861,2913,779,0
20141229.095531,2912,26,1018272,-18,2912,858,2913,795,0
20141229.095531,2912,94,1018366,6,2912,840,2913,769,0
20141229.095532,2912,4,1018370,-2,2912,864,2913,770,0
20141229.095532,2912,6,1018376,2,2912,863,2913,768,0
20141229.095533,2913,28,1018404,24,2912,870,2913,780,1
20141229.095533,2912,16,1018420,-8,2912,864,2913,780,0
20141229.095534,2913,8,1018428,4,2912,867,2913,776,1
20141229.095534,2912,6,1018434,0,2912,866,2913,775,0
20141229.095535,2913,4,1018438,2,2912,866,2913,773,1
20141229.095535,2912,46,1018484,-38,2912,851,2913,761,0
20141229.095536,2913,12,1018496,-2,2912,860,2913,804,1
20141229.095537,2912,8,1018504,-4,2912,856,2913,884,0
20141229.095537,2913,8,1018512,-2,2912,854,2913,983,1
20141229.095538,2912,6,1018518,-4,2912,851,2913,984,0
20141229.095539,2912,14,1018532,-14,2912,845,2913,984,0
20141229.095539,2912,4,1018536,-4,2912,845,2913,986,0
20141229.095539,2912,10,1018546,-10,2912,840,2913,986,0
20141229.09554,2912,4,1018550,-4,2912,839,2913,986,0
20141229.095541,2912,10,1018560,-6,2912,845,2913,986,0
20141229.095541,2912,28,1018588,-28,2912,831,2913,986,0
20141229.095541,2913,10,1018598,-2,2912,829,2913,985,1
20141229.095542,2913,30,1018628,-22,2912,822,2913,982,1
20141229.095542,2912,8,1018636,-4,2912,838,2913,982,0
20141229.095543,2912,6,1018642,-6,2912,836,2913,982,0
20141229.095543,2913,8,1018650,-2,2912,885,2913,981,1
20141229.095544,2912,4,1018654,-4,2912,922,2913,981,0
20141229.095545,2912,60,1018714,-26,2912,905,2913,971,0
20141229.095545,2913,18,1018732,-2,2912,898,2913,973,1
20141229.095545,2912,4,1018736,-4,2912,897,2913,973,0
20141229.095546,2912,216,1018952,-4,2912,803,2913,969,0
20141229.095546,2913,10,1018962,0,2912,802,2913,967,1
20141229.095547,2913,16,1018978,-2,2912,798,2913,963,1
20141229.095548,2912,222,1019200,-2,2912,692,2913,958,0
20141229.095548,2912,1234,1020434,246,2912,80,2913,967,0
20141229.095549,2912,296,1020730,54,2911,1191,2912,218,0
20141229.095549,2912,772,1021502,-216,2912,361,2913,958,0
20141229.09555,2912,52,1021554,-12,2912,386,2913,958,0
20141229.09555,2912,6,1021560,-4,2912,393,2913,958,0
20141229.09555,2912,56,1021616,32,2912,531,2913,937,0
20141229.095551,2912,18,1021634,-16,2912,725,2913,835,0
20141229.095552,2912,12,1021646,-4,2912,756,2913,850,0
20141229.095552,2912,18,1021664,-18,2912,757,2913,863,0
20141229.095553,2912,26,1021690,-26,2912,756,2913,864,0
20141229.095553,2912,4,1021694,-4,2912,754,2913,865,0
20141229.095554,2912,6,1021700,-4,2912,804,2913,866,0
20141229.095554,2912,8,1021708,-8,2912,808,2913,866,0
20141229.095555,2912,6,1021714,-6,2912,806,2913,872,0
20141229.095555,2912,6,1021720,-6,2912,806,2913,872,0
20141229.095556,2912,6,1021726,-4,2912,806,2913,873,0
20141229.095556,2912,38,1021764,10,2912,747,2913,867,0
20141229.095557,2912,34,1021798,-4,2912,730,2913,868,0
20141229.095557,2912,26,1021824,-6,2912,721,2913,863,0
20141229.095558,2912,16,1021840,-6,2912,718,2913,874,0
20141229.095558,2912,6,1021846,-6,2912,705,2913,900,0
20141229.095559,2912,10,1021856,-6,2912,732,2913,901,0
20141229.095559,2912,44,1021900,-4,2912,710,2913,905,0
20141229.0956,2912,4,1021904,-4,2912,708,2913,905,0
20141229.0956,2913,46,1021950,36,2912,707,2913,884,1
20141229.095601,2913,16,1021966,-4,2912,620,2913,884,1
20141229.095601,2912,72,1022038,-64,2912,587,2913,898,0
20141229.095602,2912,6,1022044,-4,2912,604,2913,897,0
20141229.095602,2913,16,1022060,6,2912,601,2913,892,1
20141229.095603,2912,6,1022066,-4,2912,599,2913,892,0
20141229.095603,2912,6,1022072,-4,2912,596,2913,892,0
20141229.095604,2912,14,1022086,-10,2912,591,2913,891,0
20141229.095604,2912,4,1022090,-4,2912,589,2913,891,0
20141229.095605,2912,4,1022094,-4,2912,587,2913,888,0
20141229.095605,2912,10,1022104,-4,2912,587,2913,885,0
20141229.095606,2912,8,1022112,-4,2912,588,2913,883,0
20141229.095606,2912,12,1022124,-4,2912,586,2913,887,0
20141229.095607,2912,12,1022136,-12,2912,582,2913,879,0
20141229.095608,2912,4,1022140,-4,2912,582,2913,880,0
20141229.095608,2912,4,1022144,-4,2912,581,2913,880,0
20141229.095609,2912,24,1022168,-24,2912,570,2913,900,0
20141229.095609,2912,50,1022218,-6,2912,545,2913,904,0
20141229.09561,2912,4,1022222,-4,2912,544,2913,905,0
20141229.09561,2912,6,1022228,-4,2912,591,2913,906,0
20141229.09561,2912,12,1022240,-12,2912,585,2913,906,0
20141229.095611,2912,160,1022400,-114,2912,512,2913,908,0
20141229.095611,2912,4,1022404,0,2912,510,2913,909,0
20141229.095612,2912,2,1022406,2,2912,516,2913,914,0
20141229.095612,2912,104,1022510,24,2912,664,2913,914,0
20141229.095613,2912,14,1022524,8,2912,614,2913,920,0
20141229.095614,2913,4,1022528,0,2912,614,2913,919,1
20141229.095615,2912,40,1022568,0,2912,594,2913,919,0
20141229.095616,2912,44,1022612,-4,2912,568,2913,919,0
20141229.095616,2912,2,1022614,2,2912,567,2913,919,0
20141229.095617,2912,4,1022618,2,2912,573,2913,922,0
20141229.095618,2912,18,1022636,16,2912,577,2913,907,0
20141229.095618,2912,2,1022638,0,2912,574,2913,907,0
20141229.095619,2912,2,1022640,0,2912,573,2913,907,0
20141229.095619,2913,52,1022692,6,2912,550,2913,909,1
20141229.09562,2912,104,1022796,0,2912,501,2913,908,0
20141229.09562,2912,4,1022800,0,2912,499,2913,908,0
20141229.09562,2912,4,1022804,0,2912,497,2913,908,0
20141229.095621,2912,32,1022836,28,2912,486,2913,908,0
20141229.095622,2912,6,1022842,0,2912,484,2913,908,0
20141229.095622,2912,20,1022862,4,2912,516,2913,909,0
20141229.095623,2912,4,1022866,0,2912,514,2913,909,0
20141229.095623,2912,26,1022892,22,2912,502,2913,909,0
20141229.095624,2912,6,1022898,0,2912,519,2913,909,0
20141229.095624,2912,4,1022902,-4,2912,517,2913,910,0
20141229.095625,2912,4,1022906,-4,2912,515,2913,910,0
20141229.095625,2912,8,1022914,-8,2912,511,2913,910,0
20141229.095626,2912,4,1022918,-4,2912,509,2913,910,0
20141229.095626,2912,12,1022930,0,2912,505,2913,910,0
20141229.095627,2912,210,1023140,116,2912,400,2913,910,0
20141229.095627,2913,24,1023164,-6,2912,395,2913,902,1
20141229.095628,2912,72,1023236,16,2912,361,2913,902,0
20141229.095628,2912,4,1023240,-4,2912,361,2913,922,0
20141229.095629,2912,728,1023968,448,2911,890,2912,131,0
20141229.09563,2912,6,1023974,2,2911,889,2912,203,0
20141229.095631,2912,2,1023976,2,2911,899,2912,256,0
20141229.095632,2912,10,1023986,0,2911,898,2912,254,0
20141229.095632,2911,10,1023996,0,2911,892,2912,254,0
20141229.095632,2911,48,1024044,0,2911,881,2912,254,0
20141229.095633,2911,32,1024076,-2,2911,869,2912,697,0
20141229.095634,2912,14,1024090,0,2911,844,2912,705,1
20141229.095634,2912,1840,1025930,-254,2912,234,2913,925,1
20141229.095634,2912,468,1026398,-398,2911,955,2912,102,1
20141229.095635,2911,14,1026412,-2,2911,850,2912,142,0
20141229.095636,2912,18,1026430,2,2911,847,2912,201,1
20141229.095636,2912,10,1026440,2,2911,846,2912,198,1
20141229.095637,2911,6,1026446,-2,2911,844,2912,201,0
20141229.095638,2911,8,1026454,2,2911,841,2912,201,0
20141229.095638,2912,8,1026462,0,2911,840,2912,203,1
20141229.095638,2912,16,1026478,2,2911,836,2912,196,1
20141229.095639,2912,18,1026496,0,2911,833,2912,197,1
20141229.095639,2911,6,1026502,-2,2911,832,2912,197,0
20141229.09564,2912,6,1026508,-4,2911,831,2912,197,1
20141229.09564,2911,6,1026514,-6,2911,828,2912,197,0
20141229.095641,2911,146,1026660,136,2911,835,2912,127,0
20141229.095642,2911,40,1026700,-2,2911,870,2912,127,0
20141229.095642,2912,264,1026964,-44,2911,962,2912,2,1
20141229.095643,2912,8,1026972,2,2912,50,2913,925,1
20141229.095643,2912,4,1026976,0,2912,54,2913,926,1
20141229.095644,2913,6,1026982,2,2912,107,2913,925,1
20141229.095644,2912,46,1027028,42,2912,93,2913,925,0
20141229.095645,2912,8,1027036,4,2912,90,2913,925,0
20141229.095645,2912,16,1027052,12,2912,320,2913,925,0
20141229.095646,2912,16,1027068,0,2912,342,2913,929,0
20141229.095646,2912,4,1027072,0,2912,369,2913,929,0
20141229.095647,2912,12,1027084,2,2912,371,2913,1929,0
20141229.095647,2912,104,1027188,-100,2912,318,2913,5931,0
20141229.095648,2912,144,1027332,44,2912,354,2913,5914,0
20141229.095648,2912,16,1027348,-6,2912,344,2913,908,0
20141229.095649,2912,4,1027352,-4,2912,352,2913,908,0
20141229.095649,2912,4,1027356,-4,2912,610,2913,883,0
20141229.09565,2912,96,1027452,-14,2912,578,2913,863,0
20141229.09565,2912,8,1027460,2,2912,576,2913,864,0
20141229.095651,2913,76,1027536,38,2912,554,2913,850,1
20141229.095651,2912,4,1027540,0,2912,553,2913,850,0
20141229.095652,2912,26,1027566,22,2912,355,2913,852,0
20141229.095653,2913,1126,1028692,-136,2912,357,2913,284,1
20141229.095653,2913,570,1029262,-298,2913,438,2914,298,1
20141229.095654,2914,16,1029278,-6,2913,461,2914,294,1
20141229.095654,2913,286,1029564,180,2913,465,2914,156,0
20141229.095655,2913,12,1029576,-12,2913,502,2914,309,0
20141229.095655,2913,2,1029578,-2,2913,502,2914,309,0
20141229.095656,2913,20,1029598,0,2913,492,2914,316,0
20141229.095656,2913,2,1029600,-2,2913,491,2914,317,0
20141229.095659,2913,2,1029602,0,2913,492,2914,344,0
20141229.095659,2913,2,1029604,0,2913,491,2914,344,0
20141229.0957,2913,10,1029614,-2,2913,488,2914,345,0
20141229.0957,2913,4,1029618,-4,2913,486,2914,346,0
20141229.095701,2913,48,1029666,-4,2913,462,2914,354,0
20141229.095701,2913,4,1029670,-4,2913,460,2914,357,0
20141229.095702,2913,56,1029726,-42,2913,459,2914,329,0
20141229.095702,2913,4,1029730,-4,2913,457,2914,327,0
20141229.095703,2913,4,1029734,0,2913,277,2914,329,0
20141229.095703,2913,8,1029742,2,2913,273,2914,334,0
20141229.095704,2913,14,1029756,0,2913,266,2914,333,0
20141229.095704,2913,40,1029796,36,2913,246,2914,1366,0
20141229.095705,2913,342,1030138,-152,2912,644,2913,5,0
20141229.095705,2913,2,1030140,0,2912,625,2913,4,0
20141229.095706,2913,18,1030158,0,2913,8,2914,475,0
20141229.095706,2913,4,1030162,-4,2913,159,2914,376,0
20141229.095707,2913,4,1030166,-4,2913,162,2914,221,0
20141229.095707,2913,4,1030170,-4,2913,160,2914,224,0
20141229.095708,2913,4,1030174,-2,2913,160,2914,222,0
20141229.095708,2913,4,1030178,-4,2913,158,2914,372,0
20141229.095709,2913,8,1030186,-4,2913,155,2914,381,0
20141229.09571,2913,32,1030218,0,2913,141,2914,223,0
20141229.09571,2913,164,1030382,-4,2913,89,2914,221,0
20141229.095711,2913,8,1030390,2,2913,36,2914,223,0
20141229.095711,2913,4,1030394,0,2913,38,2914,224,0
20141229.095712,2913,14,1030408,0,2913,35,2914,322,0
20141229.095712,2913,28,1030436,16,2913,225,2914,308,0
20141229.095712,2913,14,1030450,-4,2913,218,2914,305,0
20141229.095713,2913,4,1030454,-4,2913,216,2914,302,0
20141229.095714,2913,8,1030462,-4,2913,213,2914,303,0
20141229.095714,2913,2,1030464,-2,2913,226,2914,319,0
20141229.095714,2913,60,1030524,2,2913,196,2914,323,0
20141229.095715,2914,606,1031130,236,2912,698,2913,55,1
20141229.095717,2913,22,1031152,0,2912,519,2913,396,0
20141229.095718,2913,6,1031158,-2,2912,516,2913,397,0
20141229.095718,2913,12,1031170,-8,2912,507,2913,390,0
20141229.095719,2913,86,1031256,-2,2912,475,2913,567,0
20141229.095719,2912,4,1031260,0,2912,473,2913,595,0
20141229.09572,2913,6,1031266,0,2912,472,2913,576,1
20141229.09572,2913,16,1031282,-2,2912,465,2913,578,1
20141229.095721,2912,4,1031286,0,2912,463,2913,561,0
20141229.095721,2912,6,1031292,0,2912,461,2913,521,0
20141229.095722,2912,4,1031296,0,2912,462,2913,519,0
20141229.095722,2912,4,1031300,0,2912,460,2913,533,0
20141229.095723,2913,8,1031308,-4,2912,458,2913,520,1
20141229.095723,2912,6,1031314,2,2912,456,2913,489,0
20141229.095724,2912,4,1031318,0,2912,455,2913,380,0
20141229.095724,2913,30,1031348,-26,2912,455,2913,364,1
20141229.095725,2912,4,1031352,0,2912,454,2913,366,0
20141229.095725,2913,130,1031482,-42,2912,429,2913,326,1
20141229.095726,2913,6,1031488,-6,2912,427,2913,325,1
20141229.095726,2912,4,1031492,-4,2912,426,2913,325,0
20141229.095727,2912,4,1031496,-4,2912,434,2913,325,0
20141229.095728,2913,18,1031514,-6,2912,632,2913,320,1
20141229.095728,2912,4,1031518,-4,2912,632,2913,320,0
20141229.095728,2912,8,1031526,-6,2912,638,2913,320,0
20141229.095729,2912,4,1031530,-4,2912,639,2913,320,0
20141229.09573,2912,8,1031538,-4,2912,636,2913,320,0
20141229.09573,2912,6,1031544,-4,2912,631,2913,319,0
20141229.09573,2912,4,1031548,-4,2912,629,2913,294,0
20141229.095731,2912,4,1031552,-4,2912,628,2913,294,0
20141229.095732,2912,4,1031556,-4,2912,627,2913,298,0
20141229.095732,2913,12,1031568,-12,2912,625,2913,294,1
20141229.095732,2912,6,1031574,-4,2912,624,2913,293,0
20141229.095733,2912,6,1031580,-4,2912,621,2913,297,0
20141229.095734,2912,208,1031788,-66,2912,515,2913,308,0
20141229.095734,2912,4,1031792,-4,2912,513,2913,308,0
20141229.095734,2912,112,1031904,-14,2912,472,2913,389,0
20141229.095735,2912,204,1032108,-90,2912,370,2913,414,0
20141229.095735,2912,348,1032456,-196,2911,1110,2912,157,0
20141229.095736,2912,8,1032464,-2,2911,1018,2912,182,0
20141229.095737,2911,8,1032472,-6,2911,1012,2912,182,0
20141229.095737,2912,22,1032494,-18,2911,1010,2912,173,1
20141229.095738,2912,16,1032510,-8,2911,1008,2912,167,1
20141229.095738,2912,10,1032520,-8,2911,1006,2912,214,1
20141229.095739,2912,212,1032732,-144,2911,906,2912,211,1
20141229.095739,2911,6,1032738,2,2911,903,2912,211,0
20141229.095739,2911,68,1032806,-2,2911,871,2912,210,0
20141229.09574,2912,18,1032824,-2,2911,867,2912,205,1
20141229.095741,2911,10,1032834,0,2911,870,2912,203,0
20141229.095741,2911,8,1032842,-2,2911,868,2912,201,0
20141229.095742,2912,16,1032858,-6,2911,835,2912,199,1
20141229.095742,2911,22,1032880,0,2911,828,2912,197,0
20141229.095743,2912,144,1033024,-102,2911,815,2912,143,1
20141229.095743,2911,8,1033032,-2,2911,823,2912,146,0
20141229.095744,2912,12,1033044,-4,2911,822,2912,143,1
20141229.095744,2912,10,1033054,-8,2911,822,2912,142,1
20141229.095745,2911,8,1033062,-6,2911,819,2912,141,0
20141229.095745,2911,2,1033064,-2,2911,808,2912,145,0
20141229.095746,2911,2,1033066,-2,2911,807,2912,146,0
20141229.095748,2911,4,1033070,-2,2911,809,2912,163,0
20141229.095749,2911,62,1033132,-38,2911,793,2912,163,0
20141229.095751,2911,2,1033134,-2,2911,817,2912,180,0
20141229.095751,2912,6,1033140,-4,2911,787,2912,178,1
20141229.095752,2912,4,1033144,-2,2911,787,2912,179,1
20141229.095752,2912,2,1033146,0,2911,787,2912,178,1
20141229.095753,2911,2,1033148,0,2911,786,2912,183,0
20141229.095754,2912,2,1033150,-2,2911,787,2912,182,1
20141229.095755,2912,2,1033152,0,2911,792,2912,181,1
20141229.095756,2912,2,1033154,-2,2911,792,2912,181,1
20141229.095757,2911,10,1033164,-2,2911,789,2912,180,0
20141229.095758,2912,4,1033168,-4,2911,792,2912,182,1
20141229.095759,2911,4,1033172,0,2911,807,2912,224,0
20141229.095759,2911,2,1033174,0,2911,806,2912,225,0
20141229.0958,2911,4,1033178,-4,2911,805,2912,225,0
20141229.0958,2911,2,1033180,0,2911,804,2912,225,0
20141229.095801,2911,6,1033186,-4,2911,801,2912,225,0
20141229.095801,2911,52,1033238,-46,2911,775,2912,225,0
20141229.095802,2911,6,1033244,-6,2911,772,2912,227,0
20141229.095802,2911,4,1033248,-4,2911,776,2912,227,0
20141229.095803,2911,8,1033256,-4,2911,778,2912,227,0
20141229.095804,2911,12,1033268,-4,2911,776,2912,225,0
20141229.095804,2911,4,1033272,-4,2911,774,2912,225,0
20141229.095806,2911,4,1033276,0,2911,782,2912,236,0
20141229.095807,2912,28,1033304,-24,2911,778,2912,235,1
20141229.095807,2911,4,1033308,-2,2911,777,2912,234,0
20141229.095808,2911,2,1033310,0,2911,777,2912,236,0
20141229.095808,2911,2,1033312,0,2911,777,2912,236,0
20141229.095809,2911,2,1033314,-2,2911,779,2912,236,0
20141229.09581,2912,6,1033320,0,2911,779,2912,233,1
20141229.09581,2912,2,1033322,0,2911,781,2912,240,1
20141229.095811,2912,96,1033418,-96,2911,782,2912,192,1
20141229.095811,2911,6,1033424,0,2911,789,2912,189,0
20141229.095812,2911,10,1033434,0,2911,800,2912,189,0
20141229.095812,2911,6,1033440,0,2911,803,2912,193,0
20141229.095813,2911,12,1033452,-2,2911,795,2912,191,0
20141229.095813,2911,2,1033454,-2,2911,794,2912,191,0
20141229.095814,2912,8,1033462,-4,2911,794,2912,187,1
20141229.095814,2912,4,1033466,-2,2911,795,2912,185,1
20141229.095815,2912,6,1033472,0,2911,836,2912,182,1
20141229.095816,2912,202,1033674,-184,2911,826,2912,86,1
20141229.095816,2912,2,1033676,2,2911,825,2912,85,1
20141229.095816,2912,2,1033678,2,2911,927,2912,84,1
20141229.095817,2912,170,1033848,-78,2912,337,2913,495,1
20141229.095817,2912,50,1033898,-30,2912,349,2913,490,1
20141229.095818,2913,8,1033906,2,2912,319,2913,488,1
20141229.095818,2912,30,1033936,-30,2912,306,2913,489,0
20141229.095819,2912,4,1033940,-4,2912,305,2913,489,0
20141229.095821,2912,10,1033950,-10,2912,334,2913,489,0
20141229.095821,2912,10,1033960,0,2912,334,2913,489,0
20141229.095822,2912,4,1033964,0,2912,332,2913,489,0
20141229.095823,2912,2,1033966,0,2912,332,2913,500,0
20141229.095824,2913,10,1033976,0,2912,335,2913,495,1
20141229.095828,2913,2,1033978,2,2912,422,2913,480,1
20141229.095828,2913,18,1033996,2,2912,424,2913,472,1
20141229.095829,2913,16,1034012,10,2912,424,2913,464,1
20141229.09583,2912,10,1034022,4,2912,419,2913,464,0
20141229.095831,2912,8,1034030,0,2912,415,2913,464,0
20141229.095831,2912,10,1034040,0,2912,411,2913,463,0
20141229.095834,2913,20,1034060,-20,2912,450,2913,455,1
20141229.095834,2913,20,1034080,-20,2912,458,2913,445,1
20141229.095837,2912,60,1034140,0,2912,471,2913,443,0
20141229.095837,2913,4,1034144,0,2912,471,2913,441,1
20141229.095838,2912,14,1034158,6,2912,489,2913,440,0
20141229.095841,2913,4,1034162,-2,2912,490,2913,440,1
20141229.095841,2913,6,1034168,-2,2912,488,2913,438,1
20141229.095842,2912,30,1034198,-20,2912,475,2913,436,0
20141229.095843,2913,448,1034646,126,2912,485,2913,59,1
20141229.095844,2913,120,1034766,66,2913,66,2914,492,1
20141229.095846,2913,8,1034774,0,2913,96,2914,507,1
20141229.095846,2914,4,1034778,0,2913,95,2914,506,1
20141229.095846,2913,10,1034788,0,2913,89,2914,496,0
20141229.095847,2913,184,1034972,148,2912,586,2913,62,0
20141229.095848,2913,6,1034978,0,2912,469,2913,59,0
20141229.095849,2912,10,1034988,0,2912,469,2913,234,0
20141229.095849,2912,6,1034994,2,2912,466,2913,234,0
20141229.09585,2913,2,1034996,2,2912,466,2913,233,1
20141229.095853,2912,904,1035900,442,2912,22,2913,246,0
20141229.095853,2912,52,1035952,-30,2911,959,2912,77,0
20141229.095854,2912,170,1036122,-2,2912,139,2913,332,0
20141229.095855,2913,4,1036126,4,2912,107,2913,330,1
20141229.095856,2913,44,1036170,22,2912,110,2913,321,1
20141229.095858,2912,4,1036174,0,2912,114,2913,322,0
20141229.095859,2913,20,1036194,20,2912,118,2913,317,1
20141229.095901,2912,2,1036196,0,2912,120,2913,356,0
20141229.095903,2912,4,1036200,-4,2912,174,2913,358,0
20141229.095906,2913,6,1036206,0,2912,199,2913,355,1
20141229.095907,2912,2,1036208,-2,2912,213,2913,356,0
20141229.095907,2912,2,1036210,-2,2912,245,2913,356,0
20141229.095908,2912,4,1036214,0,2912,247,2913,357,0
20141229.095911,2913,2,1036216,0,2912,332,2913,323,1
20141229.095912,2912,2,1036218,0,2912,331,2913,424,0
20141229.095913,2913,4,1036222,4,2912,331,2913,424,1
20141229.095914,2912,4,1036226,0,2912,329,2913,424,0
20141229.095914,2912,2,1036228,0,2912,328,2913,424,0
20141229.095916,2912,40,1036268,0,2912,308,2913,424,0
20141229.095917,2913,2,1036270,2,2912,307,2913,424,1
20141229.095917,2913,2,1036272,2,2912,307,2913,423,1
20141229.095919,2912,2,1036274,0,2912,307,2913,431,0
20141229.09592,2912,2,1036276,-2,2912,306,2913,431,0
20141229.09592,2912,8,1036284,6,2912,305,2913,428,0
20141229.095922,2912,8,1036292,0,2912,301,2913,430,0
20141229.095923,2912,2,1036294,-2,2912,335,2913,430,0
20141229.095925,2912,4,1036298,0,2912,286,2913,433,0
20141229.095926,2913,2,1036300,0,2912,286,2913,432,1
20141229.095926,2913,10,1036310,0,2912,286,2913,427,1
20141229.095928,2912,12,1036322,0,2912,282,2913,433,0
20141229.095929,2912,10,1036332,-10,2912,307,2913,437,0
20141229.095929,2912,10,1036342,-10,2912,304,2913,452,0
20141229.095931,2912,2,1036344,0,2912,310,2913,452,0
20141229.095931,2913,16,1036360,10,2912,310,2913,448,1
20141229.095932,2912,2,1036362,0,2912,279,2913,448,0
20141229.095933,2913,2,1036364,0,2912,279,2913,447,1
20141229.095934,2913,2,1036366,0,2912,279,2913,345,1
20141229.095935,2913,4,1036370,0,2912,292,2913,342,1
20141229.095936,2912,2,1036372,0,2912,291,2913,343,0
20141229.095937,2913,14,1036386,-6,2912,315,2913,341,1
20141229.095938,2913,12,1036398,0,2912,313,2913,350,1
20141229.095939,2912,2,1036400,0,2912,312,2913,350,0
20141229.09594,2912,8,1036408,0,2912,309,2913,350,0
20141229.095941,2912,2,1036410,0,2912,312,2913,352,0
20141229.095942,2913,4,1036414,-2,2912,312,2913,350,1
20141229.095942,2913,4,1036418,-2,2912,384,2913,348,1
20141229.095943,2913,2,1036420,0,2912,384,2913,347,1
20141229.095943,2913,16,1036436,-16,2912,384,2913,339,1
20141229.095944,2912,2,1036438,-2,2912,385,2913,339,0
20141229.095945,2913,2,1036440,-2,2912,385,2913,339,1
20141229.095947,2912,2,1036442,-2,2912,385,2913,344,0
20141229.095948,2913,30,1036472,-30,2912,376,2913,329,1
20141229.095949,2912,2,1036474,0,2912,373,2913,329,0
20141229.095951,2913,10,1036484,10,2912,374,2913,303,1
20141229.095954,2913,2,1036486,2,2912,380,2913,369,1
20141229.095955,2913,2,1036488,2,2912,380,2913,368,1
20141229.095956,2913,62,1036550,-16,2912,390,2913,338,1
20141229.095957,2912,30,1036580,-20,2912,375,2913,353,0
20141229.095957,2913,50,1036630,50,2912,375,2913,329,1
20141229.095958,2912,2,1036632,2,2912,374,2913,329,0
20141229.100001,2913,438,1037070,-40,2912,389,2913,158,1
20141229.100002,2914,498,1037568,-244,2913,16,2914,599,1
20141229.100002,2914,708,1038276,-236,2913,123,2914,279,1
20141229.100003,2914,112,1038388,78,2913,142,2914,225,1
20141229.100003,2915,530,1038918,-268,2914,52,2915,1114,1
20141229.100004,2915,48,1038966,0,2914,110,2915,1090,1
20141229.100004,2915,56,1039022,-30,2914,224,2915,1063,1
20141229.100005,2915,90,1039112,-18,2914,221,2915,992,1
20141229.100005,2915,2,1039114,-2,2914,221,2915,979,1
20141229.100006,2915,84,1039198,2,2914,393,2915,938,1
20141229.100006,2915,24,1039222,-24,2914,395,2915,926,1
20141229.100007,2915,48,1039270,16,2914,395,2915,901,1
20141229.100007,2915,110,1039380,-28,2914,395,2915,846,1
20141229.100008,2915,60,1039440,2,2914,390,2915,818,1
20141229.100009,2914,54,1039494,0,2914,390,2915,790,0
20141229.10001,2915,34,1039528,-2,2914,391,2915,801,1
20141229.10001,2914,32,1039560,-4,2914,388,2915,803,0
20141229.100011,2915,24,1039584,0,2914,388,2915,792,1
20141229.100012,2915,16,1039600,0,2914,388,2915,787,1
20141229.100013,2915,12,1039612,-12,2914,388,2915,781,1
20141229.100013,2914,4,1039616,-2,2914,386,2915,781,0
20141229.100014,2915,16,1039632,0,2914,385,2915,776,1
20141229.100015,2914,2,1039634,0,2914,384,2915,783,0
20141229.100016,2915,2,1039636,0,2914,384,2915,782,1
20141229.100016,2914,6,1039642,0,2914,403,2915,781,0
20141229.100017,2914,4,1039646,-2,2914,401,2915,785,0
20141229.100018,2915,24,1039670,-24,2914,404,2915,773,1
20141229.100018,2914,20,1039690,0,2914,414,2915,780,0
20141229.100019,2915,100,1039790,32,2914,409,2915,752,1
20141229.10002,2915,12,1039802,8,2914,404,2915,754,1
20141229.10002,2915,68,1039870,40,2914,402,2915,725,1
20141229.10002,2915,2,1039872,0,2914,405,2915,726,1
20141229.100021,2914,34,1039906,30,2914,407,2915,726,0
20141229.100022,2915,4,1039910,4,2914,407,2915,730,1
20141229.100022,2915,30,1039940,20,2914,1407,2915,715,1
20141229.100023,2915,10,1039950,10,2914,1411,2915,717,1
20141229.100023,2915,2,1039952,0,2914,1411,2915,706,1
20141229.100024,2915,12,1039964,8,2914,1409,2915,702,1
20141229.100024,2915,16,1039980,4,2914,1408,2915,695,1
20141229.100025,2915,42,1040022,2,2914,1407,2915,678,1
20141229.100025,2915,116,1040138,102,2914,1357,2915,633,1
20141229.100026,2915,280,1040418,122,2914,1230,2915,486,1
20141229.100027,2915,198,1040616,62,2914,1147,2916,672,1
20141229.100027,2915,2,1040618,-2,2914,1147,2916,657,1
20141229.100028,2915,8,1040626,-8,2914,1148,2916,713,1
20141229.100028,2915,6,1040632,-6,2914,1148,2915,371,1
20141229.100029,2915,270,1040902,-204,2914,1139,2915,249,1
20141229.10003,2915,104,1041006,18,2914,1139,2915,261,1
20141229.10003,2915,22,1041028,0,2914,1153,2916,737,1
20141229.100031,2915,2,1041030,-2,2914,1153,2915,251,1
20141229.100031,2915,46,1041076,-40,2914,1143,2916,738,1
20141229.100032,2914,2082,1043158,152,2914,153,2915,262,0
20141229.100033,2914,58,1043216,-52,2914,126,2915,361,0
20141229.100033,2914,260,1043476,86,2913,375,2914,38,0
20141229.100035,2914,2,1043478,0,2913,326,2914,32,0
20141229.100037,2914,6,1043484,0,2913,328,2914,31,0
20141229.100037,2914,62,1043546,2,2914,172,2915,737,0
20141229.100037,2914,348,1043894,128,2914,1,2915,630,0
20141229.100038,2914,12,1043906,-2,2913,339,2914,137,0
20141229.100038,2914,20,1043926,0,2913,340,2914,128,0
20141229.100039,2914,2,1043928,0,2913,340,2914,127,0
20141229.10004,2913,4,1043932,0,2913,339,2914,127,0
20141229.100042,2914,6,1043938,-4,2913,303,2914,1135,1
20141229.100043,2914,44,1043982,0,2913,316,2914,1139,1
20141229.100045,2913,8,1043990,0,2913,413,2914,2152,0
20141229.100046,2913,4,1043994,-2,2913,422,2914,2149,0
20141229.100047,2913,34,1044028,0,2913,420,2914,2134,0
20141229.100047,2913,2044,1046072,-170,2913,400,2914,1100,0
20141229.100048,2914,30,1046102,30,2913,432,2914,1075,1
20141229.100049,2914,150,1046252,-4,2914,102,2915,619,1
20141229.100051,2914,2,1046254,-2,2914,123,2915,628,1
20141229.100053,2914,246,1046500,214,2913,433,2914,957,1
20141229.100055,2914,8,1046508,8,2913,424,2914,2091,1
20141229.100055,2914,2,1046510,0,2913,425,2914,2085,1
20141229.100056,2914,6,1046516,2,2913,424,2914,2083,1
20141229.100056,2913,2,1046518,0,2913,423,2914,2083,0
20141229.100058,2913,20,1046538,0,2913,416,2914,1084,0
20141229.100058,2914,4,1046542,2,2913,416,2914,1083,1
20141229.100059,2914,2168,1048710,-330,2914,205,2915,625,1
20141229.100101,2915,62,1048772,-2,2914,244,2915,466,1
20141229.100102,2914,4,1048776,4,2914,243,2915,415,0
20141229.100103,2914,486,1049262,-140,2913,514,2914,759,0
20141229.100103,2913,6,1049268,-6,2913,482,2914,784,0
20141229.100104,2914,2,1049270,0,2913,482,2914,1783,1
20141229.100105,2913,2,1049272,-2,2913,471,2914,1794,0
20141229.10011,2914,2906,1052178,-980,2913,525,2914,343,1
20141229.10011,2914,668,1052846,548,2914,265,2915,418,1
20141229.100111,2914,2,1052848,0,2914,274,2915,418,1
20141229.100112,2915,6,1052854,-6,2914,274,2915,401,1
20141229.100113,2914,20,1052874,0,2914,264,2915,406,0
20141229.100115,2914,196,1053070,2,2914,164,2915,359,0
20141229.100117,2914,6,1053076,4,2914,159,2915,360,0
20141229.100117,2914,50,1053126,40,2914,135,2915,360,0
20141229.100118,2914,64,1053190,-2,2914,103,2915,420,0
20141229.100118,2915,2,1053192,-2,2914,96,2915,429,1
20141229.100119,2914,248,1053440,244,2913,564,2914,1029,0
20141229.10012,2914,4,1053444,0,2913,564,2914,1031,0
20141229.100122,2914,8,1053452,6,2913,564,2914,977,0
20141229.100122,2914,2,1053454,2,2913,564,2914,978,0
20141229.100123,2914,10,1053464,10,2913,564,2914,973,0
20141229.100124,2914,4,1053468,4,2913,588,2914,971,0
20141229.100124,2914,1958,1055426,-212,2914,123,2915,428,0
20141229.100125,2914,10,1055436,0,2914,139,2915,428,0
20141229.100128,2914,2,1055438,0,2914,142,2915,429,0
20141229.10013,2914,4,1055442,0,2914,140,2915,429,0
20141229.100132,2914,24,1055466,-22,2914,152,2915,429,0
20141229.100134,2914,168,1055634,-2,2914,66,2915,442,0
20141229.100134,2915,4,1055638,0,2914,56,2915,440,1
20141229.100135,2914,4,1055642,2,2914,62,2915,440,0
20141229.100136,2914,4,1055646,4,2914,60,2915,440,0
20141229.100137,2914,122,1055768,102,2913,618,2914,1043,0
20141229.100138,2914,40,1055808,0,2913,602,2914,1060,0
20141229.100138,2914,16,1055824,0,2913,602,2914,1070,0
20141229.100139,2914,6,1055830,0,2913,602,2914,1082,0
20141229.100141,2914,2002,1057832,-178,2913,602,2914,78,0
20141229.100141,2914,96,1057928,-4,2914,102,2915,438,0
20141229.100142,2915,2,1057930,0,2914,107,2915,462,1
20141229.100143,2914,6,1057936,2,2914,104,2915,462,0
20141229.100144,2914,212,1058148,210,2913,603,2914,1047,0
20141229.100147,2914,4,1058152,2,2913,591,2914,2164,0
20141229.100148,2914,6,1058158,0,2913,591,2914,2122,0
20141229.10015,2914,24,1058182,24,2913,591,2914,2089,0
20141229.10015,2914,2,1058184,2,2913,596,2914,2090,0
20141229.100152,2914,2002,1060186,-244,2913,596,2914,1054,0
20141229.100152,2914,2,1060188,0,2913,608,2914,1043,0
20141229.100155,2914,2,1060190,0,2913,610,2914,1042,0
20141229.1002,2914,4,1060194,0,2913,610,2914,1041,0
20141229.100202,2913,16,1060210,0,2913,593,2914,1042,0
20141229.100204,2913,42,1060252,0,2913,571,2914,1042,0
20141229.100205,2913,12,1060264,0,2913,575,2914,43,0
20141229.100206,2914,88,1060352,26,2914,2,2915,610,1
20141229.100206,2914,2,1060354,0,2914,3,2915,620,1
20141229.100207,2915,2,1060356,-2,2914,159,2915,619,1
20141229.100208,2914,2,1060358,2,2914,199,2915,611,0
20141229.100208,2914,396,1060754,394,2914,2,2915,611,0
20141229.100209,2914,140,1060894,128,2913,638,2914,49,0
20141229.100209,2914,72,1060966,0,2913,638,2914,14,0
20141229.10021,2914,4,1060970,-2,2913,564,2914,1108,0
20141229.10021,2914,2,1060972,0,2913,564,2914,1107,0
20141229.100211,2914,394,1061366,-394,2913,564,2914,912,0
20141229.100212,2914,10,1061376,0,2913,564,2914,907,0
20141229.100212,2914,2,1061378,0,2913,564,2914,907,0
20141229.100213,2914,20,1061398,0,2913,564,2914,897,0
20141229.100214,2914,112,1061510,-12,2913,512,2914,896,0
20141229.100215,2914,8,1061518,-8,2913,517,2914,892,0
20141229.100216,2914,22,1061540,-22,2913,527,2914,881,0
20141229.100216,2914,2,1061542,0,2913,620,2914,880,0
20141229.100217,2913,10,1061552,4,2913,620,2914,883,0
20141229.10022,2913,8,1061560,8,2913,641,2914,886,0
20141229.100221,2914,4,1061564,0,2913,642,2914,884,1
20141229.100222,2914,2,1061566,-2,2913,649,2914,883,1
20141229.100227,2914,200,1061766,0,2913,651,2914,789,1
20141229.100227,2914,2,1061768,0,2913,661,2914,788,1
20141229.10023,2914,8,1061776,-8,2913,660,2914,785,1
20141229.100231,2914,50,1061826,0,2913,660,2914,760,1
20141229.100232,2914,2,1061828,0,2913,660,2914,759,1
20141229.100233,2914,2,1061830,-2,2913,691,2914,759,1
20141229.100233,2914,40,1061870,0,2913,691,2914,739,1
20141229.100234,2913,4,1061874,0,2913,689,2914,739,0
20141229.100236,2914,1538,1063412,-1522,2914,334,2915,655,1
20141229.100236,2914,26,1063438,-6,2914,372,2915,535,1
20141229.100238,2914,26,1063464,-26,2914,364,2915,476,1
20141229.100239,2914,42,1063506,0,2914,343,2915,476,1
20141229.100241,2914,688,1064194,-116,2913,725,2914,957,1
20141229.100243,2914,4,1064198,4,2913,666,2914,965,1
20141229.100244,2914,30,1064228,20,2913,657,2914,968,1
20141229.100245,2914,1902,1066130,-220,2914,201,2915,466,1
20141229.100245,2914,20,1066150,0,2914,201,2915,466,1
20141229.100246,2914,2,1066152,0,2914,227,2915,466,1
20141229.100247,2914,462,1066614,378,2913,665,2914,926,1
20141229.100249,2914,10,1066624,10,2913,660,2914,956,1
20141229.100249,2914,2,1066626,0,2913,659,2914,955,1
20141229.100251,2914,2,1066628,2,2913,682,2914,976,1
20141229.100252,2914,24,1066652,0,2913,682,2914,964,1
20141229.100252,2914,30,1066682,0,2913,684,2914,949,1
20141229.100253,2914,60,1066742,0,2913,704,2914,969,1
20141229.100253,2914,6,1066748,2,2913,704,2914,966,1
20141229.100254,2914,2,1066750,2,2913,705,2914,978,1
20141229.100255,2914,10,1066760,0,2913,682,2914,1019,1
20141229.100258,2914,4,1066764,4,2913,688,2914,1035,1
20141229.100259,2914,10,1066774,10,2913,688,2914,1026,1
20141229.100301,2914,2,1066776,2,2913,690,2914,982,1
20141229.100301,2914,20,1066796,20,2913,690,2914,972,1
20141229.100307,2914,20,1066816,20,2913,768,2914,834,1
20141229.100309,2913,6,1066822,4,2913,670,2914,832,0
20141229.100309,2914,2,1066824,2,2913,741,2914,831,1
20141229.100313,2914,16,1066840,0,2913,787,2914,825,1
20141229.100314,2914,2,1066842,2,2913,807,2914,834,1
20141229.100314,2914,2,1066844,2,2913,825,2914,833,1
20141229.100315,2914,2,1066846,2,2913,825,2914,832,1
20141229.100317,2914,104,1066950,0,2913,839,2914,790,1
20141229.100319,2914,2,1066952,0,2913,850,2914,789,1
20141229.10032,2914,6,1066958,6,2913,848,2914,794,1
20141229.10032,2914,2,1066960,2,2913,848,2914,798,1
20141229.10032,2914,10,1066970,0,2913,848,2914,793,1
20141229.100321,2914,4,1066974,2,2913,844,2914,791,1
20141229.100322,2914,18,1066992,18,2913,834,2914,782,1
20141229.100322,2914,30,1067022,30,2913,834,2914,767,1
20141229.100324,2913,4,1067026,0,2913,832,2914,767,0
20141229.100326,2914,10,1067036,10,2913,848,2914,762,1
20141229.100326,2913,4,1067040,4,2913,816,2914,762,0
20141229.100326,2913,12,1067052,12,2913,810,2914,762,0
20141229.100327,2913,16,1067068,16,2913,782,2914,790,0
20141229.100328,2914,8,1067076,6,2913,782,2914,768,1
20141229.100328,2913,2,1067078,0,2913,781,2914,768,0
20141229.100329,2914,8,1067086,0,2913,781,2914,769,1
20141229.100331,2913,2,1067088,0,2913,820,2914,814,0
20141229.100332,2914,4,1067092,4,2913,822,2914,812,1
20141229.100333,2913,10,1067102,0,2913,841,2914,733,0
20141229.100334,2914,2,1067104,2,2913,1183,2914,732,1
20141229.100336,2914,2,1067106,2,2913,1185,2914,721,1
20141229.100337,2914,6,1067112,6,2913,1186,2914,718,1
20141229.100339,2914,2,1067114,0,2913,1176,2914,717,1
20141229.10034,2913,2,1067116,0,2913,1176,2914,717,0
20141229.10034,2914,2,1067118,2,2913,1176,2914,716,1
20141229.100341,2914,2,1067120,2,2913,1177,2914,715,1
20141229.100342,2914,10,1067130,0,2913,1179,2914,710,1
20141229.100343,2914,16,1067146,0,2913,1179,2914,702,1
20141229.100343,2914,2,1067148,2,2913,1184,2914,701,1
20141229.100344,2914,1004,1068152,0,2913,1194,2914,184,1
20141229.100344,2914,2,1068154,2,2913,1194,2914,183,1
20141229.100345,2914,26,1068180,0,2913,1194,2914,170,1
20141229.100345,2914,8,1068188,8,2913,1199,2914,166,1
20141229.100346,2914,12,1068200,12,2913,1203,2914,153,1
20141229.100347,2914,10,1068210,6,2913,1198,2914,149,1
20141229.100348,2914,2,1068212,0,2913,1198,2914,149,1
20141229.100349,2914,2,1068214,-2,2913,1198,2914,148,1
20141229.10035,2914,10,1068224,-10,2913,1198,2914,143,1
20141229.100352,2914,286,1068510,82,2914,75,2915,555,1
20141229.100352,2914,42,1068552,38,2914,55,2915,575,1
20141229.100353,2915,2,1068554,0,2914,261,2915,549,1
20141229.100355,2914,80,1068634,40,2914,294,2915,537,0
20141229.100356,2914,200,1068834,-150,2914,195,2915,536,0
20141229.1004,2914,60,1068894,0,2914,122,2915,520,0
20141229.100401,2914,52,1068946,0,2914,115,2915,520,0
20141229.100405,2914,4,1068950,-4,2914,114,2915,525,0
20141229.100408,2914,202,1069152,8,2914,38,2915,472,0
20141229.100408,2915,2,1069154,-2,2914,88,2915,455,1
20141229.100409,2915,24,1069178,-2,2914,91,2915,359,1
20141229.100409,2915,52,1069230,-46,2914,112,2915,318,1
20141229.10041,2915,8,1069238,-4,2914,208,2915,314,1
20141229.10041,2915,6,1069244,-4,2914,213,2915,311,1
20141229.100411,2915,18,1069262,-4,2914,220,2915,302,1
20141229.100411,2915,12,1069274,-8,2914,230,2915,296,1
20141229.100411,2915,4,1069278,-2,2914,225,2915,294,1
20141229.100412,2915,10,1069288,-6,2914,226,2915,289,1
20141229.100412,2915,8,1069296,-4,2914,468,2915,285,1
20141229.100413,2915,12,1069308,0,2914,519,2915,279,1
20141229.100414,2915,8,1069316,2,2914,520,2915,275,1
20141229.100414,2915,2,1069318,0,2914,522,2915,274,1
20141229.100415,2915,2,1069320,0,2914,525,2915,276,1
20141229.100416,2915,2,1069322,0,2914,525,2915,275,1
20141229.100416,2914,38,1069360,22,2914,523,2915,258,0
20141229.100418,2915,22,1069382,-8,2914,592,2915,247,1
20141229.100419,2914,60,1069442,40,2914,539,2915,257,0
20141229.100419,2915,14,1069456,0,2914,518,2915,254,1
20141229.10042,2915,8,1069464,2,2914,517,2915,250,1
20141229.10042,2915,8,1069472,-4,2914,540,2915,246,1
20141229.100421,2915,182,1069654,-6,2914,474,2915,206,1
20141229.100421,2915,408,1070062,102,2915,60,2916,995,1
20141229.100422,2916,138,1070200,30,2915,40,2916,853,1
20141229.100423,2916,32,1070232,-10,2915,35,2916,787,1
20141229.100423,2915,38,1070270,0,2915,35,2916,742,0
20141229.100424,2915,6,1070276,0,2915,35,2916,740,0
20141229.100424,2915,2,1070278,2,2915,37,2916,740,0
20141229.100425,2916,4,1070282,-2,2915,60,2916,742,1
20141229.100426,2916,10,1070292,-10,2915,87,2916,730,1
20141229.100426,2916,22,1070314,0,2915,100,2916,720,1
20141229.100427,2916,6,1070320,-6,2915,100,2916,718,1
20141229.100427,2916,16,1070336,-10,2915,187,2916,760,1
20141229.100428,2916,8,1070344,-4,2915,188,2916,756,1
20141229.100428,2916,4,1070348,-2,2915,179,2916,703,1
20141229.100429,2916,4,1070352,0,2915,268,2916,665,1
20141229.10043,2915,6,1070358,6,2915,256,2916,668,0
20141229.100431,2916,6,1070364,0,2915,283,2916,664,1
20141229.100432,2916,30,1070394,-14,2915,254,2916,674,1
20141229.100432,2916,34,1070428,18,2915,252,2916,645,1
20141229.100433,2916,4,1070432,2,2915,262,2916,645,1
20141229.100434,2916,12,1070444,10,2915,305,2916,639,1
20141229.100434,2915,42,1070486,40,2915,286,2916,619,0
20141229.100435,2915,20,1070506,16,2915,276,2916,621,0
20141229.100436,2916,12,1070518,10,2915,289,2916,616,1
20141229.100436,2916,4,1070522,4,2915,309,2916,615,1
20141229.100437,2915,220,1070742,210,2915,203,2916,633,0
20141229.100437,2915,410,1071152,-258,2914,562,2915,88,0
20141229.100438,2915,6,1071158,-2,2914,515,2915,308,0
20141229.100439,2915,22,1071180,0,2914,507,2915,371,0
20141229.100439,2915,2,1071182,0,2914,448,2915,370,0
20141229.10044,2915,4,1071186,0,2914,456,2915,461,0
20141229.100441,2915,4,1071190,0,2914,446,2915,459,0
20141229.100442,2915,42,1071232,0,2914,437,2915,444,0
20141229.100443,2915,2,1071234,0,2914,439,2915,443,0
20141229.100443,2915,26,1071260,0,2914,441,2915,430,0
20141229.100444,2915,2,1071262,0,2914,444,2915,439,0
20141229.100447,2915,8,1071270,-2,2914,496,2915,545,0
20141229.100451,2915,214,1071484,-2,2914,502,2915,438,0
20141229.100453,2915,10,1071494,-8,2914,507,2915,438,0
20141229.100455,2915,22,1071516,0,2914,533,2915,428,0
20141229.100456,2915,122,1071638,-2,2914,544,2915,369,0
20141229.100457,2915,6,1071644,0,2914,548,2915,274,0
20141229.100458,2915,10,1071654,0,2914,548,2915,269,0
20141229.100459,2915,410,1072064,154,2914,464,2915,89,0
20141229.1005,2915,24,1072088,22,2914,545,2915,74,0
20141229.1005,2916,170,1072258,134,2914,549,2916,795,1
20141229.100501,2915,20,1072278,0,2914,535,2915,70,0
20141229.100502,2915,2,1072280,0,2914,552,2915,94,0
20141229.100502,2914,8,1072288,0,2914,534,2915,102,0
20141229.100503,2915,2,1072290,-2,2914,534,2915,101,1
20141229.100504,2915,2,1072292,0,2914,534,2915,100,1
20141229.100504,2915,4,1072296,0,2914,534,2915,98,1
20141229.100505,2915,2,1072298,0,2914,528,2915,116,1
20141229.100506,2915,48,1072346,22,2914,528,2915,92,1
20141229.100507,2914,32,1072378,-24,2914,311,2915,92,0
20141229.100508,2915,4,1072382,2,2914,303,2915,223,1
20141229.100509,2915,150,1072532,-94,2914,235,2915,236,1
20141229.10051,2915,12,1072544,8,2914,231,2915,263,1
20141229.10051,2914,4,1072548,2,2914,229,2915,263,0
20141229.100512,2915,2,1072550,2,2914,222,2915,319,1
20141229.100512,2914,6,1072556,2,2914,147,2915,311,0
20141229.100514,2914,4,1072560,-2,2914,195,2915,312,0
20141229.100514,2914,2,1072562,-2,2914,203,2915,312,0
20141229.100515,2915,40,1072602,40,2914,163,2915,293,1
20141229.100516,2914,2,1072604,0,2914,159,2915,293,0
20141229.100516,2915,20,1072624,10,2914,150,2915,294,1
20141229.100518,2915,2,1072626,2,2914,171,2915,294,1
20141229.10052,2915,2,1072628,0,2914,175,2915,292,1
20141229.100522,2915,20,1072648,2,2914,183,2915,283,1
20141229.100523,2915,40,1072688,-40,2914,185,2915,265,1
20141229.100525,2915,2,1072690,0,2914,188,2915,265,1
20141229.100525,2915,6,1072696,0,2914,186,2915,263,1
20141229.100526,2914,4,1072700,4,2914,198,2915,263,0
20141229.100527,2915,8,1072708,8,2914,198,2915,258,1
20141229.100527,2915,12,1072720,10,2914,207,2915,252,1
20141229.100529,2914,4,1072724,-4,2914,202,2915,255,0
20141229.100529,2914,22,1072746,-12,2914,190,2915,255,0
20141229.10053,2915,2,1072748,0,2914,178,2915,256,1
20141229.100532,2915,4,1072752,-4,2914,178,2915,255,1
20141229.100534,2915,2,1072754,0,2914,181,2915,254,1
20141229.100535,2914,4,1072758,-2,2914,179,2915,255,0
20141229.100535,2914,2,1072760,0,2914,178,2915,254,0
20141229.100536,2914,2,1072762,-2,2914,177,2915,254,0
20141229.100539,2914,4,1072766,0,2914,175,2915,251,0
20141229.10054,2915,2,1072768,2,2914,171,2915,251,1
20141229.100541,2914,2,1072770,0,2914,170,2915,252,0
20141229.100542,2914,10,1072780,0,2914,173,2915,252,0
20141229.100545,2915,10,1072790,10,2914,175,2915,247,1
20141229.100546,2915,14,1072804,0,2914,171,2915,245,1
20141229.100549,2914,4,1072808,-4,2914,301,2915,224,0
20141229.10055,2915,448,1073256,-180,2915,235,2916,900,1
20141229.10055,2915,472,1073728,-286,2914,513,2915,117,1
20141229.100553,2915,20,1073748,-20,2914,419,2915,1135,1
20141229.100553,2915,2270,1076018,6,2915,1,2916,836,1
20141229.100554,2915,10,1076028,2,2915,178,2916,758,1
20141229.100556,2915,360,1076388,230,2914,441,2915,920,1
20141229.100557,2914,2,1076390,0,2914,400,2915,922,0
20141229.100558,2914,10,1076400,0,2914,385,2915,932,0
20141229.1006,2915,4,1076404,4,2914,386,2915,950,1
20141229.100602,2915,600,1077004,0,2914,386,2915,653,1
20141229.100603,2915,1374,1078378,-226,2915,364,2916,842,1
20141229.100605,2915,30,1078408,-30,2915,364,2916,823,1
20141229.100606,2915,6,1078414,0,2915,361,2916,823,1
20141229.100606,2915,2,1078416,0,2915,362,2916,838,1
20141229.100609,2915,8,1078424,-8,2915,360,2916,844,1
20141229.100609,2915,2,1078426,-2,2915,369,2916,852,1
20141229.10061,2915,2,1078428,-2,2915,368,2916,848,1
20141229.100611,2915,8,1078436,-6,2915,365,2916,870,1
20141229.100613,2915,12,1078448,-2,2915,359,2916,839,1
20141229.100613,2915,2,1078450,-2,2915,358,2916,839,1
20141229.100615,2916,20,1078470,0,2915,362,2916,834,1
20141229.100616,2915,40,1078510,0,2915,342,2916,824,0
20141229.100616,2915,12,1078522,-12,2915,425,2916,689,0
20141229.100617,2915,208,1078730,-208,2915,249,2916,894,0
20141229.100618,2915,4,1078734,-2,2915,248,2916,921,0
20141229.100618,2915,4,1078738,0,2915,246,2916,921,0
20141229.100619,2915,2,1078740,-2,2915,245,2916,923,0
20141229.100619,2915,488,1079228,-232,2914,471,2915,97,0
20141229.100623,2915,2,1079230,-2,2914,355,2915,297,0
20141229.100625,2915,22,1079252,-2,2914,348,2915,1304,0
20141229.100626,2914,2,1079254,-2,2914,331,2915,1307,0
20141229.100628,2915,4,1079258,0,2914,473,2915,1307,1
20141229.100628,2915,2002,1081260,-244,2914,538,2915,307,1
20141229.100629,2915,10,1081270,10,2914,536,2915,302,1
20141229.100631,2914,2,1081272,0,2914,567,2915,323,0
20141229.100632,2915,2,1081274,2,2914,567,2915,323,1
20141229.100633,2914,10,1081284,8,2914,560,2915,319,0
20141229.100634,2915,4,1081288,2,2914,559,2915,319,1
20141229.100635,2915,2,1081290,0,2914,559,2915,319,1
20141229.100635,2915,32,1081322,32,2914,578,2915,304,1
20141229.100637,2915,20,1081342,20,2914,578,2915,298,1
20141229.100639,2915,46,1081388,40,2914,594,2915,279,1
20141229.10064,2915,2,1081390,0,2914,594,2915,279,1
20141229.100645,2915,2004,1083394,-40,2914,596,2915,282,1
20141229.100646,2915,2,1083396,2,2914,589,2915,281,1
20141229.100648,2914,4,1083400,0,2914,587,2915,311,0
20141229.100648,2914,20,1083420,20,2914,576,2915,311,0
20141229.100649,2914,4,1083424,0,2914,574,2915,311,0
20141229.100651,2915,10,1083434,0,2914,561,2915,310,1
20141229.100654,2914,26,1083460,-20,2914,548,2915,321,0
20141229.100655,2914,84,1083544,-16,2914,521,2915,322,0
20141229.100655,2915,2,1083546,2,2914,600,2915,325,1
20141229.100656,2915,4,1083550,0,2914,600,2915,323,1
20141229.100657,2915,2,1083552,2,2914,600,2915,323,1
20141229.100658,2914,4,1083556,2,2914,607,2915,347,0
20141229.100659,2914,46,1083602,-8,2914,584,2915,346,0
20141229.100659,2914,4,1083606,4,2914,593,2915,346,0
20141229.100701,2915,2,1083608,0,2914,607,2915,348,1
20141229.100704,2915,2,1083610,0,2914,557,2915,346,1
20141229.100712,2915,22,1083632,8,2914,586,2915,338,1
20141229.100718,2915,2,1083634,2,2914,574,2915,379,1
20141229.100718,2914,6,1083640,6,2914,571,2915,380,0
20141229.10072,2914,12,1083652,10,2914,566,2915,385,0
20141229.100728,2914,18,1083670,-10,2914,564,2915,396,0
20141229.100728,2914,2,1083672,-2,2914,563,2915,396,0
20141229.100729,2914,2,1083674,-2,2914,562,2915,490,0
20141229.10073,2915,2,1083676,2,2914,567,2915,490,1
20141229.100731,2915,4,1083680,4,2914,582,2915,488,1
20141229.100732,2914,10,1083690,-10,2914,585,2915,491,0
20141229.100734,2914,2,1083692,0,2914,584,2915,500,0
20141229.100738,2914,10,1083702,-10,2914,601,2915,506,0
20141229.100741,2914,2,1083704,0,2914,606,2915,529,0
20141229.100745,2915,40,1083744,40,2914,604,2915,512,1
20141229.100749,2915,2,1083746,2,2914,614,2915,528,1
20141229.10075,2915,40,1083786,40,2914,636,2915,508,1
20141229.100751,2915,14,1083800,0,2914,622,2915,501,1
20141229.100753,2914,574,1084374,-252,2914,325,2915,501,0
20141229.100753,2914,650,1085024,-276,2913,723,2914,261,0
20141229.100754,2913,4,1085028,2,2913,683,2914,257,0
20141229.100758,2913,2,1085030,2,2913,679,2914,282,0
20141229.1008,2914,40,1085070,40,2913,676,2914,281,1
20141229.1008,2913,2,1085072,0,2913,675,2914,341,0
20141229.100803,2913,2,1085074,2,2913,675,2914,345,0
20141229.100805,2913,2,1085076,2,2913,673,2914,345,0
20141229.100806,2914,42,1085118,42,2913,653,2914,324,1
20141229.100807,2913,2,1085120,0,2913,662,2914,311,0
20141229.100809,2913,2,1085122,2,2913,681,2914,305,0
20141229.100811,2913,2,1085124,0,2913,681,2914,309,0
20141229.100812,2913,44,1085168,40,2913,660,2914,292,0
20141229.100813,2913,18,1085186,14,2913,658,2914,285,0
20141229.100813,2913,2,1085188,0,2913,657,2914,285,0
20141229.100814,2913,6,1085194,0,2913,654,2914,285,0
20141229.100815,2913,4,1085198,2,2913,652,2914,285,0
20141229.100816,2913,100,1085298,-4,2913,602,2914,320,0
20141229.100817,2913,6,1085304,2,2913,599,2914,330,0
20141229.100818,2913,2,1085306,0,2913,595,2914,333,0
20141229.100819,2913,14,1085320,12,2913,592,2914,329,0
20141229.10082,2913,4,1085324,4,2913,591,2914,336,0
20141229.100821,2914,2,1085326,0,2913,592,2914,335,1
20141229.100821,2913,30,1085356,28,2913,579,2914,335,0
20141229.100823,2914,4,1085360,4,2913,595,2914,338,1
20141229.100823,2913,2,1085362,2,2913,594,2914,339,0
20141229.100825,2913,4,1085366,4,2913,593,2914,339,0
20141229.100825,2913,414,1085780,342,2913,385,2914,339,0
20141229.100826,2913,4,1085784,4,2913,375,2914,338,0
20141229.100828,2914,6,1085790,6,2913,377,2914,340,1
20141229.100829,2914,4,1085794,2,2913,376,2914,339,1
20141229.10083,2913,2,1085796,0,2913,375,2914,339,0
20141229.100831,2913,6,1085802,-2,2913,372,2914,342,0
20141229.100832,2913,46,1085848,40,2913,354,2914,342,0
20141229.100833,2913,2,1085850,2,2913,353,2914,342,0
20141229.100833,2913,2,1085852,2,2913,352,2914,342,0
20141229.100834,2913,2,1085854,2,2913,351,2914,342,0
20141229.100834,2914,4,1085858,4,2913,351,2914,344,1
20141229.100835,2913,2,1085860,0,2913,350,2914,344,0
20141229.100838,2913,4,1085864,0,2913,349,2914,327,0
20141229.100839,2913,4,1085868,4,2913,347,2914,328,0
20141229.100842,2913,2,1085870,0,2913,346,2914,326,0
20141229.100843,2913,2,1085872,0,2913,346,2914,326,0
20141229.100844,2913,2,1085874,-2,2913,345,2914,327,0
20141229.100844,2913,4,1085878,0,2913,343,2914,327,0
20141229.100846,2914,2,1085880,2,2913,348,2914,331,1
20141229.100851,2913,2,1085882,-2,2913,348,2914,333,0
20141229.100852,2913,2,1085884,0,2913,348,2914,343,0
20141229.100853,2913,2,1085886,2,2913,347,2914,345,0
20141229.100857,2913,34,1085920,-4,2913,346,2914,330,0
20141229.100857,2914,4,1085924,-4,2913,346,2914,328,1
20141229.100859,2914,32,1085956,0,2913,345,2914,263,1
20141229.1009,2913,14,1085970,-4,2913,348,2914,261,0
20141229.100901,2914,10,1085980,-10,2913,348,2914,255,1
20141229.100902,2914,32,1086012,-32,2913,348,2914,231,1
20141229.100903,2913,2,1086014,-2,2913,347,2914,228,0
20141229.100905,2914,2,1086016,0,2913,346,2914,213,1
20141229.100907,2913,2,1086018,0,2913,345,2914,211,0
20141229.100909,2913,2,1086020,0,2913,356,2914,227,0
20141229.10091,2914,2,1086022,0,2913,356,2914,230,1
20141229.100914,2913,2,1086024,0,2913,355,2914,238,0
20141229.100917,2913,10,1086034,0,2913,351,2914,236,0
20141229.100917,2913,2,1086036,-2,2913,350,2914,236,0
20141229.100918,2913,40,1086076,-38,2913,330,2914,237,0
20141229.10092,2913,42,1086118,8,2913,309,2914,237,0
20141229.100921,2913,10,1086128,0,2913,306,2914,241,0
20141229.100924,2914,2,1086130,0,2913,410,2914,245,1
20141229.100927,2914,176,1086306,-114,2913,414,2914,167,1
20141229.100928,2914,28,1086334,24,2913,414,2914,199,1
20141229.10093,2913,4,1086338,0,2913,413,2914,199,0
20141229.100931,2913,56,1086394,14,2913,385,2914,207,0
20141229.100932,2913,8,1086402,0,2913,381,2914,206,0
20141229.100932,2914,4,1086406,0,2913,381,2914,209,1
20141229.100934,2913,2,1086408,-2,2913,380,2914,209,0
20141229.100935,2914,48,1086456,4,2913,380,2914,185,1
20141229.100937,2914,2,1086458,-2,2913,381,2914,163,1
20141229.100938,2913,8,1086466,-6,2913,378,2914,162,0
20141229.100939,2914,14,1086480,-12,2913,365,2914,161,1
20141229.10094,2913,2,1086482,0,2913,364,2914,162,0
20141229.10094,2913,26,1086508,-24,2913,363,2914,150,0
20141229.100943,2913,64,1086572,-52,2913,337,2914,151,0
20141229.100946,2913,4,1086576,2,2913,370,2914,182,0
20141229.100949,2914,2,1086578,0,2913,369,2914,187,1
20141229.10095,2913,8,1086586,0,2913,365,2914,187,0
20141229.100951,2913,20,1086606,-20,2913,359,2914,195,0
20141229.100952,2913,2,1086608,0,2913,358,2914,195,0
20141229.100952,2914,20,1086628,-16,2913,368,2914,210,1
20141229.100954,2913,10,1086638,0,2913,364,2914,211,0
20141229.100955,2913,2,1086640,-2,2913,364,2914,225,0
20141229.100957,2913,2,1086642,-2,2913,364,2914,226,0
20141229.100959,2913,6,1086648,-6,2913,364,2914,238,0
20141229.101,2913,20,1086668,-20,2913,354,2914,248,0
20141229.101002,2913,2,1086670,0,2913,356,2914,248,0
20141229.101003,2913,4,1086674,0,2913,354,2914,248,0
20141229.101005,2913,2,1086676,0,2913,352,2914,248,0
20141229.101007,2914,34,1086710,0,2913,351,2914,236,1
20141229.101008,2914,4,1086714,-2,2913,350,2914,235,1
20141229.10101,2913,10,1086724,2,2913,357,2914,234,0
20141229.101012,2913,10,1086734,-10,2913,352,2914,238,0
20141229.101014,2914,2,1086736,0,2913,352,2914,235,1
20141229.101015,2914,12,1086748,0,2913,354,2914,231,1
20141229.101016,2914,22,1086770,-20,2913,354,2914,221,1
20141229.101018,2913,2,1086772,0,2913,353,2914,222,0
20141229.101019,2913,2,1086774,-2,2913,353,2914,221,0
20141229.101019,2913,4,1086778,-4,2913,351,2914,221,0
20141229.10102,2914,32,1086810,-24,2913,351,2914,205,1
20141229.101022,2914,16,1086826,0,2913,351,2914,112,1
20141229.101023,2913,2,1086828,-2,2913,350,2914,116,0
20141229.101024,2914,22,1086850,-4,2913,352,2914,106,1
20141229.101024,2914,2,1086852,0,2913,352,2914,105,1
20141229.101025,2913,6,1086858,4,2913,351,2914,103,0
20141229.101025,2913,14,1086872,2,2913,345,2914,102,0
20141229.101025,2913,12,1086884,-6,2913,339,2914,104,0
20141229.101029,2914,10,1086894,-10,2913,372,2914,101,1
20141229.10103,2913,2,1086896,0,2913,371,2914,102,0
20141229.101034,2914,2,1086898,0,2913,373,2914,107,1
20141229.101034,2914,20,1086918,-8,2913,373,2914,97,1
20141229.101037,2914,2,1086920,2,2913,353,2914,116,1
20141229.101038,2914,4,1086924,0,2913,353,2914,115,1
20141229.101039,2913,8,1086932,-8,2913,349,2914,115,0
20141229.101039,2914,2,1086934,2,2913,349,2914,114,1
20141229.101042,2914,4,1086938,4,2913,349,2914,122,1
20141229.101043,2914,2,1086940,0,2913,349,2914,121,1
20141229.101045,2914,42,1086982,40,2913,329,2914,171,1
20141229.101045,2914,4,1086986,-4,2913,329,2914,169,1
20141229.101046,2913,2,1086988,2,2913,328,2914,169,0
20141229.101048,2913,46,1087034,0,2913,305,2914,265,0
20141229.101048,2914,2,1087036,0,2913,305,2914,264,1
20141229.101051,2914,40,1087076,20,2913,305,2914,244,1
20141229.101052,2913,2,1087078,0,2913,304,2914,244,0
20141229.101053,2914,2,1087080,0,2913,304,2914,243,1
20141229.101053,2913,2,1087082,2,2913,303,2914,243,0
20141229.101055,2913,24,1087106,0,2913,291,2914,253,0
20141229.101057,2913,36,1087142,36,2913,273,2914,437,0
20141229.101059,2913,12,1087154,6,2913,296,2914,437,0
20141229.101059,2913,68,1087222,-2,2913,262,2914,437,0
20141229.1011,2913,2,1087224,0,2913,262,2914,436,0
20141229.101101,2914,2,1087226,-2,2913,262,2914,435,1
20141229.101101,2913,100,1087326,-44,2913,182,2914,437,0
20141229.101102,2913,2,1087328,0,2913,182,2914,437,0
20141229.101103,2913,44,1087372,-12,2913,161,2914,429,0
20141229.101103,2913,4,1087376,2,2913,159,2914,429,0
20141229.101105,2913,2,1087378,0,2913,159,2914,430,0
20141229.101105,2913,6,1087384,0,2913,156,2914,430,0
20141229.101105,2913,4,1087388,0,2913,154,2914,430,0
20141229.101106,2913,22,1087410,2,2913,145,2914,430,0
20141229.101111,2914,2,1087412,-2,2913,152,2914,436,1
20141229.101112,2913,6,1087418,4,2913,149,2914,436,0
20141229.101112,2913,2,1087420,0,2913,148,2914,436,0
20141229.101113,2913,26,1087446,-2,2913,136,2914,456,0
20141229.101114,2913,154,1087600,-24,2912,740,2914,568,0
20141229.101115,2913,20,1087620,-18,2912,740,2914,589,0
20141229.101116,2913,26,1087646,4,2912,741,2914,588,0
20141229.101117,2913,2,1087648,2,2912,741,2914,588,0
20141229.101118,2913,4,1087652,2,2912,741,2914,589,0
20141229.101119,2913,2,1087654,0,2912,732,2914,583,0
20141229.101121,2913,2,1087656,2,2913,107,2914,483,0
20141229.101122,2913,34,1087690,-20,2913,98,2914,495,0
20141229.101124,2913,2,1087692,0,2913,85,2914,494,0
20141229.101127,2914,2,1087694,-2,2913,86,2914,493,1
20141229.101127,2913,2,1087696,-2,2913,106,2914,485,0
20141229.101128,2913,340,1088036,130,2912,831,2913,832,0
20141229.101129,2913,2,1088038,2,2912,752,2913,842,0
20141229.10113,2913,2,1088040,2,2912,756,2913,851,0
20141229.101131,2913,2,1088042,0,2912,657,2913,861,0
20141229.101132,2913,2,1088044,2,2912,657,2913,880,0
20141229.101132,2913,1760,1089804,-20,2913,224,2914,475,0
20141229.101137,2913,2,1089806,0,2913,300,2914,502,0
20141229.101147,2913,2,1089808,-2,2913,300,2914,534,0
20141229.101149,2913,10,1089818,-10,2913,295,2914,534,0
20141229.101151,2913,2,1089820,0,2913,302,2914,524,0
20141229.101152,2914,162,1089982,-64,2913,312,2914,458,1
20141229.101152,2913,4,1089986,-4,2913,310,2914,458,0
20141229.101153,2913,2,1089988,0,2913,310,2914,458,0
20141229.101154,2914,92,1090080,2,2913,312,2914,412,1
20141229.101156,2913,6,1090086,-6,2913,346,2914,413,0
20141229.101157,2913,2,1090088,-2,2913,355,2914,413,0
20141229.101202,2913,2,1090090,0,2913,355,2914,413,0
20141229.101203,2913,46,1090136,0,2913,332,2914,414,0
20141229.101207,2913,2,1090138,0,2913,352,2914,416,0
20141229.10121,2913,10,1090148,-10,2913,348,2914,417,0
20141229.10121,2913,4,1090152,-4,2913,346,2914,417,0
20141229.101211,2914,2,1090154,-2,2913,346,2914,415,1
20141229.101215,2914,2,1090156,0,2913,362,2914,432,1
20141229.10122,2913,6,1090162,-6,2913,371,2914,453,0
20141229.101224,2914,4,1090166,0,2913,385,2914,448,1
20141229.101226,2913,30,1090196,-20,2913,332,2914,444,0
20141229.101227,2914,2,1090198,-2,2913,332,2914,443,1
20141229.101229,2913,6,1090204,-6,2913,329,2914,443,0
20141229.10123,2914,2,1090206,0,2913,328,2914,442,1
20141229.101232,2913,2,1090208,0,2913,327,2914,441,0
20141229.101234,2913,2,1090210,0,2913,326,2914,441,0
20141229.101242,2913,2,1090212,0,2913,327,2914,445,0
20141229.101252,2913,2,1090214,0,2913,342,2914,448,0
20141229.101257,2913,2,1090216,-2,2913,322,2914,447,0
20141229.101259,2913,22,1090238,-22,2913,310,2914,448,0
20141229.1013,2913,4,1090242,-4,2913,308,2914,448,0
20141229.1013,2913,4,1090246,0,2913,312,2914,448,0
20141229.101301,2913,2,1090248,-2,2913,313,2914,452,0
20141229.101304,2914,2,1090250,0,2913,316,2914,453,1
20141229.101305,2913,4,1090254,-2,2913,334,2914,452,0
20141229.101307,2913,10,1090264,0,2913,329,2914,453,0
20141229.10131,2913,10,1090274,0,2913,324,2914,464,0
20141229.101311,2913,8,1090282,0,2913,321,2914,464,0
20141229.101313,2913,24,1090306,-24,2913,298,2914,465,0
20141229.101313,2914,2,1090308,-2,2913,298,2914,464,1
20141229.101314,2913,2,1090310,-2,2913,307,2914,464,0
20141229.101315,2914,16,1090326,-14,2913,304,2914,456,1
20141229.101319,2914,30,1090356,-30,2913,305,2914,448,1
20141229.101321,2914,12,1090368,-2,2913,309,2914,443,1
20141229.101322,2913,10,1090378,-10,2913,304,2914,443,0
20141229.101323,2914,2,1090380,2,2913,304,2914,442,1
20141229.101326,2913,2,1090382,-2,2913,305,2914,443,0
20141229.101329,2913,2,1090384,-2,2913,305,2914,443,0
20141229.101331,2913,8,1090392,-2,2913,304,2914,443,0
20141229.101332,2913,20,1090412,0,2913,316,2914,443,0
20141229.101334,2913,10,1090422,0,2913,311,2914,443,0
20141229.101335,2913,6,1090428,0,2913,308,2914,444,0
20141229.101335,2914,2,1090430,2,2913,313,2914,443,1
20141229.101337,2914,2,1090432,2,2913,313,2914,423,1
20141229.101339,2913,2,1090434,2,2913,312,2914,453,0
20141229.101341,2913,10,1090444,10,2913,307,2914,453,0
20141229.101343,2914,4,1090448,0,2913,308,2914,454,1
20141229.101344,2913,2,1090450,2,2913,323,2914,454,0
20141229.101344,2913,2,1090452,2,2913,321,2914,454,0
20141229.101345,2913,2,1090454,2,2913,322,2914,454,0
20141229.101346,2913,2,1090456,2,2913,321,2914,454,0
20141229.101347,2913,2,1090458,2,2913,320,2914,454,0
20141229.101349,2913,4,1090462,2,2913,317,2914,454,0
20141229.101349,2914,2,1090464,2,2913,316,2914,453,1
20141229.10135,2914,4,1090468,4,2913,316,2914,453,1
20141229.101351,2913,2,1090470,2,2913,315,2914,453,0
20141229.101352,2914,4,1090474,4,2913,346,2914,451,1
20141229.101353,2914,2,1090476,0,2913,346,2914,450,1
20141229.101353,2914,20,1090496,0,2913,342,2914,446,1
20141229.101354,2913,8,1090504,2,2913,338,2914,446,0
20141229.101355,2914,10,1090514,0,2913,338,2914,441,1
20141229.101356,2913,2,1090516,0,2913,341,2914,442,0
20141229.101356,2913,22,1090538,0,2913,330,2914,442,0
20141229.101401,2913,320,1090858,58,2913,160,2914,447,0
20141229.101401,2914,22,1090880,-18,2913,160,2914,547,1
20141229.101402,2914,114,1090994,-46,2913,140,2914,512,1
20141229.101403,2914,74,1091068,-74,2913,140,2914,485,1
20141229.101403,2914,86,1091154,-12,2913,135,2914,452,1
20141229.101403,2913,224,1091378,42,2913,136,2914,341,0
20141229.101404,2914,44,1091422,10,2913,263,2914,319,1
20141229.101405,2913,52,1091474,10,2913,261,2914,285,0
20141229.101407,2913,6,1091480,-2,2913,258,2914,285,0
20141229.101408,2913,10,1091490,8,2913,255,2914,284,0
20141229.10141,2914,2,1091492,0,2913,258,2914,383,1
20141229.10141,2914,6,1091498,6,2913,259,2914,380,1
20141229.101412,2913,20,1091518,-8,2913,248,2914,383,0
20141229.101414,2914,2,1091520,2,2913,257,2914,382,1
20141229.101416,2914,2,1091522,0,2913,257,2914,382,1
20141229.101417,2913,10,1091532,-6,2913,255,2914,381,0
20141229.101417,2914,92,1091624,-52,2913,210,2914,380,1
20141229.101418,2913,10,1091634,10,2913,204,2914,420,0
20141229.101419,2913,42,1091676,-18,2913,187,2914,419,0
20141229.101421,2913,20,1091696,0,2913,180,2914,420,0
20141229.101423,2914,10,1091706,0,2913,184,2914,415,1
20141229.101425,2914,26,1091732,0,2913,187,2914,394,1
20141229.101426,2913,4,1091736,2,2913,194,2914,393,0
20141229.101429,2913,2,1091738,0,2913,195,2914,394,0
20141229.10143,2914,100,1091838,46,2913,204,2914,344,1
20141229.10143,2914,22,1091860,2,2913,193,2914,338,1
20141229.101431,2913,12,1091872,0,2913,187,2914,343,0
20141229.101431,2913,218,1092090,-140,2913,384,2914,234,0
20141229.101432,2914,2,1092092,-2,2913,384,2914,263,1
20141229.101434,2914,2,1092094,0,2913,386,2914,262,1
20141229.101438,2914,56,1092150,-56,2913,392,2914,229,1
20141229.10144,2914,22,1092172,-20,2913,385,2914,118,1
20141229.101441,2914,236,1092408,-206,2914,152,2915,475,1
20141229.101442,2914,90,1092498,-90,2914,117,2915,475,1
20141229.101442,2915,2,1092500,2,2914,117,2915,474,1
20141229.101443,2914,234,1092734,0,2913,392,2914,84,0
20141229.101445,2913,600,1093334,270,2913,92,2914,285,0
20141229.101448,2913,404,1093738,60,2912,682,2914,327,0
20141229.10145,2913,668,1094406,360,2913,16,2914,387,0
20141229.10145,2914,52,1094458,20,2912,359,2914,377,1
20141229.101452,2913,4,1094462,4,2913,47,2914,308,0
20141229.101452,2914,10,1094472,10,2913,47,2914,303,1
20141229.101454,2913,2,1094474,2,2913,66,2914,313,0
20141229.101457,2913,2,1094476,0,2913,17,2914,317,0
20141229.101457,2912,40,1094516,-28,2912,392,2914,327,0
20141229.101458,2913,2,1094518,2,2912,392,2913,19,1
20141229.101459,2913,38,1094556,0,2913,8,2914,355,1
20141229.1015,2913,2,1094558,0,2913,19,2914,289,1
20141229.103,2912,52,1094610,36,2912,438,2913,124,0
20141229.103002,2913,60,1094670,40,2912,462,2913,147,1
20141229.103002,2913,150,1094820,124,2912,401,2913,125,1
20141229.103002,2913,6,1094826,2,2912,401,2913,122,1
20141229.103003,2913,248,1095074,-2,2912,401,2913,2,1
20141229.103003,2913,12,1095086,0,2913,1,2914,249,1
20141229.103004,2913,6,1095092,2,2913,1,2914,251,1
20141229.103005,2913,6,1095098,-4,2913,64,2914,351,1
20141229.103006,2913,104,1095202,-102,2913,25,2914,350,1
20141229.103007,2913,22,1095224,-2,2913,73,2914,380,1
20141229.103008,2913,52,1095276,34,2913,47,2914,380,1
20141229.103009,2913,60,1095336,60,2913,17,2914,381,1
20141229.103009,2913,2,1095338,2,2913,16,2914,381,1
20141229.10301,2913,8,1095346,8,2913,13,2914,381,1
20141229.103011,2913,20,1095366,20,2913,4,2914,371,1
20141229.103011,2912,14,1095380,0,2912,743,2914,372,0
20141229.103013,2912,4,1095384,0,2912,745,2914,377,0
20141229.103014,2912,2,1095386,0,2912,744,2914,378,0
20141229.103015,2912,2,1095388,2,2912,743,2914,378,0
20141229.103016,2913,2,1095390,0,2912,739,2914,352,1
20141229.103017,2913,180,1095570,72,2913,130,2914,425,1
20141229.103017,2913,278,1095848,278,2912,699,2914,435,1
20141229.103018,2913,100,1095948,0,2912,699,2914,435,1
20141229.103018,2912,2,1095950,0,2912,698,2914,445,0
20141229.103021,2913,10,1095960,10,2912,698,2913,48,1
20141229.103023,2913,32,1095992,32,2912,698,2913,33,1
20141229.103025,2913,12,1096004,8,2912,418,2913,3,1
20141229.103026,2913,6,1096010,6,2912,432,2913,12,1
20141229.103027,2913,4,1096014,2,2912,432,2913,12,1
20141229.103027,2913,4,1096018,-2,2912,432,2913,113,1
20141229.103032,2913,100,1096118,82,2912,433,2913,76,1
20141229.103034,2913,4,1096122,0,2912,434,2913,78,1
20141229.103034,2913,60,1096182,0,2912,434,2913,48,1
20141229.103037,2913,2,1096184,2,2912,435,2913,48,1
20141229.103037,2912,20,1096204,20,2912,425,2913,48,0
20141229.103038,2912,44,1096248,-24,2912,404,2913,48,0
20141229.103039,2913,8,1096256,8,2912,405,2913,44,1
20141229.103041,2913,20,1096276,20,2912,405,2913,36,1
20141229.103045,2913,2,1096278,2,2912,421,2913,31,1
20141229.103047,2913,328,1096606,-78,2913,24,2914,297,1
20141229.103048,2913,104,1096710,4,2912,408,2914,304,1
20141229.103048,2913,2,1096712,-2,2912,406,2914,304,1
20141229.103049,2913,2,1096714,-2,2912,407,2913,1,1
20141229.103049,2913,4,1096718,-4,2913,52,2914,305,1
20141229.10305,2913,126,1096844,-10,2912,395,2914,306,1
20141229.10305,2913,2,1096846,0,2912,396,2913,1,1
20141229.103051,2912,10,1096856,-10,2912,391,2913,101,0
20141229.103051,2912,38,1096894,4,2912,372,2913,106,0
20141229.103053,2912,10,1096904,2,2912,384,2913,107,0
20141229.103057,2912,6,1096910,0,2912,383,2913,159,0
20141229.103058,2913,6,1096916,6,2912,384,2913,155,1
20141229.103058,2912,16,1096932,-2,2912,376,2913,156,0
20141229.1031,2912,2,1096934,2,2912,374,2913,75,0
20141229.103101,2912,10,1096944,0,2912,374,2913,79,0
20141229.103102,2913,2,1096946,0,2912,374,2913,79,1
20141229.103103,2912,20,1096966,0,2912,365,2913,81,0
20141229.103104,2912,12,1096978,6,2912,360,2913,81,0
20141229.103105,2912,94,1097072,-24,2912,314,2913,87,0
20141229.103106,2912,76,1097148,28,2912,260,2913,652,0
20141229.103107,2912,6,1097154,0,2912,247,2913,663,0
20141229.103107,2912,2,1097156,2,2912,246,2913,673,0
20141229.103108,2912,2,1097158,2,2912,274,2913,653,0
20141229.10311,2912,4,1097162,2,2912,272,2913,663,0
20141229.10311,2912,24,1097186,20,2912,260,2913,663,0
20141229.103111,2912,20,1097206,0,2912,251,2913,663,0
20141229.103112,2912,12,1097218,0,2912,245,2913,664,0
20141229.103113,2912,4,1097222,0,2912,243,2913,665,0
20141229.103114,2912,44,1097266,42,2912,221,2913,665,0
20141229.103115,2912,2,1097268,0,2912,219,2913,666,0
20141229.103117,2912,2,1097270,0,2912,218,2913,666,0
20141229.103117,2912,4,1097274,4,2912,216,2913,666,0
20141229.103119,2912,4,1097278,0,2912,215,2913,671,0
20141229.10312,2912,60,1097338,60,2912,186,2913,671,0
20141229.103121,2913,2,1097340,-2,2912,186,2913,675,1
20141229.103121,2913,2,1097342,0,2912,187,2913,674,1
20141229.103122,2912,16,1097358,16,2912,179,2913,674,0
20141229.103123,2912,4,1097362,0,2912,178,2913,674,0
20141229.103123,2912,12,1097374,2,2912,182,2913,675,0
20141229.103125,2912,2,1097376,2,2912,180,2913,675,0
20141229.103125,2912,2,1097378,2,2912,179,2913,675,0
20141229.103126,2912,4,1097382,2,2912,177,2913,675,0
20141229.103127,2912,8,1097390,0,2912,174,2913,675,0
20141229.103128,2912,8,1097398,-6,2912,198,2913,676,0
20141229.103129,2912,4,1097402,-4,2912,196,2913,675,0
20141229.10313,2913,2,1097404,0,2912,196,2913,674,1
20141229.103133,2912,20,1097424,12,2912,186,2913,674,0
20141229.103134,2912,2,1097426,2,2912,185,2913,676,0
20141229.103135,2913,20,1097446,-16,2912,183,2913,660,1
20141229.103136,2912,6,1097452,-2,2912,181,2913,659,0
20141229.103138,2912,2,1097454,0,2912,181,2913,660,0
20141229.103139,2912,2,1097456,0,2912,181,2913,670,0
20141229.103143,2912,8,1097464,8,2912,220,2913,701,0
20141229.103145,2912,28,1097492,0,2912,217,2913,701,0
20141229.103146,2912,2,1097494,0,2912,232,2913,708,0
20141229.103146,2912,512,1098006,-216,2911,965,2913,308,0
20141229.103147,2912,2,1098008,0,2911,967,2913,308,0
20141229.103147,2912,2,1098010,-2,2911,967,2913,320,0
20141229.103148,2912,2,1098012,0,2911,967,2913,321,0
20141229.103148,2912,90,1098102,-38,2912,101,2913,560,0
20141229.103149,2912,10,1098112,-10,2912,167,2913,556,0
20141229.103149,2913,26,1098138,-26,2912,157,2913,543,1
20141229.10315,2912,2,1098140,-2,2912,250,2913,573,0
20141229.103151,2912,102,1098242,-100,2912,200,2913,523,0
20141229.103152,2912,10,1098252,-10,2912,207,2913,534,0
20141229.103152,2912,12,1098264,-12,2912,201,2913,537,0
20141229.103153,2912,2,1098266,0,2912,308,2913,537,0
20141229.103153,2912,6,1098272,0,2912,305,2913,539,0
20141229.103153,2912,4,1098276,0,2912,303,2913,539,0
20141229.103154,2913,4,1098280,-2,2912,304,2913,537,1
20141229.103155,2912,28,1098308,-8,2912,301,2913,526,0
20141229.103158,2913,12,1098320,0,2912,332,2913,523,1
20141229.103159,2913,4,1098324,-4,2912,332,2913,518,1
20141229.1032,2912,2,1098326,-2,2912,331,2913,517,0
20141229.1032,2912,14,1098340,-12,2912,325,2913,567,0
20141229.103201,2912,12,1098352,0,2912,321,2913,567,0
20141229.103202,2913,2,1098354,-2,2912,321,2913,566,1
20141229.103202,2912,2,1098356,-2,2912,322,2913,566,0
20141229.103203,2912,6,1098362,-6,2912,319,2913,565,0
20141229.103204,2912,2,1098364,0,2912,319,2913,565,0
20141229.103205,2912,2,1098366,0,2912,318,2913,566,0
20141229.103205,2912,2,1098368,-2,2912,317,2913,566,0
20141229.103208,2912,2,1098370,0,2912,322,2913,531,0
20141229.10321,2912,80,1098450,-80,2912,282,2913,536,0
20141229.103212,2913,2,1098452,0,2912,282,2913,535,1
20141229.103213,2912,10,1098462,-10,2912,307,2913,538,0
20141229.103215,2913,2,1098464,0,2912,307,2913,559,1
20141229.103216,2912,20,1098484,-20,2912,297,2913,559,0
20141229.103217,2912,596,1099080,276,2911,1647,2912,105,0
20141229.10322,2912,10,1099090,8,2911,1658,2912,140,0
20141229.10322,2911,4,1099094,-4,2911,1656,2912,143,0
20141229.103221,2911,414,1099508,-264,2911,1452,2912,144,0
20141229.103221,2911,8,1099516,2,2911,1449,2912,154,0
20141229.103222,2911,4,1099520,2,2911,1434,2912,246,0
20141229.103223,2911,352,1099872,18,2911,1258,2912,474,0
20141229.103224,2911,26,1099898,0,2911,1245,2912,660,0
20141229.103224,2911,2,1099900,2,2911,1244,2912,661,0
20141229.103225,2911,20,1099920,0,2911,1234,2912,733,0
20141229.103225,2911,18,1099938,0,2911,1224,2912,733,0
20141229.103226,2912,12,1099950,10,2911,1223,2912,732,1
20141229.103227,2911,2,1099952,2,2911,1222,2912,694,0
20141229.103229,2911,4,1099956,2,2911,1220,2912,730,0
20141229.10323,2912,2,1099958,0,2911,1220,2912,734,1
20141229.10323,2912,2,1099960,0,2911,1222,2912,732,1
20141229.103231,2911,10,1099970,4,2911,1216,2912,762,0
20141229.103234,2912,4,1099974,4,2911,1213,2912,790,1
20141229.103235,2911,6,1099980,6,2911,1217,2912,790,0
20141229.103236,2911,24,1100004,2,2911,1207,2912,767,0
20141229.103236,2911,2,1100006,2,2911,1206,2912,768,0
20141229.103237,2911,2,1100008,2,2911,1205,2912,789,0
20141229.103237,2911,12,1100020,2,2911,1199,2912,790,0
20141229.103238,2911,6,1100026,0,2911,1197,2912,789,0
20141229.103239,2912,2,1100028,2,2911,1197,2912,789,1
20141229.10324,2912,2,1100030,2,2911,1197,2912,788,1
20141229.10324,2911,4,1100034,0,2911,1195,2912,788,0
20141229.103241,2911,44,1100078,-30,2911,1173,2912,798,0
20141229.103242,2911,8,1100086,0,2911,1169,2912,698,0
20141229.103243,2911,4,1100090,0,2911,1169,2912,722,0
20141229.103245,2911,2,1100092,2,2911,1201,2912,1240,0
20141229.103245,2911,2,1100094,0,2911,1200,2912,1240,0
20141229.103246,2911,14,1100108,0,2911,1188,2912,1232,0
20141229.103247,2911,4,1100112,0,2911,1186,2912,1233,0
20141229.103247,2911,2,1100114,0,2911,1185,2912,1233,0
20141229.103248,2911,6,1100120,0,2911,1182,2912,1233,0
20141229.103248,2911,2,1100122,2,2911,1181,2912,1236,0
20141229.103249,2911,2,1100124,0,2911,1180,2912,1236,0
20141229.103249,2911,2,1100126,0,2911,1179,2912,1234,0
20141229.10325,2911,10,1100136,0,2911,1217,2912,1234,0
20141229.103251,2911,2,1100138,0,2911,1222,2912,1233,0
20141229.103252,2911,694,1100832,-66,2911,877,2912,1060,0
20141229.103252,2911,244,1101076,-220,2911,757,2912,942,0
20141229.103253,2911,1514,1102590,10,2910,2117,2911,456,0
20141229.103253,2911,286,1102876,0,2910,2118,2911,427,0
20141229.103254,2910,112,1102988,54,2910,2075,2911,309,0
20141229.103254,2910,420,1103408,-108,2910,1870,2911,321,0
20141229.103255,2910,500,1103908,-436,2910,1644,2911,299,0
20141229.103256,2911,24,1103932,-22,2910,1640,2911,361,1
20141229.103256,2910,6,1103938,-6,2910,1637,2911,387,0
20141229.103257,2910,6,1103944,-2,2910,1636,2911,381,0
20141229.103258,2910,2002,1105946,-1806,2910,635,2911,391,0
20141229.103258,2910,228,1106174,-20,2910,511,2911,414,0
20141229.103259,2910,10,1106184,-4,2910,506,2911,449,0
20141229.103259,2910,22,1106206,-22,2910,496,2911,449,0
20141229.103259,2910,108,1106314,-108,2910,443,2911,400,0
20141229.1033,2909,904,1107218,238,2909,568,2910,360,0
20141229.103301,2909,42,1107260,2,2909,536,2910,438,0
20141229.103301,2909,402,1107662,-50,2909,385,2910,419,0
20141229.103302,2910,22,1107684,0,2909,386,2910,443,1
20141229.103302,2910,6,1107690,4,2909,386,2910,451,1
20141229.103303,2909,22,1107712,2,2909,381,2910,482,0
20141229.103303,2909,198,1107910,-152,2909,307,2910,477,0
20141229.103304,2909,622,1108532,-212,2909,80,2910,479,0
20141229.103304,2909,24,1108556,12,2909,71,2910,483,0
20141229.103305,2909,644,1109200,558,2908,1202,2909,394,0
20141229.103305,2909,804,1110004,26,2908,1002,2909,196,0
20141229.103306,2909,582,1110586,-334,2909,664,2910,421,0
20141229.103306,2909,82,1110668,-80,2909,654,2910,421,0
20141229.103307,2910,96,1110764,-92,2909,655,2910,457,1
20141229.103307,2909,68,1110832,2,2909,641,2910,441,0
20141229.103308,2909,118,1110950,-12,2909,585,2910,442,0
20141229.103308,2909,4,1110954,-4,2909,586,2910,442,0
20141229.103309,2909,2,1110956,0,2909,586,2910,478,0
20141229.10331,2909,2,1110958,-2,2909,597,2910,481,0
20141229.103311,2909,12,1110970,-10,2909,625,2910,478,0
20141229.103311,2909,4,1110974,0,2909,627,2910,476,0
20141229.103311,2909,2,1110976,0,2909,629,2910,476,0
20141229.103312,2910,34,1111010,0,2909,640,2910,790,1
20141229.103313,2909,2,1111012,0,2909,736,2910,705,0
20141229.103314,2910,4,1111016,0,2909,782,2910,671,1
20141229.103314,2909,2,1111018,-2,2909,781,2910,671,0
20141229.103314,2909,26,1111044,16,2909,790,2910,660,0
20141229.103315,2910,112,1111156,0,2909,793,2910,606,1
20141229.103316,2909,14,1111170,-14,2909,788,2910,606,0
20141229.103316,2910,36,1111206,10,2909,777,2910,598,1
20141229.103316,2909,24,1111230,-24,2909,765,2910,609,0
20141229.103317,2910,1278,1112508,-1084,2910,201,2911,684,1
20141229.103318,2910,2,1112510,0,2910,200,2911,613,1
20141229.103318,2910,10,1112520,2,2910,197,2911,693,1
20141229.103319,2910,108,1112628,-70,2910,147,2911,699,1
20141229.103319,2911,16,1112644,-14,2910,143,2911,1688,1
20141229.10332,2910,286,1112930,-160,2909,865,2910,100,0
20141229.10332,2910,268,1113198,-252,2910,17,2911,5916,0
20141229.103321,2910,156,1113354,-36,2910,66,2911,5917,0
20141229.103321,2910,98,1113452,4,2910,502,2911,5851,0
20141229.103322,2910,14,1113466,2,2910,533,2911,5851,0
20141229.103322,2910,64,1113530,-34,2910,502,2911,5850,0
20141229.103323,2910,114,1113644,-102,2910,453,2911,5837,0
20141229.103323,2910,4,1113648,0,2910,461,2911,5837,0
20141229.103324,2910,6,1113654,-2,2910,461,2911,5833,0
20141229.103325,2910,86,1113740,-84,2910,470,2911,5800,0
20141229.103325,2910,24,1113764,-22,2910,479,2911,5798,0
20141229.103326,2910,32,1113796,-22,2910,467,2911,5798,0
20141229.103326,2910,22,1113818,-20,2910,470,2911,5789,0
20141229.103327,2910,24,1113842,-20,2910,458,2911,5786,0
20141229.103327,2910,26,1113868,-26,2910,446,2911,5787,0
20141229.103328,2910,16,1113884,-14,2910,438,2911,5807,0
20141229.103328,2910,10,1113894,0,2910,491,2911,5807,0
20141229.103329,2910,10,1113904,0,2910,491,2911,5810,0
20141229.103329,2910,24,1113928,-20,2910,485,2911,5811,0
20141229.10333,2911,16,1113944,-4,2910,479,2911,5808,1
20141229.10333,2910,232,1114176,-232,2910,363,2911,5808,0
20141229.103331,2910,726,1114902,-242,2909,391,2910,175,0
20141229.103332,2909,56,1114958,2,2909,386,2910,234,0
20141229.103332,2910,2,1114960,2,2909,386,2910,250,1
20141229.103333,2910,60,1115020,0,2909,361,2910,311,1
20141229.103333,2910,16,1115036,2,2909,360,2910,327,1
20141229.103334,2909,34,1115070,10,2909,344,2910,338,0
20141229.103334,2910,42,1115112,0,2909,349,2910,318,1
20141229.103335,2910,6,1115118,-2,2909,348,2910,225,1
20141229.103335,2909,6,1115124,-2,2909,348,2910,222,0
20141229.103336,2909,4,1115128,2,2909,350,2910,222,0
20141229.103336,2910,10,1115138,10,2909,351,2910,217,1
20141229.103337,2909,4,1115142,2,2909,355,2910,437,0
20141229.103338,2909,22,1115164,2,2909,348,2910,439,0
20141229.103338,2910,4,1115168,4,2909,351,2910,468,1
20141229.103339,2909,16,1115184,12,2909,363,2910,488,0
20141229.103339,2910,4,1115188,0,2909,363,2910,499,1
20141229.10334,2909,6,1115194,2,2909,372,2910,504,0
20141229.10334,2910,206,1115400,-110,2909,371,2910,432,1
20141229.103341,2909,4,1115404,0,2909,371,2910,398,0
20141229.103341,2909,4,1115408,2,2909,370,2910,399,0
20141229.103342,2909,10,1115418,6,2909,366,2910,401,0
20141229.103343,2909,4,1115422,-4,2909,373,2910,401,0
20141229.103343,2909,6,1115428,0,2909,370,2910,401,0
20141229.103344,2909,26,1115454,-26,2909,357,2910,417,0
20141229.103344,2910,2,1115456,0,2909,371,2910,427,1
20141229.103345,2910,152,1115608,-60,2909,329,2910,367,1
20141229.103345,2909,208,1115816,6,2909,225,2910,417,0
20141229.103346,2909,30,1115846,0,2909,214,2910,508,0
20141229.103347,2909,48,1115894,38,2909,225,2910,512,0
20141229.103348,2909,14,1115908,0,2909,223,2910,531,0
20141229.103349,2909,2,1115910,0,2909,228,2910,549,0
20141229.103349,2909,28,1115938,2,2909,215,2910,550,0
20141229.10335,2910,2,1115940,0,2909,218,2910,554,1
20141229.10335,2909,6,1115946,0,2909,215,2910,644,0
20141229.103351,2909,22,1115968,0,2909,205,2910,635,0
20141229.103352,2909,2,1115970,0,2909,202,2910,625,0
20141229.103353,2909,4,1115974,0,2909,202,2910,656,0
20141229.103353,2909,2,1115976,0,2909,202,2910,656,0
20141229.103355,2910,2,1115978,-2,2909,205,2910,653,1
20141229.103355,2909,18,1115996,-14,2909,196,2910,657,0
20141229.103356,2909,10,1116006,-6,2909,191,2910,650,0
20141229.103356,2909,14,1116020,-10,2909,186,2910,653,0
20141229.103356,2909,14,1116034,-8,2909,181,2910,653,0
20141229.103357,2909,40,1116074,-8,2909,182,2910,633,0
20141229.103358,2909,24,1116098,-14,2909,186,2910,635,0
20141229.103359,2909,22,1116120,8,2909,191,2910,631,0
20141229.1034,2909,2,1116122,2,2909,191,2910,631,0
20141229.1034,2910,16,1116138,-16,2909,191,2910,623,1
20141229.103401,2909,38,1116176,-12,2909,174,2910,623,0
20141229.103401,2909,2,1116178,-2,2909,235,2910,620,0
20141229.103402,2909,6,1116184,-6,2909,247,2910,645,0
20141229.103403,2909,4,1116188,0,2909,341,2910,644,0
20141229.103403,2910,4,1116192,-4,2909,347,2910,642,1
20141229.103404,2909,10,1116202,-4,2909,349,2910,624,0
20141229.103405,2909,24,1116226,-20,2909,352,2910,614,0
20141229.103405,2910,2,1116228,0,2909,353,2910,613,1
20141229.103406,2909,6,1116234,6,2909,351,2910,600,0
20141229.103407,2909,2,1116236,2,2909,353,2910,613,0
20141229.103408,2909,224,1116460,-200,2909,354,2910,475,0
20141229.10341,2909,12,1116472,-8,2909,353,2910,471,0
20141229.10341,2909,10,1116482,6,2909,348,2910,472,0
20141229.10341,2909,220,1116702,-116,2909,239,2910,473,0
20141229.103411,2910,32,1116734,-6,2909,277,2910,542,1
20141229.103412,2909,4,1116738,0,2909,277,2910,526,0
20141229.103413,2909,2,1116740,0,2909,280,2910,531,0
20141229.103415,2909,8,1116748,-4,2909,337,2910,497,0
20141229.103415,2909,10,1116758,0,2909,335,2910,504,0
20141229.103416,2910,4,1116762,0,2909,339,2910,502,1
20141229.103416,2910,36,1116798,-20,2909,339,2910,483,1
20141229.103417,2910,8,1116806,-2,2909,342,2910,481,1
20141229.103417,2909,2,1116808,0,2909,353,2910,481,0
20141229.103418,2909,8,1116816,0,2909,350,2910,483,0
20141229.103419,2909,24,1116840,-2,2909,338,2910,483,0
20141229.103419,2910,2,1116842,-2,2909,339,2910,477,1
20141229.103421,2909,20,1116862,20,2909,340,2910,473,0
20141229.103421,2910,2,1116864,-2,2909,344,2910,473,1
20141229.103424,2909,18,1116882,18,2909,348,2910,486,0
20141229.103424,2909,38,1116920,-32,2909,353,2910,471,0
20141229.103425,2910,8,1116928,-8,2909,365,2910,465,1
20141229.103427,2909,20,1116948,20,2909,358,2910,754,0
20141229.103428,2909,42,1116990,0,2909,359,2910,734,0
20141229.103429,2909,8,1116998,2,2909,357,2910,735,0
20141229.103429,2910,4,1117002,0,2909,357,2910,732,1
20141229.10343,2909,4,1117006,2,2909,357,2910,734,0
20141229.103431,2909,8,1117014,4,2909,355,2910,742,0
20141229.103431,2909,6,1117020,2,2909,352,2910,741,0
20141229.103432,2909,12,1117032,12,2909,348,2910,733,0
20141229.103432,2909,2,1117034,2,2909,350,2910,734,0
20141229.103433,2909,16,1117050,0,2909,342,2910,740,0
20141229.103434,2909,8,1117058,-8,2909,338,2910,724,0
20141229.103434,2910,4,1117062,0,2909,339,2910,724,1
20141229.103436,2909,6,1117068,-6,2909,336,2910,725,0
20141229.103437,2909,2,1117070,0,2909,354,2910,721,0
20141229.103438,2910,30,1117100,12,2909,351,2910,708,1
20141229.103438,2910,2,1117102,2,2909,355,2910,707,1
20141229.103439,2909,4,1117106,0,2909,355,2910,707,0
20141229.10344,2910,2,1117108,2,2909,366,2910,711,1
20141229.103441,2909,2,1117110,-2,2909,366,2910,711,0
20141229.103442,2910,4,1117114,4,2909,368,2910,709,1
20141229.103442,2909,40,1117154,-4,2909,347,2910,709,0
20141229.103443,2909,42,1117196,2,2909,328,2910,708,0
20141229.103443,2909,6,1117202,6,2909,327,2910,706,0
20141229.103444,2910,26,1117228,12,2909,328,2910,692,1
20141229.103444,2909,10,1117238,0,2909,335,2910,708,0
20141229.103445,2909,8,1117246,2,2909,338,2910,705,0
20141229.103446,2910,2,1117248,-2,2909,338,2910,705,1
20141229.103449,2910,22,1117270,4,2909,338,2910,713,1
20141229.10345,2909,6,1117276,0,2909,335,2910,724,0
20141229.10345,2910,4,1117280,0,2909,336,2910,722,1
20141229.103452,2910,2,1117282,0,2909,344,2910,723,1
20141229.103453,2909,10,1117292,0,2909,340,2910,719,0
20141229.103453,2909,2,1117294,0,2909,341,2910,719,0
20141229.103454,2909,14,1117308,4,2909,367,2910,719,0
20141229.103455,2909,4,1117312,2,2909,367,2910,718,0
20141229.103455,2909,2,1117314,0,2909,366,2910,713,0
20141229.103457,2909,2,1117316,0,2909,385,2910,712,0
20141229.103458,2909,30,1117346,30,2909,370,2910,717,0
20141229.103459,2909,2,1117348,2,2909,370,2910,718,0
20141229.1035,2909,20,1117368,8,2909,360,2910,718,0
20141229.1035,2909,20,1117388,2,2909,351,2910,722,0
20141229.103501,2910,6,1117394,-2,2909,550,2910,718,1
20141229.103502,2910,22,1117416,14,2909,551,2910,697,1
20141229.103502,2909,20,1117436,0,2909,546,2910,692,0
20141229.103503,2909,4,1117440,0,2909,547,2910,694,0
20141229.103505,2910,10,1117450,0,2909,574,2910,690,1
20141229.103507,2910,22,1117472,2,2909,512,2910,686,1
20141229.103508,2909,4,1117476,-4,2909,523,2910,686,0
20141229.103509,2910,10,1117486,0,2909,532,2910,685,1
20141229.103509,2910,24,1117510,0,2909,546,2910,674,1
20141229.103511,2909,10,1117520,-10,2909,552,2910,667,0
20141229.103511,2910,2,1117522,0,2909,553,2910,651,1
20141229.103512,2910,2,1117524,0,2909,553,2910,600,1
20141229.103513,2909,2,1117526,-2,2909,553,2910,600,0
20141229.103515,2910,6,1117532,-4,2909,559,2910,598,1
20141229.103515,2909,2,1117534,0,2909,559,2910,598,0
20141229.103517,2910,2,1117536,0,2909,560,2910,591,1
20141229.103518,2909,26,1117562,-24,2909,553,2910,593,0
20141229.103519,2910,2,1117564,-2,2909,553,2910,594,1
20141229.10352,2910,26,1117590,-6,2909,552,2910,585,1
20141229.10352,2910,2,1117592,-2,2909,557,2910,584,1
20141229.103521,2910,4,1117596,-4,2909,603,2910,332,1
20141229.103522,2909,4,1117600,-4,2909,611,2910,332,0
20141229.103522,2910,6,1117606,-6,2909,624,2910,329,1
20141229.103522,2910,6,1117612,-4,2909,638,2910,328,1
20141229.103523,2909,18,1117630,-16,2909,675,2910,324,0
20141229.103524,2909,2,1117632,0,2909,674,2910,324,0
20141229.103524,2910,42,1117674,-42,2909,674,2910,313,1
20141229.103525,2910,2,1117676,-2,2909,686,2910,303,1
20141229.103526,2910,66,1117742,0,2909,707,2910,276,1
20141229.103527,2910,368,1118110,-128,2909,746,2910,93,1
20141229.103527,2910,196,1118306,64,2910,22,2911,1192,1
20141229.103528,2910,10,1118316,-10,2910,39,2911,1182,1
20141229.103528,2911,10,1118326,-10,2910,41,2911,1177,1
20141229.103529,2910,14,1118340,-2,2910,35,2911,1177,0
20141229.103529,2910,70,1118410,-58,2909,915,2910,124,0
20141229.10353,2910,180,1118590,0,2909,807,2910,165,0
20141229.10353,2909,22,1118612,8,2909,806,2910,166,0
20141229.103531,2910,4,1118616,0,2909,805,2910,165,1
20141229.103531,2910,4,1118620,0,2909,814,2910,163,1
20141229.103532,2910,220,1118840,84,2909,814,2910,54,1
20141229.103533,2910,22,1118862,-16,2909,826,2910,53,1
20141229.103533,2910,106,1118968,4,2910,53,2911,1174,1
20141229.103534,2911,8,1118976,-6,2910,54,2911,1171,1
20141229.103534,2910,22,1118998,-20,2910,47,2911,1171,0
20141229.103535,2910,2,1119000,-2,2910,152,2911,1173,0
20141229.103537,2910,2,1119002,0,2910,159,2911,1173,0
20141229.103538,2910,2,1119004,-2,2910,158,2911,1173,0
20141229.103538,2910,6,1119010,-4,2910,260,2911,1173,0
20141229.103539,2911,6,1119016,-2,2910,284,2911,1173,1
20141229.10354,2911,4,1119020,-2,2910,284,2911,1192,1
20141229.103541,2910,2,1119022,-2,2910,287,2911,1193,0
20141229.103542,2910,22,1119044,-2,2910,276,2911,1193,0
20141229.103543,2910,36,1119080,-36,2910,400,2911,1190,0
20141229.103544,2911,2,1119082,-2,2910,400,2911,1194,1
20141229.103545,2911,20,1119102,0,2910,427,2911,1180,1
20141229.103545,2910,4,1119106,0,2910,428,2911,1180,0
20141229.103547,2911,2,1119108,-2,2910,486,2911,1181,1
20141229.10355,2910,6,1119114,0,2910,497,2911,1181,0
20141229.10355,2911,8,1119122,0,2910,497,2911,1177,1
20141229.103551,2911,20,1119142,-20,2910,497,2911,1167,1
20141229.103554,2910,2,1119144,0,2910,510,2911,1179,0
20141229.103555,2911,2,1119146,0,2910,513,2911,1183,1
20141229.103556,2910,8,1119154,-4,2910,509,2911,1184,0
20141229.103557,2910,2,1119156,0,2910,528,2911,1183,0
20141229.103557,2911,20,1119176,0,2910,533,2911,1173,1
20141229.103558,2910,2,1119178,0,2910,537,2911,1173,0
20141229.1036,2910,26,1119204,26,2910,532,2911,1173,0
20141229.103603,2911,38,1119242,-38,2910,693,2911,1154,1
20141229.103605,2911,10,1119252,0,2910,702,2911,1149,1
20141229.103606,2910,20,1119272,0,2910,706,2911,1149,0
20141229.103607,2910,2,1119274,2,2910,705,2911,1149,0
20141229.103608,2910,400,1119674,-16,2910,507,2911,1149,0
20141229.103609,2911,2,1119676,0,2910,510,2911,1149,1
20141229.10361,2910,2,1119678,2,2910,509,2911,1149,0
20141229.103611,2910,2,1119680,2,2910,509,2911,1148,0
20141229.103612,2911,2,1119682,0,2910,509,2911,1150,1
20141229.103613,2910,76,1119758,68,2910,475,2911,1150,0
20141229.103613,2911,2,1119760,0,2910,476,2911,1164,1
20141229.103614,2911,4,1119764,0,2910,476,2911,1162,1
20141229.103615,2910,2,1119766,0,2910,475,2911,1162,0
20141229.103615,2911,2,1119768,-2,2910,487,2911,1161,1
20141229.103616,2910,2,1119770,0,2910,522,2911,1161,0
20141229.103617,2911,2,1119772,0,2910,562,2911,1160,1
20141229.103618,2910,2,1119774,2,2910,562,2911,1161,0
20141229.103619,2911,38,1119812,0,2910,562,2911,1142,1
20141229.10362,2911,4,1119816,0,2910,623,2911,1139,1
20141229.103621,2910,42,1119858,6,2910,620,2911,1119,0
20141229.103621,2911,4,1119862,2,2910,623,2911,1117,1
20141229.103622,2911,20,1119882,14,2910,625,2911,1108,1
20141229.103622,2911,2,1119884,0,2910,632,2911,1107,1
20141229.103623,2910,2,1119886,0,2910,631,2911,1107,0
20141229.103623,2911,158,1120044,0,2910,633,2911,1028,1
20141229.103624,2911,6,1120050,-4,2910,642,2911,1015,1
20141229.103624,2911,346,1120396,18,2910,642,2911,842,1
20141229.103625,2911,106,1120502,-2,2910,641,2911,722,1
20141229.103625,2911,1178,1121680,78,2911,34,2912,758,1
20141229.103626,2911,2,1121682,-2,2911,136,2912,838,1
20141229.103626,2912,24,1121706,20,2911,203,2912,821,1
20141229.103627,2912,2,1121708,0,2911,252,2912,2821,1
20141229.103628,2912,470,1122178,416,2911,5,2912,5868,1
20141229.103628,2911,12,1122190,2,2910,905,2911,4,0
20141229.103629,2911,14,1122204,-4,2911,5,2912,5848,0
20141229.10363,2911,96,1122300,-94,2911,74,2912,5806,0
20141229.10363,2911,148,1122448,-36,2910,744,2911,2,0
20141229.103631,2911,12,1122460,-10,2911,25,2912,5806,0
20141229.103631,2911,54,1122514,-50,2911,49,2912,5806,0
20141229.103632,2911,2,1122516,-2,2911,68,2912,5806,0
20141229.103633,2911,176,1122692,-78,2910,886,2911,66,0
20141229.103634,2911,132,1122824,4,2911,64,2912,792,0
20141229.103634,2912,42,1122866,42,2911,64,2912,771,1
20141229.103636,2912,2,1122868,2,2911,77,2912,788,1
20141229.103636,2911,16,1122884,14,2911,73,2912,787,0
20141229.103637,2911,4,1122888,0,2911,107,2912,794,0
20141229.103638,2912,2,1122890,0,2911,199,2912,795,1
20141229.103641,2911,2378,1125268,160,2910,789,2911,77,0
20141229.103641,2911,8,1125276,-2,2910,638,2911,124,0
20141229.103642,2911,2,1125278,0,2910,641,2911,126,0
20141229.103642,2911,252,1125530,-54,2911,103,2912,854,0
20141229.103643,2911,116,1125646,108,2911,47,2912,812,0
20141229.103643,2911,4,1125650,0,2911,73,2912,813,0
20141229.103644,2911,4,1125654,0,2911,72,2912,799,0
20141229.103645,2911,8,1125662,0,2911,70,2912,799,0
20141229.103645,2911,8,1125670,8,2911,158,2912,799,0
20141229.103646,2911,2,1125672,2,2911,215,2912,799,0
20141229.103646,2911,2,1125674,2,2911,214,2912,799,0
20141229.103647,2911,20,1125694,0,2911,289,2912,799,0
20141229.103649,2912,2,1125696,2,2911,381,2912,813,1
20141229.10365,2912,4,1125700,2,2911,415,2912,803,1
20141229.103651,2912,8,1125708,8,2911,425,2912,803,1
20141229.103651,2912,6,1125714,4,2911,425,2912,800,1
20141229.103653,2912,2,1125716,2,2911,706,2912,804,1
20141229.103654,2912,6,1125722,6,2911,707,2912,803,1
20141229.103655,2911,1414,1127136,742,2910,771,2911,382,0
20141229.103656,2910,2,1127138,0,2910,508,2911,519,0
20141229.103657,2911,8,1127146,0,2910,521,2911,540,1
20141229.103658,2910,40,1127186,0,2910,501,2911,580,0
20141229.103658,2910,2,1127188,2,2910,510,2911,575,0
20141229.103659,2911,2,1127190,2,2910,511,2911,589,1
20141229.1037,2911,1254,1128444,-646,2911,374,2912,711,1
20141229.1037,2912,98,1128542,-42,2911,493,2912,598,1
20141229.103701,2911,4,1128546,0,2911,502,2912,599,0
20141229.103702,2911,4,1128550,0,2911,500,2912,599,0
20141229.103702,2911,2,1128552,0,2911,499,2912,440,0
20141229.103704,2912,10,1128562,0,2911,500,2912,436,1
20141229.103704,2912,18,1128580,10,2911,500,2912,427,1
20141229.103705,2912,16,1128596,16,2911,510,2912,419,1
20141229.103705,2912,16,1128612,16,2911,512,2912,413,1
20141229.103706,2912,8,1128620,8,2911,511,2912,409,1
20141229.103706,2912,28,1128648,10,2911,532,2912,397,1
20141229.103708,2911,2,1128650,0,2911,532,2912,395,0
20141229.103709,2911,100,1128750,0,2911,482,2912,410,0
20141229.10371,2912,4,1128754,-4,2911,484,2912,432,1
20141229.103711,2911,2,1128756,0,2911,485,2912,473,0
20141229.103712,2912,2,1128758,-2,2911,485,2912,472,1
20141229.103712,2912,2,1128760,0,2911,485,2912,471,1
20141229.103713,2911,2,1128762,0,2911,484,2912,473,0
20141229.103713,2911,6,1128768,0,2911,481,2912,473,0
20141229.103714,2912,2,1128770,0,2911,483,2912,474,1
20141229.103715,2912,8,1128778,-2,2911,483,2912,453,1
20141229.103718,2911,2,1128780,-2,2911,491,2912,453,0
20141229.103719,2911,2,1128782,0,2911,490,2912,452,0
20141229.103721,2912,6,1128788,4,2911,490,2912,460,1
20141229.103721,2912,2,1128790,0,2911,490,2912,459,1
20141229.103722,2912,4,1128794,-2,2911,489,2912,459,1
20141229.103723,2912,8,1128802,8,2911,495,2912,455,1
20141229.103723,2911,4,1128806,0,2911,495,2912,454,0
20141229.103724,2912,6,1128812,6,2911,495,2912,451,1
20141229.103724,2912,4,1128816,4,2911,495,2912,449,1
20141229.103725,2912,56,1128872,32,2911,496,2912,426,1
20141229.103726,2912,4,1128876,0,2911,496,2912,507,1
20141229.103727,2912,4,1128880,0,2911,496,2912,506,1
20141229.103727,2912,4,1128884,-4,2911,496,2912,506,1
20141229.103728,2912,2,1128886,0,2911,496,2912,504,1
20141229.10373,2911,400,1129286,0,2911,298,2912,488,0
20141229.103731,2911,2,1129288,-2,2911,287,2912,607,0
20141229.103732,2911,92,1129380,32,2911,261,2912,587,0
20141229.103732,2912,4,1129384,0,2911,261,2912,585,1
20141229.103733,2912,2,1129386,2,2911,261,2912,585,1
20141229.103734,2912,8,1129394,0,2911,293,2912,583,1
20141229.103735,2912,14,1129408,12,2911,295,2912,576,1
20141229.103736,2912,10,1129418,-10,2911,298,2912,571,1
20141229.103742,2912,2,1129420,0,2911,393,2912,531,1
20141229.103743,2912,4,1129424,0,2911,394,2912,530,1
20141229.103744,2911,2,1129426,-2,2911,395,2912,571,0
20141229.103744,2912,20,1129446,0,2911,390,2912,561,1
20141229.103745,2912,6,1129452,0,2911,390,2912,548,1
20141229.103746,2912,2,1129454,-2,2911,393,2912,542,1
20141229.103755,2912,2,1129456,0,2911,429,2912,565,1
20141229.103755,2911,2,1129458,-2,2911,428,2912,556,0
20141229.103757,2912,4,1129462,0,2911,413,2912,572,1
20141229.103759,2911,2,1129464,0,2911,422,2912,573,0
20141229.1038,2912,2,1129466,-2,2911,422,2912,572,1
20141229.1038,2912,6,1129472,0,2911,423,2912,571,1
20141229.103801,2912,4,1129476,0,2911,424,2912,562,1
20141229.103802,2912,6,1129482,-4,2911,424,2912,564,1
20141229.103804,2912,6,1129488,0,2911,433,2912,561,1
20141229.103806,2911,10,1129498,0,2911,430,2912,541,0
20141229.103807,2912,2,1129500,0,2911,430,2912,540,1
20141229.10381,2912,4,1129504,-4,2911,440,2912,544,1
20141229.103811,2912,20,1129524,0,2911,440,2912,509,1
20141229.103812,2912,2,1129526,0,2911,440,2912,508,1
20141229.103813,2911,26,1129552,-6,2911,434,2912,501,0
20141229.103815,2911,8,1129560,0,2911,430,2912,511,0
20141229.103816,2912,2,1129562,2,2911,432,2912,510,1
20141229.103817,2912,2,1129564,0,2911,434,2912,602,1
20141229.10382,2912,158,1129722,2,2911,453,2912,533,1
20141229.103821,2912,6,1129728,-6,2911,455,2912,601,1
20141229.103823,2912,4,1129732,0,2911,468,2912,599,1
20141229.103825,2912,4,1129736,-2,2911,565,2912,604,1
20141229.103827,2912,2,1129738,-2,2911,615,2912,560,1
20141229.103828,2912,2,1129740,0,2911,615,2912,558,1
20141229.103828,2912,2,1129742,0,2911,640,2912,557,1
20141229.103829,2912,2,1129744,0,2911,641,2912,554,1
20141229.103831,2911,4,1129748,-2,2911,656,2912,554,0
20141229.103832,2912,2,1129750,0,2911,657,2912,552,1
20141229.103834,2912,2,1129752,-2,2911,706,2912,546,1
20141229.103835,2912,2,1129754,-2,2911,709,2912,544,1
20141229.103836,2911,4,1129758,-4,2911,782,2912,544,0
20141229.103837,2912,2,1129760,0,2911,807,2912,532,1
20141229.103838,2911,10,1129770,0,2911,803,2912,531,0
20141229.103839,2912,2,1129772,0,2911,828,2912,530,1
20141229.103839,2912,2,1129774,0,2911,828,2912,529,1
20141229.10384,2912,16,1129790,0,2911,830,2912,523,1
20141229.103844,2912,2,1129792,0,2911,862,2912,536,1
20141229.103844,2911,2,1129794,0,2911,861,2912,536,0
20141229.103846,2912,20,1129814,0,2911,863,2912,528,1
20141229.103846,2911,2,1129816,-2,2911,863,2912,528,0
20141229.103849,2912,2,1129818,-2,2911,862,2912,577,1
20141229.10385,2912,4,1129822,-4,2911,858,2912,574,1
20141229.103851,2912,8,1129830,-6,2911,858,2912,570,1
20141229.103852,2911,10,1129840,-10,2911,852,2912,570,0
20141229.103852,2912,4,1129844,0,2911,853,2912,568,1
20141229.103856,2912,2,1129846,-2,2911,868,2912,582,1
20141229.103857,2912,2,1129848,0,2911,868,2912,592,1
20141229.103858,2912,10,1129858,4,2911,868,2912,592,1
20141229.103858,2912,2,1129860,0,2911,876,2912,591,1
20141229.103859,2912,2,1129862,0,2911,881,2912,628,1
20141229.1039,2912,2,1129864,2,2911,901,2912,636,1
20141229.103902,2912,2,1129866,2,2911,900,2912,617,1
20141229.103902,2911,2,1129868,0,2911,895,2912,617,0
20141229.103903,2912,36,1129904,-24,2911,893,2912,602,1
20141229.103904,2912,2,1129906,-2,2911,892,2912,602,1
20141229.103905,2912,2,1129908,0,2911,892,2912,601,1
20141229.103906,2912,16,1129924,-16,2911,893,2912,593,1
20141229.103908,2912,2,1129926,0,2911,894,2912,593,1
20141229.10391,2912,2,1129928,0,2911,894,2912,591,1
20141229.103911,2912,2,1129930,0,2911,897,2912,590,1
20141229.103911,2912,4,1129934,0,2911,898,2912,598,1
20141229.103913,2912,2,1129936,0,2911,900,2912,598,1
20141229.103913,2912,20,1129956,0,2911,902,2912,548,1
20141229.103917,2911,4,1129960,-2,2911,901,2912,552,0
20141229.103917,2912,6,1129966,4,2911,901,2912,549,1
20141229.103918,2912,12,1129978,0,2911,901,2912,542,1
20141229.103918,2912,10,1129988,-2,2911,902,2912,537,1
20141229.10392,2912,110,1130098,-96,2911,943,2912,482,1
20141229.103921,2912,18,1130116,0,2911,943,2912,477,1
20141229.103921,2912,10,1130126,0,2911,948,2912,462,1
20141229.103922,2912,68,1130194,-68,2911,945,2912,428,1
20141229.103922,2912,18,1130212,2,2911,945,2912,419,1
20141229.103923,2912,4,1130216,0,2911,940,2912,423,1
20141229.103925,2912,2,1130218,0,2911,938,2912,421,1
20141229.103925,2912,4,1130222,4,2911,938,2912,419,1
20141229.103926,2912,10,1130232,0,2911,938,2912,414,1
20141229.103926,2912,12,1130244,8,2911,945,2912,406,1
20141229.103927,2912,6,1130250,6,2911,945,2912,403,1
20141229.103927,2912,154,1130404,42,2911,946,2912,326,1
20141229.103928,2912,4,1130408,0,2911,956,2912,324,1
20141229.103928,2912,4,1130412,0,2911,955,2912,320,1
20141229.103929,2912,6,1130418,-2,2911,956,2912,318,1
20141229.10393,2912,12,1130430,0,2911,957,2912,312,1
20141229.10393,2912,8,1130438,-6,2911,957,2912,308,1
20141229.103931,2912,84,1130522,-2,2911,947,2912,266,1
20141229.103932,2912,4,1130526,0,2911,947,2912,264,1
20141229.103932,2912,10,1130536,-8,2911,948,2912,263,1
20141229.103933,2912,14,1130550,-8,2911,949,2912,256,1
20141229.103934,2912,20,1130570,14,2911,949,2912,252,1
20141229.103934,2912,108,1130678,94,2911,953,2912,198,1
20141229.103934,2912,16,1130694,16,2911,963,2912,189,1
20141229.103935,2912,166,1130860,128,2911,961,2913,501,1
20141229.103936,2913,326,1131186,234,2912,260,2913,493,1
20141229.103936,2912,34,1131220,0,2912,264,2913,491,0
20141229.103937,2913,2,1131222,0,2912,266,2913,490,1
20141229.103937,2912,2,1131224,2,2912,282,2913,490,0
20141229.103938,2913,2,1131226,2,2912,282,2913,489,1
20141229.103938,2912,20,1131246,0,2912,272,2913,489,0
20141229.103943,2913,2,1131248,0,2912,317,2913,509,1
20141229.103943,2912,4,1131252,0,2912,324,2913,518,0
20141229.103945,2913,2,1131254,0,2912,327,2913,517,1
20141229.103945,2913,2,1131256,0,2912,348,2913,516,1
20141229.103946,2913,2,1131258,0,2912,348,2913,515,1
20141229.103947,2913,2,1131260,0,2912,349,2913,511,1
20141229.103947,2913,2,1131262,0,2912,352,2913,510,1
20141229.103948,2913,60,1131322,24,2912,335,2913,498,1
20141229.103949,2913,100,1131422,74,2912,336,2913,448,1
20141229.103952,2913,4,1131426,0,2912,426,2913,440,1
20141229.103953,2913,4,1131430,-4,2912,426,2913,438,1
20141229.103953,2912,36,1131466,-20,2912,410,2913,436,0
20141229.103955,2913,2,1131468,-2,2912,416,2913,404,1
20141229.103956,2913,8,1131476,-6,2912,417,2913,420,1
20141229.104001,2913,8,1131484,-6,2912,425,2913,421,1
20141229.104005,2913,2,1131486,0,2912,434,2913,568,1
20141229.104006,2913,12,1131498,0,2912,434,2913,565,1
20141229.104008,2913,6,1131504,-2,2912,434,2913,562,1
20141229.104008,2912,2,1131506,-2,2912,434,2913,612,0
20141229.104009,2913,2,1131508,0,2912,434,2913,613,1
20141229.104015,2912,2,1131510,0,2912,449,2913,634,0
20141229.104017,2913,2,1131512,0,2912,451,2913,633,1
20141229.104018,2912,30,1131542,-30,2912,442,2913,613,0
20141229.104019,2913,20,1131562,18,2912,442,2913,604,1
20141229.10402,2913,8,1131570,-6,2912,443,2913,605,1
20141229.10402,2912,50,1131620,0,2912,411,2913,736,0
20141229.104021,2912,30,1131650,-20,2912,408,2913,755,0
20141229.104021,2912,2,1131652,0,2912,406,2913,757,0
20141229.104022,2912,328,1131980,-112,2912,256,2913,779,0
20141229.104022,2912,10,1131990,4,2912,241,2913,789,0
20141229.104023,2912,58,1132048,-50,2912,213,2913,789,0
20141229.104024,2912,432,1132480,-142,2911,818,2912,496,0
20141229.104024,2912,428,1132908,-4,2911,817,2912,343,0
20141229.104024,2912,112,1133020,-6,2911,817,2912,290,0
20141229.104025,2912,16,1133036,-14,2911,847,2912,97,0
20141229.104025,2912,194,1133230,-176,2912,75,2913,729,0
20141229.104026,2913,24,1133254,-20,2912,81,2913,808,1
20141229.104027,2912,176,1133430,-154,2912,117,2913,737,0
20141229.104028,2913,10,1133440,6,2912,129,2913,732,1
20141229.104031,2912,4,1133444,4,2912,424,2913,757,0
20141229.104031,2912,20,1133464,20,2912,416,2913,750,0
20141229.104033,2912,2,1133466,2,2912,473,2913,735,0
20141229.104033,2913,4,1133470,0,2912,473,2913,756,1
20141229.104034,2913,8,1133478,2,2912,473,2913,752,1
20141229.104035,2913,4,1133482,0,2912,253,2913,751,1
20141229.104037,2912,212,1133694,202,2912,148,2913,760,0
20141229.104037,2912,4,1133698,2,2912,146,2913,759,0
20141229.10404,2913,2,1133700,0,2912,362,2913,764,1
20141229.10404,2912,10,1133710,10,2912,357,2913,764,0
20141229.104041,2912,10,1133720,-2,2912,354,2913,762,0
20141229.104042,2913,4,1133724,2,2912,407,2913,759,1
20141229.104044,2912,62,1133786,2,2912,384,2913,764,0
20141229.104046,2913,2,1133788,2,2912,385,2913,778,1
20141229.104048,2913,2,1133790,2,2912,405,2913,777,1
20141229.104049,2913,2,1133792,2,2912,308,2913,776,1
20141229.104054,2913,2,1133794,2,2912,349,2913,803,1
20141229.104055,2913,4,1133798,2,2912,354,2913,801,1
20141229.104056,2913,2,1133800,0,2912,355,2913,803,1
20141229.104059,2912,12,1133812,0,2912,356,2913,804,0
20141229.104101,2912,40,1133852,38,2912,340,2913,804,0
20141229.104103,2912,10,1133862,0,2912,335,2913,751,0
20141229.104104,2912,2,1133864,2,2912,335,2913,750,0
20141229.104105,2912,2,1133866,2,2912,334,2913,750,0
20141229.104105,2912,2,1133868,0,2912,333,2913,750,0
20141229.104106,2912,2,1133870,2,2912,332,2913,750,0
20141229.104107,2912,2,1133872,2,2912,329,2913,750,0
20141229.104109,2913,2,1133874,2,2912,329,2913,748,1
20141229.10411,2912,2,1133876,2,2912,338,2913,748,0
20141229.104111,2912,2,1133878,0,2912,337,2913,749,0
20141229.104111,2912,2,1133880,2,2912,338,2913,750,0
20141229.104115,2912,2,1133882,2,2912,346,2913,751,0
20141229.104119,2912,2,1133884,-2,2912,363,2913,754,0
20141229.104121,2912,2,1133886,2,2912,415,2913,754,0
20141229.104121,2912,2,1133888,2,2912,415,2913,754,0
20141229.104123,2913,6,1133894,6,2912,415,2913,752,1
20141229.104124,2913,2,1133896,0,2912,387,2913,752,1
20141229.104126,2913,10,1133906,8,2912,387,2913,748,1
20141229.104128,2912,2,1133908,0,2912,387,2913,716,0
20141229.10413,2913,10,1133918,10,2912,387,2913,762,1
20141229.104132,2913,2,1133920,2,2912,388,2913,765,1
20141229.104133,2913,6,1133926,2,2912,391,2913,767,1
20141229.104133,2913,8,1133934,2,2912,400,2913,764,1
20141229.104134,2913,10,1133944,10,2912,401,2913,760,1
20141229.104134,2913,2,1133946,2,2912,401,2913,756,1
20141229.104135,2913,12,1133958,12,2912,401,2913,750,1
20141229.104135,2913,4,1133962,2,2912,406,2913,748,1
20141229.104136,2913,2,1133964,2,2912,407,2913,747,1
20141229.104138,2913,2,1133966,2,2912,418,2913,746,1
20141229.104139,2913,2,1133968,2,2912,416,2913,746,1
20141229.10414,2913,24,1133992,24,2912,418,2913,734,1
20141229.104143,2912,22,1134014,20,2912,436,2913,746,0
20141229.104144,2913,60,1134074,60,2912,436,2913,716,1
20141229.104144,2913,4,1134078,4,2912,426,2913,727,1
20141229.104149,2913,2,1134080,2,2912,425,2913,652,1
20141229.104149,2913,4,1134084,-2,2912,425,2913,651,1
20141229.10415,2913,4,1134088,4,2912,425,2913,649,1
20141229.104151,2913,10,1134098,10,2912,425,2913,653,1
20141229.104152,2913,20,1134118,20,2912,425,2913,643,1
20141229.104153,2913,2,1134120,0,2912,425,2913,642,1
20141229.104155,2913,2,1134122,2,2912,430,2913,654,1
20141229.104157,2912,6,1134128,6,2912,432,2913,654,0
20141229.104158,2913,2,1134130,2,2912,433,2913,665,1
20141229.104203,2913,34,1134164,0,2912,430,2913,687,1
20141229.104204,2913,6,1134170,0,2912,429,2913,685,1
20141229.104204,2913,4,1134174,4,2912,429,2913,683,1
20141229.104205,2912,10,1134184,10,2912,424,2913,683,0
20141229.104212,2912,6,1134190,6,2912,443,2913,707,0
20141229.104214,2913,36,1134226,10,2912,443,2913,636,1
20141229.104214,2912,2,1134228,0,2912,442,2913,636,0
20141229.104215,2913,2,1134230,2,2912,442,2913,632,1
20141229.104216,2913,8,1134238,8,2912,367,2913,628,1
20141229.104216,2912,734,1134972,-190,2911,685,2912,68,0
20141229.104217,2912,236,1135208,-70,2912,68,2913,547,0
20141229.104217,2912,138,1135346,112,2911,670,2912,68,0
20141229.104218,2911,2,1135348,0,2911,619,2912,68,0
20141229.104219,2912,36,1135384,-22,2911,599,2912,191,1
20141229.104221,2912,4,1135388,4,2911,658,2912,273,1
20141229.104221,2912,2,1135390,2,2911,658,2912,273,1
20141229.104225,2912,2,1135392,0,2911,670,2912,325,1
20141229.104226,2912,2,1135394,2,2911,667,2912,434,1
20141229.104231,2911,2,1135396,-2,2911,667,2912,487,0
20141229.104231,2912,6,1135402,-2,2911,667,2912,490,1
20141229.104233,2911,20,1135422,-20,2911,655,2912,507,0
20141229.104234,2911,10,1135432,0,2911,650,2912,507,0
20141229.104238,2911,2,1135434,0,2911,706,2912,698,0
20141229.104242,2912,2,1135436,0,2911,713,2912,702,1
20141229.104245,2912,22,1135458,20,2911,713,2912,690,1
20141229.104246,2912,4,1135462,0,2911,712,2912,709,1
20141229.104249,2911,2,1135464,-2,2911,712,2912,781,0
20141229.104251,2911,110,1135574,70,2911,658,2912,762,0
20141229.104253,2911,26,1135600,0,2911,652,2912,752,0
20141229.104254,2911,40,1135640,0,2911,631,2912,752,0
20141229.104254,2912,2,1135642,2,2911,631,2912,751,1
20141229.104255,2911,2,1135644,2,2911,646,2912,554,0
20141229.104256,2911,6,1135650,6,2911,628,2912,554,0
20141229.104257,2911,2,1135652,0,2911,627,2912,557,0
20141229.104304,2911,20,1135672,20,2911,615,2912,558,0
20141229.104304,2911,2,1135674,2,2911,614,2912,558,0
20141229.104304,2911,6,1135680,0,2911,611,2912,558,0
20141229.104306,2912,6,1135686,0,2911,611,2912,558,1
20141229.104309,2911,2,1135688,2,2911,613,2912,559,0
20141229.104315,2911,12,1135700,0,2911,615,2912,566,0
20141229.104317,2911,4,1135704,4,2911,614,2912,573,0
20141229.104318,2911,40,1135744,40,2911,594,2912,578,0
20141229.104319,2911,10,1135754,10,2911,582,2912,578,0
20141229.104319,2911,2,1135756,2,2911,581,2912,578,0
20141229.10432,2911,10,1135766,0,2911,576,2912,578,0
20141229.104322,2911,12,1135778,8,2911,570,2912,633,0
20141229.104322,2912,2,1135780,0,2911,570,2912,644,1
20141229.104323,2911,2,1135782,2,2911,570,2912,644,0
20141229.104326,2911,2,1135784,0,2911,568,2912,645,0
20141229.104327,2911,8,1135792,0,2911,574,2912,644,0
20141229.104328,2911,16,1135808,0,2911,566,2912,651,0
20141229.10433,2911,2,1135810,0,2911,567,2912,686,0
20141229.104332,2911,4,1135814,2,2911,566,2912,686,0
20141229.104332,2911,2,1135816,-2,2911,565,2912,685,0
20141229.104334,2912,2,1135818,2,2911,567,2912,686,1
20141229.104337,2911,4,1135822,2,2911,564,2912,687,0
20141229.10434,2911,14,1135836,4,2911,543,2912,681,0
20141229.104341,2912,24,1135860,18,2911,544,2912,669,1
20141229.104341,2911,2,1135862,0,2911,543,2912,668,0
20141229.104342,2912,8,1135870,0,2911,541,2912,665,1
20141229.104344,2911,6,1135876,6,2911,538,2912,665,0
20141229.104347,2911,10,1135886,10,2911,533,2912,699,0
20141229.104348,2912,2,1135888,0,2911,533,2912,698,1
20141229.104349,2911,2,1135890,0,2911,532,2912,597,0
20141229.104356,2911,2,1135892,2,2911,539,2912,618,0
20141229.104359,2911,2,1135894,2,2911,538,2912,614,0
20141229.1044,2911,6,1135900,0,2911,535,2912,614,0
20141229.1044,2911,2,1135902,0,2911,534,2912,614,0
20141229.104401,2912,2,1135904,0,2911,538,2912,639,1
20141229.104403,2911,4,1135908,0,2911,547,2912,641,0
20141229.104404,2911,2,1135910,0,2911,549,2912,706,0
20141229.104406,2911,2,1135912,0,2911,548,2912,691,0
20141229.10441,2911,6,1135918,-2,2911,543,2912,694,0
20141229.104412,2911,2,1135920,0,2911,542,2912,695,0
20141229.104412,2911,2,1135922,0,2911,541,2912,665,0
20141229.104413,2912,2,1135924,0,2911,541,2912,664,1
20141229.104417,2911,182,1136106,-48,2911,419,2912,553,0
20141229.104418,2911,4,1136110,2,2911,417,2912,553,0
20141229.104419,2911,2,1136112,0,2911,417,2912,554,0
20141229.104422,2912,6,1136118,-6,2911,419,2912,553,1
20141229.104425,2911,8,1136126,8,2911,411,2912,549,0
20141229.104426,2911,20,1136146,6,2911,401,2912,549,0
20141229.104436,2911,8,1136154,2,2911,398,2912,548,0
20141229.104437,2912,2,1136156,0,2911,398,2912,547,1
20141229.104442,2911,8,1136164,8,2911,394,2912,547,0
20141229.104443,2911,8,1136172,0,2911,391,2912,547,0
20141229.104453,2911,2,1136174,2,2911,394,2912,579,0
20141229.104503,2911,2,1136176,2,2911,417,2912,585,0
20141229.104503,2911,2,1136178,2,2911,416,2912,585,0
20141229.104504,2911,2,1136180,0,2911,415,2912,585,0
20141229.104505,2911,10,1136190,0,2911,409,2912,585,0
20141229.104506,2911,4,1136194,4,2911,431,2912,585,0
20141229.10451,2912,2,1136196,-2,2911,486,2912,584,1
20141229.10451,2912,2,1136198,-2,2911,486,2912,583,1
20141229.104512,2912,2,1136200,-2,2911,736,2912,582,1
20141229.104513,2912,10,1136210,-10,2911,737,2912,577,1
20141229.104516,2911,6,1136216,0,2911,740,2912,577,0
20141229.104516,2911,6,1136222,6,2911,737,2912,578,0
20141229.104518,2911,2,1136224,2,2911,742,2912,578,0
20141229.104521,2911,34,1136258,-32,2911,737,2912,564,0
20141229.104525,2912,16,1136274,2,2911,738,2912,555,1
20141229.104527,2912,2,1136276,0,2911,739,2912,555,1
20141229.104528,2912,2,1136278,-2,2911,742,2912,554,1
20141229.104535,2912,20,1136298,-20,2911,754,2912,540,1
20141229.104535,2912,4,1136302,0,2911,783,2912,541,1
20141229.104537,2911,2,1136304,2,2911,783,2912,541,0
20141229.104538,2912,4,1136308,-4,2911,783,2912,538,1
20141229.104539,2912,2,1136310,-2,2911,783,2912,536,1
20141229.104545,2912,2,1136312,-2,2911,801,2912,530,1
20141229.104546,2912,2,1136314,0,2911,796,2912,529,1
20141229.104548,2912,140,1136454,14,2911,775,2912,459,1
20141229.10455,2912,128,1136582,-110,2911,728,2912,395,1
20141229.104551,2912,20,1136602,0,2911,725,2912,389,1
20141229.104553,2912,2,1136604,-2,2911,724,2912,388,1
20141229.104556,2912,718,1137322,-454,2912,643,2913,685,1
20141229.104557,2912,1388,1138710,0,2911,759,2912,408,1
20141229.104557,2912,8,1138718,8,2911,750,2912,420,1
20141229.104558,2912,32,1138750,22,2911,750,2912,404,1
20141229.104559,2911,2,1138752,0,2911,749,2912,404,0
20141229.104559,2912,4,1138756,2,2911,749,2912,402,1
20141229.104601,2912,12,1138768,0,2911,742,2912,396,1
20141229.104602,2912,4,1138772,0,2911,718,2912,395,1
20141229.104605,2911,20,1138792,0,2911,720,2912,398,0
20141229.104606,2912,4,1138796,4,2911,720,2912,400,1
20141229.104607,2911,140,1138936,100,2911,636,2912,1362,0
20141229.104608,2912,10,1138946,0,2911,635,2912,1357,1
20141229.104609,2911,168,1139114,74,2911,550,2912,1357,0
20141229.10461,2912,2324,1141438,88,2911,600,2912,196,1
20141229.10461,2912,372,1141810,372,2912,322,2913,603,1
20141229.104611,2912,12,1141822,-12,2912,407,2913,463,1
20141229.104611,2912,2,1141824,0,2912,421,2913,463,1
20141229.104614,2913,8,1141832,0,2912,250,2913,459,1
20141229.104615,2912,8,1141840,4,2912,246,2913,459,0
20141229.104617,2912,2,1141842,2,2912,260,2913,459,0
20141229.104619,2912,522,1142364,422,2911,650,2912,842,0
20141229.10462,2912,12,1142376,2,2911,593,2912,847,0
20141229.104621,2912,100,1142476,0,2911,593,2912,798,0
20141229.104622,2913,1616,1144092,-226,2912,295,2913,452,1
20141229.104623,2912,2,1144094,0,2912,294,2913,452,0
20141229.104624,2912,64,1144158,-64,2912,272,2913,452,0
20141229.104625,2912,6,1144164,0,2912,270,2913,452,0
20141229.104626,2912,8,1144172,0,2912,266,2913,452,0
20141229.104626,2912,2,1144174,0,2912,265,2913,453,0
20141229.104629,2913,20,1144194,0,2912,294,2913,463,1
20141229.10463,2912,100,1144294,-100,2912,245,2913,442,0
20141229.104633,2912,2,1144296,0,2912,273,2913,446,0
20141229.104634,2913,2,1144298,0,2912,273,2913,445,1
20141229.104639,2912,48,1144346,-48,2912,269,2913,445,0
20141229.10464,2913,2,1144348,0,2912,278,2913,444,1
20141229.10464,2913,14,1144362,0,2912,279,2913,437,1
20141229.104641,2913,2,1144364,2,2912,284,2913,436,1
20141229.104642,2912,262,1144626,-156,2912,153,2913,436,0
20141229.104643,2913,2,1144628,0,2912,150,2913,435,1
20141229.104645,2913,20,1144648,20,2912,150,2913,445,1
20141229.104646,2912,2,1144650,0,2912,270,2913,448,0
20141229.104648,2913,2,1144652,2,2912,273,2913,448,1
20141229.104648,2912,4,1144656,4,2912,275,2913,444,0
20141229.104651,2912,1004,1145660,452,2912,273,2913,447,0
20141229.104652,2912,332,1145992,-322,2912,108,2913,449,0
20141229.104653,2912,216,1146208,2,2911,667,2912,152,0
20141229.104653,2912,2,1146210,0,2911,607,2912,151,0
20141229.104654,2912,12,1146222,0,2911,618,2912,147,0
20141229.104659,2912,60,1146282,-10,2911,628,2912,127,0
20141229.1047,2912,2,1146284,0,2911,692,2912,126,0
20141229.104703,2912,8,1146292,-8,2911,692,2912,122,0
20141229.104706,2912,244,1146536,16,2912,180,2913,645,0
20141229.104707,2912,6,1146542,0,2912,229,2913,487,0
20141229.104708,2913,12,1146554,2,2912,247,2913,481,1
20141229.104709,2913,40,1146594,34,2912,247,2913,462,1
20141229.10471,2912,2,1146596,2,2912,247,2913,462,0
20141229.104714,2912,22,1146618,20,2912,262,2913,474,0
20141229.104715,2912,2,1146620,2,2912,245,2913,474,0
20141229.104717,2912,10,1146630,0,2912,237,2913,475,0
20141229.104717,2912,10,1146640,10,2912,232,2913,475,0
20141229.104724,2913,4,1146644,4,2912,243,2913,481,1
20141229.104725,2913,20,1146664,18,2912,347,2913,471,1
20141229.104725,2912,2,1146666,2,2912,347,2913,488,0
20141229.104728,2912,20,1146686,0,2912,237,2913,488,0
20141229.104729,2912,20,1146706,20,2912,227,2913,490,0
20141229.10473,2913,22,1146728,0,2912,227,2913,477,1
20141229.104735,2913,4,1146732,-4,2912,237,2913,461,1
20141229.104739,2913,10,1146742,-10,2912,264,2913,477,1
20141229.10474,2913,10,1146752,-10,2912,268,2913,472,1
20141229.104745,2913,10,1146762,-10,2912,271,2913,489,1
20141229.104746,2913,2,1146764,0,2912,271,2913,488,1
20141229.104749,2913,2,1146766,2,2912,260,2913,489,1
20141229.104751,2912,16,1146782,0,2912,252,2913,488,0
20141229.104755,2912,200,1146982,0,2912,158,2913,488,0
20141229.104756,2912,6,1146988,0,2912,153,2913,488,0
20141229.104757,2913,4,1146992,4,2912,153,2913,486,1
20141229.104758,2913,2,1146994,2,2912,169,2913,470,1
20141229.1048,2913,2,1146996,0,2912,169,2913,469,1
20141229.1048,2913,20,1147016,20,2912,169,2913,459,1
20141229.104801,2913,2,1147018,0,2912,169,2913,458,1
20141229.104802,2912,2,1147020,0,2912,168,2913,458,0
20141229.104806,2912,14,1147034,14,2912,162,2913,462,0
20141229.104807,2913,2,1147036,0,2912,162,2913,462,1
20141229.104811,2912,8,1147044,4,2912,164,2913,462,0
20141229.104812,2913,4,1147048,4,2912,164,2913,460,1
20141229.104818,2912,10,1147058,0,2912,203,2913,460,0
20141229.104819,2913,2,1147060,2,2912,217,2913,459,1
20141229.104821,2913,4,1147064,4,2912,215,2913,550,1
20141229.104822,2913,2,1147066,2,2912,235,2913,553,1
20141229.104827,2913,2,1147068,2,2912,200,2913,559,1
20141229.104833,2913,2,1147070,0,2912,236,2913,559,1
20141229.104834,2913,100,1147170,100,2912,236,2913,509,1
20141229.104837,2913,2,1147172,2,2912,232,2913,508,1
20141229.104837,2912,2,1147174,0,2912,231,2913,508,0
20141229.104844,2912,2,1147176,2,2912,351,2913,518,0
20141229.104845,2913,30,1147206,0,2912,351,2913,508,1
20141229.104846,2913,100,1147306,98,2912,351,2913,458,1
20141229.104846,2913,2,1147308,0,2912,363,2913,446,1
20141229.104848,2912,6,1147314,0,2912,363,2913,450,0
20141229.104848,2913,200,1147514,112,2912,379,2913,354,1
20141229.104849,2913,480,1147994,208,2912,378,2913,115,1
20141229.10485,2913,232,1148226,182,2913,251,2914,508,1
20141229.104853,2914,8,1148234,4,2913,297,2914,430,1
20141229.104853,2914,326,1148560,298,2913,296,2914,282,1
20141229.104854,2914,164,1148724,134,2913,295,2914,276,1
20141229.104854,2913,240,1148964,-2,2913,176,2914,337,0
20141229.104855,2914,2,1148966,-2,2913,165,2914,338,1
20141229.104855,2914,34,1149000,18,2913,255,2914,321,1
20141229.104856,2914,4,1149004,2,2913,269,2914,320,1
20141229.104857,2913,2,1149006,2,2913,270,2914,320,0
20141229.104857,2914,2,1149008,2,2913,270,2914,322,1
20141229.104858,2914,2,1149010,0,2913,270,2914,321,1
20141229.104859,2914,26,1149036,22,2913,278,2914,312,1
20141229.1049,2914,2,1149038,2,2913,267,2914,347,1
20141229.104901,2914,4,1149042,4,2913,267,2914,338,1
20141229.104902,2913,2,1149044,2,2913,208,2914,338,0
20141229.104902,2913,14,1149058,2,2913,228,2914,336,0
20141229.104903,2913,4,1149062,2,2913,252,2914,341,0
20141229.104904,2914,6,1149068,6,2913,302,2914,342,1
20141229.104906,2914,8,1149076,-2,2913,304,2914,325,1
20141229.104907,2913,2,1149078,2,2913,316,2914,319,0
20141229.104908,2914,4,1149082,4,2913,316,2914,319,1
20141229.104909,2914,6,1149088,2,2913,337,2914,317,1
20141229.10491,2913,6,1149094,0,2913,437,2914,309,0
20141229.104911,2914,2,1149096,0,2913,436,2914,309,1
20141229.104912,2914,2,1149098,2,2913,442,2914,326,1
20141229.104912,2914,12,1149110,4,2913,443,2914,320,1
20141229.104913,2914,4,1149114,-2,2913,444,2914,318,1
20141229.104914,2914,14,1149128,-2,2913,439,2914,315,1
20141229.104918,2914,40,1149168,-40,2913,467,2914,399,1
20141229.104922,2914,4,1149172,0,2913,579,2914,412,1
20141229.104922,2914,2,1149174,0,2913,579,2914,412,1
20141229.104923,2914,2,1149176,0,2913,579,2914,411,1
20141229.104923,2913,6,1149182,6,2913,597,2914,411,0
20141229.104924,2914,402,1149584,-360,2913,583,2914,210,1
20141229.104924,2914,2,1149586,-2,2913,589,2914,209,1
20141229.104925,2914,4,1149590,0,2913,580,2914,208,1
20141229.104926,2914,2,1149592,-2,2913,580,2914,208,1
20141229.104926,2914,8,1149600,-8,2913,591,2914,204,1
20141229.104928,2914,2,1149602,0,2913,653,2914,205,1
20141229.10493,2914,10,1149612,-4,2913,682,2914,201,1
20141229.104932,2914,20,1149632,0,2913,739,2914,193,1
20141229.104932,2914,10,1149642,-2,2913,739,2914,189,1
20141229.104933,2914,4,1149646,0,2913,439,2914,187,1
20141229.104933,2914,44,1149690,-22,2913,741,2914,166,1
20141229.104934,2914,2,1149692,2,2913,741,2914,165,1
20141229.104934,2914,14,1149706,8,2913,760,2914,160,1
20141229.104935,2914,2,1149708,0,2913,760,2914,159,1
20141229.104936,2914,4,1149712,-2,2913,760,2914,158,1
20141229.104937,2914,2,1149714,0,2913,760,2914,158,1
20141229.104937,2914,34,1149748,-12,2913,765,2914,143,1
20141229.104938,2914,350,1150098,-78,2913,715,2914,18,1
20141229.104939,2914,48,1150146,-38,2914,321,2915,700,1
20141229.10494,2914,2,1150148,-2,2914,349,2915,700,1
20141229.10494,2914,6,1150154,-6,2914,372,2915,701,1
20141229.104942,2914,2,1150156,0,2914,374,2915,704,1
20141229.104943,2914,4,1150160,0,2914,372,2915,703,1
20141229.104945,2915,20,1150180,0,2914,383,2915,696,1
20141229.104946,2915,4,1150184,4,2914,384,2915,694,1
20141229.104946,2915,24,1150208,0,2914,384,2915,686,1
20141229.104947,2915,4,1150212,2,2914,387,2915,682,1
20141229.104947,2915,4,1150216,0,2914,390,2915,679,1
20141229.104948,2915,6,1150222,4,2914,402,2915,676,1
20141229.104949,2915,2,1150224,2,2914,402,2915,675,1
20141229.104949,2914,88,1150312,-80,2914,362,2915,673,0
20141229.10495,2915,2,1150314,2,2914,363,2915,672,1
20141229.104951,2915,2,1150316,0,2914,394,2915,672,1
20141229.104954,2915,4,1150320,2,2914,458,2915,681,1
20141229.104955,2915,4,1150324,4,2914,458,2915,679,1
20141229.104956,2915,20,1150344,8,2914,458,2915,689,1
20141229.104957,2915,12,1150356,10,2914,458,2915,683,1
20141229.104957,2915,2,1150358,0,2914,458,2915,688,1
20141229.104959,2915,10,1150368,10,2914,329,2915,684,1
20141229.105,2915,12,1150380,0,2914,322,2915,678,1
20141229.105002,2915,2,1150382,2,2914,402,2915,676,1
20141229.105002,2915,202,1150584,194,2914,419,2915,578,1
20141229.105003,2914,2,1150586,2,2914,414,2915,579,0
20141229.105004,2915,2,1150588,2,2914,415,2915,578,1
20141229.105004,2915,2,1150590,2,2914,409,2915,578,1
20141229.105005,2915,24,1150614,24,2914,416,2915,566,1
20141229.105005,2915,20,1150634,20,2914,416,2915,556,1
20141229.105007,2915,2,1150636,0,2914,431,2915,557,1
20141229.105007,2915,12,1150648,2,2914,431,2915,551,1
20141229.10501,2915,2,1150650,0,2914,428,2915,563,1
20141229.105011,2915,16,1150666,-8,2914,428,2915,555,1
20141229.105013,2914,4,1150670,4,2914,448,2915,572,0
20141229.105014,2914,2,1150672,2,2914,452,2915,572,0
20141229.105015,2914,6,1150678,-6,2914,438,2915,575,0
20141229.105016,2914,4,1150682,-4,2914,436,2915,585,0
20141229.105017,2914,2,1150684,0,2914,436,2915,585,0
20141229.105017,2915,6,1150690,0,2914,436,2915,582,1
20141229.105018,2915,2,1150692,0,2914,454,2915,581,1
20141229.105019,2914,4,1150696,-4,2914,452,2915,595,0
20141229.105019,2915,22,1150718,0,2914,452,2915,584,1
20141229.10502,2915,2,1150720,-2,2914,452,2915,584,1
20141229.105021,2914,2,1150722,-2,2914,453,2915,595,0
20141229.105021,2915,32,1150754,4,2914,451,2915,581,1
20141229.105022,2915,6,1150760,-6,2914,451,2915,578,1
20141229.105022,2914,20,1150780,0,2914,440,2915,577,0
20141229.105023,2915,2,1150782,0,2914,450,2915,582,1
20141229.105024,2915,4,1150786,0,2914,450,2915,581,1
20141229.105026,2915,2,1150788,0,2914,489,2915,587,1
20141229.105026,2914,22,1150810,10,2914,483,2915,579,0
20141229.105027,2915,2,1150812,0,2914,489,2915,580,1
20141229.105028,2915,2,1150814,2,2914,485,2915,579,1
20141229.105029,2914,2,1150816,-2,2914,483,2915,588,0
20141229.10503,2915,100,1150916,100,2914,479,2915,538,1
20141229.105031,2915,102,1151018,100,2914,479,2915,497,1
20141229.105032,2915,106,1151124,88,2914,473,2915,445,1
20141229.105033,2915,2,1151126,2,2914,473,2915,444,1
20141229.105034,2915,10,1151136,-6,2914,473,2915,431,1
20141229.105035,2915,24,1151160,-18,2914,461,2915,422,1
20141229.105035,2915,2,1151162,0,2914,461,2915,423,1
20141229.105036,2915,10,1151172,-8,2914,461,2915,418,1
20141229.105036,2915,28,1151200,2,2914,461,2915,404,1
20141229.105037,2915,20,1151220,0,2914,462,2915,398,1
20141229.105037,2915,2,1151222,-2,2914,460,2915,397,1
20141229.105038,2915,8,1151230,-2,2914,470,2915,393,1
20141229.105038,2915,22,1151252,-16,2914,470,2915,382,1
20141229.105039,2914,20,1151272,0,2914,456,2915,382,0
20141229.10504,2915,2,1151274,0,2914,410,2915,381,1
20141229.105041,2915,24,1151298,-4,2914,410,2915,370,1
20141229.105042,2915,2,1151300,-2,2914,410,2915,369,1
20141229.105042,2915,40,1151340,-8,2914,410,2915,349,1
20141229.105043,2915,2,1151342,-2,2914,410,2915,348,1
20141229.105043,2915,100,1151442,-10,2914,408,2915,298,1
20141229.105044,2915,6,1151448,0,2914,850,2915,295,1
20141229.105046,2915,122,1151570,20,2914,889,2915,234,1
20141229.105046,2915,400,1151970,270,2914,889,2915,34,1
20141229.105047,2915,68,1152038,-32,2915,238,2916,811,1
20141229.105047,2915,20,1152058,0,2915,262,2916,815,1
20141229.105048,2915,96,1152154,-96,2915,310,2916,762,1
20141229.105048,2915,2,1152156,-2,2915,430,2916,687,1
20141229.10505,2915,22,1152178,-22,2915,430,2916,628,1
20141229.105052,2915,2,1152180,0,2915,437,2916,627,1
20141229.105053,2916,4,1152184,0,2915,435,2916,648,1
20141229.105053,2916,10,1152194,-2,2915,436,2916,649,1
20141229.105054,2916,24,1152218,4,2915,436,2916,637,1
20141229.105055,2915,4,1152222,0,2915,639,2916,638,0
20141229.105056,2916,58,1152280,2,2915,613,2916,642,1
20141229.105056,2916,22,1152302,-2,2915,611,2916,647,1
20141229.105057,2916,6,1152308,2,2915,659,2916,645,1
20141229.105057,2916,4,1152312,0,2915,710,2916,643,1
20141229.105058,2916,24,1152336,-2,2915,760,2916,639,1
20141229.105058,2915,2,1152338,0,2915,809,2916,639,0
20141229.105059,2915,2,1152340,0,2915,809,2916,640,0
20141229.1051,2916,4,1152344,0,2915,807,2916,648,1
20141229.1051,2915,12,1152356,2,2915,801,2916,651,0
20141229.105101,2916,2,1152358,2,2915,800,2916,650,1
20141229.105102,2915,6,1152364,0,2915,808,2916,664,0
20141229.105103,2916,100,1152464,76,2915,807,2916,615,1
20141229.105104,2916,2,1152466,2,2915,826,2916,612,1
20141229.105104,2916,10,1152476,-6,2915,821,2916,613,1
20141229.105105,2915,200,1152676,0,2915,720,2916,614,0
20141229.105106,2916,14,1152690,0,2915,718,2916,607,1
20141229.105107,2916,6,1152696,-4,2915,717,2916,610,1
20141229.105107,2916,100,1152796,32,2915,717,2916,659,1
20141229.105108,2916,90,1152886,0,2915,736,2916,615,1
20141229.105109,2916,4,1152890,0,2915,743,2916,512,1
20141229.10511,2915,24,1152914,16,2915,730,2916,512,0
20141229.105111,2916,110,1153024,44,2915,731,2916,457,1
20141229.105111,2916,2,1153026,2,2915,735,2916,456,1
20141229.105111,2916,20,1153046,8,2915,735,2916,446,1
20141229.105112,2916,4,1153050,4,2915,729,2916,536,1
20141229.105113,2916,2,1153052,2,2915,731,2916,537,1
20141229.105113,2916,156,1153208,126,2915,731,2916,459,1
20141229.105113,2916,404,1153612,336,2915,738,2916,257,1
20141229.105114,2916,32,1153644,28,2915,733,2916,243,1
20141229.105114,2916,306,1153950,150,2916,864,2917,1443,1
20141229.105115,2917,252,1154202,-228,2916,109,2917,1318,1
20141229.105115,2917,260,1154462,-8,2915,814,2916,4,1
20141229.105116,2916,184,1154646,-36,2915,661,2916,265,0
20141229.105116,2915,90,1154736,-78,2915,671,2916,387,0
20141229.105117,2916,52,1154788,-22,2915,666,2916,516,1
20141229.105118,2916,604,1155392,-600,2915,665,2916,214,1
20141229.105118,2917,612,1156004,474,2916,94,2917,1176,1
20141229.105118,2916,6,1156010,6,2916,91,2917,1176,0
20141229.105119,2915,186,1156196,184,2915,422,2916,102,0
20141229.105119,2916,30,1156226,-28,2915,317,2916,138,1
20141229.10512,2916,6,1156232,-6,2915,260,2916,323,1
20141229.105121,2916,12,1156244,-12,2915,201,2916,343,1
20141229.105121,2916,10,1156254,-10,2915,143,2916,404,1
20141229.105121,2916,104,1156358,0,2915,175,2916,365,1
20141229.105122,2916,6,1156364,0,2915,175,2916,386,1
20141229.105122,2915,24,1156388,4,2915,150,2916,637,0
20141229.105123,2916,34,1156422,-2,2915,166,2916,643,1
20141229.105124,2916,26,1156448,22,2915,172,2916,630,1
20141229.105124,2916,12,1156460,6,2915,178,2916,630,1
20141229.105125,2916,2,1156462,2,2915,180,2916,629,1
20141229.105125,2916,4,1156466,4,2915,179,2916,626,1
20141229.105126,2915,216,1156682,-22,2915,90,2916,649,0
20141229.105126,2915,184,1156866,146,2914,429,2915,248,0
20141229.105127,2915,10,1156876,-2,2914,418,2915,250,0
20141229.105128,2915,8,1156884,-2,2914,366,2915,249,0
20141229.105129,2914,4,1156888,0,2914,364,2915,255,0
20141229.10513,2915,6,1156894,0,2914,438,2915,357,1
20141229.105131,2915,6,1156900,0,2914,439,2915,355,1
20141229.105131,2915,2,1156902,0,2914,449,2915,352,1
20141229.105133,2915,6,1156908,0,2914,468,2915,348,1
20141229.105134,2914,778,1157686,-546,2913,511,2914,173,0
20141229.105134,2914,10,1157696,0,2913,454,2914,224,0
20141229.105135,2914,60,1157756,-36,2913,452,2914,196,0
20141229.105135,2913,20,1157776,0,2913,452,2914,191,0
20141229.105136,2914,6,1157782,-4,2913,451,2914,188,1
20141229.105137,2914,2,1157784,0,2913,474,2914,184,1
20141229.105137,2914,6,1157790,-6,2913,476,2914,181,1
20141229.105138,2914,6,1157796,-2,2913,515,2914,179,1
20141229.105138,2914,50,1157846,-30,2913,521,2914,154,1
20141229.105139,2913,14,1157860,14,2913,486,2914,146,0
20141229.105139,2913,12,1157872,0,2913,481,2914,149,0
20141229.10514,2914,8,1157880,2,2913,481,2914,146,1
20141229.105141,2913,6,1157886,0,2913,479,2914,185,0
20141229.105145,2914,2,1157888,0,2913,513,2914,230,1
20141229.105147,2914,20,1157908,0,2913,520,2914,221,1
20141229.105148,2914,20,1157928,0,2913,512,2914,220,1
20141229.105151,2913,16,1157944,0,2913,504,2914,235,0
20141229.105152,2913,2,1157946,2,2913,497,2914,266,0
20141229.105153,2914,4,1157950,0,2913,500,2914,284,1
20141229.105154,2913,6,1157956,0,2913,494,2914,282,0
20141229.105155,2914,2,1157958,-2,2913,497,2914,281,1
20141229.105156,2914,4,1157962,2,2913,476,2914,295,1
20141229.105158,2914,4,1157966,0,2913,465,2914,354,1
20141229.1052,2913,2,1157968,0,2913,448,2914,350,0
20141229.105202,2914,2,1157970,0,2913,449,2914,351,1
20141229.105206,2913,2,1157972,2,2913,461,2914,355,0
20141229.105207,2913,2,1157974,2,2913,468,2914,352,0
20141229.105208,2914,20,1157994,0,2913,468,2914,309,1
20141229.105209,2913,20,1158014,0,2913,458,2914,313,0
20141229.10521,2914,2,1158016,0,2913,458,2914,412,1
20141229.10521,2914,2,1158018,-2,2913,463,2914,411,1
20141229.105213,2914,10,1158028,0,2913,475,2914,407,1
20141229.105214,2913,2,1158030,2,2913,435,2914,408,0
20141229.105216,2913,4,1158034,0,2913,443,2914,414,0
20141229.10522,2914,182,1158216,-160,2913,433,2914,309,1
20141229.105222,2913,2,1158218,-2,2913,432,2914,300,0
20141229.105224,2913,8,1158226,0,2913,446,2914,307,0
20141229.105226,2914,4,1158230,4,2913,429,2914,310,1
20141229.105227,2913,4,1158234,-4,2913,439,2914,309,0
20141229.105227,2913,10,1158244,-10,2913,435,2914,310,0
20141229.105229,2913,4,1158248,0,2913,433,2914,361,0
20141229.10523,2913,6,1158254,0,2913,455,2914,361,0
20141229.105233,2914,2,1158256,2,2913,455,2914,361,1
20141229.105234,2914,20,1158276,20,2913,455,2914,366,1
20141229.105238,2913,2,1158278,2,2913,454,2914,368,0
20141229.105242,2914,2,1158280,2,2913,454,2914,388,1
20141229.105242,2913,6,1158286,0,2913,451,2914,388,0
20141229.105246,2914,10,1158296,10,2913,450,2914,376,1
20141229.105247,2913,2,1158298,-2,2913,449,2914,365,0
20141229.105248,2913,900,1159198,-476,2912,614,2913,169,0
20141229.10525,2912,56,1159254,30,2912,589,2913,188,0
20141229.105251,2912,6,1159260,0,2912,586,2913,345,0
20141229.105252,2912,2,1159262,2,2912,598,2913,362,0
20141229.105253,2912,2,1159264,2,2912,597,2913,362,0
20141229.105254,2913,2,1159266,-2,2912,590,2913,411,1
20141229.105255,2913,2,1159268,0,2912,587,2913,411,1
20141229.105256,2912,22,1159290,0,2912,570,2913,411,0
20141229.105256,2912,2,1159292,0,2912,567,2913,411,0
20141229.105257,2913,2,1159294,-2,2912,567,2913,410,1
20141229.105258,2913,2,1159296,0,2912,557,2913,409,1
20141229.105303,2912,2,1159298,0,2912,551,2913,435,0
20141229.105304,2912,4,1159302,0,2912,548,2913,437,0
20141229.105305,2912,2,1159304,2,2912,547,2913,437,0
20141229.105306,2912,22,1159326,-12,2912,541,2913,462,0
20141229.105307,2912,4,1159330,0,2912,538,2913,462,0
20141229.105309,2912,8,1159338,0,2912,539,2913,465,0
20141229.105309,2912,8,1159346,8,2912,533,2913,465,0
20141229.105313,2912,6,1159352,2,2912,397,2913,485,0
20141229.105314,2912,2,1159354,-2,2912,401,2913,485,0
20141229.105315,2912,262,1159616,4,2912,271,2913,486,0
20141229.105315,2912,546,1160162,6,2911,997,2912,26,0
20141229.105316,2912,2,1160164,0,2911,887,2912,224,0
20141229.105317,2911,102,1160266,-80,2911,828,2912,240,0
20141229.105317,2911,20,1160286,-20,2911,818,2912,240,0
20141229.105318,2911,4,1160290,-4,2911,1816,2912,251,0
20141229.105318,2911,2,1160292,-2,2911,4802,2912,248,0
20141229.105319,2913,472,1160764,380,2912,30,2913,501,1
20141229.105319,2912,2,1160766,-2,2912,29,2913,432,0
20141229.10532,2912,72,1160838,8,2911,4795,2912,972,0
20141229.10532,2912,2,1160840,2,2911,4800,2912,972,0
20141229.105321,2912,2,1160842,2,2911,4800,2912,971,0
20141229.105321,2912,12,1160854,6,2912,1,2913,297,0
20141229.105322,2912,210,1161064,-100,2911,906,2912,2,0
20141229.105323,2912,100,1161164,-48,2911,752,2912,104,0
20141229.105323,2912,6,1161170,0,2911,767,2912,111,0
20141229.105324,2912,2,1161172,2,2911,767,2912,149,0
20141229.105324,2912,2,1161174,0,2911,767,2912,148,0
20141229.105325,2912,100,1161274,100,2911,766,2912,201,0
20141229.105327,2912,4,1161278,0,2911,745,2912,359,0
20141229.105328,2911,2,1161280,-2,2911,755,2912,378,0
20141229.105329,2912,4,1161284,2,2911,749,2912,376,1
20141229.10533,2912,2,1161286,2,2911,749,2912,386,1
20141229.105331,2911,60,1161346,20,2911,670,2912,386,0
20141229.105331,2912,4,1161350,0,2911,671,2912,384,1
20141229.105333,2912,4,1161354,4,2911,673,2912,382,1
20141229.105334,2911,2,1161356,0,2911,707,2912,382,0
20141229.105335,2912,2,1161358,0,2911,701,2912,381,1
20141229.105336,2912,4,1161362,0,2911,526,2912,379,1
20141229.105336,2912,4,1161366,0,2911,505,2912,380,1
20141229.105344,2912,2,1161368,0,2911,531,2912,399,1
20141229.105344,2912,2,1161370,2,2911,530,2912,402,1
20141229.105345,2911,2,1161372,0,2911,535,2912,402,0
20141229.105345,2911,40,1161412,0,2911,515,2912,403,0
20141229.105351,2911,4,1161416,-2,2911,497,2912,503,0
20141229.105352,2912,32,1161448,16,2911,508,2912,509,1
20141229.105354,2911,10,1161458,10,2911,503,2912,479,0
20141229.105356,2912,2,1161460,0,2911,501,2912,510,1
20141229.105356,2912,2,1161462,2,2911,491,2912,509,1
20141229.105357,2912,4,1161466,0,2911,491,2912,512,1
20141229.105357,2912,2,1161468,2,2911,486,2912,544,1
20141229.105358,2911,76,1161544,-28,2911,448,2912,544,0
20141229.105359,2912,40,1161584,-24,2911,448,2912,528,1
20141229.105401,2911,22,1161606,-22,2911,432,2912,529,0
20141229.105402,2912,2,1161608,0,2911,432,2912,528,1
20141229.105404,2911,20,1161628,-14,2911,427,2912,573,0
20141229.105405,2912,2,1161630,0,2911,427,2912,570,1
20141229.105405,2912,10,1161640,2,2911,436,2912,565,1
20141229.105406,2911,2,1161642,0,2911,436,2912,565,0
20141229.105407,2911,2,1161644,-2,2911,437,2912,566,0
20141229.105408,2912,2,1161646,-2,2911,446,2912,568,1
20141229.105411,2912,2,1161648,0,2911,446,2912,572,1
20141229.105412,2911,2,1161650,0,2911,441,2912,567,0
20141229.105413,2911,2,1161652,0,2911,441,2912,567,0
20141229.105413,2911,2,1161654,-2,2911,440,2912,611,0
20141229.105414,2912,40,1161694,-40,2911,438,2912,591,1
20141229.105414,2911,4,1161698,0,2911,439,2912,591,0
20141229.105417,2911,6,1161704,-6,2911,480,2912,595,0
20141229.105418,2911,2,1161706,0,2911,478,2912,594,0
20141229.105419,2911,2,1161708,0,2911,501,2912,577,0
20141229.105422,2911,4,1161712,0,2911,549,2912,541,0
20141229.105423,2911,20,1161732,0,2911,537,2912,542,0
20141229.105425,2911,20,1161752,0,2911,527,2912,542,0
20141229.105428,2912,6,1161758,0,2911,540,2912,539,1
20141229.105431,2912,2,1161760,0,2911,555,2912,569,1
20141229.105433,2912,20,1161780,0,2911,586,2912,569,1
20141229.105434,2912,2,1161782,-2,2911,590,2912,568,1
20141229.105436,2912,12,1161794,-12,2911,638,2912,532,1
20141229.105436,2912,10,1161804,0,2911,638,2912,527,1
20141229.105437,2911,6,1161810,-6,2911,625,2912,523,0
20141229.105438,2911,4,1161814,0,2911,625,2912,523,0
20141229.105439,2912,22,1161836,6,2911,621,2912,521,1
20141229.10544,2912,2,1161838,0,2911,621,2912,520,1
20141229.10544,2911,62,1161900,-30,2911,605,2912,510,0
20141229.105441,2911,20,1161920,-2,2911,595,2912,510,0
20141229.105441,2912,2,1161922,0,2911,646,2912,509,1
20141229.105443,2912,10,1161932,-10,2911,647,2912,510,1
20141229.105444,2911,2,1161934,2,2911,647,2912,511,0
20141229.105445,2912,10,1161944,0,2911,647,2912,506,1
20141229.105446,2911,36,1161980,6,2911,631,2912,549,0
20141229.10545,2911,2,1161982,0,2911,642,2912,573,0
20141229.105452,2912,2,1161984,0,2911,642,2912,593,1
20141229.105454,2911,26,1162010,-26,2911,624,2912,593,0
20141229.105455,2911,4,1162014,0,2911,589,2912,594,0
20141229.105456,2911,2,1162016,0,2911,595,2912,604,0
20141229.1055,2911,4,1162020,-4,2911,576,2912,489,0
20141229.105501,2912,2,1162022,0,2911,596,2912,488,1
20141229.105501,2912,8,1162030,-8,2911,596,2912,489,1
20141229.105502,2912,2,1162032,-2,2911,596,2912,488,1
20141229.105504,2911,12,1162044,0,2911,592,2912,482,0
20141229.105506,2912,2,1162046,-2,2911,626,2912,481,1
20141229.105509,2911,2,1162048,-2,2911,624,2912,481,0
20141229.105509,2912,2,1162050,0,2911,619,2912,480,1
20141229.105511,2911,6,1162056,-6,2911,616,2912,480,0
20141229.105517,2912,10,1162066,-10,2911,609,2912,487,1
20141229.105519,2912,2,1162068,0,2911,609,2912,491,1
20141229.105523,2911,12,1162080,-12,2911,585,2912,582,0
20141229.105524,2911,20,1162100,-14,2911,574,2912,582,0
20141229.105526,2911,2,1162102,-2,2911,576,2912,598,0
20141229.10553,2912,4,1162106,0,2911,590,2912,619,1
20141229.105532,2912,16,1162122,0,2911,2648,2912,601,1
20141229.105533,2912,502,1162624,-100,2912,307,2913,365,1
20141229.105533,2912,2,1162626,0,2912,349,2913,300,1
20141229.105534,2912,2,1162628,-2,2912,438,2913,297,1
20141229.105535,2913,4,1162632,0,2912,440,2913,295,1
20141229.105537,2912,2,1162634,0,2912,401,2913,328,0
20141229.105538,2913,2,1162636,2,2912,326,2913,327,1
20141229.105542,2912,2,1162638,0,2912,342,2913,359,0
20141229.105544,2912,4,1162642,-2,2912,337,2913,358,0
20141229.105545,2913,4,1162646,0,2912,334,2913,357,1
20141229.105546,2913,92,1162738,92,2912,336,2913,311,1
20141229.105547,2913,2,1162740,0,2912,336,2913,313,1
20141229.10555,2913,4,1162744,2,2912,338,2913,452,1
20141229.105551,2912,12,1162756,-2,2912,342,2913,453,0
20141229.105553,2912,2,1162758,0,2912,342,2913,3465,0
20141229.105553,2912,688,1163446,-458,2911,2721,2912,123,0
20141229.105554,2912,262,1163708,-50,2911,2737,2912,1,0
20141229.105555,2912,180,1163888,4,2912,49,2913,487,0
20141229.105555,2912,34,1163922,2,2912,189,2913,496,0
20141229.105556,2912,6,1163928,0,2912,186,2913,646,0
20141229.105556,2912,6,1163934,6,2912,183,2913,646,0
20141229.105557,2913,2,1163936,2,2912,183,2913,645,1
20141229.105557,2912,2,1163938,0,2912,185,2913,646,0
20141229.105559,2912,4,1163942,4,2912,248,2913,649,0
20141229.1056,2913,2,1163944,0,2912,284,2913,649,1
20141229.105601,2913,2,1163946,2,2912,285,2913,616,1
20141229.105602,2912,2,1163948,0,2912,362,2913,638,0
20141229.105605,2912,2,1163950,0,2912,374,2913,657,0
20141229.105606,2912,8,1163958,4,2912,370,2913,657,0
20141229.105609,2912,24,1163982,4,2912,359,2913,666,0
20141229.10561,2913,2,1163984,2,2912,359,2913,665,1
20141229.105612,2912,20,1164004,18,2912,349,2913,675,0
20141229.105613,2912,2,1164006,2,2912,348,2913,673,0
20141229.105614,2912,14,1164020,0,2912,338,2913,673,0
20141229.105615,2913,2,1164022,0,2912,341,2913,672,1
20141229.105615,2912,4,1164026,0,2912,339,2913,672,0
20141229.105617,2912,2,1164028,0,2912,337,2913,672,0
20141229.105618,2912,2,1164030,0,2912,336,2913,673,0
20141229.105619,2912,444,1164474,408,2912,115,2913,713,0
20141229.105619,2912,230,1164704,-56,2911,2648,2912,133,0
20141229.105621,2912,2,1164706,2,2911,440,2912,288,0
20141229.105622,2912,4,1164710,2,2911,440,2912,415,0
20141229.105622,2911,6,1164716,-6,2911,437,2912,458,0
20141229.105632,2911,2,1164718,-2,2911,447,2912,478,0
20141229.105632,2912,54,1164772,-38,2911,437,2912,461,1
20141229.105632,2912,4,1164776,-4,2911,437,2912,459,1
20141229.105633,2912,2,1164778,-2,2911,452,2912,458,1
20141229.105634,2912,10,1164788,6,2911,449,2912,455,1
20141229.105634,2911,22,1164810,-14,2911,438,2912,455,0
20141229.105637,2912,8,1164818,-8,2911,435,2912,459,1
20141229.105637,2911,2,1164820,2,2911,424,2912,460,0
20141229.105641,2911,14,1164834,2,2911,419,2912,467,0
20141229.105641,2911,838,1165672,-114,2910,1093,2911,54,0
20141229.105642,2911,4,1165676,2,2910,950,2911,126,0
20141229.105643,2910,14,1165690,8,2910,885,2911,382,0
20141229.105643,2910,4,1165694,2,2910,878,2911,400,0
20141229.105644,2910,16,1165710,2,2910,868,2911,401,0
20141229.105644,2910,80,1165790,-78,2910,828,2911,421,0
20141229.105645,2910,20,1165810,-10,2910,819,2911,446,0
20141229.105645,2910,80,1165890,-76,2910,643,2911,670,0
20141229.105646,2910,20,1165910,0,2910,567,2911,741,0
20141229.105646,2910,20,1165930,-10,2910,556,2911,744,0
20141229.105647,2910,124,1166054,-78,2910,494,2911,898,0
20141229.105647,2910,26,1166080,0,2910,481,2911,898,0
20141229.105648,2910,152,1166232,-122,2910,411,2911,898,0
20141229.105648,2910,4,1166236,2,2910,409,2911,900,0
20141229.105649,2910,384,1166620,-234,2910,359,2911,676,0
20141229.10565,2911,108,1166728,-36,2910,331,2911,693,1
20141229.10565,2910,56,1166784,-10,2910,304,2911,693,0
20141229.105651,2910,174,1166958,-76,2910,238,2911,684,0
20141229.105652,2910,70,1167028,-4,2910,204,2911,684,0
20141229.105652,2910,14,1167042,12,2910,198,2911,687,0
20141229.105653,2910,4,1167046,2,2910,204,2911,687,0
20141229.105653,2910,62,1167108,-30,2910,204,2911,727,0
20141229.105654,2910,78,1167186,-52,2910,172,2911,734,0
20141229.105655,2910,24,1167210,-14,2910,163,2911,735,0
20141229.105655,2910,20,1167230,-18,2910,153,2911,773,0
20141229.105655,2910,18,1167248,0,2910,144,2911,774,0
20141229.105656,2910,14,1167262,-2,2910,172,2911,551,0
20141229.105656,2910,12,1167274,-4,2910,268,2911,549,0
20141229.105657,2910,126,1167400,0,2910,206,2911,539,0
20141229.105658,2910,2,1167402,0,2910,239,2911,540,0
20141229.105658,2910,90,1167492,-16,2910,195,2911,539,0
20141229.105659,2910,8,1167500,0,2910,205,2911,539,0
20141229.1057,2910,4,1167504,2,2910,256,2911,547,0
20141229.1057,2910,200,1167704,-72,2910,185,2911,552,0
20141229.105701,2910,40,1167744,40,2910,166,2911,547,0
20141229.105701,2910,20,1167764,12,2910,160,2911,544,0
20141229.105702,2910,26,1167790,6,2910,147,2911,541,0
20141229.105702,2910,10,1167800,10,2910,143,2911,541,0
20141229.105706,2910,74,1167874,-2,2910,115,2911,549,0
20141229.105707,2910,2,1167876,0,2910,182,2911,550,0
20141229.105708,2910,4,1167880,-2,2910,180,2911,552,0
20141229.105709,2910,6,1167886,-2,2910,180,2911,562,0
20141229.10571,2910,2,1167888,-2,2910,180,2911,562,0
20141229.10571,2910,2,1167890,0,2910,179,2911,564,0
20141229.105711,2910,10,1167900,-8,2910,174,2911,565,0
20141229.105711,2910,6,1167906,-4,2910,172,2911,565,0
20141229.105712,2910,4,1167910,0,2910,175,2911,566,0
20141229.105713,2910,14,1167924,-2,2910,168,2911,564,0
20141229.105714,2910,2,1167926,2,2910,259,2911,563,0
20141229.105714,2910,12,1167938,10,2910,253,2911,563,0
20141229.105715,2910,12,1167950,10,2910,269,2911,547,0
20141229.105718,2910,4,1167954,4,2910,268,2911,547,0
20141229.105719,2910,2,1167956,0,2910,268,2911,547,0
20141229.10572,2910,6,1167962,2,2910,280,2911,548,0
20141229.105721,2911,2,1167964,0,2910,285,2911,547,1
20141229.105721,2910,20,1167984,0,2910,275,2911,547,0
20141229.105722,2910,2,1167986,2,2910,274,2911,547,0
20141229.105723,2910,22,1168008,22,2910,268,2911,547,0
20141229.105724,2910,52,1168060,0,2910,245,2911,558,0
20141229.105725,2910,2,1168062,2,2910,244,2911,558,0
20141229.105725,2911,20,1168082,0,2910,244,2911,548,1
20141229.105726,2910,220,1168302,218,2910,246,2911,400,0
20141229.105727,2910,10,1168312,10,2910,253,2911,390,0
20141229.10573,2910,2,1168314,0,2910,327,2911,334,0
20141229.105731,2910,2,1168316,0,2910,327,2911,336,0
20141229.105731,2911,42,1168358,-30,2910,328,2911,324,1
20141229.105732,2911,2,1168360,0,2910,331,2911,344,1
20141229.105734,2911,8,1168368,4,2910,337,2911,341,1
20141229.105737,2911,4,1168372,4,2910,345,2911,342,1
20141229.105738,2911,6,1168378,0,2910,345,2911,342,1
20141229.105739,2910,4,1168382,0,2910,375,2911,340,0
20141229.10574,2910,12,1168394,4,2910,376,2911,341,0
20141229.10574,2910,8,1168402,4,2910,372,2911,341,0
20141229.105741,2910,2,1168404,0,2910,371,2911,342,0
20141229.105743,2911,10,1168414,8,2910,372,2911,338,1
20141229.105743,2910,4,1168418,4,2910,370,2911,337,0
20141229.105744,2911,40,1168458,-32,2910,375,2911,321,1
20141229.105745,2910,10,1168468,10,2910,370,2911,319,0
20141229.105746,2911,2,1168470,0,2910,369,2911,319,1
20141229.105747,2910,20,1168490,0,2910,362,2911,319,0
20141229.105748,2910,150,1168640,-138,2910,383,2911,249,0
20141229.105748,2911,2,1168642,0,2910,391,2911,238,1
20141229.105749,2911,2,1168644,0,2910,391,2911,241,1
20141229.105749,2911,2,1168646,0,2910,391,2911,240,1
20141229.10575,2910,2,1168648,0,2910,390,2911,240,0
20141229.10575,2910,6,1168654,6,2910,387,2911,241,0
20141229.105752,2911,32,1168686,-16,2910,387,2911,226,1
20141229.105752,2910,2,1168688,2,2910,386,2911,226,0
20141229.105753,2910,2,1168690,2,2910,385,2911,223,0
20141229.105755,2910,4,1168694,0,2910,383,2911,231,0
20141229.105756,2910,6,1168700,-2,2910,377,2911,231,0
20141229.105757,2910,20,1168720,0,2910,367,2911,250,0
20141229.105758,2910,10,1168730,10,2910,362,2911,250,0
20141229.105759,2910,8,1168738,0,2910,358,2911,263,0
20141229.105801,2910,8,1168746,0,2910,354,2911,247,0
20141229.105802,2910,2,1168748,2,2910,353,2911,247,0
20141229.105803,2911,2,1168750,0,2910,355,2911,249,1
20141229.105804,2910,8,1168758,0,2910,352,2911,266,0
20141229.105805,2910,208,1168966,-6,2910,248,2911,342,0
20141229.105806,2910,68,1169034,8,2910,210,2911,320,0
20141229.105807,2911,32,1169066,6,2910,213,2911,313,1
20141229.105811,2910,6,1169072,4,2910,234,2911,198,0
20141229.105812,2911,2,1169074,0,2910,236,2911,138,1
20141229.105813,2910,2,1169076,2,2910,240,2911,141,0
20141229.105814,2911,16,1169092,16,2910,238,2911,137,1
20141229.105815,2911,4,1169096,4,2910,259,2911,138,1
20141229.105817,2911,4,1169100,4,2910,272,2911,198,1
20141229.105818,2910,2,1169102,2,2910,272,2911,198,0
20141229.105819,2910,2,1169104,0,2910,305,2911,212,0
20141229.105819,2911,10,1169114,4,2910,305,2911,207,1
20141229.10582,2911,6,1169120,-6,2910,280,2911,204,1
20141229.10582,2910,2,1169122,2,2910,280,2911,229,0
20141229.105821,2911,6,1169128,0,2910,280,2911,228,1
20141229.105822,2911,16,1169144,-14,2910,281,2911,217,1
20141229.105823,2911,16,1169160,16,2910,281,2911,209,1
20141229.105823,2910,4,1169164,0,2910,279,2911,213,0
20141229.105824,2911,4,1169168,0,2910,295,2911,211,1
20141229.105826,2910,2,1169170,0,2910,336,2911,212,0
20141229.105827,2910,16,1169186,-4,2910,331,2911,210,0
20141229.105827,2910,4,1169190,0,2910,330,2911,210,0
20141229.105828,2910,2,1169192,2,2910,300,2911,213,0
20141229.105829,2911,2,1169194,0,2910,321,2911,212,1
20141229.10583,2910,4,1169198,4,2910,328,2911,212,0
20141229.105831,2910,2,1169200,2,2910,328,2911,212,0
20141229.105832,2911,2,1169202,-2,2910,334,2911,221,1
20141229.105832,2910,20,1169222,18,2910,351,2911,221,0
20141229.105837,2911,16,1169238,-6,2910,356,2911,217,1
20141229.105837,2911,16,1169254,16,2910,356,2911,209,1
20141229.105838,2911,20,1169274,20,2910,355,2911,200,1
20141229.10584,2910,10,1169284,6,2910,355,2911,202,0
20141229.105841,2911,8,1169292,2,2910,359,2911,198,1
20141229.105842,2910,2,1169294,0,2910,362,2911,198,0
20141229.105843,2910,42,1169336,-24,2910,366,2911,178,0
20141229.105844,2910,2,1169338,0,2910,365,2911,178,0
20141229.105845,2910,10,1169348,0,2910,366,2911,178,0
20141229.105846,2910,4,1169352,4,2910,366,2911,178,0
20141229.105846,2910,2,1169354,2,2910,365,2911,178,0
20141229.105847,2911,4,1169358,0,2910,364,2911,177,1
20141229.105848,2910,2,1169360,0,2910,362,2911,181,0
20141229.105848,2911,2,1169362,0,2910,361,2911,180,1
20141229.105849,2911,6,1169368,6,2910,361,2911,177,1
20141229.10585,2911,2,1169370,2,2910,361,2911,176,1
20141229.105853,2911,18,1169388,-2,2910,362,2911,172,1
20141229.105855,2910,8,1169396,-8,2910,353,2911,173,0
20141229.105856,2910,14,1169410,-10,2910,346,2911,173,0
20141229.105859,2910,2,1169412,0,2910,402,2911,173,0
20141229.105902,2911,8,1169420,2,2910,425,2911,167,1
20141229.105902,2911,2,1169422,0,2910,441,2911,165,1
20141229.105904,2910,4,1169426,-4,2910,436,2911,166,0
20141229.105905,2910,6,1169432,-6,2910,431,2911,168,0
20141229.105908,2911,2,1169434,0,2910,445,2911,169,1
20141229.105908,2910,14,1169448,-14,2910,438,2911,169,0
20141229.105909,2910,40,1169488,4,2910,421,2911,172,0
20141229.105912,2911,14,1169502,0,2910,405,2911,171,1
20141229.105914,2910,2,1169504,0,2910,363,2911,171,0
20141229.105914,2911,2,1169506,0,2910,365,2911,171,1
20141229.105915,2910,2,1169508,2,2910,365,2911,171,0
20141229.105917,2911,2,1169510,0,2910,381,2911,174,1
20141229.105919,2910,4,1169514,4,2910,378,2911,174,0
20141229.105919,2910,2,1169516,0,2910,377,2911,177,0
20141229.105923,2911,2,1169518,0,2910,496,2911,177,1
20141229.105926,2910,2,1169520,2,2910,530,2911,175,0
20141229.10593,2911,12,1169532,-10,2910,565,2911,169,1
20141229.105931,2911,346,1169878,-10,2911,2,2912,531,1
20141229.105932,2912,198,1170076,-74,2911,36,2912,445,1
20141229.105933,2911,2,1170078,0,2911,229,2912,395,0
20141229.105934,2911,4,1170082,-4,2911,258,2912,385,0
20141229.105937,2911,60,1170142,-12,2911,229,2912,370,0
20141229.105943,2912,2,1170144,0,2911,219,2912,963,1
20141229.105948,2911,2,1170146,2,2911,273,2912,780,0
20141229.105948,2911,2,1170148,0,2911,272,2912,780,0
20141229.105954,2912,4,1170152,-2,2911,301,2912,580,1
20141229.105959,2912,34,1170186,-34,2911,349,2912,562,1
20141229.11,2912,40,1170226,-8,2911,349,2912,543,1
20141229.11,2912,246,1170472,2,2911,349,2912,415,1
20141229.110001,2913,818,1171290,-312,2912,1,2913,1036,1
20141229.110001,2912,6,1171296,4,2912,108,2913,967,0
20141229.110002,2913,92,1171388,46,2912,123,2913,904,1
20141229.110003,2913,20,1171408,4,2912,136,2913,803,1
20141229.110003,2913,14,1171422,12,2912,205,2913,788,1
20141229.110004,2913,92,1171514,8,2912,192,2913,732,1
20141229.110004,2913,10,1171524,-2,2912,191,2913,743,1
20141229.110005,2913,18,1171542,4,2912,190,2913,735,1
20141229.110005,2913,8,1171550,-4,2912,191,2913,743,1
20141229.110007,2911,786,1172336,268,2911,428,2912,1,0
20141229.110007,2912,28,1172364,-12,2911,301,2912,214,1
20141229.110008,2912,34,1172398,0,2911,301,2912,201,1
20141229.11001,2912,40,1172438,-40,2911,245,2912,229,1
20141229.110012,2912,6,1172444,-2,2911,247,2912,229,1
20141229.110012,2912,2,1172446,-2,2911,267,2912,258,1
20141229.110013,2912,2,1172448,-2,2911,266,2912,257,1
20141229.110015,2912,2,1172450,-2,2911,270,2912,257,1
20141229.110016,2912,2,1172452,0,2911,270,2912,263,1
20141229.110017,2912,6,1172458,0,2911,270,2912,260,1
20141229.110018,2912,2,1172460,0,2911,270,2912,259,1
20141229.110019,2912,6,1172466,-6,2911,270,2912,256,1
20141229.11002,2912,4,1172470,0,2911,271,2912,255,1
20141229.110021,2912,12,1172482,-6,2911,272,2912,249,1
20141229.110022,2912,4,1172486,0,2911,278,2912,241,1
20141229.110025,2912,2,1172488,0,2911,383,2912,241,1
20141229.110027,2912,240,1172728,0,2911,397,2912,111,1
20141229.110027,2912,192,1172920,66,2912,102,2913,1048,1
20141229.110028,2913,2,1172922,-2,2912,132,2913,1017,1
20141229.11003,2913,24,1172946,-4,2912,143,2913,816,1
20141229.110031,2912,2,1172948,2,2912,143,2913,822,0
20141229.110031,2912,4,1172952,0,2912,142,2913,833,0
20141229.110033,2912,4,1172956,2,2912,140,2913,880,0
20141229.110034,2913,2,1172958,0,2912,137,2913,884,1
20141229.110035,2912,2,1172960,2,2912,144,2913,886,0
20141229.110036,2913,80,1173040,-40,2912,144,2913,846,1
20141229.110037,2912,8,1173048,8,2912,138,2913,847,0
20141229.110038,2913,2,1173050,0,2912,138,2913,845,1
20141229.110039,2913,84,1173134,0,2912,128,2913,888,1
20141229.11004,2913,2,1173136,0,2912,129,2913,879,1
20141229.11004,2913,2,1173138,0,2912,131,2913,868,1
20141229.110042,2912,2,1173140,0,2912,141,2913,890,0
20141229.110043,2913,4,1173144,-2,2912,146,2913,919,1
20141229.110044,2912,2,1173146,2,2912,145,2913,919,0
20141229.110046,2913,4,1173150,2,2912,187,2913,918,1
20141229.110048,2912,12,1173162,6,2912,181,2913,918,0
20141229.110048,2913,42,1173204,-18,2912,221,2913,898,1
20141229.11005,2913,6,1173210,4,2912,279,2913,896,1
20141229.110051,2912,2,1173212,2,2912,282,2913,866,0
20141229.110052,2912,2,1173214,0,2912,287,2913,857,0
20141229.110054,2912,2,1173216,0,2912,306,2913,847,0
20141229.110056,2912,2,1173218,2,2912,305,2913,842,0
20141229.110057,2912,2,1173220,2,2912,304,2913,848,0
20141229.1101,2912,4,1173224,4,2912,305,2913,770,0
20141229.110102,2913,4,1173228,4,2912,304,2913,769,1
20141229.110105,2912,12,1173240,2,2912,300,2913,759,0
20141229.110105,2913,6,1173246,6,2912,299,2913,757,1
20141229.110108,2912,2,1173248,0,2912,302,2913,759,0
20141229.110111,2912,664,1173912,426,2911,530,2912,213,0
20141229.110111,2912,6,1173918,6,2911,480,2912,210,0
20141229.110113,2912,24,1173942,24,2911,460,2912,220,0
20141229.110117,2912,12,1173954,12,2911,461,2912,236,0
20141229.110117,2912,2,1173956,2,2911,460,2912,235,0
20141229.110119,2912,2,1173958,2,2911,460,2912,239,0
20141229.110121,2912,12,1173970,12,2911,452,2912,233,0
20141229.110126,2912,2,1173972,2,2911,462,2912,259,0
20141229.110128,2912,2,1173974,2,2911,461,2912,259,0
20141229.110132,2912,2,1173976,2,2911,482,2912,258,0
20141229.110132,2912,2,1173978,2,2911,482,2912,257,0
20141229.110136,2911,2,1173980,0,2911,484,2912,254,0
20141229.11014,2912,2,1173982,2,2911,487,2912,253,1
20141229.110141,2911,10,1173992,-6,2911,483,2912,253,0
20141229.110141,2912,4,1173996,0,2911,483,2912,256,1
20141229.110147,2912,6,1174002,6,2911,414,2912,426,1
20141229.110149,2911,2,1174004,0,2911,415,2912,426,0
20141229.11015,2912,2,1174006,0,2911,416,2912,455,1
20141229.110155,2912,24,1174030,-16,2911,408,2912,474,1
20141229.110157,2911,24,1174054,-12,2911,397,2912,473,0
20141229.110158,2911,2,1174056,2,2911,396,2912,473,0
20141229.110204,2912,42,1174098,-2,2911,465,2912,491,1
20141229.110205,2911,2,1174100,0,2911,464,2912,493,0
20141229.110205,2911,4,1174104,-2,2911,462,2912,493,0
20141229.110209,2911,6,1174110,-6,2911,459,2912,548,0
20141229.110209,2911,2,1174112,0,2911,459,2912,548,0
20141229.11021,2911,2,1174114,0,2911,460,2912,550,0
20141229.110212,2912,2,1174116,0,2911,460,2912,580,1
20141229.110214,2911,2,1174118,2,2911,459,2912,579,0
20141229.110216,2912,146,1174264,-48,2911,469,2912,514,1
20141229.110219,2911,2,1174266,0,2911,478,2912,484,0
20141229.110219,2911,2,1174268,-2,2911,477,2912,484,0
20141229.110221,2912,2,1174270,0,2911,477,2912,485,1
20141229.110222,2912,6,1174276,0,2911,477,2912,482,1
20141229.110227,2912,2,1174278,0,2911,495,2912,471,1
20141229.110229,2911,44,1174322,-32,2911,521,2912,418,0
20141229.11023,2911,2,1174324,-2,2911,520,2912,418,0
20141229.11023,2911,2,1174326,0,2911,519,2912,418,0
20141229.110231,2911,28,1174354,-14,2911,506,2912,418,0
20141229.110231,2912,2,1174356,0,2911,506,2912,417,1
20141229.110234,2911,2,1174358,-2,2911,505,2912,418,0
20141229.110235,2911,2,1174360,0,2911,504,2912,418,0
20141229.110236,2912,20,1174380,-20,2911,499,2912,408,1
20141229.110238,2912,50,1174430,-50,2911,499,2912,385,1
20141229.11024,2911,20,1174450,0,2911,489,2912,385,0
20141229.11024,2912,10,1174460,-10,2911,490,2912,380,1
20141229.110244,2912,22,1174482,-12,2911,490,2912,362,1
20141229.110246,2911,100,1174582,-58,2911,441,2912,352,0
20141229.11025,2911,2,1174584,-2,2911,442,2912,352,0
20141229.110251,2911,186,1174770,-130,2911,461,2912,132,0
20141229.110251,2912,12,1174782,0,2911,501,2912,126,1
20141229.110252,2912,8,1174790,-8,2911,500,2912,122,1
20141229.110253,2912,2,1174792,0,2911,501,2912,121,1
20141229.110253,2912,242,1175034,-22,2911,568,2913,968,1
20141229.110254,2911,786,1175820,640,2911,378,2913,875,0
20141229.110254,2912,4,1175824,-2,2912,70,2913,885,1
20141229.110255,2912,300,1176124,-138,2911,199,2912,73,1
20141229.110255,2912,2,1176126,0,2911,274,2912,162,1
20141229.110256,2911,2,1176128,0,2911,273,2912,173,0
20141229.110256,2912,8,1176136,0,2911,273,2912,172,1
20141229.110257,2912,2,1176138,0,2911,274,2912,171,1
20141229.110258,2912,182,1176320,-80,2911,274,2912,91,1
20141229.110258,2912,8,1176328,0,2911,274,2912,88,1
20141229.110259,2911,100,1176428,-38,2911,210,2912,59,0
20141229.110301,2912,2,1176430,0,2911,228,2912,96,1
20141229.110302,2911,4,1176434,0,2911,225,2912,96,0
20141229.110307,2911,4,1176438,0,2911,210,2912,159,0
20141229.110313,2911,2,1176440,0,2911,149,2912,370,0
20141229.110315,2911,40,1176480,38,2911,129,2912,370,0
20141229.110317,2912,2,1176482,0,2911,132,2912,370,1
20141229.110321,2912,2,1176484,0,2911,135,2912,370,1
20141229.110322,2912,30,1176514,0,2911,136,2912,407,1
20141229.110328,2912,4,1176518,0,2911,198,2912,367,1
20141229.110331,2911,20,1176538,-20,2911,208,2912,365,0
20141229.110332,2911,8,1176546,-8,2911,214,2912,365,0
20141229.110333,2912,2,1176548,0,2911,202,2912,364,1
20141229.110337,2912,100,1176648,44,2911,234,2912,299,1
20141229.110337,2911,4,1176652,0,2911,242,2912,299,0
20141229.110338,2912,74,1176726,-32,2911,240,2912,264,1
20141229.110339,2912,2,1176728,0,2911,346,2912,264,1
20141229.11034,2912,2,1176730,0,2911,347,2912,264,1
20141229.110341,2911,4,1176734,-2,2911,344,2912,263,0
20141229.110342,2912,2,1176736,-2,2911,344,2912,263,1
20141229.110343,2912,2,1176738,-2,2911,344,2912,262,1
20141229.110344,2912,4,1176742,0,2911,332,2912,260,1
20141229.110344,2912,36,1176778,0,2911,332,2912,242,1
20141229.110346,2912,2,1176780,0,2911,336,2912,25,1
20141229.110346,2912,12,1176792,6,2911,356,2912,19,1
20141229.110347,2912,40,1176832,-4,2912,80,2913,818,1
20141229.110347,2912,2,1176834,-2,2912,80,2913,790,1
20141229.110349,2912,12,1176846,0,2912,79,2913,775,1
20141229.110407,2913,32,1176878,16,2912,229,2913,771,1
20141229.110407,2912,2,1176880,0,2912,228,2913,771,0
20141229.110409,2913,4,1176884,0,2912,228,2913,773,1
20141229.110409,2913,12,1176896,12,2912,228,2913,767,1
20141229.11041,2913,6,1176902,6,2912,228,2913,763,1
20141229.110411,2913,2,1176904,2,2912,231,2913,762,1
20141229.110415,2913,2,1176906,2,2912,263,2913,763,1
20141229.110416,2913,2,1176908,2,2912,285,2913,762,1
20141229.110417,2912,2,1176910,0,2912,284,2913,966,0
20141229.110418,2913,2,1176912,2,2912,284,2913,965,1
20141229.110419,2913,2,1176914,2,2912,284,2913,964,1
20141229.110419,2913,6,1176920,2,2912,284,2913,961,1
20141229.11042,2912,204,1177124,58,2912,182,2913,987,0
20141229.110421,2912,336,1177460,-56,2911,442,2912,110,0
20141229.110422,2911,2,1177462,-2,2911,225,2912,183,0
20141229.110422,2912,34,1177496,16,2911,225,2912,178,1
20141229.110423,2912,28,1177524,0,2911,225,2912,170,1
20141229.110424,2912,2,1177526,0,2911,225,2912,199,1
20141229.110425,2912,4,1177530,4,2911,225,2912,198,1
20141229.110428,2912,6,1177536,6,2911,286,2912,278,1
20141229.110429,2912,2,1177538,2,2911,286,2912,282,1
20141229.11043,2911,2,1177540,0,2911,272,2912,282,0
20141229.110435,2911,2,1177542,-2,2911,282,2912,307,0
20141229.110437,2912,44,1177586,26,2911,284,2912,302,1
20141229.11044,2911,2,1177588,-2,2911,283,2912,341,0
20141229.110441,2912,4,1177592,4,2911,292,2912,342,1
20141229.110443,2912,2,1177594,0,2911,292,2912,323,1
20141229.110443,2911,2,1177596,-2,2911,291,2912,337,0
20141229.110445,2912,120,1177716,0,2911,292,2912,255,1
20141229.110445,2911,2,1177718,0,2911,291,2912,255,0
20141229.110449,2911,2,1177720,0,2911,290,2912,275,0
20141229.110451,2911,610,1178330,366,2910,509,2911,90,0
20141229.110452,2911,36,1178366,18,2910,504,2911,72,0
20141229.110453,2911,6,1178372,4,2910,509,2911,69,0
20141229.110453,2911,4,1178376,2,2910,509,2911,87,0
20141229.110454,2911,6,1178382,2,2910,526,2911,114,0
20141229.110455,2911,238,1178620,-68,2910,541,2911,1,0
20141229.110455,2911,2,1178622,0,2911,115,2912,329,0
20141229.110456,2911,22,1178644,0,2911,105,2912,331,0
20141229.110458,2912,100,1178744,100,2911,106,2912,281,1
20141229.1105,2911,10,1178754,0,2911,104,2912,284,0
20141229.110501,2912,100,1178854,96,2911,110,2912,249,1
20141229.110502,2911,2,1178856,0,2911,110,2912,265,0
20141229.110504,2911,2,1178858,0,2911,116,2912,265,0
20141229.110505,2911,8,1178866,-8,2911,113,2912,268,0
20141229.110507,2912,22,1178888,6,2911,115,2912,268,1
20141229.110507,2911,108,1178996,-76,2911,69,2912,264,0
20141229.110509,2911,206,1179202,-114,2911,1,2912,292,0
20141229.110509,2911,2,1179204,0,2911,146,2912,282,0
20141229.11051,2911,4,1179208,0,2911,146,2912,286,0
20141229.110512,2911,402,1179610,-276,2911,10,2912,288,0
20141229.110513,2911,16,1179626,0,2911,4,2912,339,0
20141229.110516,2911,2,1179628,0,2911,25,2912,416,0
20141229.110519,2912,2,1179630,0,2911,173,2912,417,1
20141229.110526,2912,4,1179634,0,2911,168,2912,391,1
20141229.110528,2912,46,1179680,0,2911,167,2912,369,1
20141229.110529,2912,40,1179720,8,2911,169,2912,337,1
20141229.110531,2912,2,1179722,0,2911,171,2912,336,1
20141229.110533,2912,4,1179726,-4,2911,171,2912,403,1
20141229.110536,2912,4,1179730,0,2911,185,2912,420,1
20141229.110536,2912,4,1179734,0,2911,185,2912,419,1
20141229.110537,2912,40,1179774,28,2911,185,2912,399,1
20141229.110539,2912,8,1179782,-2,2911,203,2912,335,1
20141229.110541,2912,2,1179784,2,2911,204,2912,334,1
20141229.110547,2911,120,1179904,-22,2911,162,2912,277,0
20141229.110548,2912,2,1179906,0,2911,163,2912,276,1
20141229.110548,2911,76,1179982,0,2911,125,2912,276,0
20141229.110555,2911,6,1179988,0,2911,164,2912,286,0
20141229.110601,2912,2,1179990,0,2911,169,2912,286,1
20141229.110603,2912,2,1179992,2,2911,297,2912,263,1
20141229.110605,2912,4,1179996,2,2911,322,2912,235,1
20141229.110607,2912,20,1180016,20,2911,322,2912,225,1
20141229.110609,2912,10,1180026,0,2911,322,2912,219,1
20141229.110611,2912,20,1180046,20,2911,324,2912,230,1
20141229.110612,2911,2,1180048,0,2911,323,2912,230,0
20141229.110617,2912,2,1180050,0,2911,394,2912,244,1
20141229.110617,2912,10,1180060,10,2911,395,2912,239,1
20141229.110622,2912,4,1180064,4,2911,430,2912,247,1
20141229.110624,2912,20,1180084,20,2911,436,2912,237,1
20141229.110625,2912,454,1180538,176,2912,1,2913,1046,1
20141229.110627,2912,4,1180542,-4,2912,296,2913,805,1
20141229.110629,2913,16,1180558,0,2912,304,2913,797,1
20141229.110629,2913,2,1180560,2,2912,314,2913,797,1
20141229.11063,2913,6,1180566,6,2912,317,2913,794,1
20141229.110632,2913,2,1180568,2,2912,188,2913,793,1
20141229.110633,2913,4,1180572,2,2912,188,2913,787,1
20141229.110634,2912,20,1180592,0,2912,99,2913,787,0
20141229.110635,2912,138,1180730,0,2912,32,2913,797,0
20141229.110636,2912,66,1180796,-18,2911,609,2912,131,0
20141229.110637,2912,18,1180814,16,2911,604,2912,122,0
20141229.110637,2912,30,1180844,24,2911,604,2912,107,0
20141229.110638,2912,8,1180852,6,2911,604,2912,111,0
20141229.110638,2912,6,1180858,2,2911,604,2912,108,0
20141229.110639,2912,8,1180866,6,2911,614,2912,104,0
20141229.110639,2912,6,1180872,2,2911,615,2912,101,0
20141229.11064,2912,202,1181074,186,2912,133,2913,803,0
20141229.110641,2913,4,1181078,2,2912,134,2913,802,1
20141229.110642,2913,80,1181158,0,2912,134,2913,762,1
20141229.110643,2913,20,1181178,20,2912,135,2913,762,1
20141229.110644,2913,2,1181180,2,2912,136,2913,761,1
20141229.110645,2913,2,1181182,2,2912,137,2913,760,1
20141229.110646,2912,2,1181184,0,2912,136,2913,760,0
20141229.110646,2912,4,1181188,0,2912,135,2913,760,0
20141229.11065,2913,70,1181258,-46,2912,138,2913,748,1
20141229.110651,2913,20,1181278,-18,2912,138,2913,744,1
20141229.110652,2913,2,1181280,-2,2912,138,2913,745,1
20141229.110653,2913,180,1181460,162,2912,139,2913,648,1
20141229.110656,2913,6,1181466,6,2912,139,2913,635,1
20141229.110659,2913,8,1181474,8,2912,159,2913,627,1
20141229.110659,2913,2,1181476,2,2912,158,2913,637,1
20141229.1107,2912,2,1181478,0,2912,162,2913,641,0
20141229.110702,2913,16,1181494,0,2912,168,2913,632,1
20141229.110706,2913,2,1181496,0,2912,169,2913,631,1
20141229.110706,2913,4,1181500,2,2912,168,2913,630,1
20141229.110706,2913,6,1181506,6,2912,168,2913,627,1
20141229.110708,2913,140,1181646,-18,2912,168,2913,556,1
20141229.11071,2912,6,1181652,-6,2912,167,2913,554,0
20141229.110711,2913,2,1181654,0,2912,167,2913,553,1
20141229.110714,2912,4,1181658,0,2912,185,2913,551,0
20141229.110717,2913,60,1181718,-60,2912,195,2913,521,1
20141229.110719,2912,10,1181728,-10,2912,191,2913,521,0
20141229.110721,2912,2,1181730,0,2912,189,2913,514,0
20141229.110721,2912,2,1181732,-2,2912,188,2913,514,0
20141229.110725,2913,62,1181794,-62,2912,208,2913,480,1
20141229.110727,2913,10,1181804,0,2912,212,2913,476,1
20141229.110728,2913,2,1181806,0,2912,222,2913,479,1
20141229.110732,2913,4,1181810,-2,2912,221,2913,479,1
20141229.110733,2913,2,1181812,-2,2912,223,2913,478,1
20141229.110735,2913,2,1181814,0,2912,226,2913,477,1
20141229.110737,2912,2,1181816,-2,2912,226,2913,475,0
20141229.110745,2913,2,1181818,0,2912,220,2913,492,1
20141229.110746,2912,60,1181878,-60,2912,191,2913,514,0
20141229.110747,2913,2,1181880,0,2912,192,2913,516,1
20141229.110747,2913,128,1182008,-120,2912,132,2913,512,1
20141229.110748,2912,200,1182208,-98,2912,32,2913,512,0
20141229.110749,2912,64,1182272,-36,2911,788,2912,3,0
20141229.110749,2912,4,1182276,2,2911,799,2913,717,0
20141229.11075,2912,106,1182382,-6,2911,806,2912,52,0
20141229.110751,2912,2,1182384,0,2911,802,2912,51,0
20141229.110752,2912,62,1182446,0,2911,782,2912,33,0
20141229.110754,2912,10,1182456,-10,2911,774,2912,55,0
20141229.110755,2912,4,1182460,0,2911,774,2912,53,0
20141229.110756,2912,66,1182526,-64,2911,784,2912,21,0
20141229.110756,2912,4,1182530,-2,2911,784,2912,19,0
20141229.1108,2912,4,1182534,-2,2911,784,2912,17,0
20141229.110802,2912,10,1182544,0,2911,829,2912,12,0
20141229.110803,2912,96,1182640,-92,2912,67,2913,620,0
20141229.110804,2912,4,1182644,-4,2912,137,2913,580,0
20141229.110809,2912,6,1182650,-2,2912,139,2913,577,0
20141229.11081,2912,102,1182752,78,2912,88,2913,578,0
20141229.110811,2912,176,1182928,-6,2911,796,2912,52,0
20141229.110813,2912,164,1183092,-160,2912,120,2913,740,0
20141229.110814,2913,6,1183098,0,2912,170,2913,587,1
20141229.110815,2912,10,1183108,0,2912,176,2913,586,0
20141229.110818,2912,26,1183134,-26,2912,172,2913,585,0
20141229.110823,2912,346,1183480,124,2911,826,2912,222,0
20141229.110825,2911,2,1183482,0,2911,627,2912,222,0
20141229.110825,2911,12,1183494,0,2911,621,2912,222,0
20141229.110829,2911,12,1183506,12,2911,615,2912,242,0
20141229.110832,2911,26,1183532,0,2911,601,2912,244,0
20141229.110835,2912,2,1183534,2,2911,598,2912,243,1
20141229.110838,2912,2,1183536,0,2911,562,2912,242,1
20141229.11084,2911,4,1183540,2,2911,575,2912,242,0
20141229.110845,2911,2,1183542,0,2911,508,2912,242,0
20141229.110846,2911,14,1183556,0,2911,499,2912,243,0
20141229.110846,2912,2,1183558,2,2911,500,2912,251,1
20141229.110847,2912,12,1183570,0,2911,555,2912,245,1
20141229.110849,2912,4,1183574,4,2911,554,2912,245,1
20141229.11085,2911,2,1183576,2,2911,553,2912,245,0
20141229.110852,2912,20,1183596,0,2911,567,2912,237,1
20141229.110852,2911,6,1183602,0,2911,567,2912,235,0
20141229.110854,2912,2,1183604,2,2911,619,2912,229,1
20141229.110857,2912,20,1183624,20,2911,624,2912,219,1
20141229.110858,2912,10,1183634,10,2911,624,2912,214,1
20141229.110901,2912,6,1183640,6,2911,627,2912,211,1
20141229.110902,2911,14,1183654,-12,2911,680,2912,210,0
20141229.110905,2911,30,1183684,-30,2911,675,2912,210,0
20141229.110906,2912,6,1183690,6,2911,660,2912,207,1
20141229.110908,2911,2,1183692,0,2911,657,2912,218,0
20141229.110908,2912,2,1183694,2,2911,657,2912,217,1
20141229.110909,2912,30,1183724,0,2911,657,2912,202,1
20141229.110909,2911,2,1183726,2,2911,656,2912,203,0
20141229.110911,2912,2,1183728,2,2911,676,2912,205,1
20141229.110911,2912,2,1183730,2,2911,676,2912,204,1
20141229.110912,2911,2,1183732,-2,2911,676,2912,206,0
20141229.110914,2911,2,1183734,2,2911,676,2912,209,0
20141229.110919,2912,2,1183736,2,2911,721,2912,207,1
20141229.110926,2911,6,1183742,0,2911,678,2912,312,0
20141229.110928,2912,6,1183748,0,2911,679,2912,309,1
20141229.110931,2912,2,1183750,2,2911,693,2912,308,1
20141229.110934,2911,8,1183758,0,2911,690,2912,308,0
20141229.110936,2911,2,1183760,0,2911,690,2912,377,0
20141229.110937,2911,2,1183762,0,2911,689,2912,383,0
20141229.110943,2912,10,1183772,0,2911,696,2912,378,1
20141229.110944,2911,2,1183774,0,2911,695,2912,378,0
20141229.110945,2911,4,1183778,2,2911,693,2912,375,0
20141229.110954,2911,60,1183838,4,2911,670,2912,376,0
20141229.110956,2912,80,1183918,0,2911,669,2912,338,1
20141229.110958,2911,10,1183928,0,2911,658,2912,338,0
20141229.111001,2912,2,1183930,2,2911,658,2912,337,1
20141229.111002,2912,4,1183934,0,2911,662,2912,336,1
20141229.111003,2912,50,1183984,0,2911,669,2912,312,1
20141229.111008,2912,10,1183994,10,2911,670,2912,319,1
20141229.111009,2911,12,1184006,-10,2911,664,2912,319,0
20141229.111009,2912,26,1184032,0,2911,664,2912,306,1
20141229.11101,2912,2,1184034,2,2911,670,2912,305,1
20141229.11101,2911,2,1184036,0,2911,669,2912,305,0
20141229.111012,2912,6,1184042,6,2911,670,2912,291,1
20141229.111014,2911,2,1184044,-2,2911,669,2912,893,0
20141229.111015,2911,2,1184046,0,2911,662,2912,893,0
20141229.111016,2911,2,1184048,-2,2911,661,2912,893,0
20141229.111017,2912,4,1184052,4,2911,665,2912,892,1
20141229.111018,2911,22,1184074,0,2911,654,2912,895,0
20141229.11102,2912,4,1184078,4,2911,659,2912,893,1
20141229.111024,2912,4,1184082,4,2911,654,2912,881,1
20141229.111027,2911,8,1184090,0,2911,644,2912,883,0
20141229.111028,2912,8,1184098,8,2911,664,2912,879,1
20141229.111033,2911,4,1184102,0,2911,678,2912,878,0
20141229.111041,2911,2,1184104,0,2911,674,2912,879,0
20141229.111044,2911,8,1184112,0,2911,716,2912,882,0
20141229.11105,2912,2,1184114,0,2911,717,2912,884,1
20141229.111052,2912,2,1184116,0,2911,716,2912,888,1
20141229.111054,2911,2,1184118,2,2911,720,2912,844,0
20141229.1111,2911,2,1184120,2,2911,719,2912,845,0
20141229.111101,2911,2,1184122,0,2911,718,2912,849,0
20141229.111102,2912,20,1184142,-16,2911,719,2912,839,1
20141229.111107,2912,38,1184180,-28,2911,729,2912,819,1
20141229.111108,2912,2,1184182,-2,2911,729,2912,818,1
20141229.111108,2911,2,1184184,0,2911,728,2912,818,0
20141229.11111,2912,4,1184188,0,2911,729,2912,816,1
20141229.111111,2912,40,1184228,36,2911,734,2912,797,1
20141229.111112,2912,2,1184230,0,2911,735,2912,796,1
20141229.111113,2912,44,1184274,0,2911,735,2912,774,1
20141229.111116,2912,30,1184304,30,2911,751,2912,764,1
20141229.111119,2912,14,1184318,10,2911,756,2912,756,1
20141229.111121,2912,400,1184718,-206,2911,771,2912,555,1
20141229.111122,2912,4,1184722,0,2911,771,2912,543,1
20141229.111123,2911,102,1184824,0,2911,735,2912,543,0
20141229.111123,2911,2,1184826,0,2911,733,2912,543,0
20141229.111123,2911,2,1184828,2,2911,732,2912,543,0
20141229.111124,2912,2,1184830,-2,2911,732,2912,542,1
20141229.111125,2912,4,1184834,-4,2911,738,2912,540,1
20141229.111128,2911,2,1184836,0,2911,730,2912,540,0
20141229.111129,2911,102,1184938,0,2911,676,2912,551,0
20141229.11113,2911,2,1184940,0,2911,660,2912,551,0
20141229.111135,2911,2,1184942,2,2911,657,2912,551,0
20141229.111137,2911,2,1184944,0,2911,656,2912,551,0
20141229.111138,2912,40,1184984,-40,2911,658,2912,531,1
20141229.11114,2912,10,1184994,0,2911,658,2912,526,1
20141229.111142,2911,32,1185026,-6,2911,642,2912,522,0
20141229.111143,2912,40,1185066,-40,2911,650,2912,502,1
20141229.111144,2912,2,1185068,-2,2911,650,2912,503,1
20141229.111145,2911,18,1185086,8,2911,646,2912,498,0
20141229.11115,2912,2,1185088,0,2911,665,2912,497,1
20141229.11115,2911,2,1185090,2,2911,669,2912,497,0
20141229.111154,2912,20,1185110,-20,2911,691,2912,487,1
20141229.111159,2911,34,1185144,-4,2911,675,2912,487,0
20141229.111203,2911,60,1185204,0,2911,649,2912,487,0
20141229.111204,2911,4,1185208,2,2911,647,2912,488,0
20141229.111206,2912,10,1185218,-10,2911,648,2912,485,1
20141229.111206,2911,1004,1186222,-520,2910,624,2912,494,0
20141229.111207,2912,18,1186240,-14,2910,616,2912,485,1
20141229.111207,2912,6,1186246,-4,2910,832,2912,524,1
20141229.111208,2912,24,1186270,-2,2910,883,2912,512,1
20141229.111208,2912,8,1186278,-4,2910,627,2912,466,1
20141229.111209,2912,4,1186282,-2,2910,626,2912,464,1
20141229.11121,2911,12,1186294,0,2910,626,2912,470,0
20141229.11121,2912,4,1186298,-2,2910,626,2912,468,1
20141229.111211,2912,4,1186302,0,2910,626,2912,466,1
20141229.111211,2911,4,1186306,0,2910,862,2912,465,0
20141229.111212,2911,8,1186314,-4,2911,109,2912,471,0
20141229.111213,2911,6,1186320,-2,2911,211,2912,469,0
20141229.111215,2912,2,1186322,0,2911,223,2912,454,1
20141229.111218,2911,12,1186334,0,2911,211,2912,455,0
20141229.111218,2911,100,1186434,-52,2911,191,2912,455,0
20141229.11122,2911,2,1186436,-2,2911,225,2912,455,0
20141229.111226,2911,2,1186438,-2,2911,257,2912,454,0
20141229.111226,2911,2,1186440,-2,2911,256,2912,454,0
20141229.111227,2911,2,1186442,0,2911,255,2912,454,0
20141229.111229,2911,2,1186444,-2,2911,265,2912,454,0
20141229.11123,2912,350,1186794,0,2911,298,2912,279,1
20141229.111231,2912,130,1186924,-2,2911,262,2912,204,1
20141229.111231,2912,10,1186934,-6,2911,261,2912,199,1
20141229.111232,2912,8,1186942,-2,2911,273,2912,195,1
20141229.111232,2912,390,1187332,28,2912,811,2913,863,1
20141229.111233,2912,2,1187334,0,2912,79,2913,883,1
20141229.111234,2913,12,1187346,-10,2912,77,2913,877,1
20141229.111234,2912,4,1187350,0,2912,80,2913,877,0
20141229.111236,2912,4,1187354,0,2912,104,2913,880,0
20141229.111237,2912,2,1187356,2,2912,175,2913,879,0
20141229.11124,2913,20,1187376,0,2912,176,2913,871,1
20141229.111242,2912,2,1187378,0,2912,181,2913,922,0
20141229.111243,2912,60,1187438,-20,2912,151,2913,927,0
20141229.111243,2912,2,1187440,-2,2912,151,2913,927,0
20141229.11125,2913,2,1187442,0,2912,165,2913,930,1
20141229.111253,2913,10,1187452,-10,2912,157,2913,925,1
20141229.111253,2913,2,1187454,-2,2912,160,2913,924,1
20141229.111256,2912,2,1187456,-2,2912,184,2913,924,0
20141229.111259,2913,2,1187458,-2,2912,204,2913,923,1
20141229.1113,2913,2,1187460,-2,2912,208,2913,922,1
20141229.111301,2913,4,1187464,0,2912,209,2913,920,1
20141229.111301,2913,20,1187484,0,2912,209,2913,910,1
20141229.111306,2912,90,1187574,10,2912,174,2913,909,0
20141229.111307,2913,2,1187576,0,2912,174,2913,908,1
20141229.111309,2913,2,1187578,-2,2912,176,2913,908,1
20141229.111309,2912,6,1187584,0,2912,173,2913,908,0
20141229.11131,2912,346,1187930,-96,2911,337,2912,19,0
20141229.111312,2911,2,1187932,-2,2911,228,2912,174,0
20141229.111313,2912,2,1187934,0,2911,228,2912,174,1
20141229.111313,2912,8,1187942,6,2911,228,2912,170,1
20141229.111315,2912,32,1187974,0,2911,228,2912,183,1
20141229.111316,2912,2,1187976,0,2911,252,2912,182,1
20141229.11132,2912,20,1187996,0,2911,262,2912,155,1
20141229.11132,2911,4,1188000,2,2911,261,2912,154,0
20141229.111321,2912,2,1188002,2,2911,261,2912,153,1
20141229.111323,2912,14,1188016,0,2911,296,2912,176,1
20141229.111325,2912,2,1188018,2,2911,297,2912,175,1
20141229.111326,2912,20,1188038,0,2911,298,2912,168,1
20141229.111326,2912,22,1188060,0,2911,298,2912,157,1
20141229.111327,2912,2,1188062,2,2911,299,2912,145,1
20141229.111328,2911,12,1188074,8,2911,298,2912,140,0
20141229.111328,2912,20,1188094,10,2911,298,2912,130,1
20141229.111329,2912,4,1188098,0,2911,301,2912,128,1
20141229.111331,2912,256,1188354,60,2912,63,2913,914,1
20141229.111332,2912,2,1188356,-2,2912,62,2913,910,1
20141229.111333,2913,2,1188358,0,2912,62,2913,909,1
20141229.111334,2912,8,1188366,-6,2912,59,2913,909,0
20141229.111337,2912,2,1188368,0,2912,58,2913,879,0
20141229.111338,2913,10,1188378,0,2912,89,2913,865,1
20141229.111339,2912,2,1188380,-2,2912,89,2913,865,0
20141229.11134,2913,2,1188382,0,2912,89,2913,908,1
20141229.11134,2912,2,1188384,0,2912,88,2913,908,0
20141229.111341,2913,2,1188386,-2,2912,88,2913,908,1
20141229.111342,2912,2,1188388,0,2912,87,2913,912,0
20141229.111342,2912,62,1188450,-62,2912,56,2913,922,0
20141229.111343,2912,28,1188478,-28,2912,42,2913,922,0
20141229.111343,2912,88,1188566,-20,2911,331,2912,152,0
20141229.111345,2911,2,1188568,-2,2911,287,2912,152,0
20141229.111345,2912,10,1188578,10,2911,317,2912,147,1
20141229.111347,2912,2,1188580,2,2911,316,2912,158,1
20141229.111349,2912,100,1188680,100,2911,4327,2912,67,1
20141229.111349,2912,196,1188876,98,2912,3,2913,891,1
20141229.11135,2912,2,1188878,0,2912,2,2913,905,1
20141229.11135,2912,6,1188884,-2,2911,390,2913,915,1
20141229.111353,2912,4,1188888,-2,2911,357,2912,204,1
20141229.111353,2912,100,1188988,0,2911,357,2912,157,1
20141229.111354,2912,202,1189190,10,2911,367,2912,54,1
20141229.111354,2912,6,1189196,4,2911,367,2912,51,1
20141229.111355,2912,22,1189218,22,2911,401,2912,42,1
20141229.111357,2912,2,1189220,2,2911,392,2912,65,1
20141229.111358,2912,4,1189224,0,2911,394,2912,63,1
20141229.111358,2912,2,1189226,2,2911,394,2912,65,1
20141229.1114,2912,40,1189266,40,2911,453,2912,145,1
20141229.111401,2912,2,1189268,2,2911,453,2912,145,1
20141229.111402,2912,8,1189276,0,2911,453,2912,145,1
20141229.111402,2912,4,1189280,2,2911,453,2912,143,1
20141229.111403,2912,2,1189282,2,2911,466,2912,153,1
20141229.111405,2912,28,1189310,26,2911,467,2912,140,1
20141229.111406,2912,2,1189312,0,2911,474,2912,139,1
20141229.111407,2912,20,1189332,0,2911,474,2912,21,1
20141229.11141,2912,2,1189334,0,2911,475,2912,21,1
20141229.11141,2912,36,1189370,2,2911,485,2912,4,1
20141229.111411,2912,2,1189372,2,2911,525,2912,3,1
20141229.111411,2912,4,1189376,-4,2911,476,2912,3,1
20141229.111412,2912,6,1189382,2,2911,456,2912,1,1
20141229.111413,2912,204,1189586,-168,2911,467,2912,102,1
20141229.111414,2912,2,1189588,2,2911,474,2912,154,1
20141229.111414,2912,6,1189594,0,2911,457,2912,152,1
20141229.111416,2912,2,1189596,0,2911,458,2912,156,1
20141229.111423,2912,4,1189600,2,2911,370,2912,284,1
20141229.111424,2912,2,1189602,2,2911,364,2912,493,1
20141229.111425,2911,2,1189604,-2,2911,363,2912,493,0
20141229.111431,2912,2,1189606,0,2911,364,2912,290,1
20141229.111437,2912,20,1189626,20,2911,374,2912,314,1
20141229.111439,2912,10,1189636,10,2911,374,2912,259,1
20141229.111441,2912,286,1189922,172,2912,101,2913,908,1
20141229.111445,2912,6,1189928,0,2912,152,2913,918,1
20141229.111447,2913,2,1189930,-2,2912,167,2913,928,1
20141229.111449,2913,2,1189932,0,2912,168,2913,927,1
20141229.111449,2912,20,1189952,0,2912,158,2913,927,0
20141229.111453,2912,6,1189958,-6,2912,168,2913,927,0
20141229.111456,2912,2,1189960,-2,2912,173,2913,927,0
20141229.111459,2912,2,1189962,-2,2912,213,2913,930,0
20141229.1115,2912,2,1189964,-2,2912,215,2913,930,0
20141229.1115,2913,2,1189966,-2,2912,216,2913,929,1
20141229.1115,2912,48,1190014,-48,2912,192,2913,928,0
20141229.111501,2913,2,1190016,-2,2912,219,2913,927,1
20141229.111502,2912,2,1190018,-2,2912,218,2913,918,0
20141229.111503,2913,18,1190036,-18,2912,218,2913,909,1
20141229.111505,2913,2,1190038,-2,2912,217,2913,908,1
20141229.111506,2913,8,1190046,0,2912,219,2913,904,1
20141229.111509,2912,2,1190048,-2,2912,219,2913,894,0
20141229.111511,2912,4,1190052,0,2912,214,2913,894,0
20141229.111512,2912,4,1190056,-4,2912,212,2913,894,0
20141229.111512,2912,2,1190058,-2,2912,208,2913,894,0
20141229.111513,2913,2,1190060,-2,2912,211,2913,893,1
20141229.111513,2912,2,1190062,0,2912,210,2913,893,0
20141229.111514,2912,2,1190064,-2,2912,206,2913,893,0
20141229.111516,2913,2,1190066,-2,2912,206,2913,892,1
20141229.111517,2913,2,1190068,-2,2912,206,2913,891,1
20141229.111518,2913,2,1190070,0,2912,206,2913,890,1
20141229.111521,2913,4,1190074,-4,2912,206,2913,888,1
20141229.111522,2913,2,1190076,0,2912,208,2913,888,1
20141229.111524,2913,4,1190080,-4,2912,215,2913,886,1
20141229.111527,2912,2,1190082,0,2912,220,2913,887,0
20141229.111527,2913,4,1190086,-4,2912,220,2913,887,1
20141229.11153,2913,10,1190096,0,2912,223,2913,887,1
20141229.111534,2913,8,1190104,0,2912,223,2913,884,1
20141229.111535,2913,12,1190116,-12,2912,213,2913,878,1
20141229.111539,2913,10,1190126,0,2912,213,2913,868,1
20141229.11154,2913,2,1190128,-2,2912,213,2913,872,1
20141229.111544,2913,16,1190144,0,2912,213,2913,864,1
20141229.111545,2913,2,1190146,-2,2912,6221,2913,860,1
20141229.111547,2913,2,1190148,-2,2912,223,2913,862,1
20141229.111548,2912,286,1190434,-182,2912,82,2913,861,0
20141229.111549,2912,56,1190490,38,2912,50,2913,871,0
20141229.111549,2912,100,1190590,26,2911,380,2912,102,0
20141229.111551,2912,2,1190592,0,2911,407,2912,101,0
20141229.111552,2912,14,1190606,10,2911,407,2912,98,0
20141229.111552,2912,2,1190608,2,2911,407,2912,97,0
20141229.111553,2912,2,1190610,2,2911,407,2912,111,0
20141229.111554,2912,4,1190614,0,2911,407,2912,109,0
20141229.111557,2912,2,1190616,0,2911,410,2912,159,0
20141229.111558,2912,6,1190622,6,2911,410,2912,156,0
20141229.111558,2912,10,1190632,10,2911,410,2912,151,0
20141229.111559,2912,4,1190636,0,2911,410,2912,129,0
20141229.111601,2912,2,1190638,2,2911,410,2912,129,0
20141229.111603,2912,10,1190648,0,2911,416,2912,121,0
20141229.111604,2912,2,1190650,0,2911,406,2912,120,0
20141229.111605,2912,24,1190674,0,2911,406,2912,109,0
20141229.111606,2912,2,1190676,0,2911,405,2912,108,0
20141229.111608,2912,2,1190678,0,2911,416,2912,108,0
20141229.111608,2912,8,1190686,8,2911,415,2912,104,0
20141229.111615,2911,4,1190690,-2,2911,477,2912,119,0
20141229.111617,2912,2,1190692,2,2911,477,2912,118,1
20141229.11162,2912,40,1190732,20,2911,478,2912,125,1
20141229.111623,2912,14,1190746,4,2911,478,2912,118,1
20141229.111625,2911,2,1190748,-2,2911,481,2912,119,0
20141229.111627,2912,2,1190750,0,2911,464,2912,124,1
20141229.111627,2912,12,1190762,10,2911,464,2912,118,1
20141229.111634,2912,2,1190764,2,2911,465,2912,131,1
20141229.111635,2912,2,1190766,2,2911,464,2912,127,1
20141229.111641,2912,2,1190768,2,2911,470,2912,123,1
20141229.111642,2912,240,1191008,148,2911,470,2912,3,1
20141229.111642,2912,8,1191016,-6,2912,99,2913,1482,1
20141229.111643,2912,20,1191036,0,2912,101,2913,1492,1
20141229.111643,2912,16,1191052,-16,2912,100,2913,1491,1
20141229.111644,2912,2,1191054,-2,2912,99,2913,1491,1
20141229.111645,2912,2,1191056,-2,2912,98,2913,1491,1
20141229.111648,2912,8,1191064,0,2912,94,2913,1491,1
20141229.111649,2912,2,1191066,0,2912,93,2913,1490,1
20141229.111649,2912,2,1191068,-2,2912,119,2913,1500,1
20141229.11165,2912,2,1191070,0,2912,242,2913,1466,1
20141229.111652,2912,2,1191072,0,2912,247,2913,1462,1
20141229.111655,2912,8,1191080,-6,2912,274,2913,1460,1
20141229.111656,2913,8,1191088,-8,2912,275,2913,1456,1
20141229.111703,2913,4,1191092,-4,2912,304,2913,1429,1
20141229.111704,2913,4,1191096,-4,2912,304,2913,1475,1
20141229.111705,2912,20,1191116,-20,2912,294,2913,1475,0
20141229.111707,2912,240,1191356,-136,2912,174,2913,1478,0
20141229.111707,2912,350,1191706,12,2911,540,2912,152,0
20141229.111708,2912,10,1191716,4,2911,450,2912,161,0
20141229.11171,2912,6,1191722,6,2911,450,2912,163,0
20141229.111711,2911,20,1191742,-20,2911,440,2912,222,0
20141229.111712,2912,6,1191748,2,2911,440,2912,219,1
20141229.111713,2912,2,1191750,2,2911,440,2912,218,1
20141229.111714,2912,4,1191754,4,2911,442,2912,216,1
20141229.111715,2911,2,1191756,0,2911,442,2912,216,0
20141229.111715,2912,10,1191766,0,2911,442,2912,191,1
20141229.111717,2912,4,1191770,4,2911,452,2912,181,1
20141229.111719,2912,10,1191780,10,2911,465,2912,176,1
20141229.111724,2912,40,1191820,0,2911,467,2912,165,1
20141229.111726,2912,2,1191822,2,2911,467,2912,164,1
20141229.111726,2911,4,1191826,0,2911,466,2912,164,0
20141229.111729,2912,4,1191830,2,2911,466,2912,162,1
20141229.11173,2912,2,1191832,2,2911,466,2912,163,1
20141229.111731,2912,26,1191858,-2,2911,465,2912,151,1
20141229.111734,2912,58,1191916,58,2911,455,2912,123,1
20141229.11174,2911,4,1191920,-4,2911,456,2912,136,0
20141229.111741,2912,2,1191922,2,2911,456,2912,137,1
20141229.111745,2911,2,1191924,0,2911,514,2912,137,0
20141229.111748,2912,80,1192004,-62,2911,503,2912,97,1
20141229.111749,2912,2,1192006,-2,2911,500,2912,96,1
20141229.111751,2912,2,1192008,0,2911,500,2912,95,1
20141229.111753,2911,2,1192010,-2,2911,498,2912,96,0
20141229.111757,2911,18,1192028,-8,2911,499,2912,93,0
20141229.111757,2912,2,1192030,0,2911,499,2912,92,1
20141229.111759,2912,2,1192032,0,2911,500,2912,91,1
20141229.1118,2912,2,1192034,0,2911,511,2912,90,1
20141229.111801,2912,4,1192038,-4,2911,510,2912,88,1
20141229.111803,2912,2,1192040,-2,2911,510,2912,102,1
20141229.111807,2911,2,1192042,-2,2911,458,2912,368,0
20141229.111808,2911,2,1192044,-2,2911,457,2912,369,0
20141229.111811,2912,200,1192244,64,2911,457,2912,216,1
20141229.111813,2911,2,1192246,-2,2911,471,2912,206,0
20141229.111816,2911,4,1192250,-2,2911,584,2912,206,0
20141229.111819,2912,396,1192646,254,2912,80,2913,1571,1
20141229.11182,2912,2,1192648,0,2912,79,2913,1460,1
20141229.11182,2912,192,1192840,2,2911,676,2912,86,1
20141229.111821,2911,2,1192842,0,2911,586,2912,137,0
20141229.11183,2912,40,1192882,40,2911,597,2912,133,1
20141229.11183,2912,2,1192884,2,2911,598,2912,132,1
20141229.111832,2911,2,1192886,0,2911,597,2912,173,0
20141229.111832,2912,2,1192888,0,2911,597,2912,174,1
20141229.111835,2911,2,1192890,0,2911,599,2912,175,0
20141229.111836,2911,26,1192916,-24,2911,589,2912,177,0
20141229.111837,2912,4,1192920,0,2911,590,2912,172,1
20141229.111838,2912,200,1193120,200,2911,591,2912,70,1
20141229.111838,2912,150,1193270,74,2912,177,2913,1459,1
20141229.111841,2913,4,1193274,-4,2912,194,2913,1403,1
20141229.111846,2912,2,1193276,0,2912,194,2913,1344,0
20141229.111846,2912,12,1193288,0,2912,188,2913,1293,0
20141229.111849,2913,2,1193290,0,2912,198,2913,1374,1
20141229.111852,2913,2,1193292,0,2912,197,2913,1371,1
20141229.111853,2912,2,1193294,0,2912,196,2913,1366,0
20141229.111857,2912,4,1193298,2,2912,197,2913,1372,0
20141229.111859,2913,2,1193300,0,2912,198,2913,1370,1
20141229.111901,2912,8,1193308,0,2912,222,2913,1370,0
20141229.111905,2912,4,1193312,0,2912,297,2913,1371,0
20141229.111912,2913,20,1193332,0,2912,304,2913,1361,1
20141229.111916,2912,4,1193336,0,2912,303,2913,1362,0
20141229.111917,2912,2,1193338,0,2912,304,2913,1362,0
20141229.111918,2912,30,1193368,-18,2912,290,2913,1363,0
20141229.111924,2912,8,1193376,-8,2912,290,2913,1382,0
20141229.111924,2912,4,1193380,-4,2912,288,2913,1382,0
20141229.111925,2913,2,1193382,-2,2912,288,2913,1382,1
20141229.111927,2912,8,1193390,-6,2912,284,2913,1382,0
20141229.111933,2912,6,1193396,-6,2912,294,2913,1376,0
20141229.111935,2913,4,1193400,0,2912,294,2913,1373,1
20141229.111935,2913,2,1193402,-2,2912,294,2913,1372,1
20141229.111939,2913,4,1193406,-2,2912,305,2913,1378,1
20141229.111944,2913,4,1193410,-4,2912,317,2913,1377,1
20141229.111944,2913,2,1193412,-2,2912,317,2913,1376,1
20141229.111944,2913,2,1193414,0,2912,318,2913,1398,1
20141229.111946,2912,10,1193424,-10,2912,313,2913,1398,0
20141229.11195,2912,2,1193426,-2,2912,306,2913,1393,0
20141229.111952,2912,2,1193428,0,2912,307,2913,1391,0
20141229.111953,2913,6,1193434,-6,2912,322,2913,1388,1
20141229.111955,2913,24,1193458,0,2912,324,2913,1353,1
20141229.111957,2913,2,1193460,-2,2912,324,2913,1351,1
20141229.111957,2913,2,1193462,0,2912,324,2913,1350,1
20141229.112002,2913,488,1193950,128,2912,331,2913,1064,1
20141229.112002,2913,4,1193954,4,2912,341,2913,1058,1
20141229.112002,2913,20,1193974,0,2912,341,2913,1048,1
20141229.112005,2913,2,1193976,-2,2912,347,2913,1006,1
20141229.112005,2913,20,1193996,0,2912,352,2913,996,1
20141229.112008,2913,8,1194004,4,2912,353,2913,791,1
20141229.112008,2914,1582,1195586,-572,2913,3,2914,701,1
20141229.112011,2914,2,1195588,0,2913,246,2914,751,1
20141229.112011,2914,14,1195602,12,2913,248,2914,744,1
20141229.112012,2914,2,1195604,0,2913,247,2914,742,1
20141229.112014,2914,2,1195606,2,2913,412,2914,741,1
20141229.112015,2914,22,1195628,16,2913,412,2914,730,1
20141229.112017,2914,2,1195630,-2,2913,414,2914,730,1
20141229.112017,2914,2,1195632,0,2913,414,2914,733,1
20141229.112019,2913,14,1195646,-4,2913,412,2914,733,0
20141229.112021,2913,8,1195654,0,2913,424,2914,733,0
20141229.112025,2914,18,1195672,-16,2913,408,2914,737,1
20141229.112026,2914,54,1195726,30,2913,409,2914,711,1
20141229.112026,2913,2,1195728,0,2913,498,2914,711,0
20141229.112027,2914,16,1195744,12,2913,501,2914,703,1
20141229.112027,2914,4,1195748,2,2913,506,2914,701,1
20141229.112029,2913,48,1195796,48,2913,483,2914,702,0
20141229.112029,2914,2,1195798,2,2913,485,2914,701,1
20141229.112031,2914,4,1195802,4,2913,503,2914,712,1
20141229.112032,2913,2,1195804,2,2913,503,2914,712,0
20141229.112032,2914,10,1195814,10,2913,513,2914,707,1
20141229.112033,2914,2,1195816,2,2913,514,2914,712,1
20141229.112034,2913,4,1195820,0,2913,444,2914,730,0
20141229.112036,2914,20,1195840,0,2913,458,2914,720,1
20141229.112037,2914,4,1195844,4,2913,455,2914,718,1
20141229.112038,2914,4,1195848,0,2913,455,2914,716,1
20141229.112039,2914,2,1195850,2,2913,455,2914,725,1
20141229.11204,2914,2,1195852,0,2913,453,2914,758,1
20141229.112042,2914,2,1195854,0,2913,460,2914,758,1
20141229.112044,2914,824,1196678,392,2913,482,2915,914,1
20141229.112045,2914,242,1196920,2,2913,472,2915,934,1
20141229.112045,2914,32,1196952,-14,2913,475,2914,304,1
20141229.112046,2914,4,1196956,-4,2913,474,2914,303,1
20141229.112046,2914,6,1196962,-6,2913,474,2914,300,1
20141229.112048,2914,4,1196966,-2,2913,480,2914,301,1
20141229.112048,2914,18,1196984,-18,2913,480,2914,292,1
20141229.112048,2914,6,1196990,-4,2913,480,2914,289,1
20141229.112049,2914,2,1196992,-2,2913,480,2914,338,1
20141229.112051,2913,2,1196994,0,2913,481,2914,343,0
20141229.112053,2914,44,1197038,-42,2913,482,2914,378,1
20141229.112056,2914,2,1197040,-2,2913,486,2914,428,1
20141229.112056,2914,8,1197048,-4,2913,486,2914,425,1
20141229.112057,2914,14,1197062,0,2913,509,2914,418,1
20141229.112059,2914,4,1197066,-4,2913,509,2914,416,1
20141229.112059,2914,2,1197068,0,2913,509,2914,415,1
20141229.112101,2913,8,1197076,4,2913,506,2914,418,0
20141229.112102,2914,4,1197080,-4,2913,506,2914,416,1
20141229.112103,2914,102,1197182,32,2913,506,2914,365,1
20141229.112105,2914,4,1197186,0,2913,508,2914,362,1
20141229.112106,2914,2,1197188,0,2913,508,2914,361,1
20141229.112106,2913,2,1197190,2,2913,507,2914,361,0
20141229.112107,2914,2,1197192,2,2913,507,2914,360,1
20141229.11211,2914,2,1197194,2,2913,506,2914,380,1
20141229.112111,2914,2,1197196,2,2913,510,2914,379,1
20141229.112113,2913,2,1197198,0,2913,483,2914,439,0
20141229.112113,2914,8,1197206,8,2913,483,2914,435,1
20141229.112114,2914,2,1197208,2,2913,484,2914,435,1
20141229.112115,2913,2,1197210,0,2913,482,2914,435,0
20141229.112117,2914,2,1197212,0,2913,484,2914,436,1
20141229.112119,2914,2,1197214,0,2913,484,2914,435,1
20141229.112122,2914,2,1197216,0,2913,491,2914,439,1
20141229.112123,2913,2,1197218,0,2913,490,2914,439,0
20141229.112124,2913,2,1197220,2,2913,465,2914,441,0
20141229.112128,2913,4,1197224,0,2913,463,2914,671,0
20141229.11213,2914,4,1197228,4,2913,464,2914,608,1
20141229.112131,2913,20,1197248,0,2913,454,2914,608,0
20141229.112132,2913,2,1197250,0,2913,453,2914,593,0
20141229.112133,2914,4,1197254,4,2913,453,2914,593,1
20141229.112134,2913,12,1197266,10,2913,456,2914,587,0
20141229.112134,2913,6,1197272,0,2913,453,2914,584,0
20141229.112135,2913,2,1197274,0,2913,450,2914,583,0
20141229.112136,2913,6,1197280,0,2913,451,2914,583,0
20141229.112137,2913,6,1197286,0,2913,448,2914,580,0
20141229.112138,2914,2,1197288,0,2913,448,2914,679,1
20141229.112139,2913,6,1197294,0,2913,445,2914,676,0
20141229.11214,2914,12,1197306,6,2913,442,2914,670,1
20141229.112141,2913,4,1197310,0,2913,440,2914,669,0
20141229.112141,2913,206,1197516,-82,2913,337,2914,672,0
20141229.112143,2913,8,1197524,-8,2913,346,2914,664,0
20141229.112143,2913,2,1197526,0,2913,345,2914,664,0
20141229.112143,2913,10,1197536,-8,2913,341,2914,661,0
20141229.112145,2913,6,1197542,-6,2913,377,2914,659,0
20141229.112146,2914,2,1197544,2,2913,393,2914,658,1
20141229.112147,2913,6,1197550,-6,2913,391,2914,655,0
20141229.112148,2913,2,1197552,-2,2913,390,2914,651,0
20141229.112148,2913,4,1197556,-4,2913,388,2914,648,0
20141229.112149,2913,6,1197562,-6,2913,385,2914,645,0
20141229.11215,2914,2,1197564,2,2913,386,2914,644,1
20141229.112151,2914,46,1197610,-2,2913,385,2914,622,1
20141229.112151,2913,8,1197618,-6,2913,381,2914,619,0
20141229.112153,2913,6,1197624,-6,2913,382,2914,601,0
20141229.112154,2913,2,1197626,-2,2913,426,2914,596,0
20141229.112155,2913,6,1197632,-6,2913,423,2914,294,0
20141229.112155,2914,462,1198094,10,2913,478,2914,14,1
20141229.112156,2914,28,1198122,-22,2914,156,2915,1187,1
20141229.112156,2914,8,1198130,-4,2914,156,2915,1170,1
20141229.112157,2914,22,1198152,-2,2914,175,2915,1170,1
20141229.112158,2914,6,1198158,-6,2914,174,2915,1136,1
20141229.112159,2914,22,1198180,-22,2914,170,2915,1135,1
20141229.1122,2913,394,1198574,-178,2913,632,2914,108,0
20141229.112201,2914,96,1198670,0,2913,480,2914,110,1
20141229.112201,2914,6,1198676,-2,2913,485,2914,108,1
20141229.112202,2914,224,1198900,-8,2914,102,2915,1226,1
20141229.112203,2914,10,1198910,0,2914,170,2915,1159,1
20141229.112203,2915,4,1198914,-2,2914,178,2915,1158,1
20141229.112204,2914,8,1198922,0,2914,177,2915,1208,0
20141229.112204,2915,10,1198932,-8,2914,177,2915,1207,1
20141229.112205,2914,6,1198938,0,2914,177,2915,1204,0
20141229.112206,2914,6,1198944,0,2914,176,2915,1201,0
20141229.112207,2914,6,1198950,0,2914,174,2915,1198,0
20141229.112208,2915,10,1198960,0,2914,172,2915,1202,1
20141229.112208,2915,4,1198964,0,2914,177,2915,1200,1
20141229.112209,2915,8,1198972,-2,2914,186,2915,1198,1
20141229.112209,2915,4,1198976,-2,2914,186,2915,1196,1
20141229.11221,2915,8,1198984,0,2914,186,2915,1191,1
20141229.112211,2914,6,1198990,0,2914,187,2915,1189,0
20141229.112212,2914,6,1198996,0,2914,204,2915,1187,0
20141229.112212,2915,16,1199012,-8,2914,204,2915,1179,1
20141229.112213,2914,6,1199018,0,2914,201,2915,1176,0
20141229.112213,2915,2,1199020,0,2914,224,2915,1155,1
20141229.112214,2914,6,1199026,0,2914,221,2915,1152,0
20141229.112215,2915,16,1199042,0,2914,218,2915,1146,1
20141229.112215,2915,2,1199044,0,2914,218,2915,1145,1
20141229.112216,2915,62,1199106,40,2914,215,2915,1114,1
20141229.112217,2914,10,1199116,0,2914,211,2915,1118,0
20141229.112218,2914,26,1199142,0,2914,199,2915,1116,0
20141229.112219,2915,22,1199164,22,2914,199,2915,1105,1
20141229.112219,2915,14,1199178,4,2914,195,2915,1100,1
20141229.11222,2914,2,1199180,2,2914,194,2915,1100,0
20141229.11222,2914,6,1199186,0,2914,189,2915,1097,0
20141229.112221,2914,6,1199192,0,2914,187,2915,1097,0
20141229.112222,2914,14,1199206,12,2914,186,2915,1091,0
20141229.112222,2914,116,1199322,0,2914,128,2915,1098,0
20141229.112223,2914,2,1199324,0,2914,128,2915,1098,0
20141229.112223,2914,212,1199536,170,2914,75,2915,1044,0
20141229.112224,2914,150,1199686,-44,2913,723,2914,51,0
20141229.112224,2914,4,1199690,0,2913,707,2914,51,0
20141229.112225,2913,6,1199696,-6,2913,586,2914,254,0
20141229.112225,2914,12,1199708,-8,2913,584,2914,251,1
20141229.112226,2913,6,1199714,-6,2913,570,2914,251,0
20141229.112227,2914,8,1199722,-6,2913,534,2914,282,1
20141229.112227,2914,60,1199782,0,2913,537,2914,252,1
20141229.112228,2913,6,1199788,-6,2913,535,2914,252,0
20141229.112229,2913,6,1199794,-6,2913,541,2914,254,0
20141229.112229,2914,4,1199798,0,2913,543,2914,253,1
20141229.11223,2914,2,1199800,0,2913,543,2914,252,1
20141229.11223,2914,16,1199816,-14,2913,548,2914,244,1
20141229.112231,2914,12,1199828,-4,2913,547,2914,239,1
20141229.112231,2913,10,1199838,-6,2913,542,2914,207,0
20141229.112232,2913,6,1199844,-6,2913,540,2914,209,0
20141229.112233,2914,2,1199846,-2,2913,540,2914,208,1
20141229.112234,2913,54,1199900,-54,2913,537,2914,194,0
20141229.112234,2914,2,1199902,0,2913,537,2914,193,1
20141229.112235,2914,10,1199912,-10,2913,534,2914,191,1
20141229.112235,2914,50,1199962,20,2913,508,2914,191,1
20141229.112236,2913,28,1199990,-24,2913,511,2914,220,0
20141229.112237,2913,8,1199998,-8,2913,513,2914,219,0
20141229.112238,2913,6,1200004,-6,2913,510,2914,219,0
20141229.112239,2913,6,1200010,-2,2913,510,2914,219,0
20141229.11224,2914,2,1200012,0,2913,521,2914,226,1
20141229.112241,2914,2,1200014,0,2913,524,2914,226,1
20141229.112241,2914,2,1200016,0,2913,524,2914,225,1
20141229.112242,2914,2,1200018,-2,2913,524,2914,229,1
20141229.112242,2914,2,1200020,-2,2913,525,2914,230,1
20141229.112243,2914,200,1200220,-100,2913,525,2914,131,1
20141229.112243,2914,4,1200224,-2,2913,517,2914,157,1
20141229.112244,2914,10,1200234,-10,2913,493,2914,152,1
20141229.112245,2914,10,1200244,0,2913,496,2914,182,1
20141229.112245,2914,10,1200254,0,2913,496,2914,177,1
20141229.112246,2914,20,1200274,0,2913,496,2914,167,1
20141229.112246,2914,52,1200326,-52,2913,495,2914,142,1
20141229.112247,2914,4,1200330,2,2913,507,2914,140,1
20141229.112247,2914,8,1200338,2,2913,507,2914,137,1
20141229.112248,2914,2,1200340,0,2913,507,2914,136,1
20141229.11225,2914,48,1200388,-48,2913,509,2914,138,1
20141229.112251,2914,2,1200390,0,2913,510,2914,134,1
20141229.112253,2914,28,1200418,-4,2913,564,2914,122,1
20141229.112254,2914,2,1200420,-2,2913,563,2914,122,1
20141229.112256,2914,4,1200424,0,2913,586,2914,120,1
20141229.112257,2914,2,1200426,0,2913,585,2914,119,1
20141229.112259,2914,2,1200428,0,2913,587,2914,118,1
20141229.112259,2914,2,1200430,0,2913,587,2914,117,1
20141229.112301,2914,2,1200432,-2,2913,587,2914,116,1
20141229.112302,2914,12,1200444,-12,2913,587,2914,121,1
20141229.112303,2914,2,1200446,-2,2913,587,2914,120,1
20141229.112304,2914,2,1200448,0,2913,585,2914,119,1
20141229.112305,2914,8,1200456,-4,2913,566,2914,143,1
20141229.112306,2914,40,1200496,18,2913,566,2914,123,1
20141229.112307,2914,2,1200498,0,2913,566,2914,131,1
20141229.112308,2914,56,1200554,-6,2913,567,2914,103,1
20141229.112309,2914,40,1200594,0,2913,561,2914,88,1
20141229.11231,2914,32,1200626,8,2913,569,2914,73,1
20141229.11231,2914,448,1201074,-112,2913,675,2914,102,1
20141229.112311,2914,6,1201080,-2,2913,499,2914,156,1
20141229.112312,2914,8,1201088,-8,2913,505,2914,152,1
20141229.112314,2913,2,1201090,-2,2913,504,2914,153,0
20141229.112317,2914,20,1201110,0,2913,510,2914,218,1
20141229.112318,2914,18,1201128,-18,2913,510,2914,225,1
20141229.112319,2914,2,1201130,0,2913,517,2914,256,1
20141229.112321,2914,36,1201166,-36,2913,520,2914,314,1
20141229.112321,2914,2,1201168,-2,2913,524,2914,347,1
20141229.112325,2913,2,1201170,-2,2913,523,2914,348,0
20141229.112326,2913,2,1201172,0,2913,523,2914,353,0
20141229.112326,2914,28,1201200,-28,2913,517,2914,339,1
20141229.112327,2914,2,1201202,-2,2913,517,2914,338,1
20141229.112328,2914,10,1201212,0,2913,517,2914,333,1
20141229.112331,2914,602,1201814,310,2913,518,2914,49,1
20141229.112332,2914,2,1201816,2,2913,584,2914,49,1
20141229.112332,2914,98,1201914,2,2914,102,2915,1469,1
20141229.112333,2914,304,1202218,102,2914,1,2915,1369,1
20141229.112333,2914,2,1202220,0,2913,594,2914,121,1
20141229.112333,2913,16,1202236,-16,2913,582,2914,120,0
20141229.112334,2914,56,1202292,-2,2913,561,2914,113,1
20141229.112336,2913,8,1202300,-2,2913,565,2914,111,0
20141229.112337,2913,2,1202302,-2,2913,574,2914,218,0
20141229.112338,2913,4,1202306,-4,2913,527,2914,223,0
20141229.11234,2914,4,1202310,0,2913,526,2914,222,1
20141229.112341,2914,10,1202320,0,2913,521,2914,212,1
20141229.112342,2914,4,1202324,0,2913,520,2914,210,1
20141229.112344,2914,2,1202326,0,2913,395,2914,226,1
20141229.112345,2913,2,1202328,0,2913,394,2914,226,0
20141229.112346,2913,2,1202330,0,2913,389,2914,229,0
20141229.112348,2913,2,1202332,0,2913,406,2914,228,0
20141229.112349,2913,10,1202342,0,2913,416,2914,229,0
20141229.112351,2914,40,1202382,-40,2913,417,2914,208,1
20141229.112356,2913,2,1202384,-2,2913,446,2914,205,0
20141229.112357,2914,2,1202386,0,2913,448,2914,205,1
20141229.112402,2914,20,1202406,0,2913,482,2914,190,1
20141229.112403,2913,2,1202408,0,2913,465,2914,191,0
20141229.112404,2914,2,1202410,0,2913,466,2914,191,1
20141229.112407,2914,10,1202420,0,2913,467,2914,189,1
20141229.11241,2914,14,1202434,0,2913,475,2914,182,1
20141229.112415,2913,4,1202438,-4,2913,469,2914,194,0
20141229.112416,2913,6,1202444,-6,2913,463,2914,195,0
20141229.112417,2913,6,1202450,-6,2913,460,2914,222,0
20141229.112418,2914,48,1202498,0,2913,437,2914,223,1
20141229.11242,2913,50,1202548,0,2913,423,2914,223,0
20141229.11242,2913,2,1202550,0,2913,423,2914,223,0
20141229.112422,2913,34,1202584,0,2913,429,2914,206,0
20141229.112423,2913,4,1202588,0,2913,435,2914,210,0
20141229.112424,2913,4,1202592,0,2913,433,2914,210,0
20141229.112425,2914,2,1202594,0,2913,435,2914,211,1
20141229.112426,2913,32,1202626,0,2913,434,2914,193,0
20141229.112427,2914,182,1202808,-168,2914,188,2915,1320,1
20141229.112427,2915,200,1203008,72,2914,192,2915,1199,1
20141229.112428,2915,10,1203018,0,2914,294,2915,1194,1
20141229.112428,2914,2,1203020,-2,2914,298,2915,1193,0
20141229.11243,2914,6,1203026,-6,2914,295,2915,1189,0
20141229.11243,2914,4,1203030,0,2914,294,2915,1189,0
20141229.112431,2914,6,1203036,-6,2914,291,2915,1186,0
20141229.112432,2914,582,1203618,-138,2913,631,2914,211,0
20141229.112432,2913,6,1203624,0,2913,426,2914,261,0
20141229.112434,2913,4,1203628,0,2913,399,2914,282,0
20141229.112435,2913,4,1203632,-2,2913,411,2914,414,0
20141229.112436,2914,2,1203634,0,2913,413,2914,413,1
20141229.112436,2913,6,1203640,-6,2913,416,2914,413,0
20141229.112438,2913,6,1203646,-6,2913,405,2914,414,0
20141229.112439,2913,6,1203652,-6,2913,401,2914,414,0
20141229.112439,2913,102,1203754,-2,2913,402,2914,364,0
20141229.112439,2913,100,1203854,-38,2913,352,2914,364,0
20141229.11244,2913,2,1203856,-2,2913,351,2914,369,0
20141229.112441,2914,2,1203858,0,2913,351,2914,370,1
20141229.112441,2914,10,1203868,-10,2913,347,2914,369,1
20141229.112443,2913,4,1203872,-4,2913,300,2914,369,0
20141229.112443,2914,2,1203874,0,2913,301,2914,368,1
20141229.112444,2913,6,1203880,-6,2913,298,2914,369,0
20141229.112444,2914,2,1203882,0,2913,298,2914,368,1
20141229.112445,2913,2,1203884,-2,2913,297,2914,368,0
20141229.112446,2913,4,1203888,-4,2913,294,2914,368,0
20141229.112448,2913,2,1203890,-2,2913,336,2914,368,0
20141229.11245,2913,6,1203896,-6,2913,347,2914,468,0
20141229.112451,2913,6,1203902,0,2913,346,2914,468,0
20141229.112453,2913,16,1203918,-10,2913,350,2914,464,0
20141229.112455,2914,16,1203934,-10,2913,347,2914,459,1
20141229.112457,2914,26,1203960,-2,2913,360,2914,449,1
20141229.112457,2914,10,1203970,-4,2913,378,2914,394,1
20141229.112458,2914,788,1204758,122,2914,127,2915,1020,1
20141229.112459,2914,16,1204774,0,2914,191,2915,1018,1
20141229.1125,2915,4,1204778,2,2914,202,2915,1016,1
20141229.1125,2915,8,1204786,0,2914,212,2915,1023,1
20141229.112501,2915,2,1204788,2,2914,257,2915,1022,1
20141229.112501,2914,2,1204790,0,2914,256,2915,1022,0
20141229.112502,2914,8,1204798,0,2914,255,2915,1022,0
20141229.112502,2914,128,1204926,2,2914,272,2915,961,0
20141229.112503,2915,2,1204928,2,2914,220,2915,961,1
20141229.112503,2915,22,1204950,12,2914,240,2915,954,1
20141229.112504,2915,14,1204964,2,2914,239,2915,947,1
20141229.112504,2914,2,1204966,0,2914,238,2915,945,0
20141229.112505,2915,4,1204970,2,2914,233,2915,943,1
20141229.112505,2914,10,1204980,4,2914,242,2915,940,0
20141229.112506,2915,42,1205022,38,2914,242,2915,919,1
20141229.112506,2914,4,1205026,0,2914,240,2915,919,0
20141229.112507,2914,6,1205032,4,2914,239,2915,917,0
20141229.112507,2915,412,1205444,130,2914,263,2915,713,1
20141229.112508,2915,22,1205466,-10,2914,287,2915,701,1
20141229.112508,2915,10,1205476,-4,2914,378,2915,697,1
20141229.112509,2915,4,1205480,-2,2914,360,2915,695,1
20141229.112509,2915,40,1205520,-6,2914,372,2915,678,1
20141229.11251,2914,4,1205524,-2,2914,389,2915,677,0
20141229.11251,2915,16,1205540,-4,2914,396,2915,683,1
20141229.112511,2915,100,1205640,0,2914,401,2915,633,1
20141229.112511,2915,16,1205656,-2,2914,392,2915,634,1
20141229.112512,2915,6,1205662,-2,2914,393,2915,631,1
20141229.112512,2915,62,1205724,20,2914,366,2915,616,1
20141229.112513,2915,184,1205908,-150,2914,373,2915,523,1
20141229.112513,2915,108,1206016,0,2914,290,2915,470,1
20141229.112514,2915,14,1206030,-2,2914,290,2915,463,1
20141229.112514,2915,8,1206038,-2,2914,291,2915,465,1
20141229.112515,2915,30,1206068,-8,2914,291,2915,551,1
20141229.112515,2915,16,1206084,14,2914,291,2915,543,1
20141229.112516,2915,8,1206092,4,2914,291,2915,539,1
20141229.112516,2915,6,1206098,4,2914,291,2915,536,1
20141229.112517,2915,4,1206102,4,2914,293,2915,534,1
20141229.112518,2915,46,1206148,42,2914,310,2915,511,1
20141229.112518,2915,26,1206174,0,2914,309,2915,498,1
20141229.112519,2915,8,1206182,4,2914,309,2915,486,1
20141229.112519,2915,4,1206186,0,2914,330,2915,484,1
20141229.11252,2915,10,1206196,10,2914,330,2915,479,1
20141229.11252,2915,2,1206198,0,2914,331,2915,483,1
20141229.112521,2914,4,1206202,2,2914,333,2915,482,0
20141229.112522,2915,10,1206212,8,2914,335,2915,477,1
20141229.112522,2915,104,1206316,48,2914,384,2915,425,1
20141229.112524,2914,2,1206318,2,2914,384,2915,426,0
20141229.112524,2915,2,1206320,-2,2914,386,2915,425,1
20141229.112525,2914,104,1206424,24,2914,384,2915,375,0
20141229.112525,2915,10,1206434,6,2914,384,2915,371,1
20141229.112526,2915,2,1206436,0,2914,386,2915,370,1
20141229.112526,2915,4,1206440,2,2914,396,2915,368,1
20141229.112527,2914,12,1206452,10,2914,387,2915,368,0
20141229.112527,2915,12,1206464,2,2914,364,2915,372,1
20141229.112529,2914,2,1206466,2,2914,360,2915,628,0
20141229.11253,2914,6,1206472,-4,2914,364,2915,626,0
20141229.112531,2915,2,1206474,2,2914,395,2915,625,1
20141229.112532,2914,12,1206486,0,2914,396,2915,624,0
20141229.112535,2915,8,1206494,4,2914,406,2915,622,1
20141229.112538,2914,4,1206498,2,2914,411,2915,625,0
20141229.112538,2915,10,1206508,10,2914,402,2915,620,1
20141229.112539,2915,8,1206516,4,2914,387,2915,721,1
20141229.112541,2914,6,1206522,4,2914,370,2915,720,0
20141229.112542,2915,4,1206526,0,2914,372,2915,617,1
20141229.112543,2914,2,1206528,2,2914,381,2915,618,0
20141229.112544,2915,4,1206532,4,2914,380,2915,616,1
20141229.112545,2914,2,1206534,2,2914,379,2915,623,0
20141229.112546,2915,10,1206544,10,2914,385,2915,618,1
20141229.112547,2915,2,1206546,2,2914,386,2915,397,1
20141229.112547,2915,2,1206548,2,2914,386,2915,496,1
20141229.112549,2915,20,1206568,0,2914,388,2915,491,1
20141229.11255,2915,10,1206578,0,2914,389,2915,488,1
20141229.112551,2914,2,1206580,0,2914,397,2915,488,0
20141229.112552,2914,2,1206582,2,2914,391,2915,484,0
20141229.112553,2915,14,1206596,0,2914,390,2915,478,1
20141229.112553,2914,24,1206620,20,2914,388,2915,468,0
20141229.112554,2914,14,1206634,0,2914,387,2915,463,0
20141229.112554,2914,6,1206640,0,2914,410,2915,476,0
20141229.112556,2915,8,1206648,0,2914,408,2915,477,1
20141229.112557,2914,26,1206674,20,2914,406,2915,470,0
20141229.112558,2915,2,1206676,2,2914,405,2915,469,1
20141229.112558,2914,120,1206796,96,2914,346,2915,438,0
20141229.112559,2914,8,1206804,2,2914,342,2915,443,0
20141229.112601,2915,24,1206828,14,2914,297,2915,538,1
20141229.112601,2914,6,1206834,0,2914,274,2915,564,0
20141229.112602,2914,6,1206840,2,2914,280,2915,463,0
20141229.112603,2914,12,1206852,0,2914,274,2915,463,0
20141229.112604,2914,2,1206854,0,2914,274,2915,463,0
20141229.112604,2915,4,1206858,0,2914,275,2915,461,1
20141229.112604,2914,4,1206862,0,2914,274,2915,461,0
20141229.112605,2914,2,1206864,0,2914,274,2915,461,0
20141229.112606,2915,2,1206866,2,2914,275,2915,460,1
20141229.112607,2914,4,1206870,0,2914,271,2915,460,0
20141229.112608,2914,214,1207084,56,2914,166,2915,561,0
20141229.112608,2914,6,1207090,-6,2914,148,2915,520,0
20141229.112609,2914,258,1207348,202,2913,712,2915,520,0
20141229.11261,2914,254,1207602,-188,2913,625,2914,2,0
20141229.112611,2914,80,1207682,-32,2913,616,2914,12,0
20141229.112611,2914,26,1207708,-4,2914,23,2915,534,0
20141229.112612,2914,48,1207756,-42,2914,1,2915,535,0
20141229.112612,2914,12,1207768,-2,2913,616,2914,50,0
20141229.112613,2914,42,1207810,-40,2913,618,2914,31,0
20141229.112613,2913,12,1207822,0,2913,616,2914,29,0
20141229.112614,2913,10,1207832,2,2913,632,2914,25,0
20141229.112614,2914,24,1207856,-2,2913,630,2914,14,1
20141229.112615,2914,2,1207858,0,2913,628,2914,13,1
20141229.112615,2914,6,1207864,-4,2913,626,2914,11,1
20141229.112616,2914,4,1207868,0,2913,627,2914,12,1
20141229.112617,2914,94,1207962,66,2913,577,2914,199,1
20141229.112618,2914,20,1207982,12,2913,493,2914,307,1
20141229.112619,2914,2,1207984,2,2913,492,2914,308,1
20141229.112619,2913,22,1208006,0,2913,481,2914,310,0
20141229.11262,2914,212,1208218,198,2913,475,2914,212,1
20141229.112621,2913,26,1208244,-26,2913,462,2914,212,0
20141229.112621,2914,12,1208256,0,2913,456,2914,209,1
20141229.112622,2914,8,1208264,8,2913,454,2914,213,1
20141229.112622,2913,6,1208270,-6,2913,451,2914,214,0
20141229.112623,2913,6,1208276,-6,2913,448,2914,218,0
20141229.112624,2914,6,1208282,6,2913,448,2914,216,1
20141229.112624,2914,12,1208294,0,2913,442,2914,210,1
20141229.112627,2913,6,1208300,-6,2913,462,2914,249,0
20141229.112627,2914,4,1208304,4,2913,463,2914,247,1
20141229.112628,2913,6,1208310,-6,2913,460,2914,247,0
20141229.112629,2913,2,1208312,-2,2913,459,2914,247,0
20141229.11263,2913,6,1208318,-4,2913,476,2914,250,0
20141229.112631,2913,6,1208324,0,2913,473,2914,250,0
20141229.112633,2914,452,1208776,168,2913,470,2914,29,1
20141229.112633,2914,60,1208836,44,2914,75,2915,416,1
20141229.112634,2914,6,1208842,2,2914,96,2915,415,1
20141229.112634,2915,2,1208844,0,2914,170,2915,414,1
20141229.112635,2915,50,1208894,0,2914,174,2915,500,1
20141229.112636,2914,10,1208904,10,2914,170,2915,501,0
20141229.112637,2915,112,1209016,84,2914,160,2915,456,1
20141229.112638,2914,18,1209034,0,2914,155,2915,456,0
20141229.112638,2915,40,1209074,26,2914,154,2915,438,1
20141229.112639,2914,102,1209176,82,2913,328,2915,448,0
20141229.11264,2915,2,1209178,0,2914,128,2915,447,1
20141229.112642,2915,124,1209302,76,2914,131,2915,375,1
20141229.112642,2914,2,1209304,0,2914,130,2915,375,0
20141229.112643,2914,2,1209306,0,2914,146,2915,374,0
20141229.112644,2914,106,1209412,14,2913,410,2915,399,0
20141229.112645,2915,120,1209532,-50,2914,106,2915,330,1
20141229.112645,2914,2,1209534,2,2914,145,2915,332,0
20141229.112646,2915,52,1209586,52,2914,151,2915,306,1
20141229.112647,2915,54,1209640,54,2914,202,2915,280,1
20141229.112647,2915,14,1209654,14,2914,341,2915,273,1
20141229.112648,2915,18,1209672,16,2914,343,2915,264,1
20141229.112649,2915,2,1209674,2,2914,374,2915,263,1
20141229.112649,2915,4,1209678,0,2914,374,2915,262,1
20141229.11265,2914,8,1209686,0,2914,373,2915,319,0
20141229.11265,2915,184,1209870,-34,2914,373,2915,228,1
20141229.112651,2915,350,1210220,-72,2914,459,2915,54,1
20141229.112651,2915,30,1210250,-6,2914,469,2915,41,1
20141229.112652,2915,82,1210332,2,2915,230,2916,812,1
20141229.112652,2916,2,1210334,-2,2915,300,2916,734,1
20141229.112653,2916,6,1210340,2,2915,336,2916,732,1
20141229.112653,2915,30,1210370,4,2915,362,2916,719,0
20141229.112654,2915,104,1210474,104,2915,311,2916,721,0
20141229.112654,2915,12,1210486,-6,2915,309,2916,717,0
20141229.112655,2916,406,1210892,112,2915,107,2916,726,1
20141229.112655,2915,204,1211096,122,2914,469,2915,118,0
20141229.112656,2915,4,1211100,2,2914,369,2915,217,0
20141229.112656,2915,6,1211106,4,2914,369,2915,216,0
20141229.112657,2915,4,1211110,2,2914,369,2915,214,0
20141229.112657,2915,24,1211134,2,2914,359,2915,222,0
20141229.112658,2914,6,1211140,0,2914,363,2915,220,0
20141229.112658,2915,8,1211148,4,2914,343,2915,216,1
20141229.112659,2915,40,1211188,-14,2914,330,2915,209,1
20141229.112659,2915,8,1211196,4,2914,331,2915,205,1
20141229.1127,2915,4,1211200,4,2914,331,2915,202,1
20141229.1127,2915,20,1211220,20,2914,341,2915,192,1
20141229.112701,2915,124,1211344,0,2914,344,2915,130,1
20141229.112702,2915,2,1211346,0,2914,352,2915,130,1
20141229.112703,2915,2,1211348,2,2914,352,2915,129,1
20141229.112703,2915,10,1211358,0,2914,352,2915,24,1
20141229.112704,2914,2,1211360,-2,2914,351,2915,24,0
20141229.112705,2915,72,1211432,-4,2915,48,2916,683,1
20141229.112705,2915,102,1211534,-88,2915,5,2916,684,1
20141229.112706,2914,64,1211598,-12,2914,391,2915,5,0
20141229.112706,2915,2,1211600,-2,2914,376,2915,4,1
20141229.112706,2915,14,1211614,-14,2914,381,2915,209,1
20141229.112707,2915,18,1211632,-4,2914,389,2915,262,1
20141229.112709,2915,2,1211634,0,2914,441,2915,270,1
20141229.112711,2915,32,1211666,0,2914,439,2915,264,1
20141229.112712,2915,6,1211672,-6,2914,440,2915,258,1
20141229.112712,2915,6,1211678,0,2914,440,2915,255,1
20141229.112713,2915,22,1211700,0,2914,440,2915,245,1
20141229.112714,2914,20,1211720,-20,2914,431,2915,80,0
20141229.112715,2915,2,1211722,0,2914,434,2915,51,1
20141229.112715,2915,8,1211730,0,2914,434,2915,47,1
20141229.112716,2915,4,1211734,2,2914,434,2915,45,1
20141229.112716,2915,88,1211822,66,2914,444,2915,1,1
20141229.112717,2915,124,1211946,6,2915,950,2916,689,1
20141229.112717,2916,428,1212374,382,2914,444,2916,735,1
20141229.112718,2915,56,1212430,-6,2914,442,2915,3,0
20141229.112718,2915,198,1212628,-198,2914,384,2915,88,0
20141229.112719,2915,32,1212660,0,2914,385,2915,72,0
20141229.11272,2915,18,1212678,0,2914,3405,2915,16,0
20141229.11272,2915,22,1212700,22,2914,406,2915,15,0
20141229.112721,2915,2,1212702,2,2914,396,2915,22,0
20141229.112721,2915,2,1212704,0,2914,425,2915,58,0
20141229.112722,2915,6,1212710,2,2914,326,2915,85,0
20141229.112723,2915,42,1212752,-34,2914,326,2915,86,0
20141229.112724,2915,12,1212764,0,2914,327,2915,130,0
20141229.112724,2915,6,1212770,2,2914,327,2915,149,0
20141229.112726,2915,2,1212772,2,2914,327,2915,212,0
20141229.112726,2915,2,1212774,2,2914,327,2915,272,0
20141229.112727,2915,2,1212776,2,2914,337,2915,272,0
20141229.112728,2915,22,1212798,22,2914,338,2915,293,0
20141229.112729,2915,2,1212800,2,2914,338,2915,355,0
20141229.11273,2914,2,1212802,0,2914,337,2915,357,0
20141229.112731,2915,6,1212808,6,2914,337,2915,355,1
20141229.112732,2915,4,1212812,4,2914,337,2915,378,1
20141229.112732,2914,96,1212908,-84,2914,289,2915,358,0
20141229.112734,2914,242,1213150,-106,2914,158,2915,374,0
20141229.112734,2914,314,1213464,-74,2913,379,2914,12,0
20141229.112735,2913,402,1213866,300,2913,370,2915,216,0
20141229.112735,2914,14,1213880,-14,2913,350,2915,205,1
20141229.112736,2914,32,1213912,30,2913,350,2914,84,1
20141229.112737,2914,56,1213968,0,2913,342,2914,71,1
20141229.112739,2914,8,1213976,6,2913,342,2914,107,1
20141229.11274,2914,4,1213980,4,2913,3354,2914,105,1
20141229.11274,2914,20,1214000,20,2913,5397,2914,95,1
20141229.112741,2914,190,1214190,-30,2914,10,2915,306,1
20141229.112741,2914,78,1214268,6,2913,377,2915,307,1
20141229.112742,2913,24,1214292,0,2913,333,2914,269,0
20141229.112742,2914,2,1214294,0,2913,270,2914,268,1
20141229.112745,2914,2,1214296,-2,2913,256,2914,273,1
20141229.112746,2914,8,1214304,-8,2913,258,2914,272,1
20141229.112747,2914,10,1214314,0,2913,259,2914,309,1
20141229.112747,2914,60,1214374,-60,2913,259,2914,279,1
20141229.112749,2914,4,1214378,-4,2913,259,2914,284,1
20141229.112754,2914,2,1214380,0,2913,267,2914,288,1
20141229.112755,2913,2,1214382,-2,2913,276,2914,288,0
20141229.112755,2914,82,1214464,2,2913,276,2914,248,1
20141229.112756,2914,2,1214466,-2,2913,277,2914,248,1
20141229.112757,2914,10,1214476,-10,2913,275,2914,243,1
20141229.112758,2913,2,1214478,0,2913,275,2914,278,0
20141229.112759,2913,4,1214482,-2,2913,273,2914,289,0
20141229.112759,2913,2,1214484,0,2913,272,2914,289,0
20141229.1128,2913,4,1214488,0,2913,265,2914,288,0
20141229.112801,2913,30,1214518,26,2913,250,2914,288,0
20141229.112802,2913,100,1214618,-30,2913,200,2914,389,0
20141229.112802,2913,190,1214808,106,2913,104,2914,405,0
20141229.112803,2913,222,1215030,-56,2912,433,2914,414,0
20141229.112803,2913,2,1215032,2,2912,400,2913,40,0
20141229.112804,2913,2,1215034,2,2912,391,2913,79,0
20141229.112805,2913,30,1215064,0,2912,391,2913,67,0
20141229.112806,2913,4,1215068,2,2912,376,2913,86,0
20141229.112807,2912,10,1215078,-10,2912,370,2913,91,0
20141229.112809,2913,4,1215082,0,2912,310,2913,111,1
20141229.11281,2912,2,1215084,-2,2912,299,2913,152,0
20141229.112811,2912,10,1215094,-10,2912,294,2913,170,0
20141229.112811,2912,128,1215222,-104,2912,231,2913,171,0
20141229.112812,2913,2,1215224,0,2912,234,2913,171,1
20141229.112812,2913,2,1215226,0,2912,258,2913,171,1
20141229.112814,2912,8,1215234,0,2912,255,2913,172,0
20141229.112814,2913,6,1215240,0,2912,255,2913,172,1
20141229.112815,2912,12,1215252,0,2912,250,2913,196,0
20141229.112815,2912,434,1215686,-270,2912,19,2913,205,0
20141229.112816,2912,146,1215832,12,2912,16,2913,229,0
20141229.112816,2912,42,1215874,18,2911,619,2912,27,0
20141229.112817,2911,2,1215876,-2,2911,629,2912,127,0
20141229.112817,2912,10,1215886,-4,2911,614,2912,344,1
20141229.112818,2911,8,1215894,0,2911,610,2912,345,0
20141229.11282,2911,2,1215896,0,2911,617,2912,352,0
20141229.11282,2911,2,1215898,0,2911,616,2912,364,0
20141229.112821,2911,82,1215980,26,2911,575,2912,364,0
20141229.112821,2911,6,1215986,4,2911,563,2912,365,0
20141229.112822,2911,100,1216086,-42,2911,525,2912,359,0
20141229.112823,2911,32,1216118,-12,2911,508,2912,360,0
20141229.112823,2912,2,1216120,2,2911,515,2912,361,1
20141229.112824,2911,2,1216122,2,2911,514,2912,361,0
20141229.112824,2911,6,1216128,0,2911,513,2912,359,0
20141229.112825,2911,2,1216130,-2,2911,525,2912,359,0
20141229.112826,2911,10,1216140,-6,2911,520,2912,349,0
20141229.112827,2912,4,1216144,0,2911,517,2912,347,1
20141229.112828,2911,6,1216150,-6,2911,513,2912,349,0
20141229.112828,2911,14,1216164,-14,2911,505,2912,364,0
20141229.112829,2912,2,1216166,2,2911,505,2912,363,1
20141229.112829,2911,100,1216266,-24,2911,456,2912,363,0
20141229.11283,2912,8,1216274,-2,2911,454,2912,361,1
20141229.11283,2911,40,1216314,40,2911,449,2912,361,0
20141229.112831,2912,6,1216320,0,2911,447,2912,360,1
20141229.112832,2911,208,1216528,-116,2911,426,2912,385,0
20141229.112833,2911,4,1216532,0,2911,428,2912,386,0
20141229.112834,2911,2,1216534,-2,2911,429,2912,387,0
20141229.112835,2911,6,1216540,-4,2911,427,2912,392,0
20141229.112835,2911,40,1216580,0,2911,407,2912,393,0
20141229.112837,2911,2,1216582,-2,2911,407,2912,393,0
20141229.112838,2911,2,1216584,-2,2911,406,2912,187,0
20141229.112839,2912,376,1216960,-122,2912,12,2913,239,1
20141229.112839,2912,44,1217004,-22,2912,20,2913,202,1
20141229.11284,2912,6,1217010,2,2912,28,2913,207,1
20141229.11284,2912,4,1217014,2,2912,26,2913,207,1
20141229.112841,2912,52,1217066,40,2911,504,2912,5,1
20141229.112841,2912,10,1217076,-10,2911,476,2912,108,1
20141229.112843,2912,12,1217088,-10,2911,489,2912,8,1
20141229.112844,2912,16,1217104,-16,2912,10,2913,146,1
20141229.112844,2912,8,1217112,-4,2912,37,2913,181,1
20141229.112845,2912,8,1217120,-2,2912,95,2913,281,1
20141229.112845,2912,4,1217124,-2,2912,93,2913,281,1
20141229.112846,2912,10,1217134,6,2912,108,2913,281,1
20141229.112846,2912,256,1217390,198,2911,496,2912,74,1
20141229.112847,2911,18,1217408,-10,2911,477,2912,73,0
20141229.112847,2912,2,1217410,2,2911,477,2912,75,1
20141229.112849,2912,2,1217412,2,2911,497,2912,311,1
20141229.112851,2911,6,1217418,0,2911,481,2912,524,0
20141229.112852,2912,86,1217504,-40,2911,559,2912,503,1
20141229.112852,2912,4,1217508,2,2911,559,2912,501,1
20141229.112854,2911,74,1217582,-8,2911,609,2912,469,0
20141229.112855,2911,4,1217586,-2,2911,608,2912,469,0
20141229.112856,2912,2,1217588,0,2911,618,2912,468,1
20141229.112858,2911,2,1217590,-2,2911,619,2912,268,0
20141229.112858,2912,20,1217610,10,2911,614,2912,263,1
20141229.112859,2911,20,1217630,0,2911,603,2912,263,0
20141229.112859,2912,4,1217634,0,2911,603,2912,195,1
20141229.1129,2911,18,1217652,-2,2911,602,2912,187,0
20141229.112901,2912,2,1217654,0,2911,604,2912,187,1
20141229.112901,2912,394,1218048,58,2912,36,2913,482,1
20141229.112903,2913,60,1218108,-26,2912,26,2913,467,1
20141229.112903,2912,14,1218122,0,2912,19,2913,465,0
20141229.112905,2912,34,1218156,20,2912,52,2913,465,0
20141229.112906,2912,10,1218166,-6,2912,54,2913,467,0
20141229.112908,2913,4,1218170,-2,2912,60,2913,466,1
20141229.112909,2912,20,1218190,0,2912,50,2913,466,0
20141229.112909,2912,10,1218200,-6,2912,45,2913,466,0
20141229.112911,2912,6,1218206,-6,2912,47,2913,473,0
20141229.112912,2912,6,1218212,-6,2912,44,2913,478,0
20141229.112915,2912,14,1218226,-4,2912,75,2913,476,0
20141229.112916,2912,14,1218240,-12,2912,71,2913,474,0
20141229.112917,2913,2,1218242,0,2912,96,2913,472,1
20141229.112918,2912,12,1218254,0,2912,90,2913,473,0
20141229.11292,2912,400,1218654,-316,2911,635,2912,12,0
20141229.11292,2912,28,1218682,-6,2912,1,2913,473,0
20141229.112921,2911,132,1218814,-126,2911,577,2913,483,0
20141229.112922,2912,4,1218818,2,2912,1,2913,482,1
20141229.112922,2913,42,1218860,2,2911,553,2913,482,1
20141229.112923,2913,34,1218894,-34,2911,557,2912,1,1
20141229.112923,2912,2,1218896,0,2911,557,2913,454,0
20141229.112924,2912,2,1218898,-2,2911,558,2913,465,0
20141229.112924,2911,200,1219098,28,2911,463,2913,460,0
20141229.112925,2912,24,1219122,-18,2912,29,2913,470,1
20141229.112926,2912,60,1219182,58,2911,459,2912,9,1
20141229.112927,2912,8,1219190,6,2911,440,2912,33,1
20141229.112928,2912,2,1219192,0,2911,440,2912,59,1
20141229.112928,2911,4,1219196,2,2911,429,2912,59,0
20141229.112929,2912,4,1219200,2,2911,433,2912,57,1
20141229.11293,2911,2,1219202,-2,2911,432,2912,38,0
20141229.112931,2911,2,1219204,0,2911,406,2912,62,0
20141229.112931,2912,124,1219328,-106,2912,22,2913,429,1
20141229.112932,2912,142,1219470,-38,2912,1,2913,373,1
20141229.112933,2912,2,1219472,-2,2912,1,2913,373,1
20141229.112933,2912,2,1219474,0,2911,449,2913,373,1
20141229.112934,2912,2,1219476,-2,2912,99,2913,373,1
20141229.112934,2912,2,1219478,0,2912,98,2913,373,1
20141229.112935,2912,56,1219534,-52,2912,71,2913,373,1
20141229.112936,2912,12,1219546,0,2912,65,2913,397,1
20141229.112937,2912,6,1219552,-4,2912,64,2913,397,1
20141229.112938,2912,4,1219556,-4,2912,62,2913,477,1
20141229.112938,2912,4,1219560,-4,2912,60,2913,477,1
20141229.112939,2912,2,1219562,-2,2912,59,2913,478,1
20141229.112939,2912,52,1219614,-52,2912,34,2913,478,1
20141229.11294,2912,2,1219616,0,2912,34,2913,478,1
20141229.112941,2912,170,1219786,96,2912,149,2913,480,1
20141229.112941,2912,4,1219790,0,2912,147,2913,480,1
20141229.112944,2913,12,1219802,0,2912,147,2913,480,1
20141229.112945,2912,8,1219810,8,2912,143,2913,480,0
20141229.112946,2912,2,1219812,2,2912,149,2913,480,0
20141229.112947,2912,20,1219832,0,2912,198,2913,481,0
20141229.112952,2912,22,1219854,0,2912,200,2913,485,0
20141229.112952,2912,12,1219866,0,2912,194,2913,485,0
20141229.112954,2913,6,1219872,2,2912,195,2913,482,1
20141229.112955,2912,18,1219890,18,2912,186,2913,482,0
20141229.112955,2912,24,1219914,20,2912,175,2913,400,0
20141229.112956,2912,4,1219918,0,2912,173,2913,400,0
20141229.112958,2913,4,1219922,2,2912,175,2913,398,1
20141229.112959,2913,2,1219924,2,2912,174,2913,397,1
20141229.112959,2912,4,1219928,0,2912,175,2913,397,0
20141229.113,2913,2,1219930,0,2912,178,2913,396,1
20141229.133,2912,66,1219996,66,2912,145,2913,396,0
20141229.133001,2912,794,1220790,372,2911,207,2912,600,0
20141229.133001,2912,76,1220866,54,2911,213,2912,583,0
20141229.133002,2912,12,1220878,10,2911,247,2912,387,0
20141229.133002,2912,26,1220904,16,2911,246,2912,391,0
20141229.133003,2912,70,1220974,8,2911,226,2912,403,0
20141229.133003,2912,72,1221046,32,2911,223,2912,374,0
20141229.133004,2912,1492,1222538,1236,2911,3522,2912,333,0
20141229.133004,2911,6,1222544,6,2911,5523,2912,275,0
20141229.133005,2912,84,1222628,82,2911,5674,2912,232,1
20141229.133005,2912,6,1222634,4,2911,154,2912,229,1
20141229.133006,2912,266,1222900,240,2911,66,2912,183,1
20141229.133006,2912,82,1222982,2,2911,212,2912,226,1
20141229.133007,2911,2,1222984,0,2911,295,2912,259,0
20141229.133007,2911,2,1222986,2,2911,297,2912,234,0
20141229.133008,2911,4,1222990,2,2911,296,2912,294,0
20141229.133009,2911,2,1222992,0,2911,293,2912,298,0
20141229.13301,2911,4,1222996,4,2911,292,2912,303,0
20141229.13301,2911,4,1223000,2,2911,290,2912,304,0
20141229.133011,2911,6,1223006,0,2911,287,2912,305,0
20141229.133012,2911,2,1223008,0,2911,405,2912,298,0
20141229.133013,2912,2,1223010,2,2911,406,2912,287,1
20141229.133013,2912,48,1223058,2,2911,1405,2912,263,1
20141229.133014,2911,2,1223060,0,2911,1405,2912,260,0
20141229.133015,2912,242,1223302,154,2911,5407,2912,140,1
20141229.133015,2913,304,1223606,202,2912,330,2913,895,1
20141229.133015,2912,32,1223638,20,2912,260,2913,888,0
20141229.133016,2912,520,1224158,0,2911,5410,2912,382,0
20141229.133018,2912,74,1224232,-12,2911,5419,2912,350,0
20141229.133018,2912,252,1224484,-4,2911,5422,2912,226,0
20141229.133019,2912,238,1224722,-138,2911,5432,2912,107,0
20141229.133019,2913,130,1224852,-92,2911,5432,2913,924,1
20141229.133019,2911,2,1224854,2,2911,5431,2912,5,0
20141229.13302,2913,400,1225254,-10,2912,1,2913,730,1
20141229.133021,2912,2,1225256,2,2912,51,2913,735,0
20141229.133022,2913,8,1225264,8,2912,61,2913,731,1
20141229.133022,2912,4,1225268,-2,2912,59,2913,731,0
20141229.133022,2912,2,1225270,0,2912,59,2913,731,0
20141229.133023,2912,10,1225280,0,2912,55,2913,731,0
20141229.133024,2913,14,1225294,14,2912,55,2913,744,1
20141229.133024,2912,4,1225298,-4,2912,54,2913,784,0
20141229.133025,2912,20,1225318,-20,2912,44,2913,794,0
20141229.133025,2912,102,1225420,-84,2911,489,2912,53,0
20141229.133026,2912,2,1225422,2,2911,532,2912,52,0
20141229.133026,2912,382,1225804,-296,2911,480,2913,784,0
20141229.133027,2912,6,1225810,2,2911,476,2912,6,0
20141229.133028,2912,122,1225932,-120,2911,475,2912,86,0
20141229.133029,2912,88,1226020,0,2911,484,2912,42,0
20141229.13303,2911,20,1226040,0,2911,464,2912,44,0
20141229.13303,2912,20,1226060,0,2911,464,2912,38,1
20141229.133032,2912,2,1226062,0,2911,465,2912,47,1
20141229.133033,2912,4,1226066,0,2911,464,2912,45,1
20141229.133033,2912,4,1226070,0,2911,464,2912,108,1
20141229.133034,2912,4,1226074,0,2911,473,2912,157,1
20141229.133034,2912,2,1226076,0,2911,463,2912,201,1
20141229.133035,2912,24,1226100,0,2911,463,2912,219,1
20141229.133036,2910,1372,1227472,-92,2910,576,2912,274,0
20141229.133036,2910,74,1227546,12,2910,523,2911,116,0
20141229.133037,2911,328,1227874,-150,2910,360,2911,67,1
20141229.133037,2910,6,1227880,-2,2910,358,2911,123,0
20141229.133038,2910,8,1227888,2,2910,357,2911,160,0
20141229.133038,2910,20,1227908,0,2910,347,2911,150,0
20141229.133039,2911,22,1227930,-22,2910,343,2911,169,1
20141229.13304,2909,1000,1228930,-596,2909,109,2911,169,0
20141229.13304,2910,144,1229074,-46,2909,77,2910,81,1
20141229.133041,2910,44,1229118,-22,2909,86,2910,163,1
20141229.133041,2909,376,1229494,-216,2909,14,2910,214,0
20141229.133041,2910,30,1229524,0,2909,84,2910,239,1
20141229.133042,2909,162,1229686,78,2909,25,2910,238,0
20141229.133043,2909,46,1229732,24,2909,18,2910,235,0
20141229.133043,2909,12,1229744,0,2909,27,2910,238,0
20141229.133044,2908,766,1230510,-644,2908,764,2909,1,0
20141229.133044,2908,148,1230658,-146,2908,695,2909,65,0
20141229.133045,2908,92,1230750,-88,2908,661,2909,61,0
20141229.133045,2908,4,1230754,-2,2908,655,2909,73,0
20141229.133046,2908,12,1230766,-10,2908,689,2909,144,0
20141229.133047,2909,32,1230798,-20,2908,590,2909,155,1
20141229.133047,2908,6,1230804,-2,2908,588,2909,154,0
20141229.133048,2908,14,1230818,-12,2908,581,2909,102,0
20141229.133049,2908,112,1230930,-2,2908,529,2909,497,0
20141229.133049,2908,18,1230948,-2,2908,525,2909,501,0
20141229.13305,2908,2,1230950,0,2908,525,2909,501,0
20141229.13305,2909,44,1230994,-42,2908,527,2909,480,1
20141229.133051,2908,1014,1232008,-722,2908,46,2909,479,0
20141229.133051,2908,92,1232100,26,2907,250,2908,158,0
20141229.133052,2908,136,1232236,58,2907,227,2908,177,0
20141229.133052,2908,2,1232238,0,2907,313,2908,181,0
20141229.133053,2908,144,1232382,50,2907,244,2908,211,0
20141229.133053,2908,18,1232400,-8,2907,244,2908,145,0
20141229.133054,2907,136,1232536,116,2907,241,2908,76,0
20141229.133054,2908,240,1232776,-82,2908,15,2909,134,1
20141229.133055,2908,18,1232794,-4,2908,40,2909,164,1
20141229.133055,2908,30,1232824,0,2908,20,2909,244,1
20141229.133056,2907,234,1233058,-32,2907,255,2908,53,0
20141229.133056,2908,26,1233084,-24,2907,262,2908,88,1
20141229.133057,2908,80,1233164,-66,2907,271,2908,52,1
20141229.133058,2908,52,1233216,10,2907,288,2908,26,1
20141229.133058,2908,54,1233270,44,2907,291,2908,9,1
20141229.133059,2908,20,1233290,-14,2908,21,2909,233,1
20141229.1331,2907,46,1233336,-14,2908,8,2909,249,0
20141229.1331,2908,26,1233362,-2,2908,93,2909,729,1
20141229.133101,2908,278,1233640,-98,2907,256,2908,183,1
20141229.133101,2908,70,1233710,-38,2907,232,2908,159,1
20141229.133101,2908,22,1233732,-10,2907,232,2908,153,1
20141229.133102,2907,26,1233758,-2,2907,220,2908,213,0
20141229.133103,2908,210,1233968,148,2907,230,2908,369,1
20141229.133103,2908,20,1233988,-2,2907,222,2908,368,1
20141229.133104,2908,62,1234050,2,2907,223,2908,359,1
20141229.133104,2908,8,1234058,-4,2907,165,2908,355,1
20141229.133105,2908,62,1234120,-32,2907,170,2908,327,1
20141229.133105,2907,358,1234478,186,2906,512,2908,327,0
20141229.133106,2907,66,1234544,50,2906,471,2907,310,0
20141229.133107,2906,564,1235108,-166,2906,325,2907,127,0
20141229.133107,2906,140,1235248,-110,2906,256,2907,128,0
20141229.133107,2905,1492,1236740,-1058,2905,305,2906,180,0
20141229.133108,2905,94,1236834,-12,2905,291,2906,234,0
20141229.133108,2906,214,1237048,-174,2905,239,2906,378,1
20141229.133109,2905,34,1237082,-10,2905,410,2906,361,0
20141229.133109,2905,24,1237106,-18,2905,396,2906,359,0
20141229.13311,2905,66,1237172,-22,2905,382,2906,339,0
20141229.13311,2905,6,1237178,2,2905,397,2906,289,0
20141229.133111,2905,272,1237450,-202,2905,436,2906,156,0
20141229.133112,2906,344,1237794,-308,2906,170,2907,442,1
20141229.133112,2906,24,1237818,-16,2906,189,2907,417,1
20141229.133113,2907,14,1237832,-2,2906,411,2907,380,1
20141229.133113,2907,20,1237852,0,2906,524,2907,339,1
20141229.133113,2907,60,1237912,20,2906,516,2907,1093,1
20141229.133114,2906,34,1237946,22,2906,526,2907,6104,0
20141229.133115,2906,4,1237950,0,2906,625,2907,6134,0
20141229.133115,2906,6,1237956,0,2906,665,2907,162,0
20141229.133116,2907,242,1238198,52,2907,29,2908,258,1
20141229.133116,2907,12,1238210,-2,2907,131,2908,247,1
20141229.133117,2907,4,1238214,0,2907,142,2908,447,1
20141229.133117,2907,2,1238216,0,2907,138,2908,453,1
20141229.133118,2907,116,1238332,-76,2907,80,2908,473,1
20141229.133118,2907,4,1238336,-2,2907,98,2908,474,1
20141229.133119,2907,8,1238344,-4,2907,94,2908,474,1
20141229.133119,2907,196,1238540,-80,2907,94,2908,560,1
20141229.13312,2907,202,1238742,-192,2906,1299,2907,10,1
20141229.13312,2907,14,1238756,4,2906,1312,2907,37,1
20141229.133121,2907,78,1238834,-4,2907,139,2908,604,1
20141229.133121,2908,80,1238914,-28,2907,135,2908,555,1
20141229.133122,2907,2,1238916,0,2907,137,2908,571,0
20141229.133123,2907,28,1238944,-26,2907,143,2908,596,0
20141229.133124,2907,22,1238966,-12,2907,140,2908,595,0
20141229.133124,2908,22,1238988,2,2907,141,2908,588,1
20141229.133125,2907,4,1238992,0,2907,140,2908,587,0
20141229.133125,2907,4,1238996,0,2907,140,2908,585,0
20141229.133126,2907,48,1239044,-4,2907,132,2908,586,0
20141229.133126,2907,52,1239096,30,2907,123,2908,589,0
20141229.133127,2907,34,1239130,8,2907,111,2908,584,0
20141229.133127,2907,34,1239164,-4,2907,96,2908,583,0
20141229.133128,2907,12,1239176,0,2907,90,2908,585,0
20141229.133128,2908,82,1239258,2,2907,53,2908,583,1
20141229.133129,2907,106,1239364,52,2906,1315,2908,583,0
20141229.13313,2907,2,1239366,0,2906,1347,2907,5,0
20141229.13313,2907,10,1239376,-6,2906,1343,2907,10,0
20141229.133131,2907,32,1239408,-14,2907,45,2908,595,0
20141229.133131,2907,26,1239434,-12,2907,129,2908,585,0
20141229.133132,2908,98,1239532,-90,2907,110,2908,561,1
20141229.133132,2907,4,1239536,0,2907,121,2908,546,0
20141229.133132,2907,14,1239550,-10,2907,117,2908,546,0
20141229.133133,2908,200,1239750,14,2907,118,2908,431,1
20141229.133134,2908,8,1239758,-2,2907,168,2908,438,1
20141229.133134,2907,10,1239768,0,2907,303,2908,109,0
20141229.133135,2908,2,1239770,2,2907,353,2908,135,1
20141229.133135,2908,272,1240042,38,2907,378,2909,433,1
20141229.133136,2908,20,1240062,-12,2908,29,2909,387,1
20141229.133137,2907,872,1240934,-386,2906,706,2908,32,0
20141229.133138,2907,14,1240948,-12,2907,131,2908,157,0
20141229.133139,2908,14,1240962,-2,2907,217,2908,386,1
20141229.13314,2907,10,1240972,-10,2907,223,2908,412,0
20141229.13314,2907,2,1240974,0,2907,227,2908,412,0
20141229.133141,2908,86,1241060,-12,2907,188,2908,428,1
20141229.133142,2907,8,1241068,0,2907,189,2908,428,0
20141229.133143,2908,2,1241070,0,2907,323,2908,434,1
20141229.133144,2907,26,1241096,-26,2907,324,2908,428,0
20141229.133145,2907,20,1241116,0,2907,315,2908,428,0
20141229.133145,2908,82,1241198,-72,2907,289,2908,438,1
20141229.133146,2908,2,1241200,0,2907,299,2908,437,1
20141229.133147,2907,44,1241244,-2,2907,277,2908,437,0
20141229.133148,2908,2,1241246,0,2907,277,2908,436,1
20141229.133148,2907,10,1241256,-6,2907,325,2908,432,0
20141229.133149,2907,4,1241260,0,2907,323,2908,433,0
20141229.133149,2908,2,1241262,0,2907,323,2908,432,1
20141229.13315,2908,2,1241264,0,2907,325,2908,431,1
20141229.13315,2908,2,1241266,0,2907,335,2908,428,1
20141229.133151,2907,6,1241272,0,2907,334,2908,426,0
20141229.133151,2907,586,1241858,-408,2907,41,2908,427,0
20141229.133152,2907,106,1241964,-42,2906,611,2907,48,0
20141229.133152,2907,2,1241966,0,2906,611,2907,48,0
20141229.133153,2906,24,1241990,-18,2906,610,2907,70,0
20141229.133153,2907,346,1242336,-338,2907,591,2908,454,1
20141229.133155,2907,2,1242338,-2,2907,598,2908,429,1
20141229.133156,2907,82,1242420,-82,2907,565,2908,429,1
20141229.133156,2907,4,1242424,-2,2907,564,2908,428,1
20141229.133157,2908,50,1242474,-42,2907,567,2908,405,1
20141229.133158,2907,12,1242486,-6,2907,564,2908,206,0
20141229.133158,2907,4,1242490,-4,2907,566,2908,206,0
20141229.133159,2907,16,1242506,-16,2907,560,2908,213,0
20141229.1332,2907,2,1242508,0,2907,560,2908,253,0
20141229.1332,2907,6,1242514,-2,2907,564,2908,254,0
20141229.133201,2908,4,1242518,-2,2907,565,2908,252,1
20141229.133201,2907,14,1242532,-14,2907,563,2908,251,0
20141229.133203,2908,12,1242544,0,2907,579,2908,247,1
20141229.133205,2908,2,1242546,0,2907,578,2908,318,1
20141229.133205,2908,2,1242548,0,2907,578,2908,318,1
20141229.133206,2908,8,1242556,-6,2907,582,2908,318,1
20141229.133207,2907,916,1243472,-910,2907,139,2908,309,0
20141229.133207,2907,250,1243722,-198,2907,16,2908,268,0
20141229.133208,2907,34,1243756,-14,2906,630,2907,56,0
20141229.133209,2907,10,1243766,-2,2906,633,2907,52,0
20141229.133209,2907,108,1243874,-104,2907,2,2908,254,0
20141229.133209,2907,10,1243884,-2,2907,48,2908,252,0
20141229.13321,2907,8,1243892,0,2907,44,2908,257,0
20141229.13321,2907,2,1243894,2,2907,44,2908,255,0
20141229.133211,2908,2,1243896,-2,2907,51,2908,254,1
20141229.133212,2907,124,1244020,98,2906,658,2907,138,0
20141229.133213,2907,2,1244022,2,2906,669,2907,140,0
20141229.133213,2907,216,1244238,58,2906,587,2907,33,0
20141229.133214,2907,68,1244306,16,2907,26,2908,255,0
20141229.133214,2907,64,1244370,-38,2907,21,2908,235,0
20141229.133215,2908,20,1244390,-20,2907,21,2908,218,1
20141229.133215,2907,38,1244428,-4,2907,4,2908,208,0
20141229.133216,2907,12,1244440,-4,2907,10,2908,209,0
20141229.133216,2907,42,1244482,-28,2906,588,2907,96,0
20141229.133217,2907,16,1244498,-10,2906,589,2907,91,0
20141229.133217,2907,6,1244504,0,2906,589,2907,96,0
20141229.133218,2907,60,1244564,-4,2906,590,2907,79,0
20141229.133219,2907,10,1244574,6,2906,601,2907,75,0
20141229.133219,2906,206,1244780,-34,2906,489,2907,73,0
20141229.13322,2907,2,1244782,0,2906,491,2907,167,1
20141229.133221,2907,24,1244806,2,2906,491,2907,358,1
20141229.133221,2906,8,1244814,8,2906,491,2907,396,0
20141229.133222,2907,4,1244818,4,2906,488,2907,395,1
20141229.133222,2906,6,1244824,6,2906,487,2907,393,0
20141229.133223,2907,2,1244826,0,2906,490,2907,394,1
20141229.133223,2907,2,1244828,0,2906,487,2907,194,1
20141229.133224,2906,82,1244910,80,2906,452,2907,194,0
20141229.133225,2907,6,1244916,0,2906,453,2907,191,1
20141229.133225,2907,2,1244918,2,2906,454,2907,190,1
20141229.133226,2907,4,1244922,4,2906,453,2907,189,1
20141229.133227,2907,6,1244928,2,2906,454,2907,188,1
20141229.133228,2907,4,1244932,4,2906,453,2907,212,1
20141229.133228,2907,2,1244934,0,2906,456,2907,213,1
20141229.133229,2906,12,1244946,0,2906,450,2907,213,0
20141229.133229,2907,64,1245010,2,2906,420,2907,212,1
20141229.13323,2907,404,1245414,138,2906,445,2907,13,1
20141229.133231,2907,26,1245440,18,2907,41,2908,391,1
20141229.133231,2906,204,1245644,164,2906,384,2908,376,0
20141229.133232,2906,4,1245648,0,2906,398,2907,101,0
20141229.133232,2906,114,1245762,12,2906,392,2907,128,0
20141229.133234,2906,10,1245772,10,2906,395,2907,128,0
20141229.133235,2907,28,1245800,-28,2906,400,2907,116,1
20141229.133236,2906,2,1245802,0,2906,402,2907,146,0
20141229.133237,2907,62,1245864,-60,2906,422,2907,141,1
20141229.133237,2907,2,1245866,0,2906,422,2907,149,1
20141229.133239,2906,16,1245882,-6,2906,425,2907,147,0
20141229.13324,2906,2,1245884,0,2906,437,2907,147,0
20141229.133241,2907,10,1245894,10,2906,408,2907,142,1
20141229.133241,2906,20,1245914,-10,2906,398,2907,158,0
20141229.133242,2907,38,1245952,38,2906,417,2907,143,1
20141229.133243,2906,2,1245954,0,2906,441,2907,143,0
20141229.133243,2906,34,1245988,24,2906,424,2907,144,0
20141229.133243,2907,2,1245990,0,2906,428,2907,144,1
20141229.133244,2907,24,1246014,6,2906,428,2907,133,1
20141229.133245,2907,8,1246022,4,2906,430,2907,136,1
20141229.133246,2906,2,1246024,0,2906,432,2907,136,0
20141229.133247,2907,18,1246042,10,2906,431,2907,354,1
20141229.133247,2906,834,1246876,260,2905,581,2906,783,0
20141229.133248,2905,626,1247502,-198,2904,754,2906,140,0
20141229.133248,2906,8,1247510,4,2904,672,2905,64,1
20141229.133249,2904,202,1247712,90,2904,682,2905,23,0
20141229.133249,2905,126,1247838,10,2905,231,2906,208,1
20141229.13325,2905,168,1248006,-166,2905,228,2906,190,1
20141229.13325,2906,76,1248082,-64,2905,229,2906,185,1
20141229.133251,2905,30,1248112,-22,2905,230,2906,191,0
20141229.133251,2905,4,1248116,-2,2905,234,2906,191,0
20141229.133252,2905,4,1248120,-2,2905,235,2906,195,0
20141229.133253,2906,18,1248138,-4,2905,239,2906,203,1
20141229.133254,2905,14,1248152,-14,2905,242,2906,208,0
20141229.133254,2906,6,1248158,2,2905,241,2906,207,1
20141229.133255,2905,14,1248172,2,2905,235,2906,208,0
20141229.133255,2905,34,1248206,-20,2905,239,2906,207,0
20141229.133256,2905,2,1248208,-2,2905,241,2906,207,0
20141229.133256,2905,6,1248214,-4,2905,243,2906,207,0
20141229.133257,2905,2,1248216,0,2905,301,2906,203,0
20141229.133258,2905,2,1248218,-2,2905,302,2906,204,0
20141229.133258,2906,2,1248220,0,2905,303,2906,204,1
20141229.133258,2906,2,1248222,2,2905,303,2906,203,1
20141229.133259,2905,2,1248224,0,2905,333,2906,154,0
20141229.1333,2906,50,1248274,2,2905,326,2906,381,1
20141229.133301,2905,24,1248298,2,2905,321,2906,415,0
20141229.133301,2905,4,1248302,-2,2905,320,2906,425,0
20141229.133302,2905,36,1248338,-22,2905,308,2906,435,0
20141229.133302,2906,2,1248340,2,2905,309,2906,440,1
20141229.133302,2905,10,1248350,-2,2905,307,2906,633,0
20141229.133303,2905,6,1248356,-4,2905,305,2906,411,0
20141229.133304,2905,2,1248358,0,2905,313,2906,415,0
20141229.133304,2905,6,1248364,-2,2905,339,2906,621,0
20141229.133305,2905,4,1248368,-4,2905,343,2906,484,0
20141229.133306,2905,16,1248384,-8,2905,346,2906,616,0
20141229.133306,2906,22,1248406,22,2905,346,2906,408,1
20141229.133306,2905,2,1248408,0,2905,346,2906,800,0
20141229.133307,2906,32,1248440,-30,2905,341,2906,824,1
20141229.133307,2906,348,1248788,-224,2905,172,2906,793,1
20141229.133308,2905,350,1249138,134,2904,1156,2905,27,0
20141229.133309,2904,38,1249176,-16,2904,981,2905,87,0
20141229.133309,2905,178,1249354,-128,2905,232,2906,815,1
20141229.133309,2905,30,1249384,-30,2905,234,2906,815,1
20141229.13331,2905,18,1249402,-14,2905,238,2906,814,1
20141229.133311,2906,10,1249412,4,2905,251,2906,810,1
20141229.133311,2905,6,1249418,-6,2905,274,2906,811,0
20141229.133312,2905,22,1249440,-22,2905,265,2906,812,0
20141229.133313,2905,232,1249672,-190,2905,201,2906,801,0
20141229.133314,2905,2,1249674,0,2905,251,2906,801,0
20141229.133314,2905,12,1249686,0,2905,252,2906,862,0
20141229.133315,2905,10,1249696,-6,2905,249,2906,931,0
20141229.133316,2905,30,1249726,-6,2905,235,2906,218,0
20141229.133316,2906,12,1249738,0,2905,259,2906,223,1
20141229.133317,2905,16,1249754,-2,2905,348,2906,222,0
20141229.133317,2906,8,1249762,0,2905,352,2906,224,1
20141229.133318,2905,6,1249768,-6,2905,392,2906,224,0
20141229.133318,2905,2,1249770,0,2905,393,2906,225,0
20141229.133319,2905,2,1249772,2,2905,398,2906,233,0
20141229.133319,2906,8,1249780,4,2905,400,2906,231,1
20141229.133321,2905,106,1249886,-6,2905,397,2906,198,0
20141229.133322,2906,26,1249912,-14,2905,411,2906,188,1
20141229.133322,2906,24,1249936,-16,2905,416,2906,177,1
20141229.133323,2905,2,1249938,2,2905,433,2906,178,0
20141229.133323,2906,8,1249946,-4,2905,462,2906,175,1
20141229.133325,2906,352,1250298,58,2906,238,2907,589,1
20141229.133325,2906,18,1250316,0,2906,374,2907,490,1
20141229.133325,2906,20,1250336,0,2906,423,2907,490,1
20141229.133326,2907,12,1250348,10,2906,426,2907,489,1
20141229.133327,2907,20,1250368,0,2906,432,2907,483,1
20141229.133328,2906,2,1250370,2,2906,449,2907,543,0
20141229.133329,2906,2,1250372,0,2906,448,2907,543,0
20141229.13333,2907,8,1250380,-8,2906,451,2907,539,1
20141229.133331,2907,2,1250382,0,2906,455,2907,538,1
20141229.133331,2907,10,1250392,-6,2906,473,2907,539,1
20141229.133333,2907,8,1250400,-8,2906,576,2907,535,1
20141229.133333,2906,22,1250422,0,2906,566,2907,535,0
20141229.133335,2907,6,1250428,0,2906,579,2907,537,1
20141229.133335,2907,22,1250450,20,2906,569,2907,536,1
20141229.133336,2907,24,1250474,-22,2906,569,2907,524,1
20141229.133336,2907,10,1250484,-4,2906,580,2907,520,1
20141229.133337,2906,2,1250486,0,2906,582,2907,620,0
20141229.133338,2906,6,1250492,6,2906,580,2907,620,0
20141229.133338,2907,4,1250496,0,2906,588,2907,618,1
20141229.133339,2906,4,1250500,2,2906,588,2907,618,0
20141229.13334,2906,2,1250502,2,2906,588,2907,618,0
20141229.133341,2907,42,1250544,38,2906,569,2907,625,1
20141229.133341,2906,2,1250546,2,2906,579,2907,676,0
20141229.133342,2906,2,1250548,2,2906,580,2907,676,0
20141229.133343,2907,1368,1251916,-380,2907,99,2908,556,1
20141229.133345,2907,4,1251920,0,2907,158,2908,366,1
20141229.133345,2907,4,1251924,-2,2907,156,2908,365,1
20141229.133346,2908,2,1251926,0,2907,155,2908,359,1
20141229.133347,2907,4,1251930,0,2907,153,2908,394,0
20141229.133347,2907,2,1251932,0,2907,152,2908,403,0
20141229.133348,2908,6,1251938,4,2907,152,2908,411,1
20141229.133349,2908,2,1251940,-2,2907,163,2908,414,1
20141229.13335,2908,24,1251964,4,2907,179,2908,461,1
20141229.133351,2907,56,1252020,-20,2907,185,2908,435,0
20141229.133351,2908,2,1252022,0,2907,186,2908,424,1
20141229.133352,2908,14,1252036,0,2907,181,2908,440,1
20141229.133353,2907,28,1252064,-28,2907,167,2908,440,0
20141229.133354,2908,12,1252076,10,2907,164,2908,433,1
20141229.133355,2908,22,1252098,2,2907,284,2908,422,1
20141229.133356,2908,6,1252104,4,2907,284,2908,432,1
20141229.133357,2908,40,1252144,-6,2907,297,2908,414,1
20141229.133358,2907,4,1252148,0,2907,300,2908,415,0
20141229.133358,2908,14,1252162,4,2907,301,2908,408,1
20141229.133359,2907,2,1252164,0,2907,302,2908,413,0
20141229.1334,2908,6,1252170,0,2907,299,2908,420,1
20141229.133401,2908,176,1252346,-138,2907,302,2908,343,1
20141229.133402,2907,14,1252360,-14,2907,298,2908,343,0
20141229.133403,2908,20,1252380,0,2907,298,2908,333,1
20141229.133404,2908,6,1252386,-6,2907,328,2908,333,1
20141229.133404,2908,22,1252408,-2,2907,328,2908,322,1
20141229.133405,2908,12,1252420,0,2907,330,2908,320,1
20141229.13341,2908,6,1252426,0,2907,360,2908,344,1
20141229.13341,2907,2,1252428,0,2907,361,2908,345,0
20141229.13341,2907,14,1252442,-14,2907,354,2908,345,0
20141229.133411,2907,12,1252454,0,2907,354,2908,340,0
20141229.133412,2908,2,1252456,-2,2907,355,2908,340,1
20141229.133413,2908,202,1252658,-92,2907,354,2908,240,1
20141229.133413,2908,2,1252660,-2,2907,365,2908,239,1
20141229.133414,2907,26,1252686,0,2907,361,2908,229,0
20141229.133415,2907,16,1252702,8,2907,357,2908,225,0
20141229.133415,2908,2,1252704,2,2907,357,2908,227,1
20141229.133417,2908,2,1252706,2,2907,363,2908,226,1
20141229.133417,2908,2,1252708,2,2907,365,2908,236,1
20141229.133418,2908,4,1252712,4,2907,367,2908,256,1
20141229.133419,2908,2,1252714,2,2907,367,2908,255,1
20141229.13342,2907,2,1252716,0,2907,367,2908,357,0
20141229.13342,2908,4,1252720,2,2907,367,2908,357,1
20141229.133421,2908,402,1253122,156,2907,377,2908,157,1
20141229.133422,2908,4,1253126,4,2907,380,2908,161,1
20141229.133423,2908,4,1253130,0,2907,379,2908,159,1
20141229.133423,2908,4,1253134,0,2907,369,2908,158,1
20141229.133424,2908,14,1253148,14,2907,369,2908,151,1
20141229.133424,2908,42,1253190,2,2907,379,2908,130,1
20141229.133425,2907,6,1253196,4,2907,378,2908,128,0
20141229.133426,2908,2,1253198,2,2907,379,2908,128,1
20141229.133427,2908,2,1253200,2,2907,378,2908,127,1
20141229.133429,2908,100,1253300,100,2907,378,2908,83,1
20141229.13343,2908,44,1253344,36,2907,378,2908,8,1
20141229.13343,2908,60,1253404,8,2907,367,2908,31,1
20141229.133432,2908,4,1253408,2,2907,417,2908,96,1
20141229.133432,2908,4,1253412,4,2907,418,2908,424,1
20141229.133433,2907,2,1253414,-2,2907,358,2908,428,0
20141229.133434,2908,42,1253456,42,2907,359,2908,408,1
20141229.133435,2907,10,1253466,-10,2907,361,2908,409,0
20141229.133435,2907,2,1253468,0,2907,360,2908,409,0
20141229.133437,2907,4,1253472,-2,2907,358,2908,409,0
20141229.133437,2908,2,1253474,2,2907,358,2908,408,1
20141229.133438,2908,22,1253496,6,2907,359,2908,377,1
20141229.133439,2907,22,1253518,0,2907,377,2908,368,0
20141229.133439,2907,2,1253520,-2,2907,376,2908,368,0
20141229.13344,2907,28,1253548,-22,2907,391,2908,357,0
20141229.133441,2907,10,1253558,0,2907,372,2908,357,0
20141229.133441,2907,2,1253560,0,2907,371,2908,358,0
20141229.133442,2908,2,1253562,0,2907,371,2908,361,1
20141229.133444,2907,30,1253592,-10,2907,327,2908,401,0
20141229.133445,2908,4,1253596,-4,2907,327,2908,399,1
20141229.133446,2908,6,1253602,0,2907,326,2908,422,1
20141229.133446,2907,2,1253604,-2,2907,325,2908,423,0
20141229.133447,2908,2,1253606,0,2907,326,2908,422,1
20141229.133449,2908,10,1253616,0,2907,331,2908,371,1
20141229.133451,2908,12,1253628,-12,2907,331,2908,366,1
20141229.133453,2907,18,1253646,0,2907,337,2908,379,0
20141229.133456,2907,58,1253704,44,2907,309,2908,408,0
20141229.133456,2907,2,1253706,0,2907,308,2908,409,0
20141229.133457,2906,1734,1255440,1108,2906,154,2907,295,0
20141229.133458,2906,142,1255582,-68,2905,660,2906,295,0
20141229.133458,2905,592,1256174,434,2905,197,2906,295,0
20141229.133459,2905,394,1256568,302,2904,1174,2905,172,0
20141229.1335,2905,4,1256572,2,2904,973,2905,273,0
20141229.1335,2904,2,1256574,-2,2904,972,2905,180,0
20141229.133501,2904,6,1256580,2,2904,972,2905,183,0
20141229.133501,2904,20,1256600,-8,2904,969,2905,177,0
20141229.133501,2905,2,1256602,0,2904,968,2905,176,1
20141229.133502,2905,24,1256626,10,2904,969,2905,188,1
20141229.133503,2905,2,1256628,2,2904,970,2905,188,1
20141229.133503,2905,6,1256634,6,2904,1010,2905,186,1
20141229.133504,2905,152,1256786,148,2904,1003,2905,109,1
20141229.133504,2905,222,1257008,204,2905,13,2906,410,1
20141229.133506,2905,4,1257012,0,2905,221,2906,317,1
20141229.133506,2905,2,1257014,-2,2905,317,2906,317,1
20141229.133507,2905,6,1257020,-4,2905,319,2906,294,1
20141229.133507,2905,46,1257066,-42,2905,297,2906,293,1
20141229.133508,2905,10,1257076,0,2905,295,2906,293,1
20141229.133509,2905,20,1257096,0,2905,286,2906,293,1
20141229.133509,2905,2,1257098,0,2905,285,2906,293,1
20141229.13351,2906,2,1257100,0,2905,285,2906,292,1
20141229.133511,2905,8,1257108,0,2905,302,2906,291,0
20141229.133513,2906,2,1257110,2,2905,352,2906,291,1
20141229.133513,2906,12,1257122,2,2905,347,2906,285,1
20141229.133514,2905,2,1257124,0,2905,348,2906,285,0
20141229.133515,2905,2,1257126,0,2905,358,2906,285,0
20141229.133517,2905,24,1257150,-4,2905,363,2906,366,0
20141229.133517,2905,4,1257154,0,2905,361,2906,366,0
20141229.133517,2906,2,1257156,2,2905,367,2906,365,1
20141229.133518,2905,50,1257206,-36,2905,267,2906,359,0
20141229.13352,2905,280,1257486,48,2905,239,2906,359,0
20141229.133523,2905,2,1257488,2,2905,246,2906,361,0
20141229.133523,2906,100,1257588,100,2905,248,2906,311,1
20141229.133523,2906,40,1257628,-8,2905,238,2906,304,1
20141229.133524,2905,22,1257650,2,2905,228,2906,304,0
20141229.133525,2906,12,1257662,12,2905,228,2906,298,1
20141229.133525,2906,4,1257666,2,2905,337,2906,297,1
20141229.133526,2905,10,1257676,-8,2905,324,2906,297,0
20141229.133527,2905,2,1257678,0,2905,326,2906,297,0
20141229.133527,2905,200,1257878,66,2905,276,2906,298,0
20141229.133528,2905,22,1257900,2,2905,265,2906,299,0
20141229.133528,2906,6,1257906,2,2905,265,2906,297,1
20141229.133529,2905,10,1257916,10,2905,261,2906,310,0
20141229.13353,2906,2,1257918,0,2905,263,2906,310,1
20141229.133532,2905,2,1257920,2,2905,298,2906,329,0
20141229.133534,2906,18,1257938,18,2905,322,2906,324,1
20141229.133535,2905,84,1258022,0,2905,282,2906,324,0
20141229.133535,2905,52,1258074,52,2905,266,2906,314,0
20141229.133536,2904,584,1258658,-176,2904,853,2905,370,0
20141229.133537,2905,30,1258688,2,2904,812,2905,431,1
20141229.133537,2905,46,1258734,42,2904,812,2905,487,1
20141229.133538,2905,50,1258784,46,2904,811,2905,559,1
20141229.133539,2904,2,1258786,2,2904,810,2905,564,0
20141229.13354,2904,2,1258788,2,2904,840,2905,564,0
20141229.13354,2904,14,1258802,12,2904,836,2905,563,0
20141229.133541,2904,4,1258806,0,2904,835,2905,502,0
20141229.133541,2904,28,1258834,28,2904,823,2905,500,0
20141229.133542,2904,4,1258838,0,2904,816,2905,458,0
20141229.133542,2905,2,1258840,2,2904,704,2905,454,1
20141229.133543,2905,16,1258856,0,2904,714,2905,376,1
20141229.133544,2905,16,1258872,16,2904,720,2905,367,1
20141229.133544,2905,12,1258884,12,2904,714,2905,416,1
20141229.133544,2904,60,1258944,-8,2904,684,2905,417,0
20141229.133545,2905,4,1258948,4,2904,681,2905,416,1
20141229.133546,2904,110,1259058,-20,2904,626,2905,416,0
20141229.133546,2905,4,1259062,2,2904,631,2905,414,1
20141229.133547,2904,2,1259064,2,2904,633,2905,414,0
20141229.133548,2904,4,1259068,4,2904,633,2905,415,0
20141229.133549,2905,2,1259070,0,2904,627,2905,414,1
20141229.133549,2905,28,1259098,24,2904,622,2905,409,1
20141229.13355,2904,164,1259262,-74,2904,567,2905,409,0
20141229.133551,2905,4,1259266,0,2904,580,2905,410,1
20141229.133552,2905,20,1259286,20,2904,579,2905,403,1
20141229.133552,2904,200,1259486,-22,2904,484,2905,404,0
20141229.133553,2904,2,1259488,2,2904,528,2905,408,0
20141229.133553,2904,2,1259490,0,2904,531,2905,396,0
20141229.133553,2904,102,1259592,100,2904,529,2905,347,0
20141229.133554,2905,6,1259598,2,2904,628,2905,351,1
20141229.133554,2905,6,1259604,6,2904,627,2905,400,1
20141229.133556,2905,12,1259616,10,2904,628,2905,408,1
20141229.133556,2904,4,1259620,0,2904,637,2905,398,0
20141229.133557,2905,14,1259634,-2,2904,622,2905,397,1
20141229.133557,2904,2,1259636,2,2904,621,2905,398,0
20141229.133558,2905,402,1260038,322,2904,634,2905,197,1
20141229.133559,2904,158,1260196,154,2904,575,2905,196,0
20141229.133559,2905,40,1260236,-10,2904,554,2905,182,1
20141229.1336,2905,4,1260240,0,2904,553,2905,239,1
20141229.133601,2905,10,1260250,0,2904,555,2905,250,1
20141229.133601,2904,12,1260262,12,2904,549,2905,253,0
20141229.133602,2904,2,1260264,0,2904,547,2905,255,0
20141229.133602,2905,6,1260270,0,2904,553,2905,252,1
20141229.133603,2905,8,1260278,0,2904,551,2905,255,1
20141229.133603,2904,4,1260282,0,2904,508,2905,256,0
20141229.133604,2905,2,1260284,-2,2904,518,2905,258,1
20141229.133605,2904,6,1260290,0,2904,568,2905,258,0
20141229.133605,2904,14,1260304,0,2904,581,2905,254,0
20141229.133606,2904,50,1260354,-16,2904,576,2905,235,0
20141229.133606,2905,24,1260378,-2,2904,577,2905,227,1
20141229.133609,2905,38,1260416,-10,2904,601,2905,471,1
20141229.13361,2904,10,1260426,0,2904,596,2905,475,0
20141229.13361,2904,12,1260438,0,2904,545,2905,476,0
20141229.133611,2905,58,1260496,-58,2904,544,2905,447,1
20141229.133612,2905,2,1260498,-2,2904,544,2905,446,1
20141229.133612,2905,140,1260638,-128,2904,545,2905,376,1
20141229.133613,2904,6,1260644,0,2904,547,2905,377,0
20141229.133613,2905,2,1260646,0,2904,547,2905,376,1
20141229.133613,2904,6,1260652,2,2904,544,2905,378,0
20141229.133614,2905,108,1260760,8,2904,543,2905,426,1
20141229.133615,2904,2,1260762,2,2904,542,2905,429,0
20141229.133616,2905,10,1260772,0,2904,542,2905,435,1
20141229.133616,2904,2,1260774,2,2904,540,2905,736,0
20141229.133617,2905,28,1260802,0,2904,536,2905,727,1
20141229.133619,2904,6,1260808,6,2904,528,2905,732,0
20141229.133619,2904,20,1260828,20,2904,518,2905,762,0
20141229.13362,2904,2,1260830,0,2904,517,2905,762,0
20141229.133621,2904,2,1260832,2,2904,516,2905,762,0
20141229.133622,2904,6,1260838,2,2904,514,2905,762,0
20141229.133623,2904,6,1260844,2,2904,521,2905,764,0
20141229.133624,2905,92,1260936,-52,2904,520,2905,740,1
20141229.133625,2904,102,1261038,100,2904,492,2905,743,0
20141229.133626,2904,984,1262022,-364,2903,1736,2904,105,0
20141229.133626,2903,34,1262056,-2,2903,1624,2904,102,0
20141229.133627,2903,80,1262136,-68,2903,1588,2904,151,0
20141229.133627,2904,14,1262150,-10,2903,1583,2904,150,1
20141229.133628,2903,22,1262172,0,2903,1575,2904,164,0
20141229.133628,2904,8,1262180,0,2903,1580,2904,184,1
20141229.133629,2904,6,1262186,-6,2903,1582,2904,181,1
20141229.133629,2904,2,1262188,0,2903,1582,2904,181,1
20141229.13363,2903,18,1262206,2,2903,1583,2904,178,0
20141229.13363,2903,2,1262208,0,2903,1582,2904,178,0
20141229.133631,2903,206,1262414,-42,2903,1581,2904,78,0
20141229.133631,2903,60,1262474,-42,2903,1564,2904,79,0
20141229.133632,2904,12,1262486,-6,2903,1564,2904,73,1
20141229.133633,2904,30,1262516,4,2903,1565,2904,68,1
20141229.133633,2904,30,1262546,10,2903,1567,2904,55,1
20141229.133634,2904,172,1262718,88,2904,182,2905,800,1
20141229.133635,2905,22,1262740,0,2904,396,2905,799,1
20141229.133636,2904,22,1262762,22,2904,584,2905,599,0
20141229.133636,2904,4,1262766,4,2904,582,2905,599,0
20141229.133637,2904,126,1262892,12,2904,522,2905,609,0
20141229.133638,2904,4,1262896,-2,2904,475,2905,605,0
20141229.133639,2905,30,1262926,-4,2904,468,2905,602,1
20141229.133639,2905,2,1262928,2,2904,470,2905,607,1
20141229.13364,2904,10,1262938,-10,2904,465,2905,607,0
20141229.133641,2904,12,1262950,0,2904,466,2905,617,0
20141229.133641,2905,102,1263052,68,2904,468,2905,566,1
20141229.133642,2904,4,1263056,-4,2904,468,2905,558,0
20141229.133643,2905,200,1263256,22,2904,500,2905,458,1
20141229.133643,2905,4,1263260,0,2904,505,2905,456,1
20141229.133645,2904,12,1263272,0,2904,507,2905,456,0
20141229.133645,2905,2,1263274,-2,2904,510,2905,455,1
20141229.133646,2904,2,1263276,0,2904,525,2905,455,0
20141229.133647,2905,10,1263286,-8,2904,535,2905,441,1
20141229.133647,2904,46,1263332,-24,2904,514,2905,441,0
20141229.133648,2904,4,1263336,-4,2904,514,2905,441,0
20141229.133649,2904,2,1263338,0,2904,518,2905,441,0
20141229.133649,2905,10,1263348,0,2904,519,2905,436,1
20141229.13365,2905,10,1263358,0,2904,529,2905,431,1
20141229.133652,2905,2,1263360,-2,2904,692,2905,403,1
20141229.133656,2905,6,1263366,0,2904,760,2905,407,1
20141229.133657,2905,10,1263376,-8,2904,761,2905,403,1
20141229.133657,2904,6,1263382,-6,2904,757,2905,404,0
20141229.133658,2905,2,1263384,0,2904,759,2905,404,1
20141229.133659,2904,14,1263398,-14,2904,762,2905,404,0
20141229.133659,2905,66,1263464,-56,2904,767,2905,371,1
20141229.1337,2905,306,1263770,-240,2904,768,2905,221,1
20141229.133701,2905,234,1264004,48,2905,299,2906,481,1
20141229.133701,2905,128,1264132,128,2905,358,2906,351,1
20141229.133702,2905,156,1264288,-106,2905,404,2906,283,1
20141229.133702,2905,12,1264300,-12,2905,395,2906,283,1
20141229.133703,2906,14,1264314,14,2905,405,2906,276,1
20141229.133703,2906,2,1264316,0,2905,403,2906,281,1
20141229.133704,2906,2,1264318,0,2905,409,2906,288,1
20141229.133706,2906,26,1264344,20,2905,373,2906,279,1
20141229.133707,2905,4,1264348,-4,2905,394,2906,301,0
20141229.133708,2906,20,1264368,20,2905,394,2906,292,1
20141229.133708,2906,2,1264370,0,2905,387,2906,292,1
20141229.133711,2906,2,1264372,0,2905,431,2906,293,1
20141229.133712,2906,4,1264376,0,2905,432,2906,291,1
20141229.133712,2906,2,1264378,0,2905,436,2906,294,1
20141229.133712,2906,2,1264380,2,2905,436,2906,293,1
20141229.133713,2906,40,1264420,-2,2905,438,2906,274,1
20141229.133713,2906,24,1264444,-8,2905,435,2906,270,1
20141229.133714,2906,2,1264446,0,2905,415,2906,287,1
20141229.133715,2906,4,1264450,0,2905,411,2906,286,1
20141229.133716,2906,10,1264460,2,2905,512,2906,314,1
20141229.133716,2906,6,1264466,6,2905,515,2906,310,1
20141229.133717,2905,4,1264470,-2,2905,523,2906,309,0
20141229.133717,2906,4,1264474,0,2905,541,2906,323,1
20141229.133718,2905,4,1264478,-2,2905,541,2906,422,0
20141229.133719,2906,30,1264508,0,2905,533,2906,410,1
20141229.133719,2905,20,1264528,-20,2905,472,2906,410,0
20141229.13372,2905,8,1264536,0,2905,470,2906,439,0
20141229.13372,2905,20,1264556,-20,2905,460,2906,440,0
20141229.133721,2906,24,1264580,2,2905,518,2906,431,1
20141229.133723,2906,20,1264600,-12,2905,523,2906,421,1
20141229.133725,2906,4,1264604,0,2905,510,2906,452,1
20141229.133727,2905,10,1264614,-6,2905,397,2906,453,0
20141229.133728,2906,4,1264618,0,2905,405,2906,451,1
20141229.133729,2906,2,1264620,0,2905,415,2906,452,1
20141229.13373,2905,2,1264622,2,2905,422,2906,452,0
20141229.133731,2906,40,1264662,10,2905,415,2906,436,1
20141229.133732,2906,2,1264664,-2,2905,415,2906,433,1
20141229.133732,2906,8,1264672,-2,2905,416,2906,431,1
20141229.133734,2906,2,1264674,0,2905,442,2906,430,1
20141229.133735,2906,32,1264706,-28,2905,439,2906,428,1
20141229.133735,2906,10,1264716,0,2905,439,2906,423,1
20141229.133737,2906,20,1264736,0,2905,470,2906,413,1
20141229.133738,2906,12,1264748,-2,2905,576,2906,362,1
20141229.133739,2906,2,1264750,-2,2905,579,2906,341,1
20141229.13374,2906,12,1264762,0,2905,585,2906,334,1
20141229.133741,2906,2,1264764,0,2905,593,2906,336,1
20141229.133742,2906,2,1264766,-2,2905,608,2906,335,1
20141229.133743,2906,16,1264782,-12,2905,609,2906,327,1
20141229.133743,2906,106,1264888,92,2905,604,2906,274,1
20141229.133744,2905,2,1264890,-2,2905,609,2906,274,0
20141229.133744,2906,14,1264904,0,2905,594,2906,268,1
20141229.133745,2906,2,1264906,2,2905,594,2906,273,1
20141229.133746,2906,4,1264910,2,2905,624,2906,272,1
20141229.133747,2906,2,1264912,2,2905,624,2906,272,1
20141229.133748,2906,4,1264916,4,2905,635,2906,270,1
20141229.133748,2906,2,1264918,2,2905,636,2906,269,1
20141229.13375,2906,14,1264932,4,2905,630,2906,307,1
20141229.133751,2905,60,1264992,-16,2905,601,2906,280,0
20141229.133752,2906,4,1264996,4,2905,610,2906,278,1
20141229.133753,2906,24,1265020,18,2905,631,2906,267,1
20141229.133753,2906,6,1265026,6,2905,631,2906,264,1
20141229.133754,2906,10,1265036,8,2905,630,2906,268,1
20141229.133754,2906,536,1265572,-434,2906,232,2907,477,1
20141229.133755,2906,60,1265632,-60,2906,290,2907,391,1
20141229.133756,2907,2,1265634,-2,2906,296,2907,390,1
20141229.133758,2906,2,1265636,-2,2906,1058,2907,390,0
20141229.133759,2907,2,1265638,0,2906,1100,2907,369,1
20141229.1338,2907,2,1265640,-2,2906,1100,2907,368,1
20141229.1338,2907,24,1265664,-20,2906,1050,2907,366,1
20141229.133802,2906,4,1265668,-2,2906,1053,2907,367,0
20141229.133803,2907,46,1265714,-34,2906,1037,2907,364,1
20141229.133803,2907,10,1265724,0,2906,1038,2907,362,1
20141229.133804,2907,2,1265726,0,2906,1039,2907,361,1
20141229.133805,2907,4,1265730,0,2906,1044,2907,358,1
20141229.133809,2907,6,1265736,0,2906,1060,2907,391,1
20141229.133811,2907,2,1265738,0,2906,1059,2907,390,1
20141229.133812,2906,56,1265794,-20,2906,1049,2907,377,0
20141229.133813,2907,4,1265798,-2,2906,1069,2907,377,1
20141229.133813,2906,4,1265802,0,2906,1069,2907,376,0
20141229.133814,2907,2,1265804,0,2906,1084,2907,375,1
20141229.133814,2907,2,1265806,-2,2906,1084,2907,375,1
20141229.133815,2907,2,1265808,0,2906,1084,2907,374,1
20141229.133815,2907,22,1265830,0,2906,1084,2907,367,1
20141229.133816,2907,2,1265832,0,2906,1084,2907,366,1
20141229.133818,2907,2,1265834,0,2906,1098,2907,371,1
20141229.133819,2907,10,1265844,-4,2906,1097,2907,367,1
20141229.133821,2907,2,1265846,-2,2906,1100,2907,399,1
20141229.133821,2907,8,1265854,-6,2906,1081,2907,398,1
20141229.133824,2907,2,1265856,-2,2906,1080,2907,398,1
20141229.133825,2906,2,1265858,-2,2906,1044,2907,398,0
20141229.133825,2907,2,1265860,0,2906,1044,2907,397,1
20141229.133826,2907,2,1265862,0,2906,1046,2907,396,1
20141229.133827,2907,2,1265864,0,2906,1046,2907,395,1
20141229.133827,2907,2,1265866,0,2906,1046,2907,407,1
20141229.133829,2907,2,1265868,0,2906,1046,2907,497,1
20141229.13383,2907,8,1265876,-8,2906,1046,2907,494,1
20141229.133833,2907,2,1265878,0,2906,1045,2907,523,1
20141229.133833,2906,4,1265882,-2,2906,1044,2907,462,0
20141229.133836,2906,2,1265884,0,2906,1040,2907,457,0
20141229.133837,2907,2,1265886,0,2906,1041,2907,457,1
20141229.133837,2907,2,1265888,0,2906,1041,2907,457,1
20141229.133838,2907,8,1265896,-8,2906,1041,2907,452,1
20141229.133839,2907,2,1265898,0,2906,1041,2907,501,1
20141229.133839,2906,2,1265900,0,2906,1040,2907,500,0
20141229.13384,2907,12,1265912,0,2906,1040,2907,497,1
20141229.133841,2906,2,1265914,-2,2906,1039,2907,488,0
20141229.133843,2907,2,1265916,0,2906,1034,2907,524,1
20141229.133844,2907,20,1265936,-20,2906,1038,2907,517,1
20141229.133845,2907,20,1265956,0,2906,1038,2907,493,1
20141229.133846,2907,16,1265972,0,2906,1038,2907,487,1
20141229.13385,2907,2,1265974,0,2906,1040,2907,532,1
20141229.133852,2907,2,1265976,0,2906,1042,2907,545,1
20141229.133853,2906,6,1265982,0,2906,1039,2907,544,0
20141229.133853,2907,2,1265984,0,2906,1039,2907,544,1
20141229.133855,2907,2,1265986,-2,2906,1048,2907,647,1
20141229.133856,2907,2,1265988,0,2906,1049,2907,652,1
20141229.133858,2906,2,1265990,-2,2906,1050,2907,660,0
20141229.133859,2906,2,1265992,0,2906,1049,2907,660,0
20141229.133859,2907,4,1265996,-2,2906,1049,2907,658,1
20141229.133902,2906,2,1265998,-2,2906,1050,2907,779,0
20141229.133903,2907,2,1266000,0,2906,1051,2907,777,1
20141229.133904,2907,100,1266100,0,2906,1072,2907,728,1
20141229.133906,2907,102,1266202,-2,2906,1072,2907,699,1
20141229.133908,2907,20,1266222,0,2906,1073,2907,690,1
20141229.133909,2907,14,1266236,-6,2906,1073,2907,683,1
20141229.13391,2906,4,1266240,-4,2906,1071,2907,702,0
20141229.133911,2907,60,1266300,-60,2906,1072,2907,677,1
20141229.133913,2907,4,1266304,-2,2906,1075,2907,680,1
20141229.133913,2907,2,1266306,0,2906,1078,2907,679,1
20141229.133915,2906,4,1266310,-4,2906,1076,2907,694,0
20141229.133916,2906,2,1266312,-2,2906,1078,2907,693,0
20141229.133916,2906,8,1266320,-8,2906,1074,2907,693,0
20141229.133919,2907,2,1266322,2,2906,1079,2907,693,1
20141229.133919,2907,2,1266324,2,2906,1079,2907,681,1
20141229.13392,2907,2,1266326,0,2906,1079,2907,681,1
20141229.13392,2907,4,1266330,-2,2906,1079,2907,679,1
20141229.133921,2907,26,1266356,-4,2906,1078,2907,671,1
20141229.133923,2907,10,1266366,0,2906,1078,2907,666,1
20141229.133924,2906,12,1266378,-12,2906,1062,2907,666,0
20141229.133927,2907,2,1266380,-2,2906,1065,2907,766,1
20141229.133929,2907,800,1267180,-222,2906,1072,2907,373,1
20141229.13393,2907,458,1267638,-40,2906,1073,2908,1392,1
20141229.13393,2907,2,1267640,0,2906,1102,2908,1814,1
20141229.133931,2907,26,1267666,-16,2907,216,2908,1822,1
20141229.133932,2906,710,1268376,-36,2906,1140,2907,35,0
20141229.133932,2907,74,1268450,-20,2907,167,2908,1717,1
20141229.133932,2907,2,1268452,-2,2907,209,2908,1703,1
20141229.133933,2907,198,1268650,196,2907,128,2908,1713,1
20141229.133935,2907,4,1268654,0,2907,192,2908,1703,1
20141229.133936,2907,80,1268734,0,2907,189,2908,1693,1
20141229.133938,2907,4,1268738,0,2907,499,2908,1672,1
20141229.133939,2908,2,1268740,0,2907,588,2908,1665,1
20141229.133939,2908,2,1268742,-2,2907,588,2908,1655,1
20141229.133939,2908,126,1268868,-14,2907,605,2908,1577,1
20141229.133941,2907,4,1268872,4,2907,622,2908,1546,0
20141229.133943,2908,2,1268874,2,2907,627,2908,1545,1
20141229.133944,2908,10,1268884,10,2907,627,2908,1538,1
20141229.133944,2908,6,1268890,0,2907,628,2908,1526,1
20141229.133945,2908,12,1268902,6,2907,625,2908,1516,1
20141229.133946,2908,8,1268910,0,2907,626,2908,1516,1
20141229.133947,2908,8,1268918,0,2907,628,2908,1516,1
20141229.133947,2908,20,1268938,2,2907,628,2908,1464,1
20141229.133948,2907,18,1268956,0,2907,626,2908,1464,0
20141229.133948,2907,40,1268996,2,2907,612,2908,1450,0
20141229.133949,2908,6,1269002,6,2907,614,2908,1488,1
20141229.13395,2908,2,1269004,0,2907,621,2908,1501,1
20141229.133951,2908,2,1269006,2,2907,625,2908,1494,1
20141229.133951,2908,2,1269008,2,2907,626,2908,1493,1
20141229.133952,2908,2,1269010,2,2907,695,2908,1493,1
20141229.133953,2907,2,1269012,0,2907,714,2908,1509,0
20141229.133954,2908,2,1269014,0,2907,724,2908,1508,1
20141229.133955,2908,2,1269016,2,2907,724,2908,1505,1
20141229.133957,2908,4,1269020,4,2907,724,2908,1503,1
20141229.133957,2907,2,1269022,0,2907,724,2908,1504,0
20141229.133959,2907,14,1269036,0,2907,718,2908,1505,0
20141229.133959,2908,2,1269038,2,2907,718,2908,1504,1
20141229.134,2908,14,1269052,10,2907,713,2908,1502,1
20141229.134,2907,2,1269054,0,2907,697,2908,1502,0
20141229.134002,2908,40,1269094,0,2907,702,2908,1474,1
20141229.134003,2908,4,1269098,2,2907,701,2908,1485,1
20141229.134003,2908,8,1269106,8,2907,701,2908,1481,1
20141229.134005,2908,2,1269108,2,2907,701,2908,1479,1
20141229.134005,2908,100,1269208,100,2907,701,2908,1430,1
20141229.134006,2908,10,1269218,10,2907,735,2908,1423,1
20141229.134008,2907,4,1269222,4,2907,799,2908,1382,0
20141229.134008,2907,14,1269236,0,2907,799,2908,1376,0
20141229.134009,2908,2,1269238,2,2907,799,2908,1375,1
20141229.134009,2908,20,1269258,0,2907,799,2908,1362,1
20141229.134011,2907,2,1269260,0,2907,799,2908,1361,0
20141229.134012,2908,2,1269262,2,2907,799,2908,1359,1
20141229.134013,2908,2,1269264,2,2907,799,2908,1336,1
20141229.134014,2907,2,1269266,2,2907,798,2908,1326,0
20141229.134014,2907,2,1269268,0,2907,797,2908,1326,0
20141229.134015,2908,2,1269270,2,2907,848,2908,1327,1
20141229.134017,2907,2,1269272,0,2907,854,2908,1326,0
20141229.13402,2908,4,1269276,0,2907,859,2908,1324,1
20141229.13402,2908,2,1269278,0,2907,859,2908,1322,1
20141229.134021,2908,2,1269280,0,2907,860,2908,1324,1
20141229.134021,2907,2,1269282,0,2907,879,2908,1324,0
20141229.134024,2908,16,1269298,0,2907,741,2908,1307,1
20141229.134025,2907,2,1269300,2,2907,841,2908,1303,0
20141229.134026,2907,2,1269302,2,2907,841,2908,1298,0
20141229.134027,2908,6,1269308,0,2907,841,2908,1295,1
20141229.134028,2907,6,1269314,0,2907,842,2908,1293,0
20141229.134029,2908,2,1269316,0,2907,845,2908,1295,1
20141229.13403,2908,4,1269320,2,2907,849,2908,1296,1
20141229.13403,2907,2,1269322,2,2907,848,2908,1295,0
20141229.134031,2908,4,1269326,-2,2907,848,2908,1313,1
20141229.134032,2908,4,1269330,0,2907,852,2908,1310,1
20141229.134033,2908,6,1269336,0,2907,853,2908,1307,1
20141229.134034,2908,10,1269346,-6,2907,858,2908,1301,1
20141229.134036,2907,6,1269352,0,2907,856,2908,1291,0
20141229.134036,2907,62,1269414,36,2907,826,2908,1286,0
20141229.134037,2908,2,1269416,0,2907,827,2908,1285,1
20141229.134037,2907,2,1269418,0,2907,828,2908,1306,0
20141229.134038,2907,100,1269518,-100,2907,793,2908,1307,0
20141229.134039,2907,6,1269524,-2,2907,795,2908,1307,0
20141229.13404,2908,2,1269526,0,2907,795,2908,1305,1
20141229.13404,2907,40,1269566,0,2907,775,2908,1327,0
20141229.134043,2908,192,1269758,0,2907,798,2908,1324,1
20141229.134049,2907,200,1269958,-200,2907,714,2908,1327,0
20141229.134049,2907,2,1269960,-2,2907,703,2908,1322,0
20141229.134051,2907,718,1270678,-214,2906,1338,2907,2,0
20141229.134051,2907,154,1270832,-152,2906,1371,2907,30,0
20141229.134053,2907,44,1270876,0,2906,1332,2907,231,0
20141229.134054,2907,10,1270886,0,2906,1332,2907,242,0
20141229.134056,2906,2,1270888,0,2906,1319,2907,265,0
20141229.134057,2907,14,1270902,0,2906,1318,2907,256,1
20141229.1341,2907,536,1271438,-422,2907,669,2908,1301,1
20141229.1341,2907,2,1271440,0,2907,714,2908,1220,1
20141229.134102,2906,1530,1272970,156,2906,1399,2907,202,0
20141229.134104,2906,22,1272992,20,2906,1354,2907,232,0
20141229.134105,2907,376,1273368,-202,2906,1354,2907,46,1
20141229.134105,2907,14,1273382,8,2906,1404,2907,42,1
20141229.134106,2907,4,1273386,-4,2906,1409,2907,153,1
20141229.134107,2907,2,1273388,0,2906,1351,2907,180,1
20141229.134107,2907,2,1273390,-2,2906,1346,2907,183,1
20141229.13411,2906,2,1273392,0,2906,1345,2907,186,0
20141229.134111,2906,8,1273400,0,2906,1380,2907,190,0
20141229.134112,2906,12,1273412,0,2906,1374,2907,197,0
20141229.134113,2906,6,1273418,0,2906,1373,2907,202,0
20141229.134114,2907,2,1273420,0,2906,1366,2907,201,1
20141229.134115,2907,4,1273424,-4,2906,1386,2907,200,1
20141229.134116,2906,2,1273426,0,2906,1385,2907,201,0
20141229.134116,2907,2,1273428,0,2906,1385,2907,200,1
20141229.134117,2907,10,1273438,0,2906,1385,2907,202,1
20141229.134118,2906,2,1273440,-2,2906,1384,2907,232,0
20141229.134118,2907,2,1273442,0,2906,1383,2907,235,1
20141229.134119,2907,42,1273484,-42,2906,1382,2907,215,1
20141229.13412,2907,2,1273486,0,2906,1389,2907,216,1
20141229.134121,2907,24,1273510,20,2906,1415,2907,204,1
20141229.134122,2907,40,1273550,30,2906,1420,2907,185,1
20141229.134124,2907,2,1273552,2,2906,1419,2907,201,1
20141229.134124,2907,40,1273592,40,2906,1419,2907,181,1
20141229.134125,2906,10,1273602,-2,2906,1416,2907,179,0
20141229.134125,2906,2,1273604,0,2906,1399,2907,178,0
20141229.134126,2907,2,1273606,2,2906,1399,2907,182,1
20141229.134128,2906,176,1273782,0,2906,1311,2907,184,0
20141229.134131,2906,2,1273784,0,2906,1325,2907,196,0
20141229.134132,2907,20,1273804,20,2906,1325,2907,187,1
20141229.134133,2907,2,1273806,2,2906,1346,2907,186,1
20141229.134134,2906,4,1273810,-4,2906,1361,2907,200,0
20141229.134136,2907,4,1273814,4,2906,1360,2907,198,1
20141229.134138,2906,6,1273820,-6,2906,1342,2907,203,0
20141229.134139,2907,2,1273822,2,2906,1344,2907,203,1
20141229.13414,2907,2,1273824,2,2906,1346,2907,204,1
20141229.134141,2907,6,1273830,6,2906,1349,2907,201,1
20141229.134141,2906,10,1273840,-10,2906,1344,2907,201,0
20141229.134143,2907,2,1273842,2,2906,1344,2907,207,1
20141229.134144,2906,2,1273844,-2,2906,1343,2907,207,0
20141229.134145,2906,92,1273936,-92,2906,1292,2907,209,0
20141229.134146,2907,20,1273956,20,2906,1294,2907,203,1
20141229.134147,2906,20,1273976,0,2906,1285,2907,213,0
20141229.13415,2906,14,1273990,-14,2906,1284,2907,216,0
20141229.134153,2907,4,1273994,4,2906,1287,2907,220,1
20141229.134154,2906,2,1273996,0,2906,1211,2907,1252,0
20141229.134154,2906,1042,1275038,-126,2906,1187,2907,762,0
20141229.134156,2907,2,1275040,0,2906,1228,2907,751,1
20141229.134157,2906,2,1275042,2,2906,1228,2907,759,0
20141229.134158,2906,4,1275046,-4,2906,1227,2907,760,0
20141229.134159,2906,2,1275048,-2,2906,1225,2907,775,0
20141229.134159,2906,2,1275050,0,2906,1224,2907,775,0
20141229.134201,2906,26,1275076,-24,2906,1211,2907,836,0
20141229.134202,2907,1000,1276076,0,2906,1216,2907,353,1
20141229.134202,2907,272,1276348,272,2906,1231,2907,188,1
20141229.134203,2907,376,1276724,176,2907,117,2908,946,1
20141229.134204,2907,2,1276726,2,2907,177,2908,915,1
20141229.134204,2907,482,1277208,402,2906,1257,2907,856,1
20141229.134206,2907,100,1277308,100,2906,1253,2907,827,1
20141229.134206,2906,4,1277312,4,2906,1252,2907,836,0
20141229.134206,2907,6,1277318,0,2906,1252,2907,833,1
20141229.134207,2907,4,1277322,4,2906,1252,2907,831,1
20141229.134208,2907,6,1277328,6,2906,1252,2907,830,1
20141229.134208,2907,10,1277338,4,2906,1252,2907,825,1
20141229.134209,2907,1000,1278338,0,2906,1262,2907,325,1
20141229.134209,2907,8,1278346,6,2906,1260,2907,322,1
20141229.134211,2907,2,1278348,0,2906,1278,2907,1352,1
20141229.134212,2906,6,1278354,6,2906,1223,2907,1351,0
20141229.134213,2907,12,1278366,12,2906,1223,2907,1345,1
20141229.134214,2907,6,1278372,0,2906,1227,2907,1343,1
20141229.134215,2907,1002,1279374,-196,2906,1227,2907,843,1
20141229.134217,2906,2,1279376,0,2906,1321,2907,815,0
20141229.134217,2907,4,1279380,4,2906,1321,2907,813,1
20141229.134217,2907,4,1279384,0,2906,1324,2907,811,1
20141229.134218,2907,2,1279386,2,2906,1314,2907,811,1
20141229.134219,2907,24,1279410,6,2906,1314,2907,800,1
20141229.13422,2906,2,1279412,0,2906,1314,2907,801,0
20141229.134221,2907,1602,1281014,-4,2907,304,2908,1328,1
20141229.134222,2907,2,1281016,0,2907,346,2908,1218,1
20141229.134223,2907,2,1281018,0,2907,405,2908,1215,1
20141229.134224,2908,64,1281082,4,2907,375,2908,1198,1
20141229.134225,2907,224,1281306,-222,2907,268,2908,1180,0
20141229.134225,2907,2,1281308,-2,2907,264,2908,1191,0
20141229.134226,2907,40,1281348,-40,2907,248,2908,1190,0
20141229.134229,2908,110,1281458,48,2907,336,2908,1137,1
20141229.13423,2908,2,1281460,2,2907,354,2908,1137,1
20141229.13423,2908,6,1281466,6,2907,500,2908,1135,1
20141229.134231,2908,102,1281568,102,2907,505,2908,1105,1
20141229.134232,2907,6,1281574,-4,2907,502,2908,1105,0
20141229.134233,2908,10,1281584,10,2907,511,2908,1099,1
20141229.134234,2907,2,1281586,-2,2907,511,2908,1100,0
20141229.134235,2908,10,1281596,10,2907,512,2908,1095,1
20141229.134236,2907,6,1281602,0,2907,510,2908,1094,0
20141229.134237,2908,4,1281606,4,2907,513,2908,1091,1
20141229.134238,2907,20,1281626,0,2907,504,2908,1091,0
20141229.134239,2908,2,1281628,0,2907,504,2908,1088,1
20141229.13424,2908,2,1281630,0,2907,518,2908,1088,1
20141229.13424,2908,2,1281632,2,2907,419,2908,1087,1
20141229.134241,2908,4,1281636,0,2907,418,2908,1091,1
20141229.134243,2907,14,1281650,-8,2907,413,2908,1096,0
20141229.134244,2907,2,1281652,0,2907,412,2908,1097,0
20141229.134245,2907,2,1281654,0,2907,426,2908,1096,0
20141229.134246,2908,18,1281672,18,2907,441,2908,1127,1
20141229.134249,2908,2,1281674,2,2907,455,2908,1130,1
20141229.134253,2908,2,1281676,2,2907,474,2908,1147,1
20141229.134254,2907,2,1281678,0,2907,474,2908,1147,0
20141229.134256,2907,6,1281684,-4,2907,480,2908,1147,0
20141229.134258,2907,16,1281700,0,2907,473,2908,1150,0
20141229.134259,2908,2,1281702,-2,2907,474,2908,1130,1
20141229.134259,2907,2,1281704,0,2907,473,2908,1130,0
20141229.1343,2907,232,1281936,204,2907,365,2908,1119,0
20141229.134301,2908,2,1281938,0,2907,365,2908,1118,1
20141229.134306,2907,20,1281958,0,2907,357,2908,1135,0
20141229.134307,2908,2,1281960,0,2907,360,2908,1134,1
20141229.134309,2907,8,1281968,-8,2907,357,2908,1145,0
20141229.134311,2908,12,1281980,0,2907,356,2908,1141,1
20141229.134313,2908,2,1281982,0,2907,361,2908,1138,1
20141229.134314,2908,2,1281984,0,2907,364,2908,1138,1
20141229.134315,2907,2,1281986,-2,2907,363,2908,1138,0
20141229.134315,2907,2,1281988,-2,2907,362,2908,1138,0
20141229.134316,2908,4,1281992,0,2907,361,2908,1148,1
20141229.134316,2907,6,1281998,0,2907,361,2908,1148,0
20141229.134318,2907,2,1282000,-2,2907,365,2908,1149,0
20141229.134322,2908,8,1282008,0,2907,367,2908,1148,1
20141229.134325,2907,2,1282010,0,2907,369,2908,1148,0
20141229.134326,2907,2,1282012,-2,2907,368,2908,1158,0
20141229.134327,2908,2,1282014,0,2907,370,2908,1198,1
20141229.134329,2907,2,1282016,-2,2907,370,2908,1205,0
20141229.134331,2907,242,1282258,-148,2907,255,2908,1227,0
20141229.134333,2907,22,1282280,-20,2907,244,2908,1233,0
20141229.134334,2907,264,1282544,-174,2907,109,2908,1252,0
20141229.134334,2907,218,1282762,-68,2906,1496,2907,169,0
20141229.134335,2907,4,1282766,0,2906,1451,2907,295,0
20141229.134336,2907,20,1282786,0,2906,950,2907,320,0
20141229.134336,2907,2,1282788,-2,2906,950,2907,395,0
20141229.134338,2907,4,1282792,0,2906,950,2907,402,0
20141229.13434,2907,4,1282796,0,2906,958,2907,405,0
20141229.134341,2907,4,1282800,0,2906,957,2907,404,0
20141229.134343,2907,20,1282820,0,2906,957,2907,353,0
20141229.134346,2906,2,1282822,2,2906,957,2907,449,0
20141229.134347,2907,6,1282828,0,2906,957,2907,447,1
20141229.134347,2906,10,1282838,0,2906,952,2907,447,0
20141229.13435,2907,2,1282840,0,2906,948,2907,445,1
20141229.134351,2907,4,1282844,0,2906,948,2907,442,1
20141229.134352,2906,4,1282848,0,2906,949,2907,442,0
20141229.134352,2906,6,1282854,4,2906,947,2907,448,0
20141229.134353,2906,16,1282870,8,2906,940,2907,458,0
20141229.134354,2906,40,1282910,0,2906,963,2907,517,0
20141229.134355,2907,100,1283010,10,2906,963,2907,679,1
20141229.134359,2907,14,1283024,2,2906,973,2907,678,1
20141229.1344,2907,2,1283026,-2,2906,974,2907,678,1
20141229.134401,2906,2,1283028,2,2906,973,2907,678,0
20141229.134402,2907,2,1283030,0,2906,973,2907,677,1
20141229.134407,2907,4,1283034,-2,2906,975,2907,860,1
20141229.134409,2906,2,1283036,0,2906,976,2907,863,0
20141229.13441,2907,2,1283038,0,2906,976,2907,862,1
20141229.13441,2907,14,1283052,-2,2906,970,2907,856,1
20141229.134412,2906,2,1283054,0,2906,966,2907,856,0
20141229.134413,2907,2,1283056,0,2906,966,2907,855,1
20141229.134414,2907,8,1283064,0,2906,966,2907,851,1
20141229.134416,2907,2,1283066,-2,2906,973,2907,854,1
20141229.134419,2906,2,1283068,0,2906,973,2907,874,0
20141229.134423,2906,200,1283268,0,2906,874,2907,876,0
20141229.134425,2907,6,1283274,-2,2906,873,2907,881,1
20141229.134425,2907,1066,1284340,-382,2906,923,2907,259,1
20141229.134426,2907,442,1284782,442,2906,972,2907,28,1
20141229.134427,2907,56,1284838,30,2907,229,2908,1289,1
20141229.134427,2907,4,1284842,4,2907,244,2908,1283,1
20141229.134428,2907,4,1284846,4,2907,242,2908,1282,1
20141229.134429,2907,2,1284848,0,2907,270,2908,1282,1
20141229.13443,2907,2,1284850,0,2907,280,2908,1271,1
20141229.13443,2907,2,1284852,0,2907,279,2908,1262,1
20141229.134431,2907,2,1284854,0,2907,337,2908,1262,1
20141229.134431,2908,2,1284856,0,2907,337,2908,1261,1
20141229.134433,2908,4,1284860,-4,2907,338,2908,1272,1
20141229.134434,2907,4,1284864,4,2907,388,2908,1273,0
20141229.134435,2907,4,1284868,4,2907,402,2908,1095,0
20141229.134436,2907,2,1284870,0,2907,401,2908,1094,0
20141229.134436,2908,12,1284882,-12,2907,401,2908,1088,1
20141229.134438,2907,2,1284884,2,2907,614,2908,1072,0
20141229.13444,2908,2,1284886,0,2907,613,2908,1071,1
20141229.134445,2907,4,1284890,0,2907,648,2908,1070,0
20141229.134446,2908,4,1284894,0,2907,648,2908,1068,1
20141229.134446,2907,40,1284934,0,2907,549,2908,1068,0
20141229.134448,2907,96,1285030,96,2907,503,2908,1068,0
20141229.13445,2908,4,1285034,-4,2907,465,2908,1067,1
20141229.134451,2907,8,1285042,4,2907,464,2908,1077,0
20141229.134452,2908,2,1285044,0,2907,469,2908,1076,1
20141229.134456,2907,4,1285048,4,2907,470,2908,1078,0
20141229.134457,2907,62,1285110,2,2907,469,2908,1048,0
20141229.134458,2907,2,1285112,2,2907,474,2908,1050,0
20141229.134459,2907,4,1285116,4,2907,484,2908,1050,0
20141229.134503,2908,32,1285148,-12,2907,486,2908,1038,1
20141229.134504,2907,34,1285182,34,2907,472,2908,1042,0
20141229.134504,2908,8,1285190,8,2907,593,2908,1038,1
20141229.134505,2908,40,1285230,40,2907,625,2908,1019,1
20141229.134506,2907,2,1285232,0,2907,624,2908,1019,0
20141229.134507,2907,2,1285234,0,2907,623,2908,1015,0
20141229.134507,2907,2,1285236,0,2907,622,2908,1016,0
20141229.134508,2907,4,1285240,0,2907,620,2908,1016,0
20141229.134508,2907,12,1285252,0,2907,619,2908,1011,0
20141229.13451,2908,8,1285260,0,2907,619,2908,1007,1
20141229.134512,2908,8,1285268,-4,2907,618,2908,1004,1
20141229.134514,2908,1872,1287140,-588,2907,679,2908,67,1
20141229.134514,2908,136,1287276,118,2908,163,2909,816,1
20141229.134515,2908,2,1287278,0,2908,430,2909,806,1
20141229.134517,2908,2,1287280,2,2908,442,2909,848,1
20141229.134518,2908,6,1287286,0,2908,431,2909,822,1
20141229.134519,2907,1650,1288936,902,2907,358,2908,196,0
20141229.13452,2908,22,1288958,-20,2907,328,2908,304,1
20141229.134521,2908,2,1288960,0,2907,329,2908,504,1
20141229.134521,2907,14,1288974,-2,2907,323,2908,506,0
20141229.134524,2907,20,1288994,20,2907,316,2908,509,0
20141229.134525,2907,6,1289000,0,2907,316,2908,548,0
20141229.134529,2908,24,1289024,-4,2907,334,2908,542,1
20141229.134531,2907,2,1289026,2,2907,388,2908,549,0
20141229.134533,2907,2,1289028,2,2907,384,2908,509,0
20141229.134534,2907,4,1289032,0,2907,383,2908,508,0
20141229.134534,2908,2,1289034,0,2907,382,2908,508,1
20141229.134541,2907,2,1289036,2,2907,340,2908,515,0
20141229.134548,2907,2,1289038,2,2907,444,2908,368,0
20141229.13455,2908,10,1289048,-10,2907,511,2908,333,1
20141229.134551,2907,400,1289448,364,2907,246,2908,333,0
20141229.134552,2907,1006,1290454,-844,2907,287,2908,286,0
20141229.134554,2907,582,1291036,328,2906,1140,2907,812,0
20141229.134555,2907,10,1291046,0,2906,1128,2907,808,0
20141229.134556,2907,2,1291048,0,2906,1121,2907,807,0
20141229.134601,2906,2048,1293096,1758,2905,669,2907,815,0
20141229.134602,2905,26,1293122,24,2905,1238,2906,101,0
20141229.134603,2906,224,1293346,202,2906,160,2907,844,1
20141229.134603,2907,1902,1295248,-184,2907,63,2908,545,1
20141229.134604,2906,160,1295408,20,2906,250,2907,53,0
20141229.134604,2907,2,1295410,-2,2906,236,2907,114,1
20141229.134605,2907,2,1295412,0,2906,234,2907,336,1
20141229.134606,2907,100,1295512,98,2906,148,2907,391,1
20141229.134608,2906,298,1295810,144,2906,137,2907,302,0
20141229.134609,2907,6,1295816,6,2906,149,2907,300,1
20141229.134609,2907,640,1296456,-132,2907,484,2908,624,1
20141229.13461,2907,2,1296458,0,2907,615,2908,375,1
20141229.134611,2907,4,1296462,-4,2907,621,2908,376,1
20141229.134613,2907,100,1296562,-100,2907,559,2908,173,1
20141229.134615,2908,2,1296564,0,2907,532,2908,325,1
20141229.134615,2907,1004,1297568,108,2906,390,2907,600,0
20141229.134616,2907,116,1297684,-44,2906,311,2907,613,0
20141229.134616,2907,2,1297686,0,2906,333,2907,612,0
20141229.134618,2907,2,1297688,2,2906,344,2907,611,0
20141229.134621,2906,8,1297696,-8,2906,323,2907,777,0
20141229.134622,2907,10,1297706,10,2906,323,2907,772,1
20141229.134624,2906,2,1297708,-2,2906,334,2907,792,0
20141229.134625,2907,4,1297712,0,2906,355,2907,794,1
20141229.134626,2907,4,1297716,4,2906,355,2907,793,1
20141229.134629,2907,4,1297720,4,2906,358,2907,792,1
20141229.134629,2907,2,1297722,0,2906,360,2907,791,1
20141229.134631,2907,60,1297782,60,2906,365,2907,762,1
20141229.134632,2907,8,1297790,8,2906,368,2907,757,1
20141229.134633,2907,2,1297792,0,2906,370,2907,771,1
20141229.134635,2906,2,1297794,-2,2906,369,2907,771,0
20141229.134641,2906,402,1298196,-174,2906,307,2907,795,0
20141229.134643,2906,402,1298598,0,2906,295,2907,665,0
20141229.134649,2907,2,1298600,0,2906,551,2907,713,1
20141229.134651,2907,1426,1300026,-570,2907,470,2908,244,1
20141229.134654,2907,1160,1301186,216,2906,780,2907,522,1
20141229.134655,2907,12,1301198,12,2906,676,2907,518,1
20141229.134656,2907,2,1301200,2,2906,676,2907,518,1
20141229.134657,2907,1038,1302238,192,2907,684,2908,281,1
20141229.134658,2907,8,1302246,-8,2907,726,2908,259,1
20141229.134658,2908,12,1302258,-12,2907,734,2908,255,1
20141229.1347,2907,2,1302260,-2,2907,734,2908,275,0
20141229.1347,2907,2,1302262,0,2907,733,2908,273,0
20141229.134701,2907,1568,1303830,206,2906,584,2907,315,0
20141229.134702,2907,98,1303928,-14,2906,389,2907,357,0
20141229.134702,2907,2,1303930,2,2906,389,2907,357,0
20141229.134703,2907,602,1304532,598,2906,440,2907,24,0
20141229.134703,2907,4,1304536,2,2906,435,2907,12,0
20141229.134705,2907,2,1304538,2,2906,411,2907,55,0
20141229.134706,2906,4,1304542,0,2906,409,2907,55,0
20141229.134706,2907,18,1304560,12,2906,409,2907,47,1
20141229.134707,2907,94,1304654,86,2907,57,2908,481,1
20141229.134708,2907,2,1304656,2,2907,83,2908,470,1
20141229.134708,2907,4,1304660,0,2907,82,2908,470,1
20141229.134709,2907,164,1304824,154,2906,422,2907,958,1
20141229.13471,2907,2,1304826,2,2906,369,2907,967,1
20141229.13471,2907,2,1304828,0,2906,387,2907,966,1
20141229.134711,2907,336,1305164,172,2906,362,2907,821,1
20141229.134712,2907,1000,1306164,0,2906,402,2907,323,1
20141229.134712,2907,210,1306374,210,2906,457,2907,178,1
20141229.134713,2907,284,1306658,142,2906,370,2907,36,1
20141229.134713,2908,76,1306734,54,2907,2,2908,480,1
20141229.134714,2907,2,1306736,0,2907,2,2908,480,0
20141229.134715,2907,6,1306742,6,2907,20,2908,480,0
20141229.134716,2907,6,1306748,0,2907,50,2908,481,0
20141229.134717,2907,2,1306750,0,2907,49,2908,484,0
20141229.134717,2908,800,1307550,-424,2907,105,2908,99,1
20141229.134717,2907,2,1307552,0,2907,227,2908,139,0
20141229.134718,2908,24,1307576,22,2907,421,2908,149,1
20141229.134718,2907,4,1307580,0,2907,427,2908,174,0
20141229.134719,2907,40,1307620,30,2907,401,2908,174,0
20141229.13472,2907,8,1307628,-4,2907,424,2908,183,0
20141229.13472,2908,20,1307648,20,2907,426,2908,176,1
20141229.134721,2908,2,1307650,2,2907,426,2908,176,1
20141229.134723,2908,2,1307652,2,2907,426,2908,176,1
20141229.134725,2907,862,1308514,270,2906,436,2907,602,0
20141229.134725,2907,102,1308616,-100,2906,386,2907,611,0
20141229.134726,2907,12,1308628,4,2906,384,2907,605,0
20141229.134727,2908,2022,1310650,-250,2907,1,2908,145,1
20141229.134727,2907,60,1310710,6,2907,355,2908,230,0
20141229.134728,2907,2,1310712,-2,2907,388,2908,180,0
20141229.134731,2907,16,1310728,-16,2907,385,2908,185,0
20141229.134732,2907,772,1311500,318,2906,665,2907,616,0
20141229.134733,2907,2,1311502,2,2906,668,2907,647,0
20141229.134733,2907,4,1311506,4,2906,668,2907,645,0
20141229.134733,2907,20,1311526,20,2906,668,2907,635,0
20141229.134734,2907,228,1311754,228,2906,654,2907,521,0
20141229.134735,2907,110,1311864,4,2906,657,2907,466,0
20141229.134735,2907,2,1311866,0,2906,667,2907,465,0
20141229.134737,2907,2,1311868,2,2906,676,2907,464,0
20141229.134737,2907,40,1311908,0,2906,676,2907,444,0
20141229.134738,2907,140,1312048,40,2906,676,2907,374,0
20141229.134738,2907,4,1312052,2,2906,677,2907,342,0
20141229.134739,2907,2,1312054,0,2906,681,2907,341,0
20141229.13474,2907,2,1312056,2,2906,681,2907,341,0
20141229.134744,2907,34,1312090,2,2906,700,2907,336,0
20141229.134745,2907,40,1312130,20,2906,700,2907,316,0
20141229.134746,2907,6,1312136,0,2906,700,2907,313,0
20141229.134747,2907,26,1312162,26,2906,700,2907,303,0
20141229.134748,2907,2,1312164,2,2906,701,2907,302,0
20141229.134749,2907,4,1312168,0,2906,701,2907,300,0
20141229.13475,2907,2,1312170,2,2906,701,2907,299,0
20141229.13475,2907,6,1312176,6,2906,711,2907,306,0
20141229.134751,2907,2,1312178,2,2906,721,2907,305,0
20141229.134752,2907,2,1312180,2,2906,721,2907,304,0
20141229.134752,2907,2,1312182,0,2906,723,2907,303,0
20141229.134753,2907,20,1312202,20,2906,724,2907,293,0
20141229.134754,2907,2,1312204,0,2906,722,2907,293,0
20141229.134755,2906,2,1312206,2,2906,721,2907,293,0
20141229.134756,2907,4,1312210,4,2906,720,2907,291,1
20141229.134757,2907,452,1312662,452,2906,730,2907,62,1
20141229.134757,2907,18,1312680,18,2906,730,2907,42,1
20141229.134758,2907,6,1312686,2,2906,732,2907,40,1
20141229.134759,2906,80,1312766,80,2906,692,2907,40,0
20141229.134759,2907,4,1312770,2,2906,692,2907,39,1
20141229.1348,2907,4,1312774,4,2906,682,2907,67,1
20141229.1348,2908,1248,1314022,-378,2908,387,2909,1449,1
20141229.134801,2908,6,1314028,-4,2908,385,2909,1180,1
20141229.134801,2908,4,1314032,-2,2908,560,2909,1146,1
20141229.134802,2907,1712,1315744,186,2906,662,2907,144,0
20141229.134804,2907,2,1315746,2,2906,657,2907,184,0
20141229.134804,2908,370,1316116,286,2907,318,2908,148,1
20141229.134807,2908,746,1316862,-678,2908,829,2909,1307,1
20141229.134809,2909,2,1316864,2,2908,851,2909,1146,1
20141229.13481,2909,40,1316904,-28,2908,836,2909,1142,1
20141229.13481,2908,1708,1318612,428,2907,415,2908,292,0
20141229.134811,2908,2,1318614,2,2907,414,2908,299,0
20141229.134812,2908,8,1318622,4,2907,438,2908,295,0
20141229.134814,2908,4,1318626,0,2907,514,2908,295,0
20141229.134815,2908,204,1318830,4,2907,513,2908,193,0
20141229.134816,2908,486,1319316,-386,2908,860,2909,1114,0
20141229.134816,2908,2,1319318,-2,2908,859,2909,1099,0
20141229.134817,2908,2,1319320,-2,2908,866,2909,1099,0
20141229.134817,2908,4,1319324,0,2908,864,2909,1100,0
20141229.134818,2909,10,1319334,-10,2908,864,2909,1095,1
20141229.134818,2908,218,1319552,-218,2908,755,2909,1091,0
20141229.134819,2908,4,1319556,-4,2908,749,2909,1141,0
20141229.13482,2907,2000,1321556,400,2907,314,2909,1151,0
20141229.134821,2908,50,1321606,50,2907,264,2908,278,1
20141229.134821,2908,2,1321608,2,2907,208,2908,278,1
20141229.134822,2908,2,1321610,2,2907,208,2908,267,1
20141229.134825,2907,2,1321612,0,2907,217,2908,273,0
20141229.134825,2908,558,1322170,-480,2908,727,2909,1170,1
20141229.134826,2908,2,1322172,0,2908,726,2909,1165,1
20141229.134827,2908,100,1322272,-100,2908,682,2909,1116,1
20141229.134828,2908,1368,1323640,12,2907,329,2908,471,1
20141229.134828,2908,6,1323646,2,2907,298,2908,511,1
20141229.134829,2907,2,1323648,0,2907,299,2908,511,0
20141229.13483,2908,102,1323750,102,2907,300,2908,471,1
20141229.13483,2907,2,1323752,2,2907,299,2908,471,0
20141229.134831,2908,16,1323768,0,2907,301,2908,463,1
20141229.134833,2908,4,1323772,0,2907,304,2908,471,1
20141229.134835,2908,46,1323818,40,2907,305,2908,501,1
20141229.134836,2907,2,1323820,2,2907,250,2908,505,0
20141229.134839,2907,432,1324252,-118,2907,3,2908,632,0
20141229.13484,2907,8,1324260,-6,2906,839,2907,200,0
20141229.134841,2907,16,1324276,-2,2906,839,2907,202,0
20141229.134841,2907,2,1324278,-2,2906,837,2907,198,0
20141229.134842,2907,10,1324288,2,2906,840,2907,178,0
20141229.134844,2907,8,1324296,-6,2906,859,2907,174,0
20141229.134846,2907,4,1324300,-2,2906,863,2907,170,0
20141229.134847,2907,4,1324304,0,2906,862,2907,168,0
20141229.134848,2907,4,1324308,0,2906,862,2907,168,0
20141229.134848,2907,42,1324350,-2,2906,876,2907,147,0
20141229.134849,2907,604,1324954,-280,2906,594,2907,145,0
20141229.134849,2907,6,1324960,0,2906,596,2907,142,0
20141229.134851,2907,30,1324990,0,2906,638,2907,135,0
20141229.134852,2907,4,1324994,0,2906,638,2907,133,0
20141229.134852,2907,2,1324996,-2,2906,638,2907,132,0
20141229.134854,2907,4,1325000,0,2906,641,2907,154,0
20141229.134856,2906,2,1325002,2,2906,625,2907,402,0
20141229.134856,2907,2,1325004,-2,2906,625,2907,422,1
20141229.134857,2907,2,1325006,0,2906,571,2907,431,1
20141229.134858,2907,2032,1327038,-658,2907,210,2908,658,1
20141229.134859,2907,2,1327040,0,2907,601,2908,410,1
20141229.134901,2907,2,1327042,0,2907,617,2908,412,1
20141229.134902,2908,2,1327044,2,2907,645,2908,421,1
20141229.134902,2908,1018,1328062,732,2907,137,2908,433,1
20141229.134903,2907,288,1328350,-118,2906,570,2907,97,0
20141229.134904,2907,4,1328354,-2,2906,573,2907,96,0
20141229.134904,2907,192,1328546,2,2907,55,2908,707,0
20141229.134905,2907,114,1328660,-100,2907,130,2908,527,0
20141229.134906,2907,2,1328662,-2,2907,129,2908,527,0
20141229.134909,2907,258,1328920,14,2906,689,2907,32,0
20141229.134909,2907,24,1328944,20,2906,579,2907,71,0
20141229.13491,2907,2,1328946,2,2906,578,2907,71,0
20141229.134911,2907,422,1329368,98,2907,46,2908,600,0
20141229.134911,2907,96,1329464,-70,2906,579,2907,7,0
20141229.134912,2908,3588,1333052,-842,2907,127,2908,128,1
20141229.134913,2907,2,1333054,0,2907,250,2908,274,0
20141229.134914,2907,202,1333256,-2,2907,372,2908,283,0
20141229.134915,2908,2,1333258,2,2907,393,2908,280,1
20141229.134916,2907,2,1333260,-2,2907,403,2908,331,0
20141229.13492,2907,2,1333262,-2,2907,219,2908,589,0
20141229.134922,2907,2,1333264,-2,2907,159,2908,629,0
20141229.134923,2907,330,1333594,68,2906,413,2907,836,0
20141229.134924,2907,20,1333614,0,2906,430,2907,940,0
20141229.134925,2906,2,1333616,0,2906,630,2907,941,0
20141229.134925,2907,2,1333618,0,2906,630,2907,941,1
20141229.134926,2907,36,1333654,34,2906,632,2907,923,1
20141229.134926,2907,44,1333698,40,2906,632,2907,901,1
20141229.134926,2906,6,1333704,0,2906,631,2907,899,0
20141229.134935,2906,60,1333764,20,2906,604,2907,897,0
20141229.134938,2906,2,1333766,-2,2906,615,2907,897,0
20141229.134943,2906,2,1333768,0,2906,592,2907,900,0
20141229.134944,2906,44,1333812,-44,2906,572,2907,900,0
20141229.134945,2906,12,1333824,0,2906,566,2907,901,0
20141229.134945,2906,12,1333836,0,2906,561,2907,901,0
20141229.134947,2907,20,1333856,20,2906,821,2907,891,1
20141229.134952,2907,1784,1335640,-60,2907,253,2908,744,1
20141229.134952,2907,520,1336160,-306,2906,653,2907,100,1
20141229.134953,2907,304,1336464,80,2907,32,2908,847,1
20141229.134953,2907,2,1336466,0,2907,168,2908,737,1
20141229.134955,2907,20,1336486,0,2907,157,2908,616,1
20141229.134957,2907,4,1336490,-2,2907,155,2908,617,1
20141229.134959,2907,12,1336502,0,2907,149,2908,619,1
20141229.134959,2908,1274,1337776,-700,2908,364,2909,1452,1
20141229.135,2908,114,1337890,-114,2908,359,2909,1241,1
20141229.135004,2908,6,1337896,0,2908,356,2909,1248,1
20141229.135006,2908,40,1337936,0,2908,337,2909,1249,1
20141229.135007,2908,206,1338142,-206,2908,234,2909,1147,1
20141229.13501,2908,468,1338610,-362,2907,507,2908,16,1
20141229.135011,2908,440,1339050,-382,2908,935,2909,1128,1
20141229.135011,2908,234,1339284,-234,2908,818,2909,1127,1
20141229.135012,2908,114,1339398,-114,2908,803,2909,1128,1
20141229.135012,2908,2,1339400,-2,2908,802,2909,1128,1
20141229.135014,2908,4,1339404,-2,2908,800,2909,1128,1
20141229.135014,2908,4,1339408,-4,2908,799,2909,1129,1
20141229.135015,2908,2,1339410,-2,2908,797,2909,1130,1
20141229.135016,2909,4,1339414,-4,2908,798,2909,1148,1
20141229.135019,2909,6,1339420,0,2908,825,2909,1147,1
20141229.135019,2908,6,1339426,-6,2908,823,2909,1147,0
20141229.135022,2908,8,1339434,-6,2908,823,2909,1153,0
20141229.135023,2909,2,1339436,0,2908,823,2909,1152,1
20141229.135024,2909,2,1339438,-2,2908,823,2909,996,1
20141229.135025,2909,4,1339442,-2,2908,825,2909,984,1
20141229.135029,2908,2,1339444,-2,2908,824,2909,1102,0
20141229.135029,2909,8,1339452,-8,2908,824,2909,1098,1
20141229.135036,2909,2,1339454,0,2908,889,2909,1131,1
20141229.135036,2909,2,1339456,0,2908,891,2909,1129,1
20141229.135037,2909,4,1339460,-4,2908,891,2909,1159,1
20141229.135038,2908,22,1339482,-22,2908,880,2909,1159,0
20141229.135038,2908,130,1339612,0,2908,816,2909,1157,0
20141229.135039,2909,2,1339614,0,2908,816,2909,1156,1
20141229.13504,2908,2,1339616,-2,2908,815,2909,1161,0
20141229.13504,2908,6,1339622,0,2908,813,2909,1161,0
20141229.135041,2909,8,1339630,-8,2908,815,2909,1162,1
20141229.135042,2908,632,1340262,0,2908,468,2909,1174,0
20141229.135045,2908,20,1340282,0,2908,420,2909,1169,0
20141229.135046,2908,4,1340286,-4,2908,418,2909,1171,0
20141229.135046,2908,836,1341122,320,2907,655,2908,684,0
20141229.135048,2908,2,1341124,0,2907,473,2908,702,0
20141229.13505,2908,6,1341130,6,2907,520,2908,690,0
20141229.13505,2908,6,1341136,6,2907,520,2908,687,0
20141229.135052,2908,2,1341138,2,2907,530,2908,686,0
20141229.135053,2908,6,1341144,6,2907,550,2908,683,0
20141229.135055,2907,2,1341146,0,2907,554,2908,684,0
20141229.135057,2908,20,1341166,20,2907,534,2908,677,1
20141229.1351,2908,60,1341226,0,2907,552,2908,660,1
20141229.135103,2908,2,1341228,2,2907,552,2908,674,1
20141229.135106,2908,6,1341234,6,2907,562,2908,671,1
20141229.135118,2908,4,1341238,2,2907,579,2908,716,1
20141229.135119,2908,100,1341338,100,2907,592,2908,666,1
20141229.13512,2908,4,1341342,-2,2907,591,2908,666,1
20141229.135124,2907,4,1341346,0,2907,630,2908,765,0
20141229.135125,2907,10,1341356,0,2907,625,2908,765,0
20141229.135125,2908,2,1341358,2,2907,625,2908,764,1
20141229.135127,2907,2,1341360,-2,2907,626,2908,780,0
20141229.135128,2907,2,1341362,-2,2907,626,2908,780,0
20141229.135131,2907,32,1341394,-2,2907,661,2908,765,0
20141229.135138,2907,4,1341398,0,2907,730,2908,780,0
20141229.135138,2907,2,1341400,2,2907,730,2908,780,0
20141229.135141,2908,2,1341402,2,2907,732,2908,781,1
20141229.135143,2908,10,1341412,10,2907,745,2908,768,1
20141229.135144,2908,320,1341732,318,2907,745,2908,608,1
20141229.135145,2908,180,1341912,62,2907,686,2908,520,1
20141229.135146,2908,82,1341994,82,2907,687,2908,479,1
20141229.135146,2908,210,1342204,104,2907,636,2908,374,1
20141229.135147,2908,696,1342900,150,2907,636,2908,26,1
20141229.135147,2908,52,1342952,12,2908,579,2909,718,1
20141229.135155,2908,2,1342954,-2,2908,560,2909,728,1
20141229.135156,2908,2,1342956,-2,2908,559,2909,729,1
20141229.135158,2908,10,1342966,0,2908,555,2909,728,1
20141229.1352,2909,10,1342976,4,2908,554,2909,728,1
20141229.135208,2909,2,1342978,0,2908,562,2909,754,1
20141229.13521,2909,2,1342980,2,2908,572,2909,754,1
20141229.135215,2909,2,1342982,2,2908,570,2909,755,1
20141229.135215,2909,2,1342984,0,2908,570,2909,755,1
20141229.135217,2908,2,1342986,0,2908,558,2909,756,0
20141229.135218,2908,2,1342988,2,2908,557,2909,757,0
20141229.13522,2909,4,1342992,0,2908,538,2909,753,1
20141229.13522,2909,6,1342998,0,2908,538,2909,750,1
20141229.135225,2909,4,1343002,0,2908,557,2909,873,1
20141229.135226,2909,2,1343004,2,2908,557,2909,872,1
20141229.135226,2909,10,1343014,2,2908,557,2909,867,1
20141229.135228,2909,22,1343036,20,2908,557,2909,856,1
20141229.135228,2908,6,1343042,6,2908,554,2909,855,0
20141229.13523,2909,8,1343050,8,2908,556,2909,853,1
20141229.13523,2909,2,1343052,0,2908,556,2909,852,1
20141229.135232,2908,20,1343072,0,2908,550,2909,747,0
20141229.135236,2909,8,1343080,8,2908,553,2909,732,1
20141229.135236,2909,6,1343086,6,2908,553,2909,730,1
20141229.135239,2909,10,1343096,10,2908,556,2909,723,1
20141229.135239,2908,4,1343100,4,2908,556,2909,724,0
20141229.13524,2908,1258,1344358,1056,2907,828,2908,58,0
20141229.135243,2908,2,1344360,-2,2907,828,2908,57,0
20141229.135244,2908,4,1344364,0,2907,828,2908,55,0
20141229.135244,2908,46,1344410,-32,2907,828,2908,32,0
20141229.135245,2908,64,1344474,0,2908,182,2909,770,0
20141229.135247,2909,2,1344476,2,2908,230,2909,779,1
20141229.135248,2908,4,1344480,4,2908,173,2909,779,0
20141229.135249,2908,10,1344490,0,2908,168,2909,779,0
20141229.135252,2908,2,1344492,2,2908,171,2909,770,0
20141229.135252,2908,2,1344494,2,2908,220,2909,871,0
20141229.135253,2909,2,1344496,2,2908,220,2909,870,1
20141229.135254,2908,2,1344498,0,2908,223,2909,877,0
20141229.135254,2908,10,1344508,0,2908,218,2909,870,0
20141229.135255,2908,6,1344514,6,2908,216,2909,869,0
20141229.135255,2908,96,1344610,0,2908,168,2909,869,0
20141229.135256,2908,332,1344942,-96,2907,907,2908,2,0
20141229.135256,2908,24,1344966,20,2907,893,2908,80,0
20141229.135257,2908,4,1344970,4,2907,894,2908,82,0
20141229.135258,2908,4,1344974,0,2907,894,2908,81,0
20141229.135258,2908,2,1344976,2,2907,894,2908,80,0
20141229.135259,2908,12,1344988,12,2907,849,2908,76,0
20141229.1353,2908,40,1345028,0,2907,859,2908,56,0
20141229.135301,2908,2,1345030,2,2907,860,2908,55,0
20141229.135303,2907,8,1345038,2,2907,846,2908,64,0
20141229.135303,2908,6,1345044,6,2907,845,2908,61,1
20141229.135305,2908,2,1345046,0,2907,846,2908,79,1
20141229.135305,2908,6,1345052,4,2907,846,2908,75,1
20141229.135308,2907,2,1345054,2,2907,837,2908,77,0
20141229.135308,2908,10,1345064,-10,2907,837,2908,82,1
20141229.13531,2908,20,1345084,0,2907,838,2908,72,1
20141229.135311,2908,144,1345228,86,2908,119,2909,859,1
20141229.135311,2909,2,1345230,2,2908,119,2909,858,1
20141229.135313,2909,6,1345236,6,2908,122,2909,1000,1
20141229.135313,2909,4,1345240,4,2908,134,2909,998,1
20141229.135314,2909,4,1345244,4,2908,134,2909,1006,1
20141229.135314,2909,8,1345252,6,2908,133,2909,992,1
20141229.135315,2909,4,1345256,4,2908,133,2909,990,1
20141229.135316,2908,10,1345266,10,2908,129,2909,989,0
20141229.135317,2909,2,1345268,2,2908,136,2909,988,1
20141229.135318,2909,16,1345284,16,2908,131,2909,980,1
20141229.135318,2909,4,1345288,4,2908,131,2909,977,1
20141229.135319,2909,2,1345290,2,2908,131,2909,926,1
20141229.135319,2909,4,1345294,4,2908,136,2909,924,1
20141229.135321,2908,10,1345304,0,2908,205,2909,925,0
20141229.135322,2908,20,1345324,20,2908,191,2909,924,0
20141229.135323,2908,12,1345336,10,2908,196,2909,911,0
20141229.135324,2908,12,1345348,12,2908,190,2909,912,0
20141229.135325,2908,2,1345350,2,2908,190,2909,934,0
20141229.135328,2908,2,1345352,0,2908,239,2909,933,0
20141229.13533,2908,40,1345392,40,2908,219,2909,927,0
20141229.135333,2908,18,1345410,18,2908,346,2909,896,0
20141229.135334,2908,6,1345416,0,2908,346,2909,894,0
20141229.135336,2908,2,1345418,0,2908,345,2909,895,0
20141229.135337,2909,20,1345438,20,2908,348,2909,885,1
20141229.135339,2909,22,1345460,-12,2908,353,2909,931,1
20141229.13534,2908,24,1345484,0,2908,341,2909,932,0
20141229.135341,2909,48,1345532,10,2908,341,2909,908,1
20141229.135342,2909,2,1345534,2,2908,343,2909,909,1
20141229.135342,2909,2,1345536,0,2908,343,2909,908,1
20141229.135343,2908,2,1345538,-2,2908,344,2909,907,0
20141229.135346,2909,8,1345546,-4,2908,314,2909,903,1
20141229.135347,2908,8,1345554,-8,2908,310,2909,903,0
20141229.135348,2909,2,1345556,0,2908,320,2909,904,1
20141229.135349,2908,2,1345558,0,2908,329,2909,938,0
20141229.13535,2909,2,1345560,0,2908,329,2909,929,1
20141229.135351,2909,2,1345562,0,2908,328,2909,928,1
20141229.135353,2909,2,1345564,0,2908,336,2909,928,1
20141229.135354,2909,2,1345566,0,2908,337,2909,927,1
20141229.135357,2909,2,1345568,0,2908,338,2909,929,1
20141229.135358,2909,10,1345578,-10,2908,343,2909,915,1
20141229.135358,2909,6,1345584,0,2908,345,2909,902,1
20141229.1354,2909,2,1345586,-2,2908,353,2909,902,1
20141229.135401,2909,2,1345588,-2,2908,358,2909,901,1
20141229.135401,2909,40,1345628,0,2908,360,2909,851,1
20141229.135405,2909,4,1345632,0,2908,358,2909,850,1
20141229.135407,2909,2,1345634,0,2908,358,2909,838,1
20141229.135408,2909,2,1345636,0,2908,359,2909,817,1
20141229.135409,2909,4,1345640,0,2908,359,2909,815,1
20141229.13541,2909,2,1345642,-2,2908,362,2909,814,1
20141229.135411,2909,6,1345648,-4,2908,362,2909,791,1
20141229.135413,2908,20,1345668,0,2908,352,2909,778,0
20141229.135415,2909,2,1345670,0,2908,425,2909,792,1
20141229.135416,2909,60,1345730,-60,2908,425,2909,762,1
20141229.135417,2909,120,1345850,0,2908,446,2909,692,1
20141229.135418,2909,8,1345858,-6,2908,449,2909,689,1
20141229.135419,2909,2,1345860,-2,2908,470,2909,688,1
20141229.135421,2908,100,1345960,76,2908,420,2909,689,0
20141229.135421,2909,10,1345970,0,2908,420,2909,684,1
20141229.135422,2909,82,1346052,0,2908,416,2909,643,1
20141229.135423,2909,4,1346056,-4,2908,416,2909,644,1
20141229.135424,2908,2,1346058,0,2908,415,2909,643,0
20141229.135426,2909,8,1346066,-6,2908,456,2909,640,1
20141229.135426,2909,2,1346068,0,2908,457,2909,639,1
20141229.135427,2909,4,1346072,-4,2908,456,2909,637,1
20141229.13543,2909,10,1346082,-10,2908,386,2909,677,1
20141229.13543,2908,260,1346342,176,2908,226,2909,677,0
20141229.135431,2908,438,1346780,-134,2907,964,2908,104,0
20141229.135432,2908,2,1346782,0,2907,944,2908,105,0
20141229.135432,2908,4,1346786,0,2907,939,2908,181,0
20141229.135433,2908,2,1346788,2,2907,939,2908,180,0
20141229.135435,2908,2,1346790,2,2907,945,2908,190,0
20141229.135436,2908,2,1346792,2,2907,944,2908,188,0
20141229.135437,2908,14,1346806,0,2907,944,2908,188,0
20141229.135438,2908,2,1346808,0,2907,954,2908,265,0
20141229.135439,2907,2,1346810,0,2907,954,2908,295,0
20141229.13544,2908,10,1346820,10,2907,953,2908,320,1
20141229.135441,2908,10,1346830,8,2907,955,2908,316,1
20141229.135442,2908,4,1346834,0,2907,920,2908,315,1
20141229.135444,2907,4,1346838,0,2907,862,2908,346,0
20141229.135444,2908,4,1346842,4,2907,865,2908,359,1
20141229.135445,2907,2,1346844,0,2907,863,2908,359,0
20141229.135446,2908,2,1346846,0,2907,850,2908,383,1
20141229.13545,2907,4,1346850,4,2907,750,2908,536,0
20141229.135451,2907,6,1346856,6,2907,623,2908,590,0
20141229.135452,2908,4,1346860,0,2907,623,2908,595,1
20141229.135452,2908,14,1346874,14,2907,624,2908,617,1
20141229.135454,2908,10,1346884,10,2907,624,2908,613,1
20141229.135456,2908,4,1346888,4,2907,624,2908,610,1
20141229.135458,2908,10,1346898,10,2907,625,2908,670,1
20141229.135459,2908,2,1346900,2,2907,625,2908,659,1
20141229.135459,2908,2,1346902,2,2907,625,2908,637,1
20141229.135501,2908,2,1346904,2,2907,634,2908,701,1
20141229.135502,2908,2,1346906,0,2907,634,2908,706,1
20141229.135503,2908,4,1346910,0,2907,636,2908,705,1
20141229.13551,2908,2,1346912,0,2907,653,2908,703,1
20141229.135511,2908,2,1346914,2,2907,653,2908,706,1
20141229.135512,2908,2,1346916,2,2907,654,2908,770,1
20141229.135513,2907,2,1346918,0,2907,653,2908,770,0
20141229.135516,2907,2,1346920,2,2907,656,2908,770,0
20141229.135517,2908,4,1346924,2,2907,607,2908,779,1
20141229.135518,2907,2,1346926,0,2907,607,2908,779,0
20141229.135519,2908,2,1346928,2,2907,608,2908,778,1
20141229.135519,2908,2,1346930,2,2907,619,2908,777,1
20141229.135521,2907,4,1346934,0,2907,646,2908,777,0
20141229.135522,2907,200,1347134,200,2907,558,2908,857,0
20141229.135522,2907,986,1348120,500,2906,1140,2907,24,0
20141229.135523,2907,144,1348264,-40,2906,1129,2907,54,0
20141229.135523,2907,242,1348506,-12,2906,1142,2907,1,0
20141229.135524,2907,244,1348750,4,2906,1190,2907,30,0
20141229.135524,2907,16,1348766,-4,2906,1125,2907,270,0
20141229.135525,2907,4,1348770,0,2906,1064,2907,313,0
20141229.135526,2907,2,1348772,0,2906,1051,2907,335,0
20141229.135527,2907,2,1348774,0,2906,1052,2907,334,0
20141229.135529,2907,2,1348776,0,2906,1052,2907,333,0
20141229.135529,2907,2,1348778,0,2906,1054,2907,334,0
20141229.135531,2907,100,1348878,0,2906,1091,2907,280,0
20141229.135532,2907,10,1348888,-6,2906,1091,2907,306,0
20141229.135532,2906,6,1348894,-4,2906,1088,2907,190,0
20141229.135534,2907,24,1348918,-20,2906,1096,2907,225,1
20141229.135534,2906,10,1348928,0,2906,1087,2907,326,0
20141229.135536,2907,2,1348930,-2,2906,1101,2907,327,1
20141229.135537,2907,4,1348934,0,2906,1101,2907,326,1
20141229.135538,2907,2,1348936,0,2906,1146,2907,335,1
20141229.135538,2907,6,1348942,0,2906,1146,2907,352,1
20141229.135539,2906,2,1348944,0,2906,1145,2907,353,0
20141229.135542,2906,2,1348946,-2,2906,1146,2907,355,0
20141229.135545,2906,2,1348948,-2,2906,1145,2907,361,0
20141229.135548,2907,2,1348950,-2,2906,1146,2907,357,1
20141229.135548,2906,30,1348980,-26,2906,1132,2907,356,0
20141229.135549,2907,2,1348982,0,2906,1122,2907,356,1
20141229.135549,2907,6,1348988,0,2906,1120,2907,355,1
20141229.135551,2906,2,1348990,0,2906,1118,2907,364,0
20141229.135552,2906,4,1348994,0,2906,1115,2907,364,0
20141229.135553,2906,8,1349002,-6,2906,1091,2907,379,0
20141229.135554,2906,40,1349042,24,2906,1071,2907,379,0
20141229.135555,2906,2,1349044,2,2906,1075,2907,383,0
20141229.135557,2906,2,1349046,2,2906,1074,2907,383,0
20141229.135601,2906,42,1349088,-10,2906,1070,2907,385,0
20141229.135603,2907,4,1349092,0,2906,1090,2907,388,1
20141229.135603,2906,6,1349098,2,2906,1087,2907,386,0
20141229.135604,2907,2,1349100,-2,2906,1087,2907,385,1
20141229.135606,2907,2,1349102,0,2906,1087,2907,384,1
20141229.135607,2907,4,1349106,-2,2906,1087,2907,381,1
20141229.135607,2906,6,1349112,4,2906,1084,2907,381,0
20141229.135609,2907,2,1349114,0,2906,991,2907,400,1
20141229.13561,2907,2,1349116,0,2906,991,2907,399,1
20141229.135611,2906,200,1349316,-200,2906,838,2907,404,0
20141229.135612,2906,10,1349326,-2,2906,835,2907,404,0
20141229.135613,2907,2,1349328,0,2906,835,2907,403,1
20141229.135613,2906,2,1349330,-2,2906,834,2907,403,0
20141229.135614,2906,2,1349332,-2,2906,833,2907,402,0
20141229.135615,2906,2,1349334,0,2906,832,2907,404,0
20141229.135616,2906,8,1349342,-8,2906,823,2907,416,0
20141229.135616,2907,2,1349344,-2,2906,823,2907,415,1
20141229.135619,2906,4,1349348,-4,2906,826,2907,427,0
20141229.135619,2906,4,1349352,-4,2906,824,2907,427,0
20141229.135621,2907,2,1349354,0,2906,829,2907,428,1
20141229.135622,2907,4,1349358,0,2906,829,2907,426,1
20141229.135624,2907,2,1349360,0,2906,831,2907,425,1
20141229.135625,2907,24,1349384,-24,2906,831,2907,429,1
20141229.135627,2907,2,1349386,0,2906,832,2907,426,1
20141229.135628,2906,8,1349394,-6,2906,824,2907,410,0
20141229.135629,2906,36,1349430,-32,2906,808,2907,410,0
20141229.135631,2907,2,1349432,-2,2906,810,2907,409,1
20141229.135632,2907,10,1349442,0,2906,886,2907,404,1
20141229.135635,2907,12,1349454,-10,2906,885,2907,398,1
20141229.135637,2907,2,1349456,0,2906,888,2907,378,1
20141229.13564,2907,2,1349458,0,2906,939,2907,378,1
20141229.135642,2907,30,1349488,-24,2906,933,2907,376,1
20141229.135642,2907,2,1349490,0,2906,939,2907,375,1
20141229.135643,2907,12,1349502,-12,2906,938,2907,369,1
20141229.135643,2907,12,1349514,10,2906,938,2907,363,1
20141229.135646,2907,40,1349554,40,2906,942,2907,344,1
20141229.135647,2907,8,1349562,8,2906,941,2907,344,1
20141229.135653,2907,690,1350252,-280,2907,86,2908,1033,1
20141229.135656,2907,22,1350274,-2,2907,90,2908,995,1
20141229.135656,2908,10,1350284,0,2907,100,2908,990,1
20141229.135657,2907,62,1350346,-2,2907,89,2908,1391,0
20141229.135657,2907,190,1350536,-84,2906,984,2907,112,0
20141229.135659,2907,210,1350746,200,2906,990,2907,10,0
20141229.135659,2907,24,1350770,0,2907,50,2908,1435,0
20141229.1357,2908,4,1350774,0,2907,63,2908,1018,1
20141229.135701,2907,10,1350784,0,2907,59,2908,990,0
20141229.135703,2907,2,1350786,0,2907,76,2908,991,0
20141229.135704,2907,4,1350790,0,2907,91,2908,1041,0
20141229.135707,2908,46,1350836,-32,2907,96,2908,1054,1
20141229.135708,2908,2,1350838,-2,2907,97,2908,1058,1
20141229.135711,2907,60,1350898,-52,2907,138,2908,1044,0
20141229.135717,2907,2,1350900,2,2907,210,2908,1097,0
20141229.135718,2907,42,1350942,-6,2907,189,2908,1097,0
20141229.13572,2907,40,1350982,0,2907,172,2908,1157,0
20141229.13572,2907,4,1350986,-2,2907,171,2908,1157,0
20141229.13573,2908,2,1350988,0,2907,208,2908,1142,1
20141229.13573,2908,6,1350994,0,2907,209,2908,1159,1
20141229.135732,2908,8,1351002,0,2907,212,2908,1171,1
20141229.135733,2908,2,1351004,0,2907,212,2908,1170,1
20141229.135734,2907,2,1351006,-2,2907,211,2908,1170,0
20141229.135735,2908,10,1351016,-4,2907,213,2908,1165,1
20141229.135736,2908,2,1351018,-2,2907,213,2908,1164,1
20141229.13574,2908,2,1351020,0,2907,214,2908,1168,1
20141229.135743,2907,2,1351022,-2,2907,218,2908,1157,0
20141229.135745,2907,40,1351062,20,2907,198,2908,1163,0
20141229.135745,2907,396,1351458,-176,2906,924,2907,75,0
20141229.135748,2907,10,1351468,0,2906,595,2907,310,0
20141229.135749,2906,44,1351512,0,2906,584,2907,369,0
20141229.135753,2907,2,1351514,2,2906,600,2907,384,1
20141229.135754,2906,2,1351516,-2,2906,597,2907,384,0
20141229.135755,2906,2,1351518,-2,2906,592,2907,393,0
20141229.135759,2907,2,1351520,0,2906,593,2907,525,1
20141229.135801,2906,4,1351524,-2,2906,593,2907,525,0
20141229.135801,2907,2,1351526,0,2906,619,2907,523,1
20141229.135803,2906,4,1351530,-2,2906,617,2907,525,0
20141229.135803,2907,10,1351540,10,2906,617,2907,616,1
20141229.135805,2907,32,1351572,-24,2906,605,2907,614,1
20141229.135805,2907,2,1351574,0,2906,605,2907,613,1
20141229.135805,2906,2,1351576,-2,2906,604,2907,613,0
20141229.135807,2906,2,1351578,0,2906,604,2907,613,0
20141229.135809,2906,40,1351618,0,2906,583,2907,613,0
20141229.135811,2906,2,1351620,0,2906,583,2907,613,0
20141229.135813,2906,2,1351622,0,2906,592,2907,460,0
20141229.135815,2907,10,1351632,0,2906,711,2907,427,1
20141229.135816,2906,62,1351694,-62,2906,686,2907,384,0
20141229.135818,2906,2,1351696,-2,2906,685,2907,485,0
20141229.135821,2907,2,1351698,0,2906,606,2907,485,1
20141229.135832,2906,2,1351700,-2,2906,632,2907,444,0
20141229.135833,2906,2,1351702,-2,2906,621,2907,447,0
20141229.135834,2906,2,1351704,0,2906,620,2907,447,0
20141229.135834,2906,2,1351706,-2,2906,619,2907,446,0
20141229.135843,2906,4,1351710,0,2906,701,2907,441,0
20141229.135848,2907,2,1351712,0,2906,820,2907,344,1
20141229.135848,2907,2,1351714,0,2906,819,2907,343,1
20141229.13585,2906,14,1351728,-8,2906,821,2907,307,0
20141229.13585,2907,6,1351734,0,2906,815,2907,303,1
20141229.135853,2906,4,1351738,4,2906,826,2907,304,0
20141229.135854,2906,6,1351744,2,2906,835,2907,302,0
20141229.135856,2907,2,1351746,0,2906,836,2907,302,1
20141229.135857,2907,10,1351756,-8,2906,843,2907,313,1
20141229.1359,2907,2,1351758,0,2906,841,2907,312,1
20141229.1359,2906,2,1351760,0,2906,841,2907,312,0
20141229.135901,2906,4,1351764,-2,2906,841,2907,311,0
20141229.135905,2907,334,1352098,-134,2906,824,2907,301,1
20141229.135908,2907,2,1352100,0,2906,861,2907,301,1
20141229.135908,2906,2,1352102,0,2906,860,2907,300,0
20141229.135912,2907,2,1352104,0,2906,860,2907,300,1
20141229.135913,2907,10,1352114,-10,2906,855,2907,295,1
20141229.135916,2907,4,1352118,0,2906,876,2907,294,1
20141229.135919,2906,6,1352124,-6,2906,871,2907,299,0
20141229.135919,2907,2,1352126,0,2906,871,2907,299,1
20141229.135921,2907,6,1352132,0,2906,873,2907,298,1
20141229.135922,2907,2,1352134,0,2906,875,2907,302,1
20141229.135923,2906,48,1352182,-42,2906,880,2907,249,0
20141229.135925,2907,2,1352184,2,2906,880,2907,248,1
20141229.135926,2907,2,1352186,0,2906,880,2907,248,1
20141229.135928,2906,2,1352188,-2,2906,884,2907,252,0
20141229.135928,2907,2,1352190,2,2906,884,2907,251,1
20141229.135931,2907,4,1352194,0,2906,869,2907,250,1
20141229.135933,2907,200,1352394,-106,2906,899,2907,150,1
20141229.135934,2907,102,1352496,-96,2906,909,2907,126,1
20141229.135934,2907,254,1352750,128,2907,51,2908,1567,1
20141229.135935,2907,2,1352752,-2,2907,67,2908,1486,1
20141229.13594,2907,6,1352758,-4,2907,116,2908,1449,1
20141229.135942,2907,234,1352992,-140,2906,936,2907,93,1
20141229.135944,2907,12,1353004,10,2906,868,2907,235,1
20141229.135946,2907,2,1353006,2,2906,894,2907,236,1
20141229.135949,2907,10,1353016,10,2906,894,2907,241,1
20141229.13595,2907,2,1353018,0,2906,895,2907,241,1
20141229.13595,2907,22,1353040,22,2906,895,2907,230,1
20141229.135953,2906,4,1353044,0,2906,892,2907,231,0
20141229.135955,2906,2,1353046,-2,2906,909,2907,231,0
20141229.135956,2907,2,1353048,2,2906,918,2907,230,1
20141229.135958,2906,2,1353050,0,2906,863,2907,177,0
20141229.135959,2906,10,1353060,4,2906,878,2907,178,0
20141229.140001,2907,20,1353080,0,2906,878,2907,169,1
20141229.140001,2906,6,1353086,0,2906,896,2907,168,0
20141229.140002,2907,80,1353166,-16,2906,857,2907,167,1
20141229.140003,2907,2,1353168,2,2906,851,2907,165,1
20141229.140005,2907,4,1353172,2,2906,851,2907,168,1
20141229.140005,2907,2,1353174,2,2906,851,2907,172,1
20141229.140009,2906,4,1353178,4,2906,824,2907,194,0
20141229.140012,2906,6,1353184,4,2906,785,2907,487,0
20141229.140015,2906,10,1353194,0,2906,1013,2907,494,0
20141229.140018,2906,2,1353196,-2,2906,1012,2907,494,0
20141229.14002,2907,24,1353220,0,2906,1002,2907,495,1
20141229.140021,2907,6,1353226,0,2906,1003,2907,494,1
20141229.140022,2907,506,1353732,368,2906,1069,2907,211,1
20141229.140023,2907,408,1354140,154,2907,196,2908,1482,1
20141229.140023,2907,2,1354142,0,2907,195,2908,1414,1
20141229.140024,2907,2,1354144,2,2907,194,2908,1413,1
20141229.140025,2907,12,1354156,0,2907,193,2908,1387,1
20141229.140026,2907,12,1354168,0,2907,187,2908,1387,1
20141229.140026,2907,20,1354188,0,2907,269,2908,1387,1
20141229.140027,2907,2,1354190,0,2907,170,2908,1407,1
20141229.140028,2907,12,1354202,12,2907,165,2908,1407,1
20141229.140029,2907,6,1354208,2,2907,166,2908,1296,1
20141229.14003,2907,2,1354210,2,2907,210,2908,1293,1
20141229.140031,2907,14,1354224,2,2907,232,2908,1237,1
20141229.140032,2907,6,1354230,6,2907,229,2908,1251,1
20141229.140034,2907,4,1354234,4,2907,227,2908,1251,1
20141229.140035,2907,2,1354236,0,2907,226,2908,1252,1
20141229.140036,2907,44,1354280,28,2907,234,2908,1252,1
20141229.140037,2907,12,1354292,0,2907,231,2908,1251,1
20141229.140038,2907,2,1354294,-2,2907,231,2908,1251,1
20141229.140039,2908,2,1354296,0,2907,240,2908,1250,1
20141229.140042,2908,2,1354298,0,2907,202,2908,649,1
20141229.140042,2907,4,1354302,0,2907,201,2908,648,0
20141229.140044,2907,6,1354308,0,2907,198,2908,648,0
20141229.140047,2907,398,1354706,-204,2906,1092,2907,409,0
20141229.140048,2907,2,1354708,-2,2906,1094,2907,408,0
20141229.140049,2907,4,1354712,-2,2906,1094,2907,406,0
20141229.14005,2907,8,1354720,0,2906,1095,2907,402,0
20141229.140052,2907,20,1354740,0,2906,1095,2907,392,0
20141229.140052,2906,12,1354752,-2,2906,1089,2907,392,0
20141229.140054,2907,6,1354758,0,2906,1091,2907,390,1
20141229.140055,2907,734,1355492,-494,2906,1100,2907,25,1
20141229.140055,2907,56,1355548,22,2907,284,2908,718,1
20141229.140056,2907,2,1355550,2,2907,316,2908,719,1
20141229.140058,2908,10,1355560,6,2907,567,2908,720,1
20141229.140059,2908,6,1355566,0,2907,566,2908,718,1
20141229.1401,2907,6,1355572,2,2907,260,2908,767,0
20141229.1401,2908,4,1355576,4,2907,260,2908,766,1
20141229.140101,2907,10,1355586,0,2907,425,2908,766,0
20141229.140102,2907,4,1355590,4,2907,424,2908,767,0
20141229.140103,2908,8,1355598,4,2907,425,2908,763,1
20141229.140104,2907,6,1355604,6,2907,422,2908,763,0
20141229.140106,2907,8,1355612,6,2907,430,2908,762,0
20141229.140107,2908,4,1355616,4,2907,430,2908,761,1
20141229.140108,2907,2,1355618,2,2907,430,2908,766,0
20141229.140109,2907,10,1355628,10,2907,426,2908,765,0
20141229.14011,2907,6,1355634,6,2907,222,2908,765,0
20141229.140111,2907,10,1355644,10,2907,219,2908,764,0
20141229.140112,2908,2,1355646,2,2907,219,2908,563,1
20141229.140113,2907,10,1355656,10,2907,217,2908,570,0
20141229.140113,2907,4,1355660,0,2907,231,2908,570,0
20141229.140114,2908,212,1355872,44,2907,225,2908,496,1
20141229.140115,2907,8,1355880,8,2907,321,2908,512,0
20141229.140116,2907,616,1356496,-52,2907,45,2908,513,0
20141229.140117,2907,80,1356576,-12,2906,1205,2907,94,0
20141229.140117,2907,162,1356738,0,2906,1103,2907,67,0
20141229.140118,2907,164,1356902,14,2907,1,2908,612,0
20141229.140119,2907,6,1356908,4,2907,189,2908,612,0
20141229.14012,2907,2,1356910,2,2907,188,2908,612,0
20141229.140121,2907,6,1356916,6,2907,185,2908,612,0
20141229.140122,2908,6,1356922,0,2907,187,2908,611,1
20141229.140123,2908,2,1356924,0,2907,186,2908,613,1
20141229.140123,2907,6,1356930,6,2907,183,2908,615,0
20141229.140124,2907,22,1356952,22,2907,183,2908,616,0
20141229.140124,2907,50,1357002,0,2907,158,2908,633,0
20141229.140126,2907,2,1357004,0,2907,157,2908,635,0
20141229.140126,2907,4,1357008,4,2907,159,2908,635,0
20141229.140127,2907,2,1357010,2,2907,161,2908,635,0
20141229.140129,2907,42,1357052,4,2907,148,2908,721,0
20141229.14013,2908,2,1357054,0,2907,148,2908,770,1
20141229.140131,2907,30,1357084,0,2907,133,2908,771,0
20141229.140132,2907,4,1357088,4,2907,131,2908,771,0
20141229.140132,2907,240,1357328,-108,2907,11,2908,771,0
20141229.140133,2907,38,1357366,-18,2906,1034,2907,139,0
20141229.140134,2907,6,1357372,-6,2906,1022,2907,136,0
20141229.140135,2907,2,1357374,0,2906,1022,2907,194,0
20141229.140136,2907,2,1357376,0,2906,1022,2907,198,0
20141229.140137,2907,32,1357408,0,2906,1022,2907,182,0
20141229.140139,2907,4,1357412,-4,2906,1036,2907,182,0
20141229.14014,2907,16,1357428,-16,2906,1037,2907,183,0
20141229.140142,2907,4,1357432,0,2906,1037,2907,181,0
20141229.140142,2907,2,1357434,-2,2906,1038,2907,180,0
20141229.140143,2906,4,1357438,0,2906,1036,2907,180,0
20141229.140144,2907,4,1357442,0,2906,1035,2907,178,1
20141229.140144,2906,6,1357448,-6,2906,1032,2907,178,0
20141229.140146,2907,2,1357450,-2,2906,1033,2907,178,1
20141229.140147,2907,18,1357468,0,2906,1033,2907,170,1
20141229.140149,2907,6,1357474,-4,2906,1031,2907,165,1
20141229.14015,2907,10,1357484,-6,2906,1036,2907,258,1
20141229.14015,2906,4,1357488,0,2906,1034,2907,258,0
20141229.140153,2906,6,1357494,0,2906,1031,2907,260,0
20141229.140155,2907,4,1357498,0,2906,1030,2907,258,1
20141229.140156,2906,8,1357506,0,2906,1026,2907,264,0
20141229.140157,2907,2,1357508,0,2906,1026,2907,264,1
20141229.140158,2906,2,1357510,-2,2906,1025,2907,264,0
20141229.140159,2906,4,1357514,0,2906,1020,2907,264,0
20141229.1402,2907,2,1357516,-2,2906,1020,2907,263,1
20141229.140201,2907,4,1357520,-4,2906,1020,2907,261,1
20141229.140201,2906,4,1357524,0,2906,1018,2907,261,0
20141229.140204,2906,2,1357526,-2,2906,1017,2907,262,0
20141229.140205,2907,4,1357530,0,2906,1017,2907,261,1
20141229.140205,2906,2,1357532,-2,2906,1016,2907,261,0
20141229.140207,2906,4,1357536,0,2906,1021,2907,268,0
20141229.140208,2906,4,1357540,-4,2906,1019,2907,268,0
20141229.140209,2907,6,1357546,0,2906,1019,2907,296,1
20141229.14021,2906,8,1357554,0,2906,1016,2907,297,0
20141229.140211,2907,2,1357556,-2,2906,1016,2907,297,1
20141229.140212,2907,14,1357570,-2,2906,1015,2907,241,1
20141229.140213,2907,4,1357574,-2,2906,1014,2907,240,1
20141229.140213,2907,4,1357578,0,2906,1014,2907,238,1
20141229.140215,2907,2,1357580,0,2906,1014,2907,237,1
20141229.140217,2907,478,1358058,-350,2907,149,2908,742,1
20141229.140218,2907,2,1358060,0,2907,167,2908,701,1
20141229.140222,2907,2,1358062,-2,2907,460,2908,701,1
20141229.140227,2907,6,1358068,4,2907,474,2908,730,1
20141229.140229,2907,2,1358070,2,2907,489,2908,748,1
20141229.140239,2907,18,1358088,18,2907,504,2908,697,1
20141229.140241,2907,2,1358090,2,2907,534,2908,696,1
20141229.140243,2907,2,1358092,2,2907,523,2908,695,1
20141229.140244,2908,2,1358094,0,2907,557,2908,694,1
20141229.140246,2908,100,1358194,0,2907,563,2908,694,1
20141229.140247,2907,2,1358196,0,2907,563,2908,694,0
20141229.140253,2907,12,1358208,12,2907,556,2908,699,0
20141229.140255,2907,14,1358222,14,2907,551,2908,707,0
20141229.140257,2907,2,1358224,2,2907,571,2908,707,0
20141229.140259,2907,2,1358226,0,2907,580,2908,707,0
20141229.140301,2908,2,1358228,0,2907,581,2908,707,1
20141229.140302,2908,4,1358232,0,2907,586,2908,697,1
20141229.140305,2908,2,1358234,2,2907,586,2908,747,1
20141229.140307,2907,12,1358246,12,2907,546,2908,742,0
20141229.140308,2907,2,1358248,0,2907,555,2908,745,0
20141229.140309,2907,4,1358252,0,2907,554,2908,744,0
20141229.140312,2908,2,1358254,0,2907,555,2908,745,1
20141229.140315,2907,12,1358266,12,2907,541,2908,744,0
20141229.140316,2907,200,1358466,90,2907,458,2908,744,0
20141229.140317,2908,8,1358474,0,2907,458,2908,741,1
20141229.140318,2907,18,1358492,-4,2907,450,2908,740,0
20141229.140318,2908,20,1358512,20,2907,450,2908,730,1
20141229.140319,2908,50,1358562,50,2907,450,2908,705,1
20141229.140319,2907,4,1358566,0,2907,448,2908,705,0
20141229.14032,2908,6,1358572,6,2907,448,2908,702,1
20141229.140326,2908,604,1359176,216,2906,1072,2908,710,1
20141229.140326,2907,12,1359188,-12,2907,54,2908,699,0
20141229.140327,2907,4,1359192,-2,2907,54,2908,699,0
20141229.140328,2908,10,1359202,10,2907,54,2908,694,1
20141229.140329,2907,60,1359262,-60,2907,24,2908,794,0
20141229.140337,2907,2,1359264,0,2907,92,2908,849,0
20141229.140339,2907,4,1359268,0,2907,91,2908,849,0
20141229.140343,2907,62,1359330,-40,2907,73,2908,859,0
20141229.140343,2908,2,1359332,2,2907,72,2908,858,1
20141229.140344,2908,8,1359340,-2,2907,121,2908,855,1
20141229.140346,2907,4,1359344,0,2907,144,2908,855,0
20141229.140346,2908,2,1359346,0,2907,149,2908,854,1
20141229.140348,2908,2,1359348,0,2907,151,2908,854,1
20141229.140351,2907,2,1359350,2,2907,198,2908,854,0
20141229.140352,2908,2,1359352,0,2907,197,2908,853,1
20141229.140356,2907,64,1359416,-12,2907,172,2908,863,0
20141229.140357,2908,250,1359666,-196,2907,172,2908,738,1
20141229.14041,2908,2,1359668,0,2907,231,2908,729,1
20141229.140416,2907,4,1359672,-2,2907,231,2908,733,0
20141229.140419,2907,60,1359732,-12,2907,198,2908,734,0
20141229.140422,2907,2,1359734,0,2907,228,2908,764,0
20141229.140423,2908,2,1359736,0,2907,228,2908,734,1
20141229.140425,2907,2,1359738,-2,2907,249,2908,736,0
20141229.140428,2908,2,1359740,0,2907,250,2908,745,1
20141229.140438,2907,2,1359742,0,2907,291,2908,774,0
20141229.140443,2907,20,1359762,0,2907,287,2908,773,0
20141229.140445,2908,2,1359764,2,2907,261,2908,772,1
20141229.140447,2908,2,1359766,0,2907,258,2908,771,1
20141229.140447,2908,2,1359768,0,2907,258,2908,720,1
20141229.140448,2908,4,1359772,0,2907,258,2908,718,1
20141229.140454,2907,10,1359782,0,2907,267,2908,779,0
20141229.140455,2907,442,1360224,62,2906,977,2907,132,0
20141229.140456,2906,100,1360324,-90,2906,927,2907,135,0
20141229.140457,2907,6,1360330,0,2906,927,2907,158,1
20141229.140457,2907,4,1360334,-4,2906,927,2907,156,1
20141229.140459,2907,2,1360336,0,2906,927,2907,155,1
20141229.140502,2906,76,1360412,-54,2906,869,2907,151,0
20141229.140505,2906,4,1360416,4,2906,869,2907,148,0
20141229.140505,2907,2,1360418,-2,2906,869,2907,147,1
20141229.140507,2907,2,1360420,0,2906,869,2907,121,1
20141229.140508,2907,200,1360620,0,2906,879,2907,21,1
20141229.14051,2907,4,1360624,0,2906,869,2907,504,1
20141229.14051,2906,10,1360634,10,2906,849,2907,521,0
20141229.140512,2906,2,1360636,2,2906,848,2907,522,0
20141229.140513,2907,2,1360638,0,2906,863,2907,616,1
20141229.140516,2906,2,1360640,2,2906,861,2907,623,0
20141229.140518,2906,10,1360650,0,2906,855,2907,623,0
20141229.140519,2907,2,1360652,0,2906,885,2907,622,1
20141229.140523,2906,6,1360658,0,2906,883,2907,393,0
20141229.140524,2907,60,1360718,28,2906,885,2907,370,1
20141229.140527,2907,6,1360724,0,2906,889,2907,367,1
20141229.140528,2907,2,1360726,2,2906,890,2907,365,1
20141229.140529,2907,2,1360728,2,2906,890,2907,364,1
20141229.140531,2907,20,1360748,20,2906,890,2907,367,1
20141229.140534,2907,2,1360750,2,2906,886,2907,365,1
20141229.140537,2907,10,1360760,10,2906,888,2907,371,1
20141229.140542,2906,6,1360766,0,2906,889,2907,477,0
20141229.140543,2907,2,1360768,2,2906,889,2907,476,1
20141229.140547,2907,2,1360770,0,2906,889,2907,475,1
20141229.140548,2907,2,1360772,2,2906,889,2907,474,1
20141229.140548,2906,80,1360852,70,2906,850,2907,474,0
20141229.140554,2906,2,1360854,0,2906,846,2907,474,0
20141229.140557,2907,2,1360856,2,2906,846,2907,447,1
20141229.140557,2906,2,1360858,2,2906,845,2907,447,0
20141229.140605,2906,20,1360878,0,2906,867,2907,455,0
20141229.140606,2906,20,1360898,18,2906,857,2907,454,0
20141229.140608,2906,10,1360908,0,2906,853,2907,449,0
20141229.140609,2907,2,1360910,2,2906,858,2907,449,1
20141229.14061,2907,2,1360912,0,2906,858,2907,451,1
20141229.140619,2906,2,1360914,-2,2906,879,2907,523,0
20141229.14062,2906,2,1360916,-2,2906,889,2907,523,0
20141229.140624,2906,2,1360918,0,2906,891,2907,536,0
20141229.140625,2906,6,1360924,-4,2906,889,2907,535,0
20141229.140628,2907,2,1360926,2,2906,889,2907,542,1
20141229.14063,2906,32,1360958,-20,2906,873,2907,542,0
20141229.140631,2906,2,1360960,0,2906,872,2907,542,0
20141229.140637,2906,200,1361160,-16,2906,742,2907,533,0
20141229.140638,2906,20,1361180,20,2906,649,2907,533,0
20141229.140638,2906,88,1361268,88,2906,605,2907,533,0
20141229.140639,2907,200,1361468,0,2906,609,2907,443,1
20141229.14064,2906,100,1361568,-2,2906,553,2907,443,0
20141229.140641,2907,20,1361588,20,2906,557,2907,433,1
20141229.140642,2906,2,1361590,0,2906,555,2907,433,0
20141229.140644,2907,200,1361790,168,2906,549,2907,395,1
20141229.140648,2907,4,1361794,2,2906,460,2907,408,1
20141229.140649,2906,460,1362254,230,2906,219,2907,419,0
20141229.140649,2906,440,1362694,-138,2905,1623,2906,2,0
20141229.140655,2906,2,1362696,-2,2905,1633,2906,33,0
20141229.140657,2906,12,1362708,2,2905,1646,2906,31,0
20141229.140657,2906,2,1362710,0,2905,1646,2906,30,0
20141229.140659,2906,2,1362712,0,2905,1632,2906,45,0
20141229.140659,2906,22,1362734,0,2905,1634,2906,34,0
20141229.140701,2906,72,1362806,22,2906,162,2907,452,0
20141229.140702,2906,16,1362822,0,2906,168,2907,452,0
20141229.140704,2906,4,1362826,0,2906,176,2907,454,0
20141229.140706,2906,2,1362828,0,2906,192,2907,455,0
20141229.140708,2906,2,1362830,2,2906,216,2907,455,0
20141229.14071,2906,4,1362834,0,2906,217,2907,435,0
20141229.140712,2906,1742,1364576,574,2905,1718,2906,132,0
20141229.140712,2906,366,1364942,-166,2906,52,2907,278,0
20141229.140713,2906,4,1364946,-2,2906,58,2907,278,0
20141229.140713,2906,4,1364950,2,2906,56,2907,296,0
20141229.140714,2906,170,1365120,-58,2905,1726,2907,364,0
20141229.140715,2905,20,1365140,0,2905,1710,2907,365,0
20141229.140716,2906,2,1365142,-2,2905,1600,2906,106,1
20141229.140716,2906,12,1365154,0,2905,1595,2906,155,1
20141229.140717,2906,2,1365156,0,2905,1595,2906,154,1
20141229.140719,2906,2,1365158,-2,2905,1697,2906,197,1
20141229.140719,2906,4,1365162,-2,2905,1677,2906,203,1
20141229.140721,2906,2,1365164,0,2905,1671,2906,209,1
20141229.140722,2906,8,1365172,0,2905,1671,2906,206,1
20141229.140724,2905,2,1365174,2,2905,1665,2906,211,0
20141229.140725,2905,18,1365192,-16,2905,1657,2906,211,0
20141229.140726,2906,2,1365194,0,2905,1657,2906,210,1
20141229.140729,2906,16,1365210,-4,2905,1665,2906,205,1
20141229.140731,2906,40,1365250,0,2905,1705,2906,178,1
20141229.140731,2905,10,1365260,-10,2905,1700,2906,178,0
20141229.140734,2905,6,1365266,0,2905,1687,2906,205,0
20141229.140734,2906,4,1365270,0,2905,1686,2906,204,1
20141229.140735,2905,8,1365278,2,2905,1687,2906,206,0
20141229.140737,2905,4,1365282,2,2905,1686,2906,222,0
20141229.140738,2906,2,1365284,0,2905,1686,2906,231,1
20141229.14074,2905,8,1365292,0,2905,1682,2906,267,0
20141229.140741,2906,2,1365294,0,2905,1683,2906,313,1
20141229.140742,2906,2,1365296,0,2905,1683,2906,313,1
20141229.140744,2905,2,1365298,0,2905,1682,2906,316,0
20141229.140745,2905,20,1365318,-8,2905,1670,2906,319,0
20141229.140746,2905,2,1365320,0,2905,1671,2906,318,0
20141229.140747,2906,2,1365322,-2,2905,1701,2906,318,1
20141229.140748,2906,2,1365324,0,2905,1701,2906,317,1
20141229.140749,2906,36,1365360,-10,2905,1687,2906,312,1
20141229.14075,2906,916,1366276,-144,2906,24,2907,489,1
20141229.14075,2905,2048,1368324,1210,2905,778,2906,74,0
20141229.140751,2905,12,1368336,-10,2905,669,2906,340,0
20141229.140751,2906,2,1368338,0,2905,645,2906,377,1
20141229.140752,2905,16,1368354,-4,2905,510,2906,436,0
20141229.140752,2905,4,1368358,-4,2905,508,2906,437,0
20141229.140753,2905,12,1368370,-12,2905,502,2906,487,0
20141229.140754,2905,22,1368392,-16,2905,492,2906,566,0
20141229.140755,2905,30,1368422,-30,2905,480,2906,569,0
20141229.140756,2905,20,1368442,0,2905,470,2906,570,0
20141229.140757,2905,18,1368460,-18,2905,461,2906,531,0
20141229.140758,2905,10,1368470,-10,2905,456,2906,531,0
20141229.140759,2905,10,1368480,-10,2905,451,2906,521,0
20141229.140805,2906,2,1368482,2,2905,451,2906,705,1
20141229.140806,2906,34,1368516,-30,2905,436,2906,703,1
20141229.140807,2905,10,1368526,-8,2905,431,2906,707,0
20141229.140809,2905,30,1368556,-30,2905,670,2906,794,0
20141229.14081,2905,2,1368558,0,2905,664,2906,794,0
20141229.14081,2905,20,1368578,-20,2905,658,2906,794,0
20141229.140811,2905,2,1368580,-2,2905,659,2906,794,0
20141229.140811,2905,6,1368586,0,2905,656,2906,797,0
20141229.140814,2905,2,1368588,-2,2905,657,2906,797,0
20141229.140815,2905,2,1368590,0,2905,672,2906,816,0
20141229.140816,2906,6,1368596,6,2905,674,2906,813,1
20141229.140817,2906,2,1368598,0,2905,684,2906,812,1
20141229.140819,2906,2,1368600,2,2905,687,2906,812,1
20141229.14082,2905,4,1368604,0,2905,660,2906,829,0
20141229.140822,2905,2,1368606,0,2905,666,2906,829,0
20141229.140824,2905,6,1368612,0,2905,663,2906,838,0
20141229.140825,2905,22,1368634,-2,2905,650,2906,842,0
20141229.140825,2905,42,1368676,-42,2905,630,2906,842,0
20141229.140826,2905,834,1369510,224,2905,213,2906,842,0
20141229.140827,2905,428,1369938,48,2904,1029,2905,187,0
20141229.140827,2904,12,1369950,-6,2904,1023,2905,358,0
20141229.140827,2904,18,1369968,14,2904,1018,2905,371,0
20141229.140828,2904,4,1369972,4,2904,1032,2905,370,0
20141229.140828,2905,8,1369980,-4,2904,1029,2905,369,1
20141229.140829,2905,2,1369982,0,2904,1032,2905,383,1
20141229.140829,2905,2,1369984,0,2904,1032,2905,383,1
20141229.140831,2905,2,1369986,2,2904,1043,2905,396,1
20141229.140834,2905,2,1369988,2,2904,1066,2905,487,1
20141229.140836,2905,80,1370068,-4,2904,1019,2905,512,1
20141229.140836,2904,52,1370120,-30,2904,993,2905,512,0
20141229.140837,2904,20,1370140,20,2904,984,2905,516,0
20141229.140838,2905,2,1370142,0,2904,984,2905,516,1
20141229.140839,2904,402,1370544,192,2904,785,2905,516,0
20141229.14084,2905,100,1370644,100,2904,786,2905,468,1
20141229.140843,2905,2,1370646,0,2904,1197,2905,471,1
20141229.140843,2905,10,1370656,10,2904,1193,2905,470,1
20141229.140844,2904,10,1370666,0,2904,1154,2905,472,0
20141229.140844,2904,10,1370676,4,2904,1145,2905,472,0
20141229.140846,2904,2,1370678,-2,2904,1150,2905,481,0
20141229.140847,2905,2,1370680,2,2904,1149,2905,488,1
20141229.140848,2904,2,1370682,0,2904,1088,2905,490,0
20141229.140848,2904,6,1370688,-2,2904,1085,2905,490,0
20141229.140849,2904,4,1370692,0,2904,823,2905,516,0
20141229.140851,2904,30,1370722,-30,2904,811,2905,527,0
20141229.140852,2904,10,1370732,-4,2904,792,2905,528,0
20141229.140853,2904,6,1370738,-2,2904,786,2905,538,0
20141229.140854,2904,4,1370742,0,2904,994,2905,544,0
20141229.140854,2904,4,1370746,0,2904,1073,2905,544,0
20141229.140855,2904,2,1370748,-2,2904,1074,2905,554,0
20141229.140855,2904,4,1370752,-4,2904,1078,2905,561,0
20141229.140856,2905,532,1371284,-450,2904,1084,2905,267,1
20141229.140858,2905,20,1371304,2,2904,1098,2905,268,1
20141229.140859,2904,2,1371306,0,2904,1118,2905,281,0
20141229.140859,2905,6,1371312,2,2904,1122,2905,283,1
20141229.140901,2904,12,1371324,-10,2904,1147,2905,293,0
20141229.140901,2904,2,1371326,-2,2904,1146,2905,307,0
20141229.140902,2904,2,1371328,0,2904,1148,2905,307,0
20141229.140902,2904,80,1371408,-68,2904,1117,2905,294,0
20141229.140903,2905,8,1371416,-8,2904,1116,2905,330,1
20141229.140904,2904,2,1371418,-2,2904,1117,2905,329,0
20141229.140904,2904,4,1371422,2,2904,1115,2905,329,0
20141229.140906,2904,4,1371426,0,2904,1113,2905,333,0
20141229.140906,2904,2,1371428,0,2904,1111,2905,335,0
20141229.140907,2905,2,1371430,0,2904,1112,2905,334,1
20141229.140908,2905,24,1371454,0,2904,1112,2905,322,1
20141229.140908,2904,4,1371458,0,2904,1110,2905,323,0
20141229.140911,2904,52,1371510,2,2904,1194,2905,326,0
20141229.140913,2904,40,1371550,-40,2904,1173,2905,333,0
20141229.140914,2904,2,1371552,0,2904,1194,2905,338,0
20141229.140915,2904,8,1371560,-2,2904,1190,2905,338,0
20141229.140916,2905,4,1371564,-4,2904,1192,2905,336,1
20141229.140916,2904,4,1371568,0,2904,1192,2905,335,0
20141229.140918,2905,4,1371572,0,2904,1195,2905,334,1
20141229.140918,2904,6,1371578,-6,2904,1192,2905,330,0
20141229.140919,2904,14,1371592,-14,2904,1189,2905,323,0
20141229.14092,2905,2,1371594,-2,2904,1190,2905,324,1
20141229.140922,2904,22,1371616,-22,2904,1191,2905,324,0
20141229.140923,2904,38,1371654,6,2904,1171,2905,324,0
20141229.140923,2905,2,1371656,-2,2904,1171,2905,323,1
20141229.140924,2904,42,1371698,-18,2904,1152,2905,323,0
20141229.140926,2905,42,1371740,-36,2904,1133,2905,312,1
20141229.140927,2904,22,1371762,-20,2904,1133,2905,302,0
20141229.140928,2905,42,1371804,-2,2904,1131,2905,282,1
20141229.140928,2904,4,1371808,-2,2904,1131,2905,285,0
20141229.140929,2905,2,1371810,-2,2904,1136,2905,284,1
20141229.140929,2905,200,1372010,68,2904,1135,2905,185,1
20141229.14093,2904,202,1372212,-130,2904,1150,2905,86,0
20141229.140931,2905,194,1372406,-36,2905,40,2906,1404,1
20141229.140931,2905,4,1372410,-2,2905,41,2906,1337,1
20141229.140932,2906,22,1372432,0,2905,32,2906,1336,1
20141229.140934,2905,2,1372434,-2,2905,35,2906,1347,0
20141229.140935,2906,20,1372454,0,2905,145,2906,1327,1
20141229.140935,2905,2,1372456,0,2905,257,2906,1327,0
20141229.140936,2905,2,1372458,0,2905,319,2906,1327,0
20141229.140936,2905,6,1372464,4,2905,331,2906,1324,0
20141229.140936,2905,6,1372470,0,2905,488,2906,1324,0
20141229.140938,2906,32,1372502,-16,2905,507,2906,1318,1
20141229.140938,2905,2,1372504,0,2905,525,2906,1318,0
20141229.140939,2905,2,1372506,0,2905,528,2906,1319,0
20141229.14094,2905,12,1372518,-12,2905,523,2906,1319,0
20141229.140941,2906,2,1372520,0,2905,536,2906,1324,1
20141229.140943,2905,20,1372540,14,2905,531,2906,1328,0
20141229.140944,2905,2,1372542,0,2905,526,2906,1328,0
20141229.140944,2906,22,1372564,-10,2905,526,2906,1318,1
20141229.140945,2905,4,1372568,-2,2905,529,2906,1317,0
20141229.140946,2906,20,1372588,-20,2905,534,2906,1307,1
20141229.140947,2906,2,1372590,0,2905,534,2906,1306,1
20141229.140948,2905,20,1372610,-20,2905,542,2906,1307,0
20141229.140949,2905,2,1372612,0,2905,521,2906,1306,0
20141229.140952,2905,4,1372616,0,2905,539,2906,1402,0
20141229.140953,2906,20,1372636,0,2905,539,2906,1392,1
20141229.140957,2905,2,1372638,-2,2905,541,2906,1390,0
20141229.141001,2905,2,1372640,-2,2905,533,2906,1390,0
20141229.141003,2906,2,1372642,0,2905,534,2906,1389,1
20141229.141003,2905,4,1372646,-2,2905,532,2906,1389,0
20141229.141004,2905,20,1372666,0,2905,522,2906,1388,0
20141229.141005,2905,2,1372668,-2,2905,522,2906,1387,0
20141229.141006,2906,20,1372688,-20,2905,382,2906,1379,1
20141229.141009,2906,2,1372690,0,2905,531,2906,1379,1
20141229.141011,2905,20,1372710,-20,2905,520,2906,1379,0
20141229.141012,2906,2,1372712,0,2905,524,2906,1378,1
20141229.141018,2906,80,1372792,-38,2905,555,2906,1339,1
20141229.14102,2905,2,1372794,-2,2905,571,2906,1328,0
20141229.141022,2906,4,1372798,0,2905,571,2906,1336,1
20141229.141023,2905,6,1372804,-4,2905,556,2906,1335,0
20141229.141025,2906,2,1372806,-2,2905,560,2906,1334,1
20141229.141025,2905,2,1372808,-2,2905,569,2906,1334,0
20141229.141027,2906,2,1372810,-2,2905,579,2906,1334,1
20141229.141028,2906,2,1372812,0,2905,584,2906,1343,1
20141229.141031,2906,16,1372828,0,2905,575,2906,1337,1
20141229.141035,2905,2,1372830,0,2905,578,2906,1335,0
20141229.141035,2905,60,1372890,-20,2905,540,2906,1335,0
20141229.141038,2906,40,1372930,18,2905,553,2906,1316,1
20141229.141038,2905,2,1372932,0,2905,552,2906,1316,0
20141229.141039,2906,88,1373020,-74,2905,552,2906,1272,1
20141229.141039,2905,4,1373024,0,2905,550,2906,1272,0
20141229.14104,2906,6,1373030,-6,2905,554,2906,1269,1
20141229.141044,2905,2,1373032,-2,2905,568,2906,1273,0
20141229.141052,2905,4,1373036,0,2905,572,2906,1250,0
20141229.141054,2905,4,1373040,-4,2905,569,2906,1250,0
20141229.141056,2905,2,1373042,-2,2905,566,2906,1251,0
20141229.141058,2905,4,1373046,-4,2905,562,2906,1263,0
20141229.141059,2905,2,1373048,-2,2905,563,2906,1263,0
20141229.1411,2905,2,1373050,0,2905,563,2906,1263,0
20141229.141102,2905,20,1373070,-20,2905,554,2906,1262,0
20141229.141103,2905,100,1373170,-16,2905,504,2906,1262,0
20141229.141104,2906,6,1373176,0,2905,506,2906,1259,1
20141229.141104,2906,2,1373178,-2,2905,506,2906,1258,1
20141229.141106,2906,2,1373180,-2,2905,508,2906,1263,1
20141229.141109,2906,20,1373200,0,2905,506,2906,1253,1
20141229.141113,2905,2,1373202,0,2905,518,2906,1253,0
20141229.141116,2905,10,1373212,0,2905,528,2906,1253,0
20141229.141116,2906,2,1373214,-2,2905,529,2906,1253,1
20141229.141117,2906,4,1373218,-4,2905,529,2906,1252,1
20141229.141119,2905,12,1373230,0,2905,536,2906,1252,0
20141229.14112,2906,200,1373430,-176,2905,547,2906,1152,1
20141229.141122,2906,102,1373532,2,2905,497,2906,1151,1
20141229.141125,2905,4,1373536,0,2905,520,2906,1197,0
20141229.141125,2906,8,1373544,8,2905,522,2906,1193,1
20141229.141126,2906,2,1373546,2,2905,522,2906,1192,1
20141229.141127,2905,2,1373548,0,2905,521,2906,1192,0
20141229.141128,2905,132,1373680,30,2905,457,2906,1175,0
20141229.141129,2906,10,1373690,0,2905,458,2906,1168,1
20141229.14113,2906,2,1373692,0,2905,459,2906,1168,1
20141229.141133,2905,100,1373792,12,2905,411,2906,1169,0
20141229.141133,2905,46,1373838,-38,2905,390,2906,1167,0
20141229.141134,2906,2,1373840,0,2905,392,2906,1166,1
20141229.141135,2905,336,1374176,94,2905,224,2906,1166,0
20141229.141135,2905,306,1374482,-44,2904,1129,2906,1166,0
20141229.141136,2905,158,1374640,122,2904,1281,2905,122,0
20141229.141139,2905,4,1374644,4,2904,929,2905,297,0
20141229.14114,2905,2,1374646,2,2904,929,2905,296,0
20141229.14114,2905,2,1374648,0,2904,929,2905,295,0
20141229.141142,2905,2,1374650,0,2904,931,2905,299,0
20141229.141143,2904,4,1374654,-4,2904,929,2905,325,0
20141229.141145,2905,2,1374656,0,2904,929,2905,325,1
20141229.141147,2905,10,1374666,10,2904,930,2905,317,1
20141229.141147,2904,2,1374668,-2,2904,918,2905,317,0
20141229.14115,2904,2,1374670,-2,2904,934,2905,318,0
20141229.141151,2904,12,1374682,-10,2904,928,2905,319,0
20141229.141152,2904,2,1374684,0,2904,927,2905,319,0
20141229.141153,2904,22,1374706,-18,2904,936,2905,319,0
20141229.141154,2904,2,1374708,-2,2904,885,2905,319,0
20141229.141156,2905,2,1374710,2,2904,885,2905,319,1
20141229.141156,2904,2,1374712,0,2904,884,2905,319,0
20141229.141156,2904,2,1374714,-2,2904,882,2905,320,0
20141229.141158,2904,102,1374816,-96,2904,831,2905,322,0
20141229.1412,2905,10,1374826,0,2904,816,2905,334,1
20141229.141201,2904,2,1374828,-2,2904,815,2905,334,0
20141229.141202,2905,2,1374830,-2,2904,795,2905,358,1
20141229.141203,2904,138,1374968,-136,2904,726,2905,357,0
20141229.141204,2905,2,1374970,0,2904,724,2905,369,1
20141229.141205,2904,12,1374982,-2,2904,712,2905,365,0
20141229.141206,2905,14,1374996,0,2904,710,2905,363,1
20141229.141206,2904,2,1374998,0,2904,709,2905,363,0
20141229.141208,2905,4,1375002,-2,2904,708,2905,361,1
20141229.141211,2905,6,1375008,0,2904,708,2905,399,1
20141229.141212,2904,2,1375010,-2,2904,707,2905,369,0
20141229.141213,2904,6,1375016,-6,2904,704,2905,370,0
20141229.141213,2905,2,1375018,2,2904,704,2905,369,1
20141229.141214,2904,2,1375020,-2,2904,703,2905,369,0
20141229.141217,2904,20,1375040,0,2904,693,2905,358,0
20141229.141221,2904,34,1375074,-2,2904,684,2905,361,0
20141229.141231,2904,6,1375080,-2,2904,698,2905,582,0
20141229.141232,2904,18,1375098,-18,2904,661,2905,582,0
20141229.141232,2904,10,1375108,-10,2904,657,2905,598,0
20141229.141233,2904,4,1375112,0,2904,656,2905,598,0
20141229.141235,2904,4,1375116,-4,2904,655,2905,598,0
20141229.141236,2905,20,1375136,10,2904,657,2905,589,1
20141229.141237,2905,4,1375140,0,2904,657,2905,587,1
20141229.14124,2905,2,1375142,2,2904,692,2905,591,1
20141229.141241,2905,2,1375144,2,2904,692,2905,590,1
20141229.141242,2905,10,1375154,0,2904,709,2905,585,1
20141229.141242,2905,4,1375158,-2,2904,677,2905,572,1
20141229.141243,2904,2,1375160,0,2904,676,2905,573,0
20141229.141243,2904,10,1375170,-10,2904,671,2905,573,0
20141229.141247,2904,2,1375172,0,2904,709,2905,579,0
20141229.141248,2905,2,1375174,-2,2904,724,2905,578,1
20141229.141249,2904,2,1375176,0,2904,723,2905,584,0
20141229.141249,2904,2,1375178,-2,2904,722,2905,584,0
20141229.14125,2905,4,1375182,0,2904,733,2905,583,1
20141229.14125,2904,30,1375212,-30,2904,718,2905,583,0
20141229.141252,2904,30,1375242,2,2904,703,2905,388,0
20141229.141252,2905,4,1375246,-2,2904,703,2905,387,1
20141229.141254,2905,8,1375254,0,2904,703,2905,383,1
20141229.141255,2905,2,1375256,0,2904,709,2905,383,1
20141229.141257,2904,30,1375286,0,2904,694,2905,383,0
20141229.141257,2904,20,1375306,0,2904,677,2905,383,0
20141229.141258,2905,2,1375308,0,2904,677,2905,383,1
20141229.141259,2905,6,1375314,0,2904,698,2905,384,1
20141229.1413,2905,8,1375322,0,2904,703,2905,384,1
20141229.141301,2904,74,1375396,-14,2904,666,2905,384,0
20141229.141301,2905,2,1375398,0,2904,666,2905,383,1
20141229.141305,2905,4,1375402,0,2904,671,2905,380,1
20141229.141306,2905,2,1375404,0,2904,681,2905,378,1
20141229.141307,2905,4,1375408,0,2904,680,2905,376,1
20141229.141309,2905,8,1375416,-4,2904,680,2905,373,1
20141229.14131,2905,4,1375420,-4,2904,675,2905,371,1
20141229.141311,2905,10,1375430,0,2904,675,2905,366,1
20141229.141311,2904,10,1375440,0,2904,670,2905,366,0
20141229.141313,2904,150,1375590,-2,2904,685,2905,296,0
20141229.141314,2904,4,1375594,0,2904,685,2905,285,0
20141229.141319,2904,58,1375652,20,2904,681,2905,298,0
20141229.141319,2905,40,1375692,10,2904,681,2905,293,1
20141229.14132,2905,158,1375850,-54,2904,681,2905,214,1
20141229.141322,2905,38,1375888,6,2904,683,2905,196,1
20141229.141323,2905,302,1376190,-256,2904,686,2905,25,1
20141229.141323,2905,54,1376244,-2,2905,78,2906,1240,1
20141229.141324,2906,2,1376246,2,2905,195,2906,1229,1
20141229.141326,2905,6,1376252,0,2905,198,2906,1227,0
20141229.141327,2906,256,1376508,-178,2905,197,2906,1100,1
20141229.141328,2905,208,1376716,-204,2905,111,2906,1083,0
20141229.141328,2905,4,1376720,0,2905,109,2906,1083,0
20141229.141329,2905,22,1376742,-20,2905,101,2906,1082,0
20141229.14133,2906,12,1376754,-12,2905,101,2906,1068,1
20141229.14133,2905,2,1376756,-2,2905,100,2906,1069,0
20141229.141331,2905,4,1376760,0,2905,99,2906,1069,0
20141229.141332,2906,24,1376784,-22,2905,89,2906,1068,1
20141229.141333,2905,22,1376806,0,2905,48,2906,1078,0
20141229.141334,2905,2,1376808,0,2905,47,2906,1078,0
20141229.141334,2905,4,1376812,-4,2905,50,2906,1078,0
20141229.141335,2906,92,1376904,-90,2905,54,2906,1035,1
20141229.141336,2906,156,1377060,-156,2905,64,2906,950,1
20141229.141337,2906,100,1377160,0,2905,69,2906,900,1
20141229.141337,2905,62,1377222,-52,2905,39,2906,899,0
20141229.14134,2906,54,1377276,-54,2905,66,2906,872,1
20141229.141341,2905,6,1377282,-6,2905,76,2906,872,0
20141229.141342,2905,2,1377284,-2,2905,80,2906,873,0
20141229.141344,2905,62,1377346,-60,2905,126,2906,843,0
20141229.141345,2905,4,1377350,0,2905,125,2906,843,0
20141229.141346,2906,92,1377442,-90,2905,156,2906,806,1
20141229.141349,2906,2,1377444,0,2905,177,2906,807,1
20141229.14135,2906,24,1377468,-24,2905,177,2906,795,1
20141229.141351,2906,28,1377496,-8,2905,178,2906,796,1
20141229.141352,2905,4,1377500,2,2905,178,2906,795,0
20141229.141353,2906,102,1377602,0,2905,179,2906,744,1
20141229.141355,2906,26,1377628,-24,2905,189,2906,732,1
20141229.141359,2906,74,1377702,-66,2905,186,2906,711,1
20141229.141359,2906,44,1377746,0,2905,185,2906,689,1
20141229.1414,2906,16,1377762,0,2905,185,2906,681,1
20141229.1414,2905,32,1377794,8,2905,178,2906,675,0
20141229.141403,2905,6,1377800,0,2905,183,2906,674,0
20141229.141404,2906,2,1377802,-2,2905,183,2906,673,1
20141229.141406,2906,8,1377810,-8,2905,183,2906,669,1
20141229.141406,2906,14,1377824,-12,2905,197,2906,662,1
20141229.141407,2906,6,1377830,0,2905,198,2906,660,1
20141229.141407,2906,6,1377836,0,2905,198,2906,657,1
20141229.141408,2906,4,1377840,0,2905,203,2906,655,1
20141229.141409,2906,16,1377856,-16,2905,245,2906,647,1
20141229.14141,2905,40,1377896,0,2905,225,2906,647,0
20141229.14141,2906,2,1377898,0,2905,225,2906,646,1
20141229.141411,2906,6,1377904,0,2905,225,2906,643,1
20141229.141412,2906,6,1377910,0,2905,225,2906,641,1
20141229.141412,2906,2,1377912,-2,2905,225,2906,640,1
20141229.141414,2906,6,1377918,-2,2905,229,2906,637,1
20141229.141414,2906,26,1377944,10,2905,219,2906,634,1
20141229.141415,2906,20,1377964,-18,2905,222,2906,624,1
20141229.141415,2905,44,1378008,2,2905,212,2906,612,0
20141229.141416,2906,2,1378010,2,2905,213,2906,611,1
20141229.14142,2906,2,1378012,2,2905,278,2906,681,1
20141229.141421,2905,2,1378014,0,2905,277,2906,681,0
20141229.141421,2906,22,1378036,-2,2905,290,2906,672,1
20141229.141424,2906,2,1378038,2,2905,295,2906,677,1
20141229.141425,2906,2,1378040,2,2905,293,2906,676,1
20141229.141427,2906,48,1378088,-20,2905,278,2906,667,1
20141229.141428,2906,30,1378118,30,2905,309,2906,652,1
20141229.141431,2906,2,1378120,2,2905,513,2906,644,1
20141229.141433,2906,30,1378150,12,2905,516,2906,629,1
20141229.141433,2906,1260,1379410,68,2906,102,2907,500,1
20141229.141434,2906,20,1379430,-12,2906,261,2907,371,1
20141229.141435,2907,22,1379452,20,2906,290,2907,361,1
20141229.141436,2907,2,1379454,0,2906,289,2907,360,1
20141229.141437,2907,4,1379458,2,2906,253,2907,359,1
20141229.141438,2907,2,1379460,2,2906,258,2907,358,1
20141229.141438,2907,2,1379462,0,2906,278,2907,357,1
20141229.141439,2907,2,1379464,0,2906,278,2907,356,1
20141229.14144,2906,8,1379472,0,2906,278,2907,356,0
20141229.141441,2906,2,1379474,2,2906,278,2907,355,0
20141229.141441,2906,2,1379476,2,2906,257,2907,355,0
20141229.141442,2907,2,1379478,0,2906,461,2907,354,1
20141229.141443,2907,54,1379532,0,2906,460,2907,329,1
20141229.141443,2907,30,1379562,0,2906,500,2907,314,1
20141229.141444,2907,454,1380016,-60,2906,510,2907,88,1
20141229.141444,2907,178,1380194,26,2907,129,2908,821,1
20141229.141445,2908,8,1380202,0,2907,133,2908,764,1
20141229.141446,2908,6,1380208,0,2907,191,2908,694,1
20141229.141446,2908,8,1380216,0,2907,207,2908,625,1
20141229.141446,2908,2,1380218,0,2907,207,2908,573,1
20141229.141448,2907,80,1380298,-80,2907,189,2908,454,0
20141229.14145,2908,2,1380300,0,2907,180,2908,435,1
20141229.141451,2908,42,1380342,2,2907,176,2908,414,1
20141229.141453,2908,44,1380386,-4,2907,204,2908,398,1
20141229.141453,2908,4,1380390,4,2907,205,2908,398,1
20141229.141454,2907,2,1380392,-2,2907,180,2908,451,0
20141229.141455,2908,110,1380502,-4,2907,167,2908,500,1
20141229.141457,2908,4,1380506,-2,2907,183,2908,529,1
20141229.141459,2907,6,1380512,-6,2907,181,2908,538,0
20141229.1415,2907,22,1380534,-22,2907,171,2908,538,0
20141229.141501,2908,40,1380574,-12,2907,172,2908,518,1
20141229.141501,2907,18,1380592,-18,2907,163,2908,520,0
20141229.141502,2907,28,1380620,-28,2907,139,2908,521,0
20141229.141502,2907,6,1380626,-2,2907,138,2908,520,0
20141229.141503,2907,540,1381166,-14,2906,648,2907,125,0
20141229.141503,2907,8,1381174,2,2906,653,2907,48,0
20141229.141504,2907,22,1381196,22,2906,623,2907,38,0
20141229.141505,2907,2,1381198,0,2906,625,2907,37,0
20141229.141506,2907,2,1381200,2,2906,625,2907,36,0
20141229.141506,2907,4,1381204,2,2906,632,2907,44,0
20141229.141507,2907,2,1381206,0,2906,632,2907,44,0
20141229.141507,2907,6,1381212,6,2906,650,2907,41,0
20141229.141508,2906,4,1381216,2,2906,645,2907,38,0
20141229.141509,2907,2,1381218,2,2906,645,2907,38,1
20141229.141509,2907,40,1381258,-34,2906,645,2907,48,1
20141229.141511,2907,104,1381362,2,2906,656,2908,720,1
20141229.141513,2908,24,1381386,20,2906,687,2908,710,1
20141229.141513,2908,2,1381388,2,2906,687,2908,709,1
20141229.141513,2907,6,1381394,4,2906,687,2908,709,0
20141229.141514,2906,2,1381396,0,2906,680,2907,53,0
20141229.141515,2907,8,1381404,0,2906,680,2907,49,1
20141229.141515,2907,70,1381474,2,2906,689,2907,16,1
20141229.141516,2907,2,1381476,2,2906,459,2907,16,1
20141229.141517,2907,10,1381486,8,2906,508,2907,12,1
20141229.141519,2907,42,1381528,36,2907,20,2908,834,1
20141229.141519,2907,140,1381668,30,2907,4,2908,672,1
20141229.14152,2907,10,1381678,-2,2906,513,2907,95,1
20141229.14152,2907,4,1381682,-4,2906,515,2907,93,1
20141229.141521,2906,4,1381686,2,2906,520,2907,91,0
20141229.141522,2907,4,1381690,0,2906,583,2907,91,1
20141229.141523,2907,4,1381694,0,2906,588,2907,99,1
20141229.141523,2906,40,1381734,40,2906,568,2907,100,0
20141229.141524,2907,14,1381748,0,2906,568,2907,147,1
20141229.141524,2907,14,1381762,14,2906,568,2907,141,1
20141229.141526,2907,2,1381764,2,2906,566,2907,141,1
20141229.141527,2907,4,1381768,4,2906,566,2907,139,1
20141229.141531,2906,40,1381808,40,2906,568,2907,151,0
20141229.141532,2907,2,1381810,2,2906,568,2907,152,1
20141229.141534,2907,2,1381812,2,2906,571,2907,152,1
20141229.141535,2906,2,1381814,2,2906,570,2907,151,0
20141229.141537,2907,4,1381818,4,2906,569,2907,306,1
20141229.14154,2907,50,1381868,50,2906,574,2907,282,1
20141229.141547,2906,24,1381892,20,2906,572,2907,292,0
20141229.141549,2906,76,1381968,2,2906,540,2907,293,0
20141229.141554,2907,2,1381970,0,2906,541,2907,342,1
20141229.141557,2907,2,1381972,2,2906,544,2907,341,1
20141229.141558,2906,36,1382008,36,2906,526,2907,341,0
20141229.141559,2906,2,1382010,2,2906,526,2907,341,0
20141229.141607,2907,2,1382012,0,2906,538,2907,346,1
20141229.14161,2906,8,1382020,2,2906,540,2907,296,0
20141229.141612,2907,6,1382026,0,2906,539,2907,293,1
20141229.141613,2907,2,1382028,0,2906,559,2907,292,1
20141229.141615,2907,584,1382612,-84,2907,309,2908,763,1
20141229.141616,2907,8,1382620,-4,2907,305,2908,760,1
20141229.141616,2907,10,1382630,-4,2907,300,2908,743,1
20141229.141617,2907,8,1382638,-4,2907,311,2908,748,1
20141229.141617,2907,8,1382646,-4,2907,307,2908,747,1
20141229.141618,2907,4,1382650,-2,2907,305,2908,747,1
20141229.141618,2907,12,1382662,-6,2907,300,2908,747,1
20141229.141619,2907,4,1382666,-2,2907,298,2908,747,1
20141229.141619,2907,10,1382676,-4,2907,293,2908,746,1
20141229.141622,2907,2,1382678,0,2907,294,2908,745,1
20141229.141624,2907,2,1382680,0,2907,293,2908,745,1
20141229.141624,2907,2,1382682,-2,2907,292,2908,740,1
20141229.141625,2906,1168,1383850,358,2906,352,2907,1,0
20141229.141626,2907,30,1383880,-2,2906,258,2907,148,1
20141229.141628,2907,2,1383882,2,2906,208,2907,326,1
20141229.141629,2906,36,1383918,2,2906,192,2907,329,0
20141229.141632,2907,108,1384026,80,2906,212,2907,348,1
20141229.141632,2907,734,1384760,-438,2907,227,2908,1029,1
20141229.141633,2907,8,1384768,-4,2907,273,2908,774,1
20141229.141633,2907,8,1384776,-4,2907,279,2908,774,1
20141229.141634,2907,2,1384778,-2,2907,293,2908,774,1
20141229.141634,2907,2,1384780,0,2907,292,2908,774,1
20141229.141635,2907,6,1384786,-6,2907,289,2908,774,1
20141229.141636,2907,608,1385394,2,2906,371,2907,800,1
20141229.141636,2907,2,1385396,2,2906,346,2907,799,1
20141229.141637,2907,14,1385410,14,2906,345,2907,793,1
20141229.141639,2907,2,1385412,2,2906,381,2907,1003,1
20141229.141639,2907,6,1385418,6,2906,383,2907,1000,1
20141229.141645,2907,2,1385420,2,2906,385,2907,803,1
20141229.141645,2907,2,1385422,2,2906,371,2907,799,1
20141229.141646,2907,1602,1387024,-32,2907,301,2908,759,1
20141229.141648,2907,2,1387026,-2,2907,410,2908,612,1
20141229.141649,2908,6,1387032,6,2907,411,2908,610,1
20141229.14165,2908,2,1387034,2,2907,411,2908,609,1
20141229.14165,2907,50,1387084,-10,2907,401,2908,599,0
20141229.141651,2907,832,1387916,42,2906,350,2907,687,0
20141229.141652,2907,2,1387918,2,2906,350,2907,686,0
20141229.141653,2907,2,1387920,0,2906,351,2907,686,0
20141229.141656,2907,20,1387940,20,2906,349,2907,677,0
20141229.141657,2907,1354,1389294,198,2907,132,2908,625,0
20141229.141659,2907,464,1389758,70,2906,347,2907,849,0
20141229.141659,2907,2,1389760,2,2906,352,2907,848,0
20141229.1417,2907,2,1389762,2,2906,353,2907,847,0
20141229.1417,2907,2,1389764,2,2906,353,2907,850,0
20141229.141702,2907,12,1389776,12,2906,292,2907,847,0
20141229.141704,2907,1694,1391470,-18,2907,239,2908,609,0
20141229.141704,2908,4,1391474,0,2907,239,2908,607,1
20141229.141706,2907,2,1391476,-2,2907,264,2908,652,0
20141229.141706,2907,2,1391478,0,2907,268,2908,652,0
20141229.141707,2908,10,1391488,10,2907,268,2908,648,1
20141229.141709,2908,4,1391492,0,2907,270,2908,648,1
20141229.14171,2907,40,1391532,0,2907,270,2908,648,0
20141229.141712,2907,556,1392088,62,2906,442,2907,825,0
20141229.141712,2906,6,1392094,6,2906,417,2907,826,0
20141229.141713,2907,2,1392096,2,2906,408,2907,835,1
20141229.141714,2906,104,1392200,48,2906,356,2907,836,0
20141229.141715,2907,2,1392202,2,2906,356,2907,835,1
20141229.141715,2907,1870,1394072,18,2907,181,2908,793,1
20141229.141716,2907,12,1394084,-4,2907,177,2908,680,1
20141229.141716,2907,8,1394092,-4,2907,173,2908,680,1
20141229.141716,2907,6,1394098,-2,2907,170,2908,680,1
20141229.141717,2907,4,1394102,-2,2907,168,2908,680,1
20141229.141717,2908,22,1394124,-6,2907,162,2908,676,1
20141229.141718,2907,18,1394142,-14,2907,154,2908,672,0
20141229.141718,2907,8,1394150,-4,2907,150,2908,671,0
20141229.141719,2907,8,1394158,-2,2907,146,2908,651,0
20141229.14172,2907,12,1394170,-4,2907,146,2908,649,0
20141229.141721,2907,2,1394172,-2,2907,145,2908,653,0
20141229.141721,2907,2,1394174,-2,2907,145,2908,653,0
20141229.141722,2907,8,1394182,-6,2907,172,2908,654,0
20141229.141723,2907,46,1394228,0,2907,164,2908,647,0
20141229.141724,2908,2,1394230,0,2907,164,2908,646,1
20141229.141726,2908,10,1394240,10,2907,172,2908,641,1
20141229.141729,2907,2,1394242,-2,2907,169,2908,642,0
20141229.14173,2907,6,1394248,-6,2907,166,2908,643,0
20141229.141733,2907,2,1394250,0,2907,135,2908,646,0
20141229.141735,2907,20,1394270,-18,2907,126,2908,649,0
20141229.141735,2908,4,1394274,0,2907,126,2908,646,1
20141229.141736,2907,4,1394278,-2,2907,135,2908,647,0
20141229.141738,2907,40,1394318,0,2907,155,2908,647,0
20141229.141738,2907,2,1394320,0,2907,156,2908,647,0
20141229.141744,2908,2,1394322,2,2907,206,2908,666,1
20141229.141745,2907,10,1394332,-10,2907,202,2908,671,0
20141229.141748,2908,2,1394334,2,2907,203,2908,678,1
20141229.141754,2907,2,1394336,0,2907,209,2908,704,0
20141229.141755,2908,2,1394338,0,2907,211,2908,703,1
20141229.141755,2907,2,1394340,0,2907,210,2908,704,0
20141229.141757,2907,62,1394402,-62,2907,181,2908,689,0
20141229.141758,2908,10,1394412,0,2907,181,2908,684,1
20141229.141801,2908,4,1394416,0,2907,197,2908,680,1
20141229.141802,2907,200,1394616,54,2907,82,2908,738,0
20141229.141803,2907,4,1394620,-2,2907,80,2908,749,0
20141229.141804,2907,172,1394792,94,2906,592,2907,16,0
20141229.141805,2907,168,1394960,98,2907,2,2908,908,0
20141229.141806,2907,2,1394962,2,2907,56,2908,799,0
20141229.141809,2908,4,1394966,4,2907,154,2908,745,1
20141229.14181,2908,6,1394972,0,2907,156,2908,735,1
20141229.141811,2907,2,1394974,2,2907,153,2908,736,0
20141229.141811,2908,4,1394978,2,2907,153,2908,733,1
20141229.141812,2907,2,1394980,0,2907,153,2908,733,0
20141229.141814,2908,8,1394988,8,2907,154,2908,730,1
20141229.141815,2908,8,1394996,0,2907,155,2908,727,1
20141229.14182,2907,2,1394998,0,2907,184,2908,740,0
20141229.141821,2908,6,1395004,4,2907,188,2908,790,1
20141229.141822,2908,6,1395010,6,2907,188,2908,787,1
20141229.141822,2908,10,1395020,4,2907,185,2908,785,1
20141229.141823,2907,10,1395030,0,2907,185,2908,782,0
20141229.141825,2907,2,1395032,0,2907,185,2908,777,0
20141229.141825,2907,10,1395042,-10,2907,180,2908,776,0
20141229.141826,2907,2,1395044,0,2907,179,2908,775,0
20141229.141826,2908,40,1395084,40,2907,179,2908,754,1
20141229.141827,2908,70,1395154,-48,2907,176,2908,730,1
20141229.141827,2908,64,1395218,14,2907,176,2908,698,1
20141229.141828,2908,2,1395220,-2,2907,176,2908,697,1
20141229.141829,2907,2,1395222,0,2907,175,2908,698,0
20141229.141831,2908,10,1395232,0,2907,176,2908,693,1
20141229.141831,2907,6,1395238,-6,2907,168,2908,693,0
20141229.141833,2907,4,1395242,0,2907,168,2908,684,0
20141229.141833,2907,22,1395264,-20,2907,157,2908,684,0
20141229.141835,2908,2,1395266,0,2907,140,2908,683,1
20141229.141835,2908,26,1395292,2,2907,133,2908,682,1
20141229.141839,2907,40,1395332,30,2907,111,2908,682,0
20141229.14184,2907,2,1395334,0,2907,111,2908,693,0
20141229.141843,2908,2,1395336,2,2907,117,2908,691,1
20141229.141844,2907,4,1395340,0,2907,131,2908,692,0
20141229.141845,2908,2,1395342,0,2907,145,2908,691,1
20141229.141846,2907,20,1395362,20,2907,135,2908,691,0
20141229.141848,2907,20,1395382,20,2907,124,2908,892,0
20141229.141848,2907,242,1395624,228,2907,3,2908,943,0
20141229.141849,2907,18,1395642,0,2906,675,2907,87,0
20141229.14185,2907,10,1395652,4,2906,676,2907,83,0
20141229.141851,2907,242,1395894,36,2906,687,2907,15,0
20141229.141852,2907,2,1395896,0,2906,693,2907,14,0
20141229.141853,2907,30,1395926,14,2907,63,2908,1110,0
20141229.141853,2907,2,1395928,0,2907,112,2908,1003,0
20141229.141855,2907,2,1395930,0,2907,112,2908,1023,0
20141229.141857,2908,4,1395934,2,2907,224,2908,1023,1
20141229.141859,2907,2,1395936,0,2907,227,2908,1002,0
20141229.141859,2907,2,1395938,2,2907,226,2908,993,0
20141229.141908,2908,10,1395948,0,2907,237,2908,910,1
20141229.141911,2907,2,1395950,0,2907,237,2908,942,0
20141229.141916,2908,2,1395952,-2,2907,242,2908,986,1
20141229.141916,2908,40,1395992,14,2907,246,2908,967,1
20141229.141919,2908,2,1395994,2,2907,253,2908,973,1
20141229.14192,2907,4,1395998,0,2907,252,2908,967,0
20141229.141921,2908,12,1396010,12,2907,246,2908,966,1
20141229.141921,2908,60,1396070,60,2907,246,2908,936,1
20141229.141923,2908,2,1396072,2,2907,246,2908,936,1
20141229.141925,2907,2,1396074,2,2907,246,2908,935,0
20141229.141925,2907,2,1396076,0,2907,246,2908,934,0
20141229.141927,2908,18,1396094,0,2907,248,2908,924,1
20141229.141929,2908,20,1396114,18,2907,248,2908,912,1
20141229.14193,2907,42,1396156,-6,2907,228,2908,911,0
20141229.141931,2907,18,1396174,-4,2907,220,2908,910,0
20141229.141931,2908,2,1396176,0,2907,239,2908,909,1
20141229.141936,2908,24,1396200,-22,2907,253,2908,899,1
20141229.141937,2907,2,1396202,0,2907,252,2908,905,0
20141229.141938,2908,68,1396270,-44,2907,257,2908,871,1
20141229.14194,2907,2,1396272,0,2907,259,2908,876,0
20141229.141941,2908,2,1396274,2,2907,206,2908,875,1
20141229.141942,2907,84,1396358,26,2907,164,2908,875,0
20141229.141942,2907,330,1396688,-30,2906,701,2907,93,0
20141229.141943,2907,16,1396704,-16,2906,660,2907,231,0
20141229.141943,2907,24,1396728,20,2906,660,2907,314,0
20141229.141944,2906,60,1396788,0,2906,631,2907,264,0
20141229.141945,2908,548,1397336,-304,2907,132,2908,1005,1
20141229.141945,2907,384,1397720,-232,2906,629,2907,1,0
20141229.141946,2907,174,1397894,-26,2906,630,2907,2,0
20141229.141947,2907,4,1397898,2,2906,629,2907,2,0
20141229.141949,2907,84,1397982,52,2906,630,2907,12,0
20141229.14195,2907,2,1397984,0,2906,638,2907,12,0
20141229.14195,2907,86,1398070,56,2906,637,2908,926,0
20141229.141951,2907,202,1398272,100,2906,637,2907,37,0
20141229.141953,2907,82,1398354,10,2906,634,2907,47,0
20141229.141953,2906,20,1398374,2,2906,624,2907,48,0
20141229.141954,2907,2,1398376,2,2906,624,2907,51,1
20141229.141955,2907,2,1398378,2,2906,638,2907,60,1
20141229.141956,2907,16,1398394,16,2906,638,2907,55,1
20141229.141956,2906,10,1398404,0,2906,633,2907,56,0
20141229.141959,2906,264,1398668,-84,2906,502,2907,162,0
20141229.142003,2907,2,1398670,2,2906,521,2907,439,1
20141229.142004,2907,6,1398676,0,2906,521,2907,438,1
20141229.142007,2907,20,1398696,20,2906,523,2907,238,1
20141229.142009,2906,1042,1399738,-304,2905,961,2906,75,0
20141229.142009,2906,184,1399922,-178,2906,14,2907,397,0
20141229.14201,2906,28,1399950,2,2905,947,2907,389,0
20141229.14201,2906,22,1399972,6,2906,141,2907,412,0
20141229.142011,2906,2,1399974,2,2906,140,2907,408,0
20141229.142012,2906,286,1400260,278,2905,833,2906,153,0
20141229.142013,2906,2,1400262,0,2905,834,2906,157,0
20141229.142014,2906,1822,1402084,-622,2906,208,2907,50,0
20141229.142015,2907,152,1402236,-66,2907,121,2908,977,1
20141229.142016,2907,38,1402274,-34,2907,100,2908,968,1
20141229.142016,2907,202,1402476,-124,2906,287,2907,70,1
20141229.142021,2906,2,1402478,0,2906,337,2907,328,0
20141229.142022,2906,2,1402480,0,2906,565,2907,328,0
20141229.142025,2906,20,1402500,0,2906,534,2907,337,0
20141229.14203,2906,6,1402506,-2,2906,326,2907,393,0
20141229.142032,2907,6,1402512,6,2906,326,2907,394,1
20141229.142033,2906,100,1402612,-100,2906,280,2907,694,0
20141229.142034,2906,20,1402632,0,2906,284,2907,687,0
20141229.142038,2906,40,1402672,0,2906,262,2907,527,0
20141229.14204,2906,6,1402678,-6,2906,256,2907,529,0
20141229.142042,2906,4,1402682,0,2906,254,2907,522,0
20141229.142044,2906,4,1402686,-4,2906,263,2907,525,0
20141229.142044,2907,2,1402688,0,2906,263,2907,524,1
20141229.142045,2906,2,1402690,-2,2906,262,2907,525,0
20141229.142046,2907,4,1402694,4,2906,262,2907,523,1
20141229.142047,2907,12,1402706,12,2906,264,2907,516,1
20141229.14205,2906,100,1402806,2,2906,215,2907,416,0
20141229.142052,2906,4,1402810,-4,2906,213,2907,418,0
20141229.142053,2906,2,1402812,-2,2906,212,2907,418,0
20141229.142054,2907,2,1402814,2,2906,226,2907,418,1
20141229.142057,2906,2,1402816,-2,2906,230,2907,416,0
20141229.142101,2907,2,1402818,2,2906,243,2907,418,1
20141229.142101,2906,100,1402918,0,2906,193,2907,418,0
20141229.142104,2906,2,1402920,0,2906,190,2907,389,0
20141229.142105,2906,12,1402932,-2,2906,189,2907,389,0
20141229.142105,2906,100,1403032,-88,2906,139,2907,411,0
20141229.142106,2906,2,1403034,-2,2906,138,2907,468,0
20141229.142108,2906,2,1403036,0,2906,137,2907,472,0
20141229.142114,2906,2,1403038,2,2906,250,2907,431,0
20141229.142117,2907,102,1403140,-100,2906,214,2907,433,1
20141229.142118,2907,2,1403142,0,2906,214,2907,431,1
20141229.142118,2907,4,1403146,0,2906,260,2907,429,1
20141229.142119,2907,2,1403148,0,2906,260,2907,428,1
20141229.142119,2906,102,1403250,-24,2906,211,2907,426,0
20141229.142122,2907,58,1403308,8,2906,214,2907,413,1
20141229.142122,2907,50,1403358,50,2906,214,2907,492,1
20141229.142127,2907,160,1403518,24,2906,215,2907,412,1
20141229.142128,2906,170,1403688,20,2906,113,2907,497,0
20141229.142129,2906,226,1403914,36,2905,1053,2907,516,0
20141229.142133,2905,26,1403940,22,2905,844,2906,247,0
20141229.142133,2905,1352,1405292,-354,2905,176,2906,265,0
20141229.142134,2906,2,1405294,0,2905,167,2906,343,1
20141229.142134,2905,2,1405296,0,2905,166,2906,384,0
20141229.142135,2906,380,1405676,64,2904,1175,2906,545,1
20141229.142135,2905,8,1405684,-2,2905,101,2906,545,0
20141229.142136,2905,22,1405706,0,2905,92,2906,409,0
20141229.142137,2905,8,1405714,-4,2905,98,2906,414,0
20141229.142137,2905,2,1405716,-2,2905,97,2906,414,0
20141229.142138,2905,4,1405720,-2,2905,96,2906,413,0
20141229.142138,2905,84,1405804,-82,2905,54,2906,453,0
20141229.142139,2905,8,1405812,-4,2905,50,2906,453,0
20141229.142139,2905,6,1405818,-4,2905,47,2906,454,0
20141229.14214,2905,14,1405832,-2,2905,42,2906,454,0
20141229.14214,2905,10,1405842,-4,2905,37,2906,454,0
20141229.142141,2905,4,1405846,-4,2905,35,2906,454,0
20141229.142141,2905,6,1405852,-2,2905,33,2906,454,0
20141229.142142,2905,10,1405862,-4,2905,28,2906,453,0
20141229.142142,2905,10,1405872,-8,2905,23,2906,453,0
20141229.142143,2905,6,1405878,-2,2905,21,2906,454,0
20141229.142144,2905,14,1405892,-6,2905,15,2906,460,0
20141229.142144,2905,30,1405922,28,2904,1172,2905,134,0
20141229.142144,2905,2,1405924,0,2904,1172,2905,153,0
20141229.142145,2904,2,1405926,0,2904,1171,2905,370,0
20141229.142146,2905,778,1406704,620,2905,423,2906,555,1
20141229.142146,2905,38,1406742,4,2905,406,2906,337,1
20141229.142147,2905,26,1406768,2,2905,393,2906,337,1
20141229.142147,2905,2,1406770,2,2905,394,2906,338,1
20141229.142148,2905,2,1406772,2,2905,395,2906,261,1
20141229.142149,2905,4,1406776,4,2905,391,2906,261,1
20141229.142149,2905,10,1406786,10,2905,386,2906,261,1
20141229.14215,2905,44,1406830,0,2905,366,2906,1262,1
20141229.142151,2905,740,1407570,284,2904,1261,2905,453,1
20141229.142151,2905,52,1407622,6,2904,1231,2905,453,1
20141229.142151,2905,254,1407876,246,2904,1231,2905,327,1
20141229.142152,2905,172,1408048,0,2904,1146,2905,231,1
20141229.142152,2905,460,1408508,326,2905,277,2906,403,1
20141229.142153,2905,62,1408570,-62,2905,408,2906,381,1
20141229.142154,2905,6,1408576,-4,2905,596,2906,381,1
20141229.142154,2906,2,1408578,-2,2905,611,2906,488,1
20141229.142155,2905,198,1408776,-198,2905,302,2906,490,0
20141229.142155,2905,104,1408880,-6,2905,253,2906,494,0
20141229.142156,2905,20,1408900,16,2905,243,2906,518,0
20141229.142157,2905,8,1408908,6,2905,239,2906,521,0
20141229.142158,2905,128,1409036,-70,2905,178,2906,539,0
20141229.142158,2906,4,1409040,-2,2905,176,2906,527,1
20141229.142159,2906,12,1409052,-2,2905,171,2906,526,1
20141229.142159,2905,104,1409156,-104,2905,105,2906,526,0
20141229.1422,2905,62,1409218,0,2905,74,2906,526,0
20141229.1422,2904,194,1409412,-66,2904,1123,2905,166,0
20141229.142201,2904,110,1409522,10,2904,1074,2905,175,0
20141229.142201,2904,2,1409524,0,2904,1063,2905,218,0
20141229.142202,2904,12,1409536,-2,2904,1059,2905,271,0
20141229.142202,2904,2,1409538,-2,2904,1058,2905,275,0
20141229.142203,2904,6,1409544,-4,2904,1053,2905,278,0
20141229.142203,2904,4,1409548,-2,2904,1049,2905,278,0
20141229.142204,2904,4,1409552,-2,2904,1041,2905,228,0
20141229.142204,2905,12,1409564,-4,2904,1035,2905,227,1
20141229.142205,2904,6,1409570,-2,2904,1033,2905,234,0
20141229.142205,2904,48,1409618,-4,2904,1009,2905,302,0
20141229.142206,2904,2,1409620,-2,2904,1008,2905,302,0
20141229.142206,2904,4,1409624,-2,2904,1009,2905,327,0
20141229.142207,2904,24,1409648,-22,2904,997,2905,357,0
20141229.142207,2904,8,1409656,-4,2904,997,2905,357,0
20141229.142208,2904,6,1409662,-2,2904,994,2905,358,0
20141229.142209,2904,4,1409666,-2,2904,994,2905,358,0
20141229.142209,2904,14,1409680,-10,2904,1007,2905,363,0
20141229.14221,2904,4,1409684,-2,2904,1017,2905,363,0
20141229.14221,2904,2,1409686,2,2904,993,2905,363,0
20141229.142211,2905,704,1410390,-118,2905,132,2906,543,1
20141229.142212,2905,8,1410398,0,2905,128,2906,442,1
20141229.142213,2906,12,1410410,0,2905,128,2906,434,1
20141229.142213,2905,76,1410486,-26,2905,94,2906,429,0
20141229.142214,2906,8,1410494,0,2905,94,2906,438,1
20141229.142214,2906,12,1410506,0,2905,94,2906,432,1
20141229.142215,2905,2,1410508,-2,2905,93,2906,432,0
20141229.142215,2905,2,1410510,0,2905,107,2906,434,0
20141229.142216,2905,6,1410516,-6,2905,104,2906,448,0
20141229.142217,2905,34,1410550,-32,2905,87,2906,448,0
20141229.142217,2905,10,1410560,0,2905,83,2906,453,0
20141229.142218,2906,4,1410564,-2,2905,85,2906,452,1
20141229.142218,2906,4,1410568,-4,2905,94,2906,478,1
20141229.142219,2905,22,1410590,0,2905,85,2906,478,0
20141229.14222,2905,6,1410596,-4,2905,93,2906,497,0
20141229.142221,2906,20,1410616,0,2905,119,2906,549,1
20141229.142221,2905,2,1410618,-2,2905,119,2906,548,0
20141229.142222,2905,14,1410632,-14,2905,112,2906,543,0
20141229.142222,2905,202,1410834,56,2905,12,2906,523,0
20141229.142223,2904,44,1410878,-18,2904,1032,2905,102,0
20141229.142225,2905,2,1410880,0,2904,1026,2905,111,1
20141229.142226,2905,264,1411144,48,2905,102,2906,571,1
20141229.142226,2905,2,1411146,-2,2905,151,2906,471,1
20141229.142227,2906,18,1411164,-2,2905,144,2906,468,1
20141229.142227,2905,10,1411174,0,2905,141,2906,470,0
20141229.142228,2905,100,1411274,-100,2905,92,2906,450,0
20141229.14223,2905,4,1411278,0,2905,92,2906,457,0
20141229.142231,2906,6,1411284,0,2905,91,2906,457,1
20141229.142231,2906,4,1411288,0,2905,94,2906,455,1
20141229.142232,2905,6,1411294,-6,2905,91,2906,447,0
20141229.142233,2905,16,1411310,-2,2905,84,2906,447,0
20141229.142236,2905,100,1411410,-48,2905,44,2906,448,0
20141229.142236,2905,12,1411422,0,2905,125,2906,448,0
20141229.142237,2905,4,1411426,4,2905,135,2906,448,0
20141229.142238,2905,14,1411440,10,2905,161,2906,446,0
20141229.142239,2905,10,1411450,0,2905,161,2906,446,0
20141229.14224,2905,4,1411454,2,2905,159,2906,436,0
20141229.14224,2905,38,1411492,-12,2905,140,2906,436,0
20141229.142241,2905,2,1411494,2,2905,199,2906,436,0
20141229.142242,2905,4,1411498,-2,2905,201,2906,441,0
20141229.142244,2905,6,1411504,0,2905,202,2906,443,0
20141229.142251,2905,20,1411524,20,2905,497,2906,452,0
20141229.142256,2906,2,1411526,0,2905,521,2906,449,1
20141229.142257,2905,2,1411528,2,2905,515,2906,448,0
20141229.142257,2905,1030,1412558,536,2904,1218,2905,187,0
20141229.142258,2905,34,1412592,30,2904,1078,2905,279,0
20141229.142258,2905,2,1412594,2,2904,1078,2905,280,0
20141229.142259,2905,2,1412596,2,2904,1106,2905,229,0
20141229.1423,2905,30,1412626,0,2904,1107,2905,214,0
20141229.1423,2905,32,1412658,6,2904,1107,2905,228,0
20141229.142301,2905,6,1412664,6,2904,1107,2905,226,0
20141229.142301,2905,2,1412666,2,2904,1107,2905,225,0
20141229.142302,2905,14,1412680,14,2904,1110,2905,218,0
20141229.142303,2905,2,1412682,2,2904,1112,2905,218,0
20141229.142303,2905,202,1412884,0,2904,1110,2905,118,0
20141229.142304,2905,2,1412886,0,2904,1127,2905,118,0
20141229.142306,2905,6,1412892,2,2904,1148,2905,235,0
20141229.142307,2904,4,1412896,-4,2904,1146,2905,235,0
20141229.142307,2904,4,1412900,0,2904,1145,2905,236,0
20141229.142307,2905,2,1412902,2,2904,1145,2905,251,1
20141229.142308,2904,6,1412908,-2,2904,1143,2905,250,0
20141229.142309,2905,4,1412912,0,2904,1150,2905,249,1
20141229.142309,2905,2,1412914,2,2904,1150,2905,248,1
20141229.14231,2905,34,1412948,2,2904,1150,2905,231,1
20141229.142311,2905,40,1412988,0,2904,1150,2905,211,1
20141229.142313,2905,2,1412990,0,2904,1151,2905,218,1
20141229.142314,2905,2,1412992,0,2904,1151,2905,217,1
20141229.142316,2905,20,1413012,0,2904,1151,2905,209,1
20141229.142317,2904,68,1413080,-66,2904,1114,2905,209,0
20141229.142318,2904,2,1413082,0,2904,1083,2905,214,0
20141229.142319,2905,24,1413106,-20,2904,1093,2905,215,1
20141229.14232,2904,2,1413108,-2,2904,1093,2905,202,0
20141229.142322,2905,60,1413168,-56,2904,1092,2905,273,1
20141229.142323,2904,4,1413172,0,2904,1091,2905,274,0
20141229.142324,2904,56,1413228,0,2904,1070,2905,272,0
20141229.142324,2905,8,1413236,0,2904,1071,2905,269,1
20141229.142325,2905,4,1413240,-2,2904,1071,2905,267,1
20141229.142326,2905,2,1413242,0,2904,1071,2905,163,1
20141229.142326,2904,28,1413270,-10,2904,1057,2905,163,0
20141229.142327,2905,2,1413272,2,2904,1057,2905,162,1
20141229.142329,2904,2,1413274,0,2904,1052,2905,167,0
20141229.14233,2904,2,1413276,0,2904,1051,2905,268,0
20141229.142331,2905,20,1413296,0,2904,1050,2905,260,1
20141229.142333,2905,2,1413298,0,2904,1060,2905,266,1
20141229.142334,2905,6,1413304,0,2904,1061,2905,264,1
20141229.142336,2905,2,1413306,0,2904,1063,2905,270,1
20141229.142338,2905,4,1413310,0,2904,1062,2905,268,1
20141229.14234,2905,4,1413314,0,2904,1065,2905,306,1
20141229.14234,2905,2,1413316,0,2904,1065,2905,305,1
20141229.142343,2905,20,1413336,0,2904,1071,2905,325,1
20141229.142344,2905,2,1413338,0,2904,1071,2905,324,1
20141229.142348,2905,4,1413342,-2,2904,1018,2905,346,1
20141229.142348,2905,2,1413344,0,2904,1021,2905,345,1
20141229.142351,2904,2,1413346,-2,2904,1019,2905,372,0
20141229.142352,2904,12,1413358,-12,2904,1003,2905,374,0
20141229.142353,2904,2,1413360,0,2904,1055,2905,379,0
20141229.142354,2905,2,1413362,0,2904,1113,2905,378,1
20141229.142359,2904,20,1413382,0,2904,1114,2905,378,0
20141229.142401,2904,2,1413384,-2,2904,1114,2905,399,0
20141229.142403,2904,2,1413386,0,2904,1114,2905,401,0
20141229.142403,2904,2,1413388,0,2904,1122,2905,403,0
20141229.142405,2904,4,1413392,0,2904,1124,2905,404,0
20141229.142406,2905,2,1413394,0,2904,1124,2905,407,1
20141229.142407,2905,2,1413396,0,2904,1124,2905,421,1
20141229.142408,2904,42,1413438,-2,2904,1106,2905,424,0
20141229.14241,2904,2,1413440,-2,2904,1106,2905,424,0
20141229.14241,2904,2,1413442,0,2904,1106,2905,424,0
20141229.142412,2905,4,1413446,0,2904,1132,2905,422,1
20141229.142413,2905,24,1413470,-16,2904,1132,2905,414,1
20141229.142414,2905,6,1413476,-4,2904,1080,2905,411,1
20141229.142414,2905,2,1413478,0,2904,1080,2905,410,1
20141229.142416,2904,2,1413480,-2,2904,1091,2905,397,0
20141229.142419,2905,2,1413482,0,2904,1096,2905,411,1
20141229.142419,2904,10,1413492,0,2904,1091,2905,411,0
20141229.142421,2905,2,1413494,-2,2904,1091,2905,410,1
20141229.142422,2905,48,1413542,-48,2904,1090,2905,387,1
20141229.142422,2905,30,1413572,0,2904,1090,2905,372,1
20141229.142423,2905,288,1413860,-50,2904,1055,2905,226,1
20141229.142423,2905,460,1414320,-30,2905,401,2906,648,1
20141229.142424,2905,2,1414322,2,2905,681,2906,633,1
20141229.142424,2906,50,1414372,-50,2905,707,2906,608,1
20141229.142425,2906,2,1414374,-2,2905,726,2906,608,1
20141229.142427,2905,2,1414376,0,2905,742,2906,612,0
20141229.142428,2905,20,1414396,-12,2905,748,2906,613,0
20141229.14243,2906,104,1414500,-100,2905,628,2906,613,1
20141229.142433,2905,10,1414510,0,2905,634,2906,619,0
20141229.142433,2905,4,1414514,0,2905,626,2906,619,0
20141229.142435,2905,6,1414520,0,2905,561,2906,620,0
20141229.142435,2906,2,1414522,-2,2905,560,2906,619,1
20141229.142437,2905,2,1414524,0,2905,547,2906,623,0
20141229.142438,2905,2,1414526,0,2905,491,2906,622,0
20141229.142439,2906,10,1414536,0,2905,491,2906,617,1
20141229.14244,2906,2,1414538,0,2905,491,2906,616,1
20141229.14244,2906,6,1414544,0,2905,486,2906,613,1
20141229.142441,2906,8,1414552,0,2905,486,2906,709,1
20141229.142441,2906,4,1414556,0,2905,486,2906,707,1
20141229.142442,2905,990,1415546,384,2904,1066,2905,358,0
20141229.142443,2905,2,1415548,2,2904,1066,2905,357,0
20141229.142443,2905,10,1415558,8,2904,1066,2905,370,0
20141229.142446,2904,6,1415564,-4,2904,1074,2905,430,0
20141229.142447,2905,2,1415566,0,2904,1074,2905,430,1
20141229.142447,2905,2,1415568,0,2904,1074,2905,429,1
20141229.14245,2905,2,1415570,0,2904,1079,2905,428,1
20141229.142451,2905,202,1415772,202,2904,1079,2905,338,1
20141229.142452,2905,2,1415774,0,2904,1079,2905,327,1
20141229.142456,2905,2,1415776,2,2904,1084,2905,326,1
20141229.142457,2905,2,1415778,0,2904,1084,2905,325,1
20141229.142458,2905,20,1415798,0,2904,1084,2905,375,1
20141229.142459,2905,4,1415802,0,2904,1093,2905,373,1
20141229.1425,2905,6,1415808,0,2904,1103,2905,370,1
20141229.142501,2905,10,1415818,10,2904,1103,2905,365,1
20141229.142503,2905,2,1415820,2,2904,1112,2905,364,1
20141229.142504,2905,2,1415822,0,2904,1112,2905,362,1
20141229.142504,2905,2,1415824,2,2904,1112,2905,361,1
20141229.142506,2905,4,1415828,2,2904,1313,2905,361,1
20141229.142506,2905,2,1415830,0,2904,1313,2905,310,1
20141229.142507,2905,2,1415832,2,2904,1313,2905,310,1
20141229.142507,2905,4,1415836,2,2904,1313,2905,308,1
20141229.142511,2905,20,1415856,0,2904,1333,2905,305,1
20141229.142511,2905,4,1415860,0,2904,1333,2905,303,1
20141229.142513,2905,6,1415866,0,2904,1330,2905,300,1
20141229.142514,2904,100,1415966,42,2904,1280,2905,300,0
20141229.142516,2905,28,1415994,4,2904,1082,2905,287,1
20141229.142518,2905,200,1416194,200,2904,1135,2905,202,1
20141229.142518,2905,20,1416214,20,2904,1147,2905,192,1
20141229.14252,2905,10,1416224,0,2904,1148,2905,172,1
20141229.142521,2905,346,1416570,50,2905,222,2906,795,1
20141229.142521,2906,4,1416574,-2,2905,225,2906,694,1
20141229.142523,2906,2,1416576,-2,2905,250,2906,695,1
20141229.142524,2906,2,1416578,0,2905,298,2906,694,1
20141229.142526,2906,4,1416582,4,2905,307,2906,691,1
20141229.142527,2905,2,1416584,0,2905,310,2906,691,0
20141229.142529,2905,120,1416704,0,2905,256,2906,691,0
20141229.14253,2905,654,1417358,108,2904,989,2905,480,0
20141229.14253,2905,20,1417378,0,2904,989,2905,485,0
20141229.142533,2905,2,1417380,2,2904,992,2905,485,0
20141229.142534,2905,2,1417382,2,2904,994,2905,485,0
20141229.142535,2905,2,1417384,2,2904,1047,2905,484,0
20141229.142536,2905,2,1417386,2,2904,1047,2905,483,0
20141229.142537,2905,12,1417398,12,2904,1047,2905,477,0
20141229.142538,2905,10,1417408,0,2904,1140,2905,472,0
20141229.142541,2905,6,1417414,0,2904,1142,2905,470,0
20141229.142541,2905,14,1417428,14,2904,1137,2905,463,0
20141229.142543,2905,130,1417558,106,2904,1533,2905,349,0
20141229.142545,2904,2,1417560,2,2904,1532,2905,349,0
20141229.142546,2905,2,1417562,0,2904,1532,2905,348,1
20141229.142546,2905,2,1417564,0,2904,1532,2905,348,1
20141229.142548,2905,60,1417624,60,2904,1532,2905,333,1
20141229.142549,2905,14,1417638,4,2904,1073,2905,322,1
20141229.14255,2905,2,1417640,2,2904,1077,2905,321,1
20141229.142553,2905,160,1417800,0,2904,1078,2905,245,1
20141229.142554,2905,6,1417806,2,2904,1082,2905,247,1
20141229.142557,2905,2,1417808,2,2904,1085,2905,349,1
20141229.142558,2905,4,1417812,0,2904,1086,2905,347,1
20141229.142558,2905,14,1417826,0,2904,1086,2905,340,1
20141229.1426,2905,8,1417834,8,2904,1182,2905,333,1
20141229.142602,2905,4,1417838,4,2904,1095,2905,332,1
20141229.142604,2905,2,1417840,0,2904,1095,2905,332,1
20141229.142608,2904,24,1417864,24,2904,1081,2905,332,0
20141229.14261,2905,4,1417868,4,2904,1261,2905,331,1
20141229.142611,2905,20,1417888,20,2904,989,2905,321,1
20141229.142612,2904,8,1417896,2,2904,1036,2905,320,0
20141229.142613,2905,2,1417898,2,2904,1037,2905,319,1
20141229.142614,2905,2,1417900,0,2904,1037,2905,319,1
20141229.142615,2904,4,1417904,0,2904,1016,2905,327,0
20141229.142617,2904,20,1417924,20,2904,1563,2905,280,0
20141229.142618,2904,2,1417926,0,2904,1562,2905,281,0
20141229.142618,2905,2,1417928,0,2904,1562,2905,280,1
20141229.14262,2904,2,1417930,0,2904,1425,2905,280,0
20141229.142623,2905,12,1417942,10,2904,1422,2905,339,1
20141229.142627,2905,6,1417948,2,2904,1423,2905,356,1
20141229.142629,2904,200,1418148,50,2904,1314,2905,342,0
20141229.142629,2904,30,1418178,-30,2904,1299,2905,342,0
20141229.142632,2905,2,1418180,2,2904,855,2905,342,1
20141229.142632,2904,402,1418582,32,2904,663,2905,342,0
20141229.142633,2904,90,1418672,-90,2904,608,2905,337,0
20141229.142633,2904,312,1418984,-50,2904,451,2905,340,0
20141229.142634,2904,448,1419432,-46,2904,227,2905,341,0
20141229.142634,2904,454,1419886,92,2903,857,2904,200,0
20141229.142635,2904,10,1419896,-2,2903,867,2904,386,0
20141229.142636,2903,12,1419908,0,2903,939,2904,382,0
20141229.142636,2903,476,1420384,-40,2903,646,2904,385,0
20141229.142637,2903,34,1420418,2,2903,597,2904,417,0
20141229.142637,2904,4,1420422,0,2903,597,2904,416,1
20141229.142638,2904,10,1420432,0,2903,597,2904,412,1
20141229.142638,2903,644,1421076,-82,2903,277,2904,412,0
20141229.142639,2903,148,1421224,-62,2903,233,2904,412,0
20141229.142639,2903,6,1421230,0,2903,301,2904,413,0
20141229.14264,2903,2,1421232,-2,2903,300,2904,413,0
20141229.14264,2903,14,1421246,0,2903,293,2904,413,0
20141229.142641,2903,102,1421348,-58,2903,240,2904,414,0
20141229.142642,2903,6,1421354,4,2903,246,2904,515,0
20141229.142642,2903,18,1421372,6,2903,237,2904,515,0
20141229.142643,2904,2,1421374,0,2903,237,2904,514,1
20141229.142643,2903,2,1421376,-2,2903,236,2904,514,0
20141229.142645,2904,208,1421584,-138,2903,136,2904,520,1
20141229.142646,2903,124,1421708,2,2903,86,2904,577,0
20141229.142646,2903,18,1421726,-18,2903,171,2904,518,0
20141229.142646,2903,40,1421766,-40,2903,151,2904,458,0
20141229.142647,2903,16,1421782,-2,2903,267,2904,458,0
20141229.142648,2903,30,1421812,-30,2903,341,2904,458,0
20141229.142648,2903,2,1421814,0,2903,362,2904,458,0
20141229.142649,2903,28,1421842,-14,2903,349,2904,458,0
20141229.142649,2903,10,1421852,10,2903,349,2904,458,0
20141229.14265,2904,122,1421974,98,2903,291,2904,457,1
20141229.142651,2904,4,1421978,0,2903,392,2904,462,1
20141229.142651,2903,2,1421980,2,2903,406,2904,462,0
20141229.142652,2903,214,1422194,88,2903,302,2904,464,0
20141229.142653,2904,24,1422218,-22,2903,356,2904,523,1
20141229.142653,2903,448,1422666,398,2903,134,2904,523,0
20141229.142654,2903,46,1422712,40,2903,113,2904,523,0
20141229.142655,2903,2,1422714,2,2903,112,2904,523,0
20141229.142655,2903,4,1422718,4,2903,110,2904,524,0
20141229.142656,2903,32,1422750,6,2903,94,2904,524,0
20141229.142656,2903,8,1422758,6,2903,91,2904,524,0
20141229.142657,2903,4,1422762,4,2903,91,2904,524,0
20141229.142657,2904,4,1422766,0,2903,94,2904,523,1
20141229.142658,2903,4,1422770,2,2903,215,2904,523,0
20141229.142658,2903,14,1422784,-8,2903,213,2904,522,0
20141229.142659,2903,2,1422786,0,2903,374,2904,522,0
20141229.1427,2903,26,1422812,2,2903,367,2904,522,0
20141229.142701,2903,6,1422818,2,2903,446,2904,522,0
20141229.142702,2904,22,1422840,0,2903,441,2904,522,1
20141229.142703,2903,2,1422842,2,2903,467,2904,523,0
20141229.142706,2903,4,1422846,4,2903,490,2904,683,0
20141229.142707,2904,8,1422854,-8,2903,491,2904,679,1
20141229.142708,2903,22,1422876,2,2903,496,2904,684,0
20141229.142709,2903,40,1422916,0,2903,478,2904,690,0
20141229.14271,2903,10,1422926,0,2903,473,2904,692,0
20141229.142711,2903,2,1422928,0,2903,547,2904,679,0
20141229.142712,2903,2,1422930,0,2903,602,2904,668,0
20141229.142712,2903,20,1422950,0,2903,622,2904,664,0
20141229.142713,2904,2,1422952,0,2903,632,2904,663,1
20141229.142713,2903,20,1422972,-14,2903,624,2904,665,0
20141229.142714,2903,4,1422976,2,2903,645,2904,666,0
20141229.142715,2903,2,1422978,0,2903,627,2904,682,0
20141229.142716,2903,10,1422988,0,2903,640,2904,684,0
20141229.142716,2903,10,1422998,10,2903,635,2904,684,0
20141229.142719,2903,50,1423048,0,2903,697,2904,686,0
20141229.14272,2903,20,1423068,0,2903,701,2904,670,0
20141229.142721,2904,4,1423072,0,2903,702,2904,667,1
20141229.142722,2903,2,1423074,2,2903,704,2904,662,0
20141229.142723,2903,2,1423076,2,2903,703,2904,662,0
20141229.142724,2903,2,1423078,0,2903,732,2904,662,0
20141229.142725,2903,50,1423128,0,2903,707,2904,662,0
20141229.142726,2903,2,1423130,0,2903,706,2904,662,0
20141229.142727,2903,4,1423134,4,2903,714,2904,668,0
20141229.142729,2904,22,1423156,22,2903,715,2904,661,1
20141229.14273,2903,2,1423158,2,2903,776,2904,627,0
20141229.142732,2903,60,1423218,0,2903,769,2904,627,0
20141229.142733,2904,2,1423220,2,2903,779,2904,630,1
20141229.142735,2903,64,1423284,8,2903,748,2904,629,0
20141229.142736,2903,6,1423290,0,2903,746,2904,630,0
20141229.142739,2904,52,1423342,2,2903,730,2904,629,1
20141229.14274,2903,2,1423344,2,2903,729,2904,629,0
20141229.142743,2904,42,1423386,0,2903,710,2904,629,1
20141229.142745,2904,22,1423408,0,2903,716,2904,618,1
20141229.142747,2904,4,1423412,4,2903,716,2904,613,1
20141229.142747,2903,44,1423456,2,2903,697,2904,613,0
20141229.142748,2903,4,1423460,2,2903,713,2904,625,0
20141229.14275,2904,26,1423486,0,2903,716,2904,612,1
20141229.142751,2904,28,1423514,26,2903,717,2904,608,1
20141229.142752,2904,46,1423560,4,2903,718,2904,588,1
20141229.142755,2903,2,1423562,0,2903,761,2904,588,0
20141229.142755,2904,10,1423572,-10,2903,821,2904,583,1
20141229.142757,2904,4,1423576,0,2903,836,2904,580,1
20141229.142758,2904,16,1423592,-14,2903,843,2904,572,1
20141229.142759,2903,2,1423594,-2,2903,837,2904,572,0
20141229.142802,2904,2,1423596,-2,2903,919,2904,572,1
20141229.142804,2903,2,1423598,-2,2903,920,2904,574,0
20141229.142805,2903,2,1423600,2,2903,923,2904,574,0
20141229.142806,2904,2,1423602,0,2903,923,2904,573,1
20141229.142806,2904,4,1423606,0,2903,922,2904,571,1
20141229.142807,2904,6,1423612,-6,2903,922,2904,568,1
20141229.142808,2904,4,1423616,-4,2903,932,2904,566,1
20141229.142809,2904,6,1423622,-6,2903,942,2904,563,1
20141229.14281,2903,6,1423628,-2,2903,945,2904,453,0
20141229.142811,2904,180,1423808,-8,2903,973,2904,363,1
20141229.142812,2904,726,1424534,228,2904,15,2905,817,1
20141229.142812,2904,2,1424536,2,2904,29,2905,784,1
20141229.142813,2905,4,1424540,0,2904,31,2905,793,1
20141229.142814,2904,44,1424584,-36,2903,1065,2904,266,0
20141229.142814,2904,4,1424588,0,2903,957,2904,350,0
20141229.142815,2904,24,1424612,-22,2903,966,2904,353,0
20141229.142816,2904,2,1424614,0,2903,971,2904,354,0
20141229.142817,2903,2,1424616,0,2903,971,2904,354,0
20141229.142817,2904,2,1424618,0,2903,979,2904,376,1
20141229.142818,2904,8,1424626,-8,2903,979,2904,373,1
20141229.14282,2904,44,1424670,-2,2903,979,2904,352,1
20141229.14282,2903,10,1424680,0,2903,970,2904,352,0
20141229.142822,2904,6,1424686,0,2903,970,2904,354,1
20141229.142823,2903,2,1424688,0,2903,969,2904,355,0
20141229.142824,2904,2,1424690,0,2903,970,2904,374,1
20141229.142825,2904,18,1424708,-2,2903,979,2904,365,1
20141229.142826,2903,6,1424714,0,2903,978,2904,368,0
20141229.142826,2904,40,1424754,4,2903,983,2904,349,1
20141229.142827,2903,6,1424760,0,2903,980,2904,376,0
20141229.142827,2904,4,1424764,-4,2903,986,2904,374,1
20141229.142828,2904,2,1424766,-2,2903,1025,2904,373,1
20141229.142829,2904,2,1424768,0,2903,1025,2904,322,1
20141229.142831,2904,2,1424770,0,2903,1123,2904,323,1
20141229.142832,2904,2,1424772,0,2903,1116,2904,322,1
20141229.142834,2904,2,1424774,0,2903,1112,2904,322,1
20141229.142835,2904,2,1424776,0,2903,1112,2904,321,1
20141229.142836,2903,100,1424876,100,2903,1058,2904,324,0
20141229.142838,2903,6,1424882,0,2903,1061,2904,328,0
20141229.14284,2904,20,1424902,0,2903,1095,2904,318,1
20141229.142842,2903,4,1424906,-2,2903,1092,2904,323,0
20141229.142843,2903,2,1424908,2,2903,1127,2904,323,0
20141229.142843,2904,2,1424910,0,2903,1127,2904,322,1
20141229.142845,2904,26,1424936,-6,2903,1154,2904,311,1
20141229.142846,2904,4,1424940,-2,2903,1154,2904,309,1
20141229.142847,2903,4,1424944,0,2903,1152,2904,309,0
20141229.142847,2904,2,1424946,0,2903,1152,2904,308,1
20141229.142848,2904,8,1424954,0,2903,1152,2904,316,1
20141229.142849,2904,2,1424956,-2,2903,1143,2904,466,1
20141229.14285,2903,4,1424960,0,2903,1152,2904,465,0
20141229.142852,2904,2,1424962,0,2903,1152,2904,464,1
20141229.142852,2903,2,1424964,0,2903,1151,2904,464,0
20141229.142852,2904,40,1425004,-20,2903,1152,2904,444,1
20141229.142853,2903,2,1425006,0,2903,1143,2904,444,0
20141229.142856,2904,2,1425008,0,2903,1142,2904,444,1
20141229.142856,2904,20,1425028,0,2903,1166,2904,434,1
20141229.142858,2904,2,1425030,-2,2903,1177,2904,433,1
20141229.1429,2904,20,1425050,0,2903,1172,2904,424,1
20141229.142901,2904,2,1425052,0,2903,1173,2904,423,1
20141229.142902,2904,2,1425054,0,2903,1173,2904,422,1
20141229.142903,2904,4,1425058,-4,2903,1173,2904,420,1
20141229.142905,2904,44,1425102,18,2903,1180,2904,397,1
20141229.142906,2904,26,1425128,26,2903,1180,2904,389,1
20141229.142907,2904,4,1425132,0,2903,1181,2904,408,1
20141229.142909,2904,78,1425210,2,2903,1197,2904,369,1
20141229.142909,2904,2,1425212,2,2903,1197,2904,368,1
20141229.14291,2904,8,1425220,8,2903,1197,2904,365,1
20141229.142911,2904,66,1425286,46,2903,1197,2904,332,1
20141229.142914,2904,2,1425288,0,2903,1192,2904,335,1
20141229.142914,2904,2,1425290,0,2903,1192,2904,334,1
20141229.142915,2904,2,1425292,0,2903,1192,2904,333,1
20141229.142916,2904,46,1425338,-46,2903,1192,2904,311,1
20141229.142917,2904,622,1425960,-236,2904,391,2905,787,1
20141229.142919,2904,12,1425972,-12,2904,413,2905,718,1
20141229.142922,2905,2,1425974,-2,2904,442,2905,725,1
20141229.142923,2905,40,1426014,0,2904,442,2905,705,1
20141229.142926,2904,104,1426118,-68,2904,441,2905,656,0
20141229.142927,2904,6,1426124,-2,2904,461,2905,661,0
20141229.142931,2904,8,1426132,-8,2904,460,2905,678,0
20141229.142932,2905,2,1426134,2,2904,464,2905,676,1
20141229.142932,2905,2,1426136,-2,2904,464,2905,675,1
20141229.142937,2905,2,1426138,2,2904,490,2905,676,1
20141229.14294,2905,2,1426140,0,2904,493,2905,674,1
20141229.142941,2905,214,1426354,-18,2904,487,2905,578,1
20141229.142942,2905,2,1426356,0,2904,488,2905,571,1
20141229.142943,2904,2,1426358,-2,2904,487,2905,571,0
20141229.142943,2904,2,1426360,-2,2904,487,2905,571,0
20141229.142945,2904,2,1426362,0,2904,491,2905,572,0
20141229.142945,2904,2,1426364,-2,2904,490,2905,573,0
20141229.142948,2904,80,1426444,-80,2904,452,2905,579,0
20141229.142948,2904,24,1426468,-12,2904,440,2905,579,0
20141229.142949,2904,86,1426554,0,2904,398,2905,579,0
20141229.142949,2904,30,1426584,0,2904,383,2905,579,0
20141229.14295,2905,2,1426586,0,2904,382,2905,578,1
20141229.142952,2904,466,1427052,-464,2904,152,2905,579,0
20141229.142952,2904,304,1427356,-190,2903,1387,2904,173,0
20141229.142953,2904,40,1427396,0,2903,878,2904,154,0
20141229.142954,2905,1574,1428970,196,2904,30,2905,46,1
20141229.142954,2905,354,1429324,200,2905,76,2906,718,1
20141229.142955,2904,162,1429486,-152,2904,568,2905,6,0
20141229.142955,2905,248,1429734,44,2904,432,2905,190,1
20141229.142956,2905,192,1429926,0,2904,492,2905,95,1
20141229.142958,2905,10,1429936,-10,2904,528,2905,158,1
20141229.142958,2906,458,1430394,258,2904,523,2906,567,1
20141229.142958,2906,660,1431054,492,2904,533,2906,230,1
20141229.142959,2905,4,1431058,2,2905,372,2906,309,0
20141229.142959,2905,2,1431060,0,2905,602,2906,310,0
20141229.143,2905,20,1431080,20,2905,386,2906,312,0
20141229.143001,2905,1332,1432412,-704,2904,609,2905,28,0
20141229.143001,2905,12,1432424,-6,2904,608,2905,59,0
20141229.143002,2905,2,1432426,-2,2904,609,2905,58,0
20141229.143003,2906,118,1432544,74,2905,152,2906,349,1
20141229.143004,2905,2,1432546,0,2905,152,2906,361,0
20141229.143004,2905,4,1432550,0,2905,200,2906,367,0
20141229.143005,2905,4,1432554,-4,2905,198,2906,372,0
20141229.143005,2905,8,1432562,-6,2905,145,2906,373,0
20141229.143007,2905,292,1432854,18,2904,670,2905,118,0
20141229.143008,2904,4,1432858,-2,2904,657,2905,118,0
20141229.143009,2905,232,1433090,0,2905,658,2906,379,1
20141229.14301,2906,2,1433092,0,2905,684,2906,356,1
20141229.14301,2905,10,1433102,6,2905,681,2906,356,0
20141229.143011,2905,2,1433104,0,2905,680,2906,356,0
20141229.143012,2906,2,1433106,0,2905,680,2906,355,1
20141229.143012,2906,2,1433108,-2,2905,680,2906,354,1
20141229.143012,2906,2,1433110,2,2905,680,2906,353,1
20141229.143013,2906,100,1433210,-50,2905,681,2906,303,1
20141229.143014,2906,6,1433216,-2,2905,691,2906,288,1
20141229.143015,2906,4,1433220,-4,2905,691,2906,288,1
20141229.143015,2906,4,1433224,0,2905,692,2906,256,1
20141229.143018,2906,4,1433228,-2,2905,593,2906,280,1
20141229.14302,2906,2,1433230,0,2905,393,2906,283,1
20141229.143021,2905,2,1433232,0,2905,394,2906,301,0
20141229.143021,2905,2,1433234,0,2905,393,2906,302,0
20141229.143022,2906,14,1433248,-2,2905,393,2906,295,1
20141229.143023,2906,24,1433272,0,2905,393,2906,283,1
20141229.143025,2906,60,1433332,-12,2905,408,2906,253,1
20141229.143026,2906,16,1433348,4,2905,407,2906,248,1
20141229.143029,2905,70,1433418,70,2905,119,2906,277,0
20141229.143029,2905,218,1433636,90,2904,688,2905,71,0
20141229.143029,2905,2,1433638,0,2904,647,2905,70,0
20141229.14303,2905,4,1433642,-2,2904,652,2905,79,0
20141229.143033,2904,2,1433644,-2,2904,627,2905,79,0
20141229.143034,2905,2,1433646,0,2904,628,2905,78,1
20141229.143035,2905,12,1433658,-6,2904,624,2905,72,1
20141229.143036,2904,4,1433662,0,2904,633,2905,71,0
20141229.143036,2905,144,1433806,22,2905,227,2906,330,1
20141229.143038,2905,2,1433808,-2,2905,354,2906,308,1
20141229.143039,2905,4,1433812,-2,2905,354,2906,309,1
20141229.14304,2906,64,1433876,62,2905,323,2906,281,1
20141229.143041,2905,204,1434080,204,2905,71,2906,449,0
20141229.143042,2905,142,1434222,140,2904,545,2905,119,0
20141229.143042,2905,50,1434272,-46,2904,487,2905,94,0
20141229.143043,2905,20,1434292,-20,2904,561,2905,90,0
20141229.143045,2905,20,1434312,-20,2904,614,2905,80,0
20141229.143046,2905,2,1434314,-2,2904,622,2905,80,0
20141229.143046,2905,4,1434318,-4,2904,625,2905,79,0
20141229.143047,2905,4,1434322,0,2904,627,2905,77,0
20141229.143048,2905,10,1434332,0,2904,606,2905,574,0
20141229.143048,2905,6,1434338,-6,2904,604,2905,573,0
20141229.143049,2905,2,1434340,-2,2904,550,2905,572,0
20141229.143052,2905,8,1434348,0,2904,566,2905,568,0
20141229.143052,2905,2,1434350,-2,2904,566,2905,541,0
20141229.143053,2904,10,1434360,-10,2904,561,2905,542,0
20141229.143054,2905,1084,1435444,542,2905,12,2906,403,1
20141229.143054,2906,8,1435452,8,2905,145,2906,400,1
20141229.143056,2906,130,1435582,98,2905,83,2906,400,1
20141229.1431,2906,2,1435584,0,2905,170,2906,401,1
20141229.143101,2905,314,1435898,-74,2904,479,2905,254,0
20141229.143102,2905,2,1435900,0,2904,479,2905,126,0
20141229.143102,2905,26,1435926,-18,2904,489,2905,110,0
20141229.143104,2905,2,1435928,0,2904,439,2905,146,0
20141229.143104,2905,2,1435930,0,2904,443,2905,146,0
20141229.143106,2905,368,1436298,64,2905,118,2906,453,0
20141229.143106,2906,4,1436302,4,2905,128,2906,408,1
20141229.143107,2906,2,1436304,2,2905,217,2906,408,1
20141229.143107,2905,20,1436324,0,2905,217,2906,408,0
20141229.143108,2906,8,1436332,4,2905,268,2906,404,1
20141229.14311,2905,2,1436334,2,2905,283,2906,395,0
20141229.143111,2905,18,1436352,0,2905,267,2906,445,0
20141229.143111,2906,202,1436554,48,2905,291,2906,354,1
20141229.143112,2906,20,1436574,4,2905,292,2906,306,1
20141229.143113,2906,2,1436576,2,2905,292,2906,297,1
20141229.143114,2906,68,1436644,48,2905,294,2906,249,1
20141229.143114,2906,34,1436678,-34,2905,294,2906,232,1
20141229.143116,2906,18,1436696,0,2905,301,2906,222,1
20141229.143118,2905,4,1436700,0,2905,318,2906,223,0
20141229.143119,2906,2,1436702,0,2905,273,2906,257,1
20141229.143121,2905,120,1436822,120,2905,200,2906,308,0
20141229.143121,2906,4,1436826,-4,2905,207,2906,468,1
20141229.143122,2906,2,1436828,0,2905,207,2906,466,1
20141229.143123,2906,12,1436840,8,2905,204,2906,465,1
20141229.143125,2906,2,1436842,-2,2905,204,2906,465,1
20141229.143125,2906,2,1436844,-2,2905,204,2906,464,1
20141229.143126,2906,604,1437448,-602,2905,214,2906,455,1
20141229.143128,2905,2,1437450,0,2905,224,2906,773,0
20141229.143131,2905,6,1437456,0,2905,213,2906,788,0
20141229.143131,2905,4,1437460,0,2905,212,2906,788,0
20141229.143133,2906,20,1437480,0,2905,228,2906,778,1
20141229.143133,2906,10,1437490,6,2905,228,2906,773,1
20141229.143134,2905,4,1437494,4,2905,250,2906,776,0
20141229.143135,2905,500,1437994,160,2904,896,2905,272,0
20141229.143135,2905,2,1437996,0,2904,846,2905,289,0
20141229.143136,2905,10,1438006,6,2904,852,2905,283,0
20141229.143138,2905,2,1438008,2,2904,852,2905,267,0
20141229.143139,2905,2,1438010,0,2904,852,2905,266,0
20141229.143142,2905,4,1438014,2,2904,852,2905,281,0
20141229.143143,2905,194,1438208,0,2904,852,2905,184,0
20141229.143145,2905,2,1438210,2,2904,852,2905,185,0
20141229.143147,2905,16,1438226,16,2904,893,2905,177,0
20141229.143149,2904,10,1438236,0,2904,848,2905,178,0
20141229.143159,2905,2,1438238,2,2904,859,2905,280,1
20141229.1432,2905,6,1438244,6,2904,869,2905,277,1
20141229.143201,2904,4,1438248,-4,2904,874,2905,277,0
20141229.143202,2904,386,1438634,142,2904,684,2905,477,0
20141229.143203,2905,2,1438636,0,2904,735,2905,487,1
20141229.143207,2904,400,1439036,-196,2904,502,2905,487,0
20141229.143208,2905,56,1439092,0,2904,518,2905,459,1
20141229.143209,2904,1038,1440130,-908,2903,924,2904,32,0
20141229.143209,2904,8,1440138,-4,2903,724,2904,102,0
20141229.143209,2904,4,1440142,-2,2903,724,2904,100,0
20141229.143211,2904,2,1440144,-2,2903,723,2904,191,0
20141229.143213,2904,252,1440396,-80,2903,733,2904,178,0
20141229.143214,2903,70,1440466,0,2903,742,2904,148,0
20141229.143214,2903,132,1440598,78,2903,665,2904,188,0
20141229.143215,2904,6,1440604,0,2903,665,2904,186,1
20141229.143215,2904,2,1440606,0,2903,665,2904,185,1
20141229.143216,2904,4,1440610,0,2903,665,2904,183,1
20141229.143219,2903,444,1441054,-210,2903,518,2904,218,0
20141229.14322,2903,20,1441074,-2,2903,511,2904,461,0
20141229.143222,2903,2,1441076,-2,2903,500,2904,461,0
20141229.143223,2903,202,1441278,-178,2903,412,2904,471,0
20141229.143224,2903,804,1442082,-574,2902,1789,2903,63,0
20141229.143225,2903,6,1442088,0,2902,1700,2903,60,0
20141229.143226,2902,2,1442090,2,2902,1699,2903,90,0
20141229.143226,2902,248,1442338,-224,2902,1576,2903,150,0
20141229.143227,2902,70,1442408,-62,2902,1546,2903,175,0
20141229.143227,2902,54,1442462,-20,2902,1521,2903,333,0
20141229.143228,2902,4,1442466,-2,2902,1519,2903,334,0
20141229.143228,2902,10,1442476,-10,2902,1514,2903,334,0
20141229.143229,2903,4,1442480,2,2902,1514,2903,332,1
20141229.14323,2903,2,1442482,2,2902,1514,2903,331,1
20141229.14323,2902,2,1442484,0,2902,1513,2903,331,0
20141229.14323,2902,10,1442494,-10,2902,1511,2903,331,0
20141229.143231,2903,44,1442538,-36,2902,1492,2903,390,1
20141229.143231,2902,2,1442540,-2,2902,1491,2903,390,0
20141229.143233,2903,2,1442542,2,2902,1496,2903,390,1
20141229.143234,2902,4,1442546,0,2902,1496,2903,390,0
20141229.143234,2903,14,1442560,12,2902,1495,2903,384,1
20141229.143235,2903,2,1442562,2,2902,1495,2903,383,1
20141229.143236,2903,4,1442566,4,2902,1495,2903,383,1
20141229.143236,2903,16,1442582,-4,2902,1493,2903,378,1
20141229.143237,2902,2,1442584,0,2902,1497,2903,378,0
20141229.143238,2903,8,1442592,6,2902,1497,2903,474,1
20141229.14324,2902,2,1442594,0,2902,1501,2903,477,0
20141229.143241,2903,42,1442636,2,2902,1502,2903,457,1
20141229.143242,2903,10,1442646,-10,2902,1502,2903,456,1
20141229.143243,2902,400,1443046,-400,2902,1303,2903,456,0
20141229.143244,2903,10,1443056,-4,2902,1300,2903,463,1
20141229.143247,2903,30,1443086,-30,2902,1301,2903,449,1
20141229.143248,2903,2,1443088,-2,2902,1303,2903,448,1
20141229.143248,2902,2,1443090,-2,2902,1302,2903,448,0
20141229.143249,2903,2,1443092,-2,2902,1302,2903,455,1
20141229.143249,2902,4,1443096,-2,2902,1300,2903,455,0
20141229.14325,2902,18,1443114,-4,2902,1295,2903,451,0
20141229.14325,2903,64,1443178,-2,2902,1295,2903,419,1
20141229.143251,2903,838,1444016,-194,2903,425,2904,204,1
20141229.143251,2903,8,1444024,-6,2903,473,2904,177,1
20141229.143252,2904,60,1444084,40,2903,546,2904,141,1
20141229.143252,2903,14,1444098,-14,2903,554,2904,142,0
20141229.143254,2904,4,1444102,-2,2903,557,2904,141,1
20141229.143255,2903,22,1444124,-22,2903,553,2904,198,0
20141229.143256,2903,2,1444126,-2,2903,558,2904,198,0
20141229.143258,2903,2,1444128,-2,2903,478,2904,439,0
20141229.143258,2903,16,1444144,4,2903,474,2904,439,0
20141229.143259,2904,2,1444146,0,2903,465,2904,448,1
20141229.143301,2904,10,1444156,-6,2903,237,2904,463,1
20141229.143302,2904,4,1444160,-4,2903,194,2904,461,1
20141229.143302,2903,2,1444162,0,2903,183,2904,461,0
20141229.143302,2903,12,1444174,10,2903,182,2904,458,0
20141229.143304,2903,6,1444180,6,2903,197,2904,458,0
20141229.143305,2903,10,1444190,10,2903,193,2904,458,0
20141229.143305,2903,8,1444198,6,2903,191,2904,456,0
20141229.143306,2903,2,1444200,0,2903,195,2904,456,0
20141229.143307,2903,6,1444206,6,2903,204,2904,456,0
20141229.143308,2904,2,1444208,2,2903,208,2904,455,1
20141229.143308,2903,416,1444624,-222,2902,1370,2903,296,0
20141229.143309,2903,4,1444628,0,2902,1370,2903,416,0
20141229.143311,2902,2,1444630,0,2902,1370,2903,523,0
20141229.143312,2903,18,1444648,-18,2902,1369,2903,484,1
20141229.143313,2903,42,1444690,-2,2902,1365,2903,464,1
20141229.143313,2903,22,1444712,-4,2902,1362,2903,403,1
20141229.143314,2903,6,1444718,-2,2902,1352,2903,340,1
20141229.143314,2903,42,1444760,0,2902,1352,2903,320,1
20141229.143315,2903,6,1444766,0,2902,1352,2903,316,1
20141229.143315,2902,20,1444786,-8,2902,1350,2903,463,0
20141229.143316,2903,2,1444788,-2,2902,1355,2903,492,1
20141229.143318,2903,306,1445094,-306,2902,1360,2903,344,1
20141229.143319,2902,2,1445096,0,2902,1359,2903,344,0
20141229.143319,2902,54,1445150,-20,2902,1244,2903,333,0
20141229.14332,2902,2,1445152,0,2902,1245,2903,333,0
20141229.143322,2903,402,1445554,-336,2902,1245,2903,132,1
20141229.143322,2903,2,1445556,0,2902,1258,2903,131,1
20141229.143323,2903,270,1445826,72,2903,109,2904,510,1
20141229.143324,2903,4,1445830,0,2903,107,2904,478,1
20141229.143325,2903,220,1446050,0,2902,1249,2903,292,1
20141229.143325,2902,1248,1447298,-908,2902,650,2903,470,0
20141229.143326,2903,2,1447300,2,2902,638,2903,507,1
20141229.143326,2902,66,1447366,64,2902,605,2903,507,0
20141229.143327,2903,4,1447370,2,2902,604,2903,506,1
20141229.143327,2902,2,1447372,0,2902,603,2903,506,0
20141229.143328,2902,28,1447400,26,2902,640,2903,507,0
20141229.143329,2902,4,1447404,4,2902,640,2903,507,0
20141229.143329,2902,4,1447408,0,2902,639,2903,507,0
20141229.143333,2903,4,1447412,0,2902,722,2903,508,1
20141229.143333,2903,2,1447414,2,2902,723,2903,507,1
20141229.143334,2902,400,1447814,-382,2902,573,2903,507,0
20141229.143334,2903,2,1447816,2,2902,573,2903,506,1
20141229.143335,2903,16,1447832,16,2902,613,2903,498,1
20141229.143336,2902,400,1448232,-252,2902,414,2903,500,0
20141229.143337,2902,8,1448240,0,2902,423,2903,499,0
20141229.143337,2902,2,1448242,-2,2902,422,2903,499,0
20141229.143338,2902,4,1448246,-4,2902,420,2903,499,0
20141229.143338,2902,66,1448312,-20,2902,387,2903,500,0
20141229.143339,2902,42,1448354,2,2902,372,2903,511,0
20141229.14334,2903,24,1448378,10,2902,365,2903,516,1
20141229.143341,2902,20,1448398,20,2902,358,2903,517,0
20141229.143342,2902,4,1448402,0,2902,356,2903,517,0
20141229.143344,2902,4,1448406,-2,2902,355,2903,517,0
20141229.143347,2902,444,1448850,6,2902,138,2903,528,0
20141229.143347,2902,240,1449090,-68,2901,977,2903,528,0
20141229.143347,2902,10,1449100,2,2902,19,2903,524,0
20141229.143348,2901,54,1449154,-50,2901,1850,2902,12,0
20141229.143349,2901,980,1450134,-412,2901,1420,2902,179,0
20141229.143349,2901,52,1450186,-10,2901,1466,2902,230,0
20141229.143349,2902,344,1450530,-238,2901,1225,2902,229,1
20141229.14335,2901,408,1450938,-92,2901,1023,2902,242,0
20141229.14335,2902,4,1450942,-2,2901,1011,2902,262,1
20141229.143351,2901,432,1451374,-176,2901,740,2902,255,0
20141229.143352,2901,424,1451798,-36,2900,1735,2902,278,0
20141229.143352,2900,424,1452222,-12,2900,1825,2901,20,0
20141229.143353,2900,290,1452512,-254,2900,1715,2901,228,0
20141229.143353,2900,222,1452734,-206,2900,1588,2901,377,0
20141229.143354,2900,480,1453214,-198,2900,1304,2901,391,0
20141229.143354,2900,2,1453216,0,2900,1282,2901,421,0
20141229.143354,2901,408,1453624,-260,2900,1079,2901,438,1
20141229.143355,2900,52,1453676,-40,2900,1055,2901,437,0
20141229.143356,2900,94,1453770,0,2900,1005,2901,372,0
20141229.143356,2901,34,1453804,-16,2900,1000,2901,412,1
20141229.143356,2901,20,1453824,0,2900,1002,2901,404,1
20141229.143357,2900,400,1454224,-172,2900,805,2901,404,0
20141229.143358,2900,16,1454240,0,2900,832,2901,412,0
20141229.143358,2900,306,1454546,-222,2900,689,2901,434,0
20141229.143358,2900,82,1454628,-30,2900,651,2901,432,0
20141229.143359,2900,604,1455232,-140,2900,359,2901,442,0
20141229.143359,2900,64,1455296,-32,2900,327,2901,442,0
20141229.1434,2900,90,1455386,-64,2900,409,2901,444,0
20141229.1434,2900,64,1455450,-50,2900,377,2901,446,0
20141229.143401,2900,414,1455864,-128,2900,424,2901,435,0
20141229.143402,2900,2,1455866,2,2900,487,2901,409,0
20141229.143403,2900,58,1455924,-2,2900,462,2901,538,0
20141229.143403,2900,964,1456888,744,2899,871,2900,234,0
20141229.143404,2900,34,1456922,4,2899,821,2900,362,0
20141229.143404,2900,92,1457014,28,2899,823,2900,405,0
20141229.143405,2899,30,1457044,22,2899,811,2900,448,0
20141229.143405,2899,164,1457208,-122,2899,739,2900,450,0
20141229.143406,2899,54,1457262,-24,2899,725,2900,466,0
20141229.143406,2900,30,1457292,2,2899,714,2900,461,1
20141229.143407,2900,8,1457300,4,2899,717,2900,461,1
20141229.143407,2899,26,1457326,-6,2899,710,2900,458,0
20141229.143408,2900,18,1457344,-2,2899,706,2900,459,1
20141229.143408,2899,30,1457374,-6,2899,693,2900,445,0
20141229.143409,2900,492,1457866,148,2899,540,2900,372,1
20141229.143409,2899,6,1457872,4,2899,560,2900,381,0
20141229.14341,2899,114,1457986,-42,2899,494,2900,372,0
20141229.14341,2900,866,1458852,-648,2899,559,2900,160,1
20141229.143411,2899,26,1458878,0,2899,539,2900,157,0
20141229.143411,2900,104,1458982,-96,2899,599,2900,153,1
20141229.143412,2900,32,1459014,-28,2899,680,2900,168,1
20141229.143413,2900,54,1459068,-44,2899,679,2900,144,1
20141229.143413,2900,166,1459234,-22,2899,695,2900,62,1
20141229.143414,2900,128,1459362,0,2900,2,2901,397,1
20141229.143414,2900,354,1459716,160,2899,693,2900,103,1
20141229.143415,2899,48,1459764,-42,2899,638,2900,166,0
20141229.143415,2899,72,1459836,-4,2899,644,2900,143,0
20141229.143416,2900,16,1459852,-14,2899,661,2900,272,1
20141229.143416,2899,30,1459882,-22,2899,622,2900,266,0
20141229.143416,2899,48,1459930,-48,2899,513,2900,267,0
20141229.143417,2900,18,1459948,-6,2899,431,2900,271,1
20141229.143417,2900,20,1459968,-20,2899,431,2900,275,1
20141229.143418,2899,24,1459992,-22,2899,425,2900,269,0
20141229.143418,2900,12,1460004,-4,2899,235,2900,286,1
20141229.143419,2899,478,1460482,238,2898,956,2899,26,0
20141229.14342,2899,86,1460568,42,2898,908,2899,126,0
20141229.14342,2899,56,1460624,-2,2898,917,2899,109,0
20141229.14342,2899,22,1460646,-4,2898,913,2899,131,0
20141229.143421,2899,158,1460804,52,2898,895,2899,70,0
20141229.143422,2899,14,1460818,4,2898,891,2899,67,0
20141229.143422,2899,232,1461050,-154,2898,921,2899,1,0
20141229.143422,2900,14,1461064,12,2899,104,2900,434,1
20141229.143423,2900,16,1461080,-6,2899,413,2900,344,1
20141229.143423,2900,4,1461084,4,2899,416,2900,321,1
20141229.143424,2899,22,1461106,-4,2899,433,2900,315,0
20141229.143424,2899,8,1461114,-4,2899,429,2900,300,0
20141229.143425,2900,24,1461138,-12,2899,425,2900,291,1
20141229.143425,2899,6,1461144,0,2899,427,2900,288,0
20141229.143426,2899,188,1461332,-2,2899,542,2900,282,0
20141229.143427,2900,32,1461364,14,2899,544,2900,259,1
20141229.143427,2899,54,1461418,46,2899,541,2900,322,0
20141229.143428,2899,22,1461440,-10,2899,535,2900,334,0
20141229.143429,2899,106,1461546,102,2899,536,2900,313,0
20141229.14343,2899,24,1461570,-20,2899,524,2900,313,0
20141229.143431,2900,36,1461606,4,2899,519,2900,311,1
20141229.143431,2899,70,1461676,-46,2899,507,2900,299,0
20141229.143432,2899,6,1461682,-6,2899,500,2900,299,0
20141229.143432,2899,28,1461710,-2,2899,490,2900,321,0
20141229.143433,2900,6,1461716,0,2899,499,2900,319,1
20141229.143433,2900,10,1461726,4,2899,502,2900,346,1
20141229.143434,2899,262,1461988,-88,2899,734,2900,199,0
20141229.143434,2899,2,1461990,0,2899,748,2900,197,0
20141229.143435,2900,560,1462550,352,2900,23,2901,409,1
20141229.143436,2900,2,1462552,0,2900,174,2901,415,1
20141229.143436,2900,6,1462558,-4,2900,172,2901,410,1
20141229.143437,2900,28,1462586,-12,2900,226,2901,411,1
20141229.143437,2900,8,1462594,0,2900,222,2901,397,1
20141229.143438,2901,244,1462838,-170,2900,257,2901,295,1
20141229.143438,2900,14,1462852,10,2900,257,2901,296,0
20141229.143439,2900,512,1463364,-130,2899,560,2900,5,0
20141229.14344,2900,2,1463366,0,2899,490,2900,151,0
20141229.14344,2899,12,1463378,0,2899,485,2900,357,0
20141229.14344,2900,26,1463404,26,2899,486,2900,344,1
20141229.143442,2899,6,1463410,4,2899,496,2900,306,0
20141229.143442,2900,10,1463420,0,2899,529,2900,317,1
20141229.143442,2900,14,1463434,10,2899,531,2900,314,1
20141229.143443,2899,50,1463484,42,2899,523,2900,314,0
20141229.143444,2899,12,1463496,0,2899,544,2900,311,0
20141229.143445,2899,4,1463500,2,2899,857,2900,363,0
20141229.143445,2900,124,1463624,110,2899,850,2900,310,1
20141229.143446,2900,656,1464280,130,2899,888,2901,368,1
20141229.143446,2900,64,1464344,20,2900,171,2901,307,1
20141229.143446,2900,10,1464354,10,2900,171,2901,318,1
20141229.143447,2900,64,1464418,50,2900,145,2901,680,1
20141229.143448,2899,276,1464694,-220,2899,548,2900,86,0
20141229.143448,2899,34,1464728,6,2899,524,2900,126,0
20141229.143449,2899,26,1464754,-4,2899,599,2900,240,0
20141229.143449,2900,26,1464780,26,2899,599,2900,235,1
20141229.14345,2899,8,1464788,0,2899,595,2900,271,0
20141229.14345,2900,32,1464820,6,2899,595,2900,255,1
20141229.143451,2900,20,1464840,0,2899,595,2900,514,1
20141229.143451,2900,12,1464852,-4,2899,606,2900,242,1
20141229.143452,2900,6,1464858,-4,2899,611,2900,240,1
20141229.143452,2900,50,1464908,-2,2899,945,2900,208,1
20141229.143453,2900,466,1465374,226,2900,340,2901,311,1
20141229.143453,2900,10,1465384,6,2900,336,2901,298,1
20141229.143454,2901,10,1465394,0,2900,294,2901,300,1
20141229.143455,2900,10,1465404,10,2900,291,2901,298,0
20141229.143456,2900,40,1465444,20,2900,299,2901,308,0
20141229.143456,2900,22,1465466,10,2900,293,2901,307,0
20141229.143456,2900,6,1465472,-6,2900,293,2901,307,0
20141229.143458,2900,186,1465658,-2,2900,202,2901,308,0
20141229.143458,2900,10,1465668,-10,2900,161,2901,420,0
20141229.143459,2900,326,1465994,-188,2899,553,2900,75,0
20141229.1435,2900,36,1466030,-32,2899,556,2900,64,0
20141229.1435,2900,4,1466034,-4,2899,556,2900,63,0
20141229.143501,2900,404,1466438,-384,2899,356,2900,94,0
20141229.143501,2900,14,1466452,0,2899,370,2900,87,0
20141229.143502,2899,86,1466538,-42,2899,352,2900,204,0
20141229.143503,2900,102,1466640,-90,2899,1090,2900,149,1
20141229.143503,2900,10,1466650,2,2899,1087,2900,110,1
20141229.143504,2900,22,1466672,0,2899,1147,2900,73,1
20141229.143504,2900,148,1466820,122,2900,152,2901,354,1
20141229.143505,2900,402,1467222,358,2899,1189,2900,151,1
20141229.143506,2899,10,1467232,-10,2899,1135,2900,151,0
20141229.143506,2900,306,1467538,-30,2900,140,2901,416,1
20141229.143507,2901,246,1467784,-2,2900,61,2901,342,1
20141229.143507,2900,6,1467790,4,2900,63,2901,346,0
20141229.143508,2900,74,1467864,50,2900,201,2901,340,0
20141229.143509,2901,20,1467884,-20,2900,269,2901,331,1
20141229.143509,2900,66,1467950,-4,2900,289,2901,332,0
20141229.14351,2900,84,1468034,0,2900,303,2901,533,0
20141229.143511,2900,80,1468114,80,2900,264,2901,428,0
20141229.143512,2901,2,1468116,-2,2900,282,2901,408,1
20141229.143512,2900,2,1468118,2,2900,301,2901,371,0
20141229.143514,2900,110,1468228,102,2900,264,2901,351,0
20141229.143514,2901,10,1468238,-4,2900,263,2901,348,1
20141229.143514,2900,2,1468240,0,2900,262,2901,348,0
20141229.143515,2900,2,1468242,0,2900,268,2901,348,0
20141229.143516,2901,6,1468248,0,2900,269,2901,346,1
20141229.143516,2900,12,1468260,-2,2900,265,2901,341,0
20141229.143518,2900,8,1468268,0,2900,284,2901,344,0
20141229.143521,2900,10,1468278,-8,2900,284,2901,346,0
20141229.143523,2901,4,1468282,-2,2900,321,2901,346,1
20141229.143524,2900,20,1468302,0,2900,311,2901,348,0
20141229.143525,2900,8,1468310,-6,2900,312,2901,347,0
20141229.143525,2900,6,1468316,-2,2900,310,2901,347,0
20141229.143526,2901,2,1468318,0,2900,304,2901,346,1
20141229.143526,2901,2,1468320,-2,2900,305,2901,345,1
20141229.143527,2901,2,1468322,0,2900,313,2901,344,1
20141229.143529,2900,6,1468328,0,2900,319,2901,342,0
20141229.14353,2900,4,1468332,0,2900,375,2901,342,0
20141229.143531,2900,26,1468358,0,2900,370,2901,342,0
20141229.143531,2900,4,1468362,4,2900,368,2901,342,0
20141229.143533,2901,4,1468366,2,2900,378,2901,352,1
20141229.143535,2901,2,1468368,-2,2900,394,2901,344,1
20141229.143537,2900,120,1468488,-24,2900,354,2901,344,0
20141229.143537,2900,6,1468494,4,2900,361,2901,343,0
20141229.143538,2901,4,1468498,-2,2900,368,2901,341,1
20141229.143538,2901,6,1468504,-6,2900,370,2901,338,1
20141229.143539,2901,4,1468508,-4,2900,370,2901,335,1
20141229.14354,2901,2,1468510,-2,2900,381,2901,344,1
20141229.143541,2901,10,1468520,6,2900,381,2901,339,1
20141229.143541,2901,2,1468522,0,2900,391,2901,338,1
20141229.143542,2901,8,1468530,0,2900,393,2901,335,1
20141229.143542,2901,2,1468532,2,2900,396,2901,340,1
20141229.143543,2901,6,1468538,2,2900,398,2901,337,1
20141229.143545,2901,8,1468546,-2,2900,398,2901,348,1
20141229.143547,2900,108,1468654,-62,2900,404,2901,302,0
20141229.143547,2901,2,1468656,0,2900,414,2901,301,1
20141229.143547,2901,4,1468660,0,2900,414,2901,299,1
20141229.143548,2901,2,1468662,0,2900,414,2901,298,1
20141229.143549,2901,352,1469014,204,2900,414,2901,123,1
20141229.143549,2901,6,1469020,-6,2900,414,2901,120,1
20141229.143549,2901,6,1469026,0,2900,448,2901,117,1
20141229.14355,2901,68,1469094,-8,2900,419,2901,115,1
20141229.143551,2901,32,1469126,-4,2900,479,2901,84,1
20141229.143551,2901,418,1469544,112,2901,19,2902,773,1
20141229.143552,2902,90,1469634,-2,2901,20,2902,629,1
20141229.143555,2901,4,1469638,0,2901,26,2902,829,0
20141229.143556,2902,4,1469642,-4,2901,44,2902,833,1
20141229.143556,2902,6,1469648,2,2901,44,2902,831,1
20141229.143557,2901,8,1469656,0,2901,44,2902,829,0
20141229.143558,2901,20,1469676,0,2901,38,2902,839,0
20141229.143559,2901,42,1469718,-6,2901,49,2902,842,0
20141229.1436,2901,4,1469722,4,2901,68,2902,737,0
20141229.1436,2901,2,1469724,2,2901,122,2902,737,0
20141229.143601,2901,2,1469726,2,2901,152,2902,737,0
20141229.143602,2902,6,1469732,6,2901,181,2902,735,1
20141229.143603,2902,2,1469734,2,2901,225,2902,734,1
20141229.143603,2902,22,1469756,2,2901,246,2902,723,1
20141229.143604,2902,4,1469760,4,2901,254,2902,721,1
20141229.143605,2902,20,1469780,12,2901,253,2902,744,1
20141229.143606,2902,18,1469798,0,2901,265,2902,745,1
20141229.143607,2902,10,1469808,4,2901,262,2902,741,1
20141229.143608,2902,12,1469820,12,2901,262,2902,735,1
20141229.14361,2902,4,1469824,4,2901,267,2902,734,1
20141229.143611,2902,2,1469826,0,2901,267,2902,786,1
20141229.143611,2902,2,1469828,0,2901,267,2902,785,1
20141229.143613,2901,4,1469832,4,2901,280,2902,785,0
20141229.143613,2902,2,1469834,2,2901,280,2902,786,1
20141229.143614,2902,4,1469838,0,2901,280,2902,784,1
20141229.143615,2901,2,1469840,-2,2901,280,2902,784,0
20141229.143616,2901,8,1469848,4,2901,281,2902,780,0
20141229.143616,2901,400,1470248,-138,2901,96,2902,761,0
20141229.143617,2901,4,1470252,0,2901,286,2902,729,0
20141229.143618,2901,400,1470652,-30,2901,101,2902,729,0
20141229.143619,2902,4,1470656,2,2901,101,2902,738,1
20141229.14362,2902,12,1470668,12,2901,100,2902,735,1
20141229.14362,2901,212,1470880,-26,2900,696,2901,80,0
20141229.143621,2901,4,1470884,0,2900,588,2901,89,0
20141229.143621,2901,162,1471046,-26,2900,519,2901,178,0
20141229.143623,2901,2,1471048,-2,2900,522,2901,389,0
20141229.143623,2901,2,1471050,-2,2900,522,2901,388,0
20141229.143624,2901,40,1471090,-40,2900,523,2901,368,0
20141229.143624,2900,400,1471490,-138,2900,323,2901,385,0
20141229.143625,2901,2,1471492,-2,2900,319,2901,401,1
20141229.143626,2900,40,1471532,18,2900,299,2901,401,0
20141229.143627,2901,12,1471544,-12,2900,296,2901,405,1
20141229.143628,2900,14,1471558,0,2900,283,2901,403,0
20141229.143628,2901,4,1471562,0,2900,284,2901,401,1
20141229.143629,2900,4,1471566,0,2900,278,2901,451,0
20141229.143629,2901,8,1471574,-8,2900,278,2901,447,1
20141229.14363,2901,2,1471576,-2,2900,298,2901,448,1
20141229.143631,2900,46,1471622,-34,2900,275,2901,448,0
20141229.143631,2901,2,1471624,-2,2900,285,2901,443,1
20141229.143632,2901,6,1471630,0,2900,287,2901,440,1
20141229.143632,2901,2,1471632,-2,2900,337,2901,439,1
20141229.143633,2901,2,1471634,-2,2900,362,2901,437,1
20141229.143635,2901,4,1471638,2,2900,361,2901,433,1
20141229.143638,2900,2,1471640,2,2900,355,2901,437,0
20141229.143639,2901,10,1471650,0,2900,363,2901,435,1
20141229.143639,2900,2,1471652,0,2900,363,2901,435,0
20141229.143641,2901,2,1471654,-2,2900,364,2901,434,1
20141229.143642,2900,24,1471678,-4,2900,368,2901,427,0
20141229.143644,2901,616,1472294,-214,2900,382,2901,218,1
20141229.143646,2900,22,1472316,0,2900,423,2901,279,0
20141229.143648,2900,20,1472336,4,2900,418,2901,281,0
20141229.143649,2900,12,1472348,2,2900,418,2901,286,0
20141229.14365,2901,60,1472408,-22,2900,418,2901,257,1
20141229.14365,2901,2,1472410,0,2900,418,2901,256,1
20141229.143651,2901,12,1472422,-2,2900,419,2901,270,1
20141229.143652,2901,8,1472430,8,2900,419,2901,266,1
20141229.143652,2901,4,1472434,4,2900,419,2901,264,1
20141229.143656,2901,40,1472474,0,2900,471,2901,306,1
20141229.143658,2901,22,1472496,20,2900,608,2901,235,1
20141229.143659,2901,62,1472558,28,2900,618,2901,210,1
20141229.143659,2901,4,1472562,0,2900,618,2901,208,1
20141229.143659,2901,38,1472600,-32,2900,615,2901,210,1
20141229.1437,2901,4,1472604,0,2900,616,2901,209,1
20141229.143701,2900,16,1472620,0,2900,616,2901,202,0
20141229.143702,2901,18,1472638,-12,2900,615,2901,195,1
20141229.143703,2900,4,1472642,2,2900,614,2901,195,0
20141229.143703,2901,2,1472644,-2,2900,617,2901,199,1
20141229.143704,2901,72,1472716,-56,2900,610,2901,170,1
20141229.143705,2900,100,1472816,-64,2900,561,2901,170,0
20141229.143705,2900,216,1473032,-190,2900,570,2901,63,0
20141229.143706,2901,6,1473038,0,2900,571,2901,50,1
20141229.143706,2901,2,1473040,0,2900,571,2901,49,1
20141229.143707,2901,22,1473062,6,2900,650,2901,39,1
20141229.143707,2901,6,1473068,0,2900,650,2901,36,1
20141229.143707,2901,2,1473070,2,2900,650,2901,35,1
20141229.143708,2901,2,1473072,0,2900,650,2901,34,1
20141229.143709,2901,70,1473142,-40,2901,35,2902,853,1
20141229.143709,2901,22,1473164,4,2901,24,2902,774,1
20141229.14371,2901,6,1473170,-4,2901,72,2902,764,1
20141229.14371,2902,10,1473180,0,2901,82,2902,759,1
20141229.143711,2901,10,1473190,0,2901,77,2902,762,0
20141229.143712,2901,2,1473192,0,2901,76,2902,761,0
20141229.143712,2901,152,1473344,-150,2900,800,2901,2,0
20141229.143713,2901,2,1473346,0,2900,689,2901,92,0
20141229.143714,2901,4,1473350,0,2900,689,2901,122,0
20141229.143715,2901,2,1473352,0,2900,689,2901,135,0
20141229.143715,2901,2,1473354,0,2900,689,2901,134,0
20141229.143715,2901,54,1473408,-10,2900,689,2901,111,0
20141229.143716,2901,36,1473444,-30,2900,690,2901,124,0
20141229.143716,2900,6,1473450,0,2900,687,2901,124,0
20141229.143717,2901,44,1473494,-2,2900,630,2901,102,1
20141229.143718,2901,2,1473496,-2,2900,635,2901,101,1
20141229.143718,2901,2,1473498,-2,2900,635,2901,90,1
20141229.143719,2901,10,1473508,0,2900,636,2901,87,1
20141229.143719,2901,10,1473518,2,2900,636,2901,82,1
20141229.14372,2901,30,1473548,-20,2900,632,2901,69,1
20141229.143721,2901,4,1473552,0,2900,632,2901,68,1
20141229.143723,2901,62,1473614,26,2900,634,2901,41,1
20141229.143724,2901,4,1473618,2,2900,634,2901,340,1
20141229.143724,2901,2,1473620,0,2900,634,2901,356,1
20141229.143725,2901,4,1473624,0,2900,684,2901,448,1
20141229.143727,2901,6,1473630,0,2900,697,2901,473,1
20141229.143728,2901,2,1473632,0,2900,697,2901,472,1
20141229.143732,2901,6,1473638,0,2900,783,2901,470,1
20141229.143732,2901,4,1473642,4,2900,784,2901,472,1
20141229.143733,2901,8,1473650,0,2900,785,2901,478,1
20141229.143734,2901,4,1473654,4,2900,775,2901,477,1
20141229.143735,2901,42,1473696,-4,2900,789,2901,456,1
20141229.143736,2901,6,1473702,0,2900,789,2901,463,1
20141229.143737,2901,4,1473706,4,2900,790,2901,462,1
20141229.143738,2901,6,1473712,4,2900,789,2901,368,1
20141229.143739,2901,4,1473716,2,2900,789,2901,366,1
20141229.14374,2901,80,1473796,0,2900,805,2901,342,1
20141229.14374,2900,40,1473836,0,2900,786,2901,342,0
20141229.143741,2900,2,1473838,-2,2900,784,2901,342,0
20141229.143741,2901,4,1473842,4,2900,784,2901,340,1
20141229.143742,2900,20,1473862,-20,2900,812,2901,340,0
20141229.143744,2901,2,1473864,2,2900,845,2901,349,1
20141229.143745,2900,14,1473878,-12,2900,837,2901,349,0
20141229.143746,2900,4,1473882,2,2900,850,2901,349,0
20141229.143747,2901,6,1473888,4,2900,869,2901,346,1
20141229.143747,2900,20,1473908,10,2900,884,2901,356,0
20141229.143749,2900,2,1473910,0,2900,906,2901,367,0
20141229.14375,2900,20,1473930,8,2900,896,2901,368,0
20141229.143751,2900,2,1473932,-2,2900,900,2901,368,0
20141229.143753,2901,4,1473936,2,2900,927,2901,366,1
20141229.143755,2901,2,1473938,2,2900,953,2901,366,1
20141229.143756,2900,6,1473944,-6,2900,975,2901,366,0
20141229.143758,2901,2,1473946,2,2900,979,2901,365,1
20141229.143802,2901,2,1473948,2,2900,1036,2901,383,1
20141229.143803,2900,2,1473950,0,2900,1075,2901,393,0
20141229.143805,2901,2,1473952,2,2900,1131,2901,393,1
20141229.143805,2901,200,1474152,0,2900,1131,2901,293,1
20141229.143807,2901,6,1474158,2,2900,1130,2901,331,1
20141229.143808,2901,2,1474160,0,2900,1130,2901,330,1
20141229.143808,2901,96,1474256,36,2900,1131,2901,282,1
20141229.143808,2901,2,1474258,0,2900,1131,2901,281,1
20141229.143809,2901,4,1474262,4,2900,1131,2901,578,1
20141229.14381,2901,2,1474264,2,2900,1131,2901,579,1
20141229.14381,2901,4,1474268,4,2900,1131,2901,577,1
20141229.143811,2901,6,1474274,0,2900,1135,2901,579,1
20141229.143812,2901,26,1474300,22,2900,1137,2901,556,1
20141229.143814,2901,2,1474302,0,2900,1119,2901,555,1
20141229.143815,2900,28,1474330,-20,2900,1113,2901,552,0
20141229.143816,2901,8,1474338,8,2900,1103,2901,559,1
20141229.143816,2901,4,1474342,4,2900,1103,2901,557,1
20141229.143817,2901,100,1474442,0,2900,1143,2901,507,1
20141229.143819,2900,2,1474444,0,2900,1172,2901,508,0
20141229.143819,2901,2,1474446,0,2900,1172,2901,507,1
20141229.14382,2901,10,1474456,10,2900,1181,2901,502,1
20141229.143823,2901,8,1474464,6,2900,1182,2901,500,1
20141229.143825,2901,2,1474466,2,2900,1187,2901,499,1
20141229.143826,2901,4,1474470,4,2900,1187,2901,497,1
20141229.143826,2901,6,1474476,6,2900,1207,2901,494,1
20141229.143827,2901,10,1474486,10,2900,1211,2901,479,1
20141229.14383,2901,300,1474786,108,2900,1219,2901,332,1
20141229.143831,2901,6,1474792,6,2900,1219,2901,329,1
20141229.143831,2901,174,1474966,172,2900,1231,2901,243,1
20141229.143832,2901,46,1475012,40,2900,1235,2901,220,1
20141229.143833,2901,84,1475096,-16,2900,1185,2901,218,1
20141229.143833,2901,10,1475106,10,2900,1185,2901,213,1
20141229.143834,2901,2,1475108,2,2900,1182,2901,212,1
20141229.143834,2901,10,1475118,10,2900,1183,2901,208,1
20141229.143835,2901,2,1475120,2,2900,1183,2901,207,1
20141229.143837,2901,2,1475122,0,2900,1220,2901,207,1
20141229.143837,2901,8,1475130,2,2900,1220,2901,203,1
20141229.143838,2901,12,1475142,0,2900,1293,2901,200,1
20141229.143839,2901,2,1475144,0,2900,1293,2901,199,1
20141229.143839,2901,10,1475154,10,2900,1293,2901,194,1
20141229.14384,2901,2,1475156,0,2900,1292,2901,193,1
20141229.14384,2901,94,1475250,14,2900,1285,2901,146,1
20141229.143841,2901,8,1475258,4,2900,1285,2901,142,1
20141229.143841,2901,6,1475264,0,2900,1296,2901,144,1
20141229.143842,2900,2,1475266,0,2900,1296,2901,144,0
20141229.143842,2901,2,1475268,2,2900,1296,2901,144,1
20141229.143843,2901,8,1475276,0,2900,1346,2901,141,1
20141229.143844,2901,8,1475284,8,2900,1296,2901,137,1
20141229.143845,2901,50,1475334,40,2900,1296,2901,112,1
20141229.143845,2901,58,1475392,0,2900,1296,2901,83,1
20141229.143846,2901,4,1475396,2,2900,1297,2901,81,1
20141229.143847,2901,2,1475398,2,2900,1296,2901,80,1
20141229.143848,2901,4,1475402,4,2900,1287,2901,163,1
20141229.143849,2901,64,1475466,4,2900,1286,2901,132,1
20141229.14385,2901,40,1475506,36,2900,1288,2901,130,1
20141229.143851,2900,12,1475518,-6,2900,1286,2901,158,0
20141229.143852,2901,10,1475528,6,2900,1286,2901,153,1
20141229.143852,2901,10,1475538,2,2900,1286,2901,148,1
20141229.143853,2900,2,1475540,-2,2900,1286,2901,158,0
20141229.143853,2901,12,1475552,6,2900,1298,2901,153,1
20141229.143854,2901,22,1475574,2,2900,1300,2901,142,1
20141229.143855,2901,16,1475590,0,2900,1310,2901,134,1
20141229.143856,2901,2,1475592,0,2900,1309,2901,133,1
20141229.143857,2901,8,1475600,-8,2900,1300,2901,131,1
20141229.143858,2900,52,1475652,-48,2900,1310,2901,106,0
20141229.143859,2901,2,1475654,0,2900,1311,2901,105,1
20141229.143859,2901,42,1475696,0,2900,1311,2901,85,1
20141229.1439,2901,10,1475706,0,2900,1313,2901,80,1
20141229.143901,2900,12,1475718,0,2900,1308,2901,80,0
20141229.143901,2901,4,1475722,-4,2900,1309,2901,78,1
20141229.143902,2901,4,1475726,0,2900,1314,2901,76,1
20141229.143903,2901,152,1475878,-32,2901,197,2902,792,1
20141229.143903,2901,496,1476374,-152,2900,1424,2901,2,1
20141229.143904,2901,28,1476402,10,2900,1319,2901,50,1
20141229.143904,2900,6,1476408,0,2900,1316,2901,50,0
20141229.143907,2901,46,1476454,-12,2900,1286,2901,98,1
20141229.143909,2900,20,1476474,-14,2900,1274,2901,98,0
20141229.14391,2901,12,1476486,-10,2900,1283,2901,95,1
20141229.14391,2900,10,1476496,-8,2900,1286,2901,95,0
20141229.143911,2901,40,1476536,-40,2900,1297,2901,75,1
20141229.143912,2901,4,1476540,-4,2900,1295,2901,73,1
20141229.143913,2901,20,1476560,-20,2900,1288,2901,63,1
20141229.143914,2900,6,1476566,-6,2900,1285,2901,63,0
20141229.143915,2900,16,1476582,-16,2900,1287,2901,63,0
20141229.143917,2901,6,1476588,-6,2900,1296,2901,100,1
20141229.14392,2900,4,1476592,-4,2900,1291,2901,105,0
20141229.143921,2901,2,1476594,-2,2900,1287,2901,106,1
20141229.143922,2901,14,1476608,4,2900,1281,2901,105,1
20141229.143923,2901,2,1476610,2,2900,1290,2901,115,1
20141229.143924,2900,2,1476612,0,2900,1290,2901,135,0
20141229.143925,2901,126,1476738,-92,2900,1231,2901,133,1
20141229.143927,2901,2,1476740,0,2900,1205,2901,132,1
20141229.143929,2901,4,1476744,0,2900,1236,2901,134,1
20141229.14393,2900,2,1476746,-2,2900,1234,2901,134,0
20141229.14393,2901,20,1476766,0,2900,1234,2901,124,1
20141229.143931,2900,4,1476770,-2,2900,1233,2901,123,0
20141229.143933,2901,10,1476780,0,2900,1233,2901,119,1
20141229.143934,2900,4,1476784,0,2900,1235,2901,118,0
20141229.143935,2901,2,1476786,2,2900,1235,2901,117,1
20141229.143936,2900,2,1476788,-2,2900,1166,2901,433,0
20141229.143937,2901,2,1476790,0,2900,1101,2901,510,1
20141229.143938,2901,40,1476830,40,2900,1101,2901,496,1
20141229.143939,2900,1264,1478094,-294,2900,65,2901,621,0
20141229.143939,2900,130,1478224,-100,2899,662,2900,92,0
20141229.14394,2900,2,1478226,0,2899,658,2900,93,0
20141229.14394,2900,104,1478330,-2,2899,658,2900,70,0
20141229.143941,2900,2,1478332,0,2899,640,2900,112,0
20141229.143942,2899,70,1478402,24,2899,625,2900,109,0
20141229.143942,2900,42,1478444,-2,2899,655,2900,88,1
20141229.143943,2899,20,1478464,-14,2899,647,2900,143,0
20141229.143943,2900,100,1478564,36,2899,647,2900,94,1
20141229.143945,2900,2,1478566,0,2899,647,2900,96,1
20141229.143945,2900,20,1478586,0,2899,647,2900,86,1
20141229.143946,2899,400,1478986,-124,2899,443,2900,86,0
20141229.143946,2899,400,1479386,-22,2899,234,2900,86,0
20141229.143947,2899,410,1479796,-136,2898,1002,2900,128,0
20141229.143947,2899,14,1479810,-10,2898,1209,2899,2,0
20141229.143948,2899,46,1479856,-16,2898,1213,2899,10,0
20141229.14395,2899,24,1479880,18,2898,1178,2899,9,0
20141229.14395,2899,38,1479918,-14,2899,178,2900,524,0
20141229.143951,2899,12,1479930,0,2899,224,2900,425,0
20141229.143951,2899,10,1479940,-8,2899,275,2900,442,0
20141229.143952,2899,26,1479966,-6,2899,266,2900,415,0
20141229.143954,2899,540,1480506,-422,2898,1173,2899,152,0
20141229.143955,2899,26,1480532,0,2898,1169,2899,140,0
20141229.143956,2898,404,1480936,-88,2898,960,2899,140,0
20141229.143956,2899,126,1481062,-66,2898,858,2899,155,1
20141229.143957,2898,58,1481120,-36,2898,831,2899,520,0
20141229.143957,2899,14,1481134,-2,2898,791,2899,593,1
20141229.143958,2898,6,1481140,-2,2898,751,2899,592,0
20141229.143959,2899,2,1481142,-2,2898,728,2899,591,1
20141229.144,2899,62,1481204,-42,2898,713,2899,592,1
20141229.144001,2899,2,1481206,0,2898,715,2899,591,1
20141229.144002,2899,52,1481258,-12,2898,703,2899,571,1
20141229.144003,2899,6,1481264,-4,2898,708,2899,579,1
20141229.144003,2899,10,1481274,-10,2898,705,2899,580,1
20141229.144004,2898,1416,1482690,560,2897,964,2898,293,0
20141229.144004,2897,204,1482894,-120,2897,772,2898,516,0
20141229.144005,2898,126,1483020,-52,2897,726,2898,515,1
20141229.144005,2898,148,1483168,6,2897,667,2898,495,1
20141229.144006,2897,46,1483214,2,2897,644,2898,789,0
20141229.144006,2897,1254,1484468,-382,2896,1031,2898,859,0
20141229.144007,2896,468,1484936,-162,2896,1025,2897,263,0
20141229.144007,2897,2626,1487562,-650,2896,36,2897,97,1
20141229.144008,2896,198,1487760,-174,2895,2476,2896,287,0
20141229.144008,2896,620,1488380,-260,2895,1880,2896,594,0
20141229.144009,2896,42,1488422,2,2895,1677,2896,608,0
20141229.144009,2895,18,1488440,-4,2895,1665,2896,611,0
20141229.14401,2895,2316,1490756,-1392,2895,509,2896,608,0
20141229.14401,2895,138,1490894,-104,2895,481,2896,594,0
20141229.144011,2895,308,1491202,-294,2895,331,2896,590,0
20141229.144011,2895,834,1492036,148,2894,876,2895,829,0
20141229.144012,2895,1026,1493062,672,2894,834,2895,349,0
20141229.144012,2895,744,1493806,-196,2895,58,2896,237,0
20141229.144013,2896,16,1493822,-2,2895,221,2896,622,1
20141229.144013,2896,32,1493854,-4,2895,446,2896,609,1
20141229.144014,2895,16,1493870,-6,2895,460,2896,605,0
20141229.144015,2896,46,1493916,-40,2895,526,2896,584,1
20141229.144015,2895,2,1493918,0,2895,555,2896,586,0
20141229.144015,2896,114,1494032,-64,2895,519,2896,535,1
20141229.144016,2896,230,1494262,-166,2895,534,2896,425,1
20141229.144017,2895,24,1494286,-22,2895,541,2896,439,0
20141229.144018,2896,14,1494300,-12,2895,582,2896,458,1
20141229.144018,2896,4,1494304,0,2895,581,2896,458,1
20141229.144019,2896,78,1494382,-64,2895,573,2896,443,1
20141229.144019,2896,4,1494386,-4,2895,582,2896,441,1
20141229.14402,2895,162,1494548,-162,2895,510,2896,441,0
20141229.14402,2895,4,1494552,0,2895,508,2896,441,0
20141229.14402,2895,6,1494558,-2,2895,515,2896,441,0
20141229.144021,2896,94,1494652,-18,2895,477,2896,431,1
20141229.144022,2895,116,1494768,-46,2895,416,2896,426,0
20141229.144022,2895,34,1494802,6,2895,457,2896,452,0
20141229.144023,2895,2,1494804,0,2895,457,2896,460,0
20141229.144023,2895,2,1494806,2,2895,487,2896,460,0
20141229.144024,2896,64,1494870,10,2895,469,2896,449,1
20141229.144024,2895,8,1494878,-2,2895,481,2896,445,0
20141229.144025,2895,18,1494896,2,2895,480,2896,439,0
20141229.144025,2895,90,1494986,32,2895,439,2896,436,0
20141229.144026,2896,112,1495098,-24,2895,439,2896,382,1
20141229.144026,2896,34,1495132,0,2895,442,2896,366,1
20141229.144027,2895,588,1495720,-50,2895,237,2896,269,0
20141229.144027,2896,256,1495976,-238,2895,235,2896,144,1
20141229.144028,2895,12,1495988,6,2895,265,2896,146,0
20141229.144028,2896,40,1496028,-30,2895,267,2896,144,1
20141229.144029,2896,2,1496030,-2,2895,354,2896,336,1
20141229.144029,2896,20,1496050,2,2895,323,2896,392,1
20141229.14403,2895,26,1496076,-2,2895,350,2896,416,0
20141229.14403,2896,6,1496082,-2,2895,351,2896,423,1
20141229.144031,2896,22,1496104,-6,2895,352,2896,417,1
20141229.144031,2895,16,1496120,-6,2895,350,2896,412,0
20141229.144032,2896,260,1496380,132,2895,256,2896,385,1
20141229.144032,2895,42,1496422,-10,2895,245,2896,404,0
20141229.144033,2895,22,1496444,2,2895,243,2896,414,0
20141229.144034,2896,28,1496472,-12,2895,160,2896,407,1
20141229.144035,2896,142,1496614,-58,2895,101,2896,342,1
20141229.144035,2896,26,1496640,-12,2895,109,2896,342,1
20141229.144036,2895,62,1496702,-4,2895,84,2896,359,0
20141229.144036,2895,206,1496908,168,2895,118,2896,356,0
20141229.144037,2895,34,1496942,2,2895,164,2896,351,0
20141229.144037,2896,2,1496944,-2,2895,200,2896,351,1
20141229.144038,2896,62,1497006,32,2895,190,2896,344,1
20141229.144038,2896,210,1497216,-38,2895,218,2896,333,1
20141229.144039,2895,10,1497226,4,2895,216,2896,333,0
20141229.14404,2896,8,1497234,0,2895,237,2896,336,1
20141229.14404,2896,2,1497236,-2,2895,247,2896,336,1
20141229.14404,2895,2,1497238,0,2895,247,2896,336,0
20141229.144041,2895,44,1497282,-30,2895,267,2896,320,0
20141229.144041,2895,28,1497310,-26,2895,264,2896,310,0
20141229.144042,2896,4,1497314,0,2895,267,2896,309,1
20141229.144042,2896,6,1497320,-4,2895,283,2896,306,1
20141229.144043,2895,24,1497344,0,2895,290,2896,294,0
20141229.144045,2895,14,1497358,0,2895,382,2896,295,0
20141229.144045,2896,22,1497380,-2,2895,382,2896,292,1
20141229.144046,2896,14,1497394,-2,2895,476,2896,346,1
20141229.144046,2895,16,1497410,-4,2895,489,2896,346,0
20141229.144047,2895,508,1497918,-102,2895,269,2896,352,0
20141229.144047,2895,60,1497978,44,2895,232,2896,388,0
20141229.144048,2895,68,1498046,-10,2895,225,2896,363,0
20141229.144049,2895,20,1498066,2,2895,574,2896,360,0
20141229.14405,2896,24,1498090,-8,2895,619,2896,358,1
20141229.144051,2896,20,1498110,0,2895,660,2896,348,1
20141229.144051,2896,2,1498112,-2,2895,660,2896,347,1
20141229.144052,2896,2,1498114,0,2895,661,2896,348,1
20141229.144052,2896,18,1498132,-4,2895,662,2896,339,1
20141229.144053,2896,4,1498136,-2,2895,665,2896,337,1
20141229.144053,2896,2,1498138,0,2895,675,2896,346,1
20141229.144053,2896,2,1498140,0,2895,676,2896,345,1
20141229.144055,2896,20,1498160,0,2895,685,2896,325,1
20141229.144055,2896,12,1498172,2,2895,685,2896,326,1
20141229.144056,2896,4,1498176,-2,2895,685,2896,334,1
20141229.144056,2896,1012,1499188,314,2895,191,2896,330,1
20141229.144057,2895,8,1499196,0,2895,182,2896,329,0
20141229.144057,2895,12,1499208,-10,2895,177,2896,328,0
20141229.144058,2896,28,1499236,-2,2895,174,2896,328,1
20141229.144058,2895,348,1499584,208,2894,904,2895,829,0
20141229.144059,2895,114,1499698,8,2894,859,2895,786,0
20141229.144059,2895,12,1499710,8,2894,826,2895,780,0
20141229.1441,2895,10,1499720,6,2894,799,2895,781,0
20141229.1441,2894,10,1499730,8,2894,798,2895,809,0
20141229.144101,2895,276,1500006,-44,2894,672,2895,806,1
20141229.144101,2894,32,1500038,14,2894,650,2895,992,0
20141229.144102,2895,52,1500090,46,2894,700,2895,978,1
20141229.144102,2895,14,1500104,10,2894,699,2895,974,1
20141229.144103,2894,604,1500708,-302,2894,401,2895,975,0
20141229.144103,2894,4,1500712,-4,2894,399,2895,976,0
20141229.144104,2894,56,1500768,-52,2894,373,2895,971,0
20141229.144104,2894,142,1500910,-10,2894,352,2895,941,0
20141229.144105,2894,314,1501224,4,2894,347,2895,837,0
20141229.144105,2894,6,1501230,4,2894,355,2895,817,0
20141229.144106,2894,20,1501250,6,2894,358,2895,836,0
20141229.144106,2894,34,1501284,12,2894,508,2895,835,0
20141229.144107,2895,28,1501312,22,2894,512,2895,818,1
20141229.144107,2894,28,1501340,24,2894,546,2895,791,0
20141229.144108,2895,2,1501342,2,2894,667,2895,780,1
20141229.144109,2895,8,1501350,8,2894,660,2895,791,1
20141229.144109,2894,16,1501366,12,2894,656,2895,790,0
20141229.14411,2894,4,1501370,-2,2894,656,2895,789,0
20141229.144111,2894,16,1501386,-14,2894,668,2895,790,0
20141229.144111,2895,404,1501790,-172,2894,470,2895,790,1
20141229.144112,2895,8,1501798,-2,2894,487,2895,799,1
20141229.144112,2894,4,1501802,0,2894,491,2895,819,0
20141229.144113,2894,6,1501808,2,2894,491,2895,819,0
20141229.144114,2894,2,1501810,2,2894,591,2895,820,0
20141229.144115,2894,2,1501812,0,2894,512,2895,809,0
20141229.144115,2894,12,1501824,12,2894,509,2895,810,0
20141229.144116,2895,12,1501836,4,2894,525,2895,808,1
20141229.144116,2894,10,1501846,8,2894,545,2895,808,0
20141229.144117,2895,218,1502064,18,2894,550,2895,700,1
20141229.144117,2894,56,1502120,22,2894,542,2895,691,0
20141229.144118,2895,14,1502134,0,2894,537,2895,690,1
20141229.144118,2895,12,1502146,4,2894,553,2895,788,1
20141229.144119,2895,12,1502158,10,2894,552,2895,788,1
20141229.144119,2895,4,1502162,4,2894,552,2895,786,1
20141229.14412,2895,4,1502166,2,2894,561,2895,785,1
20141229.14412,2895,10,1502176,2,2894,560,2895,779,1
20141229.144121,2895,2,1502178,2,2894,662,2895,778,1
20141229.144121,2895,36,1502214,2,2894,673,2895,754,1
20141229.144122,2895,42,1502256,0,2894,679,2895,743,1
20141229.144123,2895,46,1502302,14,2894,729,2895,725,1
20141229.144123,2894,36,1502338,18,2894,735,2895,712,0
20141229.144124,2895,54,1502392,14,2894,725,2895,700,1
20141229.144124,2895,64,1502456,62,2894,728,2895,665,1
20141229.144125,2894,6,1502462,4,2894,749,2895,668,0
20141229.144125,2895,6,1502468,2,2894,770,2895,666,1
20141229.144126,2895,96,1502564,64,2894,814,2895,624,1
20141229.144126,2895,10,1502574,6,2894,815,2895,619,1
20141229.144127,2895,84,1502658,66,2894,802,2895,593,1
20141229.144127,2895,22,1502680,22,2894,802,2895,582,1
20141229.144128,2895,4,1502684,2,2894,800,2895,581,1
20141229.144128,2895,12,1502696,2,2894,806,2895,579,1
20141229.144129,2895,32,1502728,4,2894,807,2895,567,1
20141229.14413,2894,20,1502748,4,2894,815,2895,576,0
20141229.14413,2894,16,1502764,4,2894,749,2895,578,0
20141229.144131,2895,24,1502788,10,2894,771,2895,581,1
20141229.144132,2894,12,1502800,10,2894,777,2895,595,0
20141229.144133,2894,4,1502804,4,2894,777,2895,594,0
20141229.144134,2895,2,1502806,2,2894,778,2895,603,1
20141229.144135,2895,100,1502906,100,2894,778,2895,554,1
20141229.144135,2895,50,1502956,2,2894,773,2895,530,1
20141229.144136,2895,6,1502962,4,2894,810,2895,527,1
20141229.144136,2895,4,1502966,4,2894,820,2895,525,1
20141229.144137,2895,1050,1504016,-136,2895,60,2896,472,1
20141229.144137,2896,56,1504072,0,2895,64,2896,428,1
20141229.144138,2896,166,1504238,-108,2895,289,2896,364,1
20141229.144138,2895,58,1504296,52,2895,343,2896,396,0
20141229.144139,2895,6,1504302,4,2895,357,2896,395,0
20141229.144139,2896,48,1504350,-34,2895,361,2896,373,1
20141229.14414,2896,14,1504364,-12,2895,408,2896,365,1
20141229.14414,2895,4,1504368,-2,2895,410,2896,365,0
20141229.144141,2895,2,1504370,0,2895,433,2896,365,0
20141229.144141,2895,8,1504378,0,2895,435,2896,365,0
20141229.144142,2896,2,1504380,2,2895,617,2896,364,1
20141229.144143,2896,8,1504388,2,2895,620,2896,361,1
20141229.144143,2896,6,1504394,0,2895,626,2896,311,1
20141229.144144,2896,4,1504398,0,2895,694,2896,310,1
20141229.144144,2895,6,1504404,-2,2895,695,2896,309,0
20141229.144146,2895,44,1504448,-4,2895,712,2896,295,0
20141229.144146,2895,6,1504454,2,2895,745,2896,305,0
20141229.144148,2896,12,1504466,0,2895,747,2896,299,1
20141229.144148,2896,98,1504564,46,2895,749,2896,252,1
20141229.144149,2896,2,1504566,2,2895,753,2896,251,1
20141229.144149,2896,4,1504570,2,2895,761,2896,251,1
20141229.14415,2896,76,1504646,62,2895,749,2896,215,1
20141229.14415,2896,98,1504744,-14,2895,750,2896,159,1
20141229.14415,2896,160,1504904,22,2895,748,2896,79,1
20141229.144151,2896,348,1505252,-254,2895,1022,2896,60,1
20141229.144152,2896,126,1505378,4,2896,148,2897,541,1
20141229.144152,2897,14,1505392,0,2896,152,2897,503,1
20141229.144153,2897,4,1505396,-2,2896,169,2897,523,1
20141229.144153,2896,6,1505402,-2,2896,170,2897,509,0
20141229.144154,2897,4,1505406,0,2896,174,2897,508,1
20141229.144154,2897,14,1505420,-6,2896,191,2897,505,1
20141229.144155,2896,8,1505428,0,2896,189,2897,416,0
20141229.144155,2897,8,1505436,0,2896,211,2897,412,1
20141229.144156,2896,4,1505440,4,2896,206,2897,413,0
20141229.144156,2897,54,1505494,-12,2896,245,2897,386,1
20141229.144157,2896,2,1505496,0,2896,245,2897,396,0
20141229.144157,2896,490,1505986,366,2895,1219,2896,757,0
20141229.144158,2896,14,1506000,14,2895,1044,2896,853,0
20141229.144158,2896,10,1506010,8,2895,1044,2896,849,0
20141229.144159,2896,2,1506012,0,2895,1043,2896,849,0
20141229.144159,2896,194,1506206,82,2895,1047,2896,752,0
20141229.1442,2896,16,1506222,8,2895,1044,2896,754,0
20141229.1442,2896,10,1506232,10,2895,1041,2896,750,0
20141229.144201,2895,10,1506242,0,2895,1042,2896,752,0
20141229.144202,2896,6,1506248,2,2895,1011,2896,774,1
20141229.144202,2897,1556,1507804,258,2896,146,2897,460,1
20141229.144203,2897,2,1507806,0,2896,220,2897,403,1
20141229.144203,2896,10,1507816,0,2896,236,2897,403,0
20141229.144204,2896,4,1507820,4,2896,240,2897,400,0
20141229.144204,2896,2,1507822,2,2896,238,2897,400,0
20141229.144206,2897,36,1507858,0,2896,283,2897,387,1
20141229.144206,2897,12,1507870,8,2896,277,2897,388,1
20141229.144207,2896,10,1507880,0,2896,292,2897,389,0
20141229.144207,2897,116,1507996,42,2896,304,2897,331,1
20141229.144208,2897,12,1508008,0,2896,316,2897,325,1
20141229.144209,2897,8,1508016,-4,2896,324,2897,325,1
20141229.144209,2896,58,1508074,-8,2896,304,2897,318,0
20141229.14421,2897,2,1508076,-2,2896,309,2897,332,1
20141229.144213,2897,236,1508312,4,2896,359,2897,219,1
20141229.144213,2896,10,1508322,4,2896,359,2897,215,0
20141229.144214,2897,2,1508324,-2,2896,372,2897,268,1
20141229.144215,2897,104,1508428,60,2896,374,2897,216,1
20141229.144215,2897,12,1508440,-12,2896,373,2897,310,1
20141229.144216,2896,94,1508534,20,2896,379,2897,265,0
20141229.144217,2897,2,1508536,2,2896,380,2897,297,1
20141229.144218,2896,36,1508572,0,2896,362,2897,323,0
20141229.144218,2897,70,1508642,14,2896,367,2897,296,1
20141229.144219,2897,138,1508780,-56,2896,359,2897,231,1
20141229.14422,2896,88,1508868,56,2896,338,2897,236,0
20141229.14422,2897,2,1508870,0,2896,338,2897,235,1
20141229.144221,2897,2,1508872,-2,2896,338,2897,234,1
20141229.144221,2897,14,1508886,-2,2896,297,2897,231,1
20141229.144222,2896,56,1508942,0,2896,278,2897,241,0
20141229.144223,2897,6,1508948,0,2896,286,2897,241,1
20141229.144223,2897,18,1508966,6,2896,280,2897,405,1
20141229.144224,2896,24,1508990,8,2896,276,2897,409,0
20141229.144224,2897,16,1509006,8,2896,262,2897,415,1
20141229.144225,2897,52,1509058,44,2896,259,2897,416,1
20141229.144225,2897,6,1509064,0,2896,280,2897,421,1
20141229.144226,2896,22,1509086,0,2896,270,2897,410,0
20141229.144226,2897,132,1509218,6,2896,262,2897,357,1
20141229.144227,2897,2,1509220,2,2896,319,2897,364,1
20141229.144228,2897,2,1509222,0,2896,319,2897,363,1
20141229.144228,2896,2,1509224,-2,2896,328,2897,384,0
20141229.144229,2896,10,1509234,-6,2896,323,2897,383,0
20141229.144229,2896,4,1509238,4,2896,326,2897,392,0
20141229.14423,2896,46,1509284,0,2896,308,2897,359,0
20141229.14423,2897,72,1509356,60,2896,311,2897,333,1
20141229.144231,2896,6,1509362,0,2896,308,2897,333,0
20141229.144231,2897,54,1509416,40,2896,341,2897,307,1
20141229.144232,2897,2,1509418,2,2896,339,2897,306,1
20141229.144233,2897,4,1509422,4,2896,364,2897,309,1
20141229.144233,2897,2,1509424,2,2896,364,2897,308,1
20141229.144234,2897,634,1510058,-460,2897,187,2898,378,1
20141229.144234,2898,164,1510222,-20,2897,254,2898,292,1
20141229.144235,2898,36,1510258,-36,2897,439,2898,227,1
20141229.144236,2898,98,1510356,58,2897,439,2898,180,1
20141229.144237,2898,14,1510370,2,2897,437,2898,333,1
20141229.144237,2898,10,1510380,10,2897,642,2898,328,1
20141229.144238,2898,16,1510396,0,2897,603,2898,524,1
20141229.144238,2897,4,1510400,-4,2897,599,2898,525,0
20141229.144239,2898,2,1510402,2,2897,599,2898,524,1
20141229.144239,2898,12,1510414,12,2897,607,2898,520,1
20141229.14424,2898,6,1510420,2,2897,607,2898,516,1
20141229.144241,2898,2,1510422,0,2897,611,2898,536,1
20141229.144242,2898,40,1510462,20,2897,592,2898,571,1
20141229.144242,2898,2,1510464,2,2897,604,2898,695,1
20141229.144243,2898,88,1510552,10,2897,601,2898,674,1
20141229.144243,2898,2,1510554,0,2897,551,2898,688,1
20141229.144244,2897,104,1510658,38,2897,530,2898,638,0
20141229.144245,2897,2,1510660,-2,2897,512,2898,639,0
20141229.144245,2897,42,1510702,6,2897,511,2898,618,0
20141229.144246,2898,30,1510732,-2,2897,312,2898,614,1
20141229.144247,2897,2,1510734,-2,2897,311,2898,664,0
20141229.144247,2898,12,1510746,2,2897,317,2898,681,1
20141229.144248,2897,22,1510768,-12,2897,311,2898,724,0
20141229.144249,2897,2,1510770,-2,2897,311,2898,733,0
20141229.144249,2898,2,1510772,2,2897,312,2898,737,1
20141229.14425,2897,2,1510774,0,2897,312,2898,737,0
20141229.14425,2897,4,1510778,-4,2897,310,2898,739,0
20141229.144251,2898,12,1510790,0,2897,312,2898,733,1
20141229.144252,2898,2,1510792,2,2897,329,2898,733,1
20141229.144252,2898,2,1510794,0,2897,329,2898,732,1
20141229.144253,2898,12,1510806,4,2897,329,2898,732,1
20141229.144253,2897,4,1510810,-4,2897,358,2898,733,0
20141229.144255,2898,24,1510834,0,2897,352,2898,732,1
20141229.144255,2898,400,1511234,-400,2897,352,2898,532,1
20141229.144256,2897,24,1511258,-2,2897,351,2898,521,0
20141229.144256,2897,2,1511260,-2,2897,350,2898,526,0
20141229.144257,2898,410,1511670,34,2897,350,2898,342,1
20141229.144258,2897,16,1511686,0,2897,345,2898,339,0
20141229.144258,2897,2,1511688,0,2897,344,2898,339,0
20141229.144259,2898,252,1511940,-248,2897,220,2898,339,1
20141229.144259,2897,22,1511962,-16,2897,219,2898,333,0
20141229.1443,2898,4,1511966,-4,2897,219,2898,331,1
20141229.1443,2898,10,1511976,0,2897,220,2898,326,1
20141229.144301,2898,2,1511978,-2,2897,224,2898,325,1
20141229.144302,2897,20,1511998,0,2897,214,2898,325,0
20141229.144302,2898,6,1512004,-4,2897,215,2898,328,1
20141229.144303,2898,2,1512006,2,2897,215,2898,327,1
20141229.144304,2898,2,1512008,0,2897,231,2898,333,1
20141229.144305,2898,2,1512010,0,2897,237,2898,332,1
20141229.144305,2898,10,1512020,-10,2897,248,2898,340,1
20141229.144306,2898,2,1512022,-2,2897,248,2898,339,1
20141229.144307,2898,46,1512068,-6,2897,248,2898,322,1
20141229.144307,2897,10,1512078,0,2897,244,2898,321,0
20141229.144308,2898,70,1512148,-4,2897,242,2898,291,1
20141229.14431,2897,8,1512156,-4,2897,243,2898,289,0
20141229.144312,2897,2,1512158,0,2897,246,2898,295,0
20141229.144312,2898,10,1512168,0,2897,255,2898,290,1
20141229.144314,2898,2,1512170,0,2897,267,2898,290,1
20141229.144314,2898,4,1512174,0,2897,267,2898,289,1
20141229.144316,2898,60,1512234,-50,2897,243,2898,286,1
20141229.144316,2897,4,1512238,0,2897,247,2898,387,0
20141229.144318,2898,2,1512240,0,2897,255,2898,386,1
20141229.144318,2898,8,1512248,0,2897,254,2898,387,1
20141229.14432,2898,2,1512250,-2,2897,252,2898,392,1
20141229.144321,2898,10,1512260,-10,2897,252,2898,387,1
20141229.144321,2897,2,1512262,-2,2897,251,2898,388,0
20141229.144322,2897,4,1512266,-2,2897,270,2898,386,0
20141229.144323,2898,50,1512316,0,2897,269,2898,362,1
20141229.144327,2897,20,1512336,6,2897,260,2898,364,0
20141229.144328,2898,40,1512376,0,2897,352,2898,341,1
20141229.144328,2897,2,1512378,-2,2897,261,2898,341,0
20141229.144328,2898,2,1512380,0,2897,261,2898,336,1
20141229.144329,2898,8,1512388,-8,2897,262,2898,332,1
20141229.14433,2898,8,1512396,0,2897,261,2898,330,1
20141229.144331,2898,6,1512402,0,2897,278,2898,327,1
20141229.144332,2898,20,1512422,0,2897,386,2898,318,1
20141229.144332,2897,16,1512438,0,2897,379,2898,319,0
20141229.144333,2898,4,1512442,-4,2897,454,2898,317,1
20141229.144334,2898,82,1512524,-64,2897,449,2898,274,1
20141229.144335,2898,2,1512526,2,2897,451,2898,275,1
20141229.144335,2898,10,1512536,4,2897,432,2898,271,1
20141229.144336,2898,46,1512582,40,2897,237,2898,310,1
20141229.144336,2898,30,1512612,-10,2897,523,2898,307,1
20141229.144337,2898,6,1512618,-6,2897,523,2898,277,1
20141229.144337,2898,32,1512650,2,2897,519,2898,276,1
20141229.144338,2898,20,1512670,-2,2897,520,2898,265,1
20141229.144338,2898,12,1512682,0,2897,520,2898,259,1
20141229.144339,2898,364,1513046,112,2897,944,2898,78,1
20141229.144339,2898,44,1513090,16,2897,1002,2898,62,1
20141229.14434,2898,120,1513210,4,2898,137,2899,473,1
20141229.144341,2898,6,1513216,0,2898,154,2899,483,1
20141229.144343,2898,306,1513522,-66,2897,629,2898,2,1
20141229.144343,2898,14,1513536,-10,2897,527,2898,154,1
20141229.144345,2898,2,1513538,-2,2897,532,2898,159,1
20141229.144346,2898,22,1513560,-2,2897,532,2898,148,1
20141229.144349,2898,2,1513562,0,2897,592,2898,149,1
20141229.14435,2898,80,1513642,-80,2897,592,2898,109,1
20141229.14435,2898,50,1513692,0,2897,597,2898,84,1
20141229.144351,2898,2,1513694,-2,2897,597,2898,80,1
20141229.144352,2898,46,1513740,-6,2897,606,2898,59,1
20141229.144353,2898,6,1513746,0,2897,606,2898,82,1
20141229.144354,2898,6,1513752,-2,2897,606,2898,79,1
20141229.144354,2898,8,1513760,-8,2897,606,2898,75,1
20141229.144355,2898,444,1514204,-288,2897,708,2898,5,1
20141229.144356,2898,4,1514208,0,2897,608,2898,73,1
20141229.144356,2898,4,1514212,0,2897,608,2898,74,1
20141229.144358,2898,20,1514232,0,2897,609,2898,198,1
20141229.144359,2898,4,1514236,0,2897,611,2898,436,1
20141229.144359,2898,4,1514240,-4,2897,611,2898,434,1
20141229.1444,2898,4,1514244,0,2897,611,2898,432,1
20141229.144401,2898,144,1514388,132,2897,1234,2898,403,1
20141229.144402,2898,20,1514408,10,2897,1236,2898,390,1
20141229.144404,2898,2,1514410,0,2897,621,2898,353,1
20141229.144404,2898,12,1514422,-12,2897,620,2898,362,1
20141229.144406,2898,2,1514424,0,2897,622,2898,363,1
20141229.144407,2898,600,1515024,470,2897,622,2898,63,1
20141229.144407,2898,4,1515028,0,2897,632,2898,63,1
20141229.144408,2898,264,1515292,102,2898,49,2899,1019,1
20141229.144408,2898,98,1515390,0,2898,1,2899,1029,1
20141229.144409,2898,4,1515394,0,2897,684,2898,140,1
20141229.14441,2898,292,1515686,-72,2898,138,2899,656,1
20141229.144411,2898,2,1515688,2,2898,137,2899,656,1
20141229.144412,2898,4,1515692,2,2898,136,2899,657,1
20141229.144413,2899,22,1515714,0,2898,158,2899,1003,1
20141229.144413,2898,250,1515964,118,2897,681,2898,89,0
20141229.144414,2898,46,1516010,-14,2897,680,2898,68,0
20141229.144414,2898,6,1516016,-6,2897,680,2898,65,0
20141229.144415,2898,4,1516020,-2,2897,679,2898,65,0
20141229.144416,2898,22,1516042,-22,2897,679,2898,54,0
20141229.144417,2898,62,1516104,-10,2897,645,2898,22,0
20141229.144417,2898,46,1516150,-44,2898,131,2899,1044,0
20141229.144418,2898,314,1516464,148,2898,2,2899,1046,0
20141229.144419,2898,4,1516468,-2,2897,644,2898,500,0
20141229.144419,2898,12,1516480,0,2897,644,2898,510,0
20141229.14442,2898,2,1516482,0,2897,1215,2898,515,0
20141229.14442,2898,20,1516502,0,2897,1235,2898,506,0
20141229.144421,2898,12,1516514,-10,2897,1250,2898,501,0
20141229.144421,2898,2,1516516,0,2897,1263,2898,515,0
20141229.144421,2897,20,1516536,0,2897,1273,2898,519,0
20141229.144422,2898,2,1516538,-2,2897,589,2898,518,1
20141229.144422,2898,4,1516542,0,2897,588,2898,526,1
20141229.144423,2898,6,1516548,-4,2897,590,2898,533,1
20141229.144423,2898,2,1516550,-2,2897,590,2898,532,1
20141229.144424,2898,2,1516552,-2,2897,599,2898,132,1
20141229.144425,2898,20,1516572,0,2897,599,2898,124,1
20141229.144425,2898,2,1516574,-2,2897,599,2898,124,1
20141229.144426,2898,2,1516576,0,2897,599,2898,123,1
20141229.144426,2897,42,1516618,0,2897,593,2898,138,0
20141229.144428,2898,40,1516658,4,2897,591,2898,183,1
20141229.144428,2898,20,1516678,0,2897,1258,2898,158,1
20141229.144429,2898,92,1516770,34,2897,1274,2898,90,1
20141229.144429,2898,86,1516856,58,2897,1297,2898,47,1
20141229.14443,2898,2,1516858,2,2897,1365,2898,48,1
20141229.14443,2897,2,1516860,2,2897,1394,2898,59,0
20141229.144432,2898,2,1516862,2,2897,602,2898,274,1
20141229.144432,2898,6,1516868,2,2897,601,2898,282,1
20141229.144434,2898,2,1516870,0,2897,602,2898,283,1
20141229.144434,2898,2,1516872,2,2897,602,2898,282,1
20141229.144437,2898,12,1516884,6,2897,601,2898,183,1
20141229.144437,2897,12,1516896,-6,2897,597,2898,183,0
20141229.144438,2898,12,1516908,2,2897,1274,2898,178,1
20141229.144439,2898,16,1516924,4,2897,1030,2898,173,1
20141229.14444,2898,12,1516936,4,2897,1033,2898,166,1
20141229.144441,2897,2,1516938,2,2897,1031,2898,665,0
20141229.144442,2897,856,1517794,-284,2896,537,2898,769,0
20141229.144442,2897,20,1517814,-20,2896,691,2897,1,0
20141229.144443,2897,2,1517816,-2,2896,690,2898,891,0
20141229.144444,2897,270,1518086,-38,2896,732,2897,72,0
20141229.144444,2897,2,1518088,0,2896,723,2897,71,0
20141229.144445,2896,8,1518096,2,2896,671,2897,80,0
20141229.144446,2897,4,1518100,4,2896,672,2897,79,1
20141229.144446,2897,24,1518124,4,2896,623,2897,79,1
20141229.144447,2896,52,1518176,22,2896,596,2897,64,0
20141229.144448,2896,4,1518180,4,2896,594,2897,64,0
20141229.144449,2896,14,1518194,0,2896,638,2897,65,0
20141229.14445,2897,6,1518200,0,2896,638,2897,89,1
20141229.144451,2896,10,1518210,4,2896,636,2897,96,0
20141229.144451,2897,188,1518398,60,2896,835,2897,2,1
20141229.144452,2897,98,1518496,18,2897,31,2898,746,1
20141229.144452,2897,68,1518564,-60,2896,819,2897,122,1
20141229.144453,2896,4,1518568,2,2896,816,2897,174,0
20141229.144454,2897,10,1518578,10,2896,826,2897,169,1
20141229.144454,2897,2,1518580,2,2896,832,2897,158,1
20141229.144455,2897,2,1518582,0,2896,822,2897,157,1
20141229.144455,2897,6,1518588,6,2896,782,2897,144,1
20141229.144456,2896,2,1518590,2,2896,795,2897,144,0
20141229.144457,2897,4,1518594,2,2896,790,2897,164,1
20141229.144457,2897,36,1518630,-36,2896,792,2897,147,1
20141229.144458,2897,126,1518756,52,2896,807,2897,70,1
20141229.144459,2897,2,1518758,0,2896,816,2897,69,1
20141229.1445,2896,66,1518824,2,2896,814,2897,46,0
20141229.144501,2897,100,1518924,-14,2896,817,2897,2,1
20141229.144501,2896,2,1518926,2,2896,816,2897,146,0
20141229.144502,2897,12,1518938,0,2896,791,2897,144,1
20141229.144503,2896,10,1518948,0,2896,735,2897,417,0
20141229.144503,2897,2,1518950,0,2896,733,2897,416,1
20141229.144504,2896,4,1518954,0,2896,664,2897,415,0
20141229.144505,2896,4,1518958,2,2896,671,2897,465,0
20141229.144506,2897,42,1519000,-8,2896,651,2897,465,1
20141229.144507,2896,2,1519002,2,2896,646,2897,468,0
20141229.144508,2897,32,1519034,-2,2896,646,2897,455,1
20141229.144509,2897,100,1519134,-100,2896,647,2897,407,1
20141229.144509,2896,20,1519154,18,2896,638,2897,407,0
20141229.14451,2897,2,1519156,-2,2896,639,2897,406,1
20141229.144511,2896,8,1519164,0,2896,654,2897,408,0
20141229.144514,2897,2,1519166,0,2896,646,2897,407,1
20141229.144514,2897,2,1519168,0,2896,655,2897,407,1
20141229.144515,2896,60,1519228,50,2896,634,2897,407,0
20141229.144517,2897,2,1519230,0,2896,625,2897,371,1
20141229.144518,2897,6,1519236,0,2896,616,2897,392,1
20141229.144518,2897,2,1519238,-2,2896,616,2897,391,1
20141229.144519,2897,348,1519586,-134,2896,661,2897,217,1
20141229.144521,2896,8,1519594,2,2896,683,2897,213,0
20141229.144522,2897,4,1519598,4,2896,682,2897,217,1
20141229.144523,2897,2,1519600,2,2896,682,2897,282,1
20141229.144525,2896,360,1519960,46,2896,456,2897,618,0
20141229.144526,2896,172,1520132,72,2896,127,2897,649,0
20141229.144527,2896,260,1520392,-154,2895,1034,2896,103,0
20141229.144528,2896,2,1520394,-2,2895,1080,2896,117,0
20141229.144529,2896,2,1520396,-2,2895,1080,2896,120,0
20141229.144529,2895,64,1520460,-46,2895,1069,2896,90,0
20141229.14453,2895,4,1520464,-2,2895,1073,2896,124,0
20141229.14453,2896,394,1520858,38,2896,51,2897,738,1
20141229.144531,2896,4,1520862,0,2896,50,2897,715,1
20141229.144532,2896,158,1521020,-112,2895,1045,2896,58,1
20141229.144532,2896,116,1521136,-94,2896,2,2897,779,1
20141229.144533,2896,64,1521200,6,2896,21,2897,699,1
20141229.144533,2896,44,1521244,44,2895,1244,2896,4,1
20141229.144534,2896,48,1521292,-22,2895,1024,2896,40,1
20141229.144534,2896,92,1521384,-2,2896,88,2897,699,1
20141229.144534,2896,60,1521444,60,2896,60,2897,699,1
20141229.144535,2896,90,1521534,90,2896,47,2897,717,1
20141229.144536,2896,16,1521550,12,2896,42,2897,747,1
20141229.144537,2896,106,1521656,0,2896,39,2897,744,1
20141229.144537,2897,114,1521770,0,2896,37,2897,725,1
20141229.144538,2896,8,1521778,-8,2896,35,2897,726,0
20141229.144538,2896,180,1521958,-60,2895,1251,2896,51,0
20141229.144539,2896,222,1522180,-178,2896,2,2897,743,0
20141229.144539,2896,10,1522190,2,2896,65,2897,661,0
20141229.14454,2896,500,1522690,298,2896,60,2897,470,0
20141229.144542,2896,6,1522696,0,2896,270,2897,470,0
20141229.144543,2896,6,1522702,-4,2896,339,2897,470,0
20141229.144543,2896,8,1522710,0,2896,335,2897,470,0
20141229.144545,2896,10,1522720,-10,2896,332,2897,472,0
20141229.144545,2896,4,1522724,0,2896,335,2897,472,0
20141229.144546,2896,20,1522744,8,2896,274,2897,472,0
20141229.144547,2896,2,1522746,0,2896,265,2897,473,0
20141229.144547,2897,16,1522762,2,2896,171,2897,469,1
20141229.144548,2896,100,1522862,56,2896,172,2897,469,0
20141229.144549,2896,20,1522882,10,2896,165,2897,469,0
20141229.14455,2896,8,1522890,8,2896,169,2897,720,0
20141229.144551,2897,2,1522892,2,2896,168,2897,719,1
20141229.144551,2896,16,1522908,0,2896,132,2897,722,0
20141229.144553,2896,6,1522914,0,2896,134,2897,722,0
20141229.144553,2896,42,1522956,-2,2896,113,2897,722,0
20141229.144554,2896,40,1522996,-30,2896,94,2897,731,0
20141229.144555,2896,188,1523184,-158,2895,1019,2896,52,0
20141229.144556,2896,104,1523288,-62,2895,1019,2896,6,0
20141229.144556,2897,14,1523302,2,2895,1029,2897,870,1
20141229.144557,2896,52,1523354,0,2896,125,2897,860,0
20141229.144558,2896,12,1523366,-12,2896,119,2897,760,0
20141229.144558,2896,308,1523674,98,2896,1,2897,506,0
20141229.144559,2896,14,1523688,2,2896,122,2897,505,0
20141229.144559,2897,50,1523738,2,2896,110,2897,503,1
20141229.1446,2896,92,1523830,50,2896,88,2897,485,0
20141229.144601,2896,10,1523840,10,2896,89,2897,485,0
20141229.144602,2897,26,1523866,0,2896,102,2897,473,1
20141229.144602,2896,10,1523876,0,2896,100,2897,473,0
20141229.144603,2896,40,1523916,40,2896,79,2897,473,0
20141229.144604,2897,22,1523938,20,2896,70,2897,472,1
20141229.144604,2896,2,1523940,0,2896,71,2897,472,0
20141229.144606,2896,8,1523948,6,2896,100,2897,874,0
20141229.144607,2897,6,1523954,0,2896,100,2897,871,1
20141229.144608,2897,14,1523968,8,2896,102,2897,903,1
20141229.144608,2896,8,1523976,4,2896,173,2897,903,0
20141229.144611,2896,6,1523982,0,2896,223,2897,903,0
20141229.144612,2897,4,1523986,0,2896,239,2897,1022,1
20141229.144613,2897,100,1524086,0,2896,239,2897,1022,1
20141229.144613,2896,4,1524090,0,2896,339,2897,1024,0
20141229.144614,2897,60,1524150,60,2896,339,2897,994,1
20141229.144614,2896,4,1524154,4,2896,337,2897,994,0
20141229.144615,2897,6,1524160,2,2896,384,2897,993,1
20141229.144616,2897,80,1524240,80,2896,354,2897,1013,1
20141229.144616,2896,2,1524242,0,2896,355,2897,1073,0
20141229.144616,2896,2,1524244,0,2896,354,2897,1083,0
20141229.144617,2896,394,1524638,-230,2896,142,2897,1083,0
20141229.144617,2896,320,1524958,28,2895,1041,2896,165,0
20141229.144618,2896,6,1524964,0,2895,1037,2896,172,0
20141229.144618,2896,6,1524970,-4,2895,1037,2896,172,0
20141229.144619,2896,20,1524990,0,2895,1037,2896,162,0
20141229.14462,2896,46,1525036,-2,2895,1020,2896,139,0
20141229.14462,2896,2,1525038,0,2895,1020,2896,147,0
20141229.144622,2896,2,1525040,0,2895,1024,2896,148,0
20141229.144624,2896,2,1525042,0,2895,1019,2896,171,0
20141229.144624,2895,2,1525044,2,2895,1018,2896,200,0
20141229.144625,2896,12,1525056,0,2895,1004,2896,200,1
20141229.144626,2895,214,1525270,-172,2895,1013,2896,115,0
20141229.144627,2896,4,1525274,0,2895,1002,2896,127,1
20141229.144628,2895,14,1525288,0,2895,978,2896,169,0
20141229.144629,2895,16,1525304,0,2895,984,2896,246,0
20141229.14463,2895,390,1525694,-194,2895,769,2896,278,0
20141229.144631,2895,8,1525702,-8,2895,765,2896,278,0
20141229.144632,2895,22,1525724,-20,2895,754,2896,280,0
20141229.144632,2895,2,1525726,0,2895,753,2896,280,0
20141229.144633,2895,18,1525744,-18,2895,744,2896,286,0
20141229.144634,2896,6,1525750,0,2895,746,2896,286,1
20141229.144635,2895,2,1525752,0,2895,746,2896,289,0
20141229.144635,2895,28,1525780,-18,2895,732,2896,289,0
20141229.144636,2895,22,1525802,-20,2895,752,2896,300,0
20141229.144637,2895,16,1525818,-16,2895,768,2896,300,0
20141229.144638,2896,6,1525824,-2,2895,782,2896,303,1
20141229.144638,2895,2,1525826,0,2895,781,2896,304,0
20141229.144638,2896,6,1525832,-2,2895,799,2896,303,1
20141229.144639,2895,18,1525850,6,2895,805,2896,295,0
20141229.14464,2895,102,1525952,-26,2895,749,2896,298,0
20141229.144641,2896,202,1526154,-110,2895,772,2896,210,1
20141229.144642,2896,410,1526564,-260,2896,89,2897,527,1
20141229.144643,2896,426,1526990,-60,2896,126,2897,437,1
20141229.144643,2896,294,1527284,-110,2895,1019,2897,437,1
20141229.144643,2896,118,1527402,-50,2895,805,2896,95,1
20141229.144644,2896,22,1527424,-20,2895,765,2896,114,1
20141229.144644,2896,280,1527704,-112,2896,294,2897,627,1
20141229.144645,2896,492,1528196,256,2896,83,2897,537,1
20141229.144646,2896,24,1528220,-2,2896,90,2897,529,1
20141229.144647,2896,4,1528224,-4,2896,89,2897,531,1
20141229.144648,2897,28,1528252,-12,2896,91,2897,523,1
20141229.144649,2896,2,1528254,-2,2896,93,2897,523,0
20141229.14465,2896,6,1528260,0,2896,118,2897,525,0
20141229.14465,2896,54,1528314,-50,2896,91,2897,526,0
20141229.144651,2896,8,1528322,0,2896,93,2897,526,0
20141229.144652,2896,22,1528344,-16,2896,84,2897,526,0
20141229.144653,2896,8,1528352,-4,2896,80,2897,597,0
20141229.144653,2896,2,1528354,0,2896,82,2897,598,0
20141229.144654,2896,170,1528524,-64,2895,986,2896,143,0
20141229.144655,2896,2,1528526,-2,2895,965,2896,333,0
20141229.144656,2895,2,1528528,0,2895,968,2896,333,0
20141229.144657,2896,60,1528588,0,2895,968,2896,318,1
20141229.144657,2896,42,1528630,-2,2895,969,2896,297,1
20141229.144658,2896,2,1528632,0,2895,970,2896,338,1
20141229.144658,2896,2,1528634,0,2895,971,2896,362,1
20141229.1447,2896,2,1528636,0,2895,972,2896,364,1
20141229.1447,2896,4,1528640,0,2895,1072,2896,362,1
20141229.144702,2895,18,1528658,-18,2895,1118,2896,362,0
20141229.144703,2895,2,1528660,-2,2895,1119,2896,365,0
20141229.144704,2895,12,1528672,10,2895,1114,2896,371,0
20141229.144706,2895,4,1528676,0,2895,1071,2896,371,0
20141229.144707,2895,2,1528678,2,2895,1070,2896,371,0
20141229.144707,2896,2,1528680,-2,2895,1066,2896,370,1
20141229.144709,2896,10,1528690,0,2895,1066,2896,365,1
20141229.144709,2896,2,1528692,0,2895,1066,2896,364,1
20141229.14471,2896,2,1528694,0,2895,1061,2896,363,1
20141229.144711,2896,2,1528696,0,2895,1112,2896,369,1
20141229.144712,2896,20,1528716,-20,2895,1111,2896,360,1
20141229.144713,2896,18,1528734,0,2895,1122,2896,351,1
20141229.144714,2896,2,1528736,-2,2895,1130,2896,350,1
20141229.144715,2896,710,1529446,-40,2896,245,2897,679,1
20141229.144716,2896,22,1529468,14,2896,252,2897,578,1
20141229.144716,2896,20,1529488,0,2896,242,2897,578,1
20141229.144719,2896,4,1529492,0,2896,230,2897,578,1
20141229.14472,2896,2,1529494,0,2896,230,2897,583,1
20141229.144721,2896,2,1529496,0,2896,225,2897,571,1
20141229.144721,2896,102,1529598,2,2896,175,2897,570,1
20141229.144722,2897,8,1529606,0,2896,186,2897,566,1
20141229.144723,2896,2,1529608,2,2896,188,2897,575,0
20141229.144724,2896,2,1529610,0,2896,187,2897,575,0
20141229.144724,2897,2,1529612,0,2896,189,2897,574,1
20141229.144725,2896,10,1529622,0,2896,184,2897,574,0
20141229.144727,2896,114,1529736,44,2895,976,2896,155,0
20141229.144728,2896,2,1529738,0,2895,846,2896,280,0
20141229.144728,2896,8,1529746,-8,2895,846,2896,276,0
20141229.144729,2896,4,1529750,-4,2895,847,2896,275,0
20141229.14473,2896,2,1529752,-2,2895,847,2896,281,0
20141229.14473,2896,20,1529772,-20,2895,847,2896,271,0
20141229.144731,2896,276,1530048,-18,2895,1046,2896,106,0
20141229.144731,2896,204,1530252,20,2895,1087,2896,1,0
20141229.144732,2896,4,1530256,0,2896,168,2897,655,0
20141229.144733,2897,36,1530292,12,2896,165,2897,654,1
20141229.144734,2896,264,1530556,20,2896,25,2897,687,0
20141229.144734,2896,58,1530614,-22,2895,947,2896,102,0
20141229.144735,2896,6,1530620,-4,2895,856,2896,152,0
20141229.144735,2896,2,1530622,0,2895,856,2896,152,0
20141229.144736,2896,12,1530634,0,2895,856,2896,146,0
20141229.144736,2896,202,1530836,-202,2895,856,2896,47,0
20141229.144737,2896,24,1530860,-6,2895,856,2896,35,0
20141229.144738,2896,22,1530882,-20,2895,877,2896,38,0
20141229.144739,2896,6,1530888,0,2895,877,2896,35,0
20141229.144739,2895,2,1530890,0,2895,876,2896,35,0
20141229.144742,2896,18,1530908,-2,2895,862,2896,33,1
20141229.144742,2896,16,1530924,0,2895,862,2896,25,1
20141229.144743,2896,4,1530928,0,2895,864,2896,27,1
20141229.144744,2896,18,1530946,-4,2895,864,2896,19,1
20141229.144744,2895,2,1530948,0,2895,863,2896,19,0
20141229.144745,2896,4,1530952,2,2895,868,2896,17,1
20141229.144747,2896,6,1530958,0,2895,908,2896,19,1
20141229.144747,2896,2,1530960,-2,2895,952,2896,21,1
20141229.144748,2896,2,1530962,0,2895,952,2896,20,1
20141229.144749,2896,2,1530964,0,2895,953,2896,99,1
20141229.14475,2896,2,1530966,-2,2895,954,2896,98,1
20141229.144752,2896,10,1530976,0,2895,966,2896,97,1
20141229.144752,2896,14,1530990,0,2895,966,2896,91,1
20141229.144754,2896,448,1531438,0,2895,958,2896,890,1
20141229.144754,2896,2,1531440,-2,2895,957,2896,904,1
20141229.144755,2896,10,1531450,-4,2895,957,2896,909,1
20141229.144756,2895,2,1531452,2,2895,956,2896,910,0
20141229.144757,2895,20,1531472,0,2895,948,2896,911,0
20141229.144757,2895,2,1531474,0,2895,947,2896,917,0
20141229.144758,2895,14,1531488,0,2895,940,2896,917,0
20141229.144758,2895,310,1531798,-40,2895,782,2896,917,0
20141229.144759,2895,10,1531808,0,2895,778,2896,917,0
20141229.144759,2895,12,1531820,0,2895,771,2896,917,0
20141229.1448,2895,2,1531822,0,2895,770,2896,918,0
20141229.1448,2895,2,1531824,2,2895,769,2896,918,0
20141229.144801,2895,2,1531826,0,2895,768,2896,923,0
20141229.144802,2895,4,1531830,2,2895,767,2896,921,0
20141229.144803,2896,4,1531834,-2,2895,756,2896,920,1
20141229.144803,2895,2,1531836,0,2895,755,2896,920,0
20141229.144806,2895,2,1531838,0,2895,754,2896,922,0
20141229.144806,2895,4,1531842,2,2895,750,2896,922,0
20141229.144807,2895,4,1531846,4,2895,747,2896,921,0
20141229.144807,2896,24,1531870,-6,2895,735,2896,916,1
20141229.144809,2896,4,1531874,0,2895,845,2896,915,1
20141229.144809,2896,2,1531876,-2,2895,845,2896,914,1
20141229.14481,2896,92,1531968,-32,2895,801,2896,919,1
20141229.144811,2895,2,1531970,0,2895,800,2896,924,0
20141229.144812,2895,2,1531972,0,2895,800,2896,925,0
20141229.144814,2896,6,1531978,0,2895,864,2896,922,1
20141229.144814,2895,2,1531980,2,2895,861,2896,922,0
20141229.144815,2896,4,1531984,0,2895,872,2896,921,1
20141229.144817,2895,2,1531986,0,2895,874,2896,1025,0
20141229.144817,2896,12,1531998,0,2895,874,2896,1020,1
20141229.144818,2895,40,1532038,40,2895,862,2896,1020,0
20141229.144819,2896,8,1532046,-8,2895,862,2896,1016,1
20141229.144819,2896,52,1532098,0,2895,862,2896,990,1
20141229.144821,2895,204,1532302,-22,2895,763,2896,988,0
20141229.144821,2896,2,1532304,0,2895,763,2896,987,1
20141229.144823,2895,2,1532306,0,2895,764,2896,992,0
20141229.144825,2895,12,1532318,0,2895,759,2896,1013,0
20141229.144826,2895,96,1532414,-72,2895,704,2896,1013,0
20141229.144827,2895,2,1532416,0,2895,802,2896,1013,0
20141229.144828,2895,2,1532418,-2,2895,802,2896,1013,0
20141229.144829,2895,2,1532420,-2,2895,801,2896,1018,0
20141229.144829,2896,4,1532424,0,2895,811,2896,1018,1
20141229.144831,2895,48,1532472,-12,2895,789,2896,1028,0
20141229.144831,2895,4,1532476,-4,2895,791,2896,1028,0
20141229.144831,2895,4,1532480,-4,2895,792,2896,1028,0
20141229.144832,2895,8,1532488,-8,2895,788,2896,1028,0
20141229.144833,2896,2,1532490,-2,2895,794,2896,1027,1
20141229.144834,2896,44,1532534,-4,2895,793,2896,1007,1
20141229.144834,2895,6,1532540,-6,2895,791,2896,1006,0
20141229.144835,2895,52,1532592,-14,2895,772,2896,1000,0
20141229.144836,2896,574,1533166,54,2895,537,2896,998,1
20141229.144837,2895,36,1533202,20,2895,518,2896,252,0
20141229.144838,2895,6,1533208,-6,2895,518,2896,252,0
20141229.144838,2895,6,1533214,0,2895,515,2896,253,0
20141229.14484,2895,36,1533250,0,2895,554,2896,253,0
20141229.144842,2895,64,1533314,-26,2895,525,2896,250,0
20141229.144842,2896,2,1533316,0,2895,525,2896,249,1
20141229.144843,2896,22,1533338,8,2895,534,2896,239,1
20141229.144844,2896,20,1533358,-4,2895,538,2896,241,1
20141229.144845,2895,40,1533398,18,2895,521,2896,241,0
20141229.144846,2896,308,1533706,-240,2896,452,2897,1098,1
20141229.144847,2896,904,1534610,-896,2895,789,2896,119,1
20141229.144848,2895,212,1534822,-26,2895,534,2896,32,0
20141229.144849,2896,4,1534826,-4,2895,574,2896,30,1
20141229.144849,2895,242,1535068,-84,2896,25,2897,1208,0
20141229.144849,2895,100,1535168,-54,2895,486,2896,89,0
20141229.14485,2895,12,1535180,10,2895,472,2896,129,0
20141229.144851,2895,6,1535186,0,2895,464,2896,253,0
20141229.144852,2895,2,1535188,0,2895,423,2896,257,0
20141229.144852,2895,12,1535200,0,2895,418,2896,258,0
20141229.144853,2896,10,1535210,0,2895,415,2896,255,1
20141229.144853,2896,8,1535218,0,2895,416,2896,254,1
20141229.144854,2896,4,1535222,2,2895,417,2896,265,1
20141229.144854,2896,2,1535224,0,2895,419,2896,264,1
20141229.144855,2896,22,1535246,22,2895,420,2896,269,1
20141229.144856,2895,4,1535250,0,2895,419,2896,275,0
20141229.144856,2896,4,1535254,4,2895,419,2896,273,1
20141229.144857,2896,2,1535256,0,2895,414,2896,272,1
20141229.144857,2895,38,1535294,36,2895,395,2896,274,0
20141229.144858,2895,16,1535310,-2,2895,386,2896,274,0
20141229.144858,2895,20,1535330,-20,2895,377,2896,274,0
20141229.144859,2895,2,1535332,0,2895,376,2896,274,0
20141229.144859,2895,2,1535334,0,2895,375,2896,275,0
20141229.1449,2895,6,1535340,2,2895,377,2896,277,0
20141229.144901,2895,24,1535364,16,2895,378,2896,270,0
20141229.144901,2896,2,1535366,2,2895,378,2896,269,1
20141229.144902,2895,6,1535372,-4,2895,375,2896,270,0
20141229.144902,2896,30,1535402,-12,2895,369,2896,433,1
20141229.144903,2896,76,1535478,-8,2895,352,2896,438,1
20141229.144904,2896,66,1535544,-8,2895,351,2896,407,1
20141229.144904,2896,32,1535576,0,2895,352,2896,391,1
20141229.144905,2896,38,1535614,-2,2895,350,2896,375,1
20141229.144905,2896,16,1535630,0,2895,355,2896,367,1
20141229.144905,2896,16,1535646,-4,2895,363,2896,359,1
20141229.144906,2896,32,1535678,-32,2895,364,2896,345,1
20141229.144907,2896,26,1535704,-2,2895,362,2896,333,1
20141229.144908,2896,10,1535714,0,2895,361,2896,363,1
20141229.144909,2896,2,1535716,0,2895,362,2896,366,1
20141229.144911,2896,2,1535718,-2,2895,368,2896,368,1
20141229.144912,2896,12,1535730,-10,2895,419,2896,362,1
20141229.144912,2896,2,1535732,-2,2895,421,2896,361,1
20141229.144913,2896,18,1535750,0,2895,426,2896,350,1
20141229.144915,2896,8,1535758,-8,2895,440,2896,345,1
20141229.144916,2896,20,1535778,-16,2895,488,2896,345,1
20141229.144916,2896,4,1535782,-4,2895,488,2896,353,1
20141229.144917,2896,2,1535784,0,2895,507,2896,352,1
20141229.144917,2896,8,1535792,0,2895,507,2896,440,1
20141229.14492,2896,16,1535808,-4,2895,493,2896,417,1
20141229.14492,2896,2,1535810,0,2895,496,2896,416,1
20141229.144921,2895,6,1535816,-2,2895,495,2896,415,0
20141229.144923,2896,16,1535832,-16,2895,519,2896,451,1
20141229.144923,2896,8,1535840,-8,2895,526,2896,447,1
20141229.144923,2896,24,1535864,-18,2895,525,2896,443,1
20141229.144924,2895,116,1535980,-96,2895,472,2896,435,0
20141229.144926,2895,2,1535982,0,2895,512,2896,440,0
20141229.144927,2896,6,1535988,-6,2895,512,2896,438,1
20141229.144928,2896,6,1535994,-6,2895,577,2896,436,1
20141229.144929,2895,42,1536036,0,2895,556,2896,436,0
20141229.144929,2896,10,1536046,0,2895,556,2896,431,1
20141229.14493,2896,42,1536088,-20,2895,546,2896,422,1
20141229.144931,2896,24,1536112,-14,2895,547,2896,410,1
20141229.144931,2896,16,1536128,-16,2895,552,2896,413,1
20141229.144933,2896,42,1536170,-34,2895,580,2896,397,1
20141229.144934,2895,4,1536174,-2,2895,539,2896,897,0
20141229.144935,2896,94,1536268,-66,2895,544,2896,849,1
20141229.144936,2896,10,1536278,-8,2895,465,2896,844,1
20141229.144936,2896,16,1536294,-4,2895,465,2896,835,1
20141229.144937,2895,6,1536300,0,2895,463,2896,843,0
20141229.144937,2896,4,1536304,-4,2895,463,2896,841,1
20141229.144939,2896,10,1536314,-10,2895,464,2896,856,1
20141229.144941,2896,130,1536444,-26,2895,472,2896,791,1
20141229.144941,2896,6,1536450,-6,2895,481,2896,789,1
20141229.144943,2896,2,1536452,-2,2895,506,2896,794,1
20141229.144943,2895,2,1536454,0,2895,506,2896,794,0
20141229.144944,2895,6,1536460,-2,2895,442,2896,792,0
20141229.144945,2896,2,1536462,0,2895,453,2896,791,1
20141229.144946,2896,6,1536468,2,2895,491,2896,703,1
20141229.144947,2895,8,1536476,-8,2895,500,2896,706,0
20141229.144948,2896,20,1536496,0,2895,512,2896,701,1
20141229.14495,2895,182,1536678,-138,2895,424,2896,702,0
20141229.14495,2896,8,1536686,-8,2895,441,2896,698,1
20141229.14495,2895,6,1536692,-4,2895,441,2896,696,0
20141229.144952,2895,200,1536892,-36,2895,345,2896,696,0
20141229.144953,2895,30,1536922,-14,2895,344,2896,705,0
20141229.144953,2895,4,1536926,0,2895,342,2896,706,0
20141229.144954,2895,10,1536936,0,2895,338,2896,705,0
20141229.144955,2895,40,1536976,-16,2895,430,2896,715,0
20141229.144955,2896,2,1536978,-2,2895,479,2896,719,1
20141229.144955,2895,4,1536982,0,2895,473,2896,719,0
20141229.144956,2896,2,1536984,-2,2895,482,2896,718,1
20141229.144957,2896,10,1536994,-10,2895,485,2896,763,1
20141229.144958,2896,2,1536996,-2,2895,490,2896,774,1
20141229.145,2895,68,1537064,-62,2895,460,2896,786,0
20141229.145001,2895,2,1537066,-2,2895,462,2896,786,0
20141229.145002,2895,14,1537080,-8,2895,450,2896,786,0
20141229.145003,2896,4,1537084,0,2895,458,2896,784,1
20141229.145006,2895,4,1537088,-4,2895,462,2896,791,0
20141229.145006,2896,2,1537090,0,2895,464,2896,791,1
20141229.145007,2896,24,1537114,-4,2895,485,2896,779,1
20141229.145007,2895,4,1537118,0,2895,484,2896,779,0
20141229.145007,2895,602,1537720,274,2894,974,2896,779,0
20141229.145008,2895,30,1537750,-30,2895,222,2896,779,0
20141229.145009,2895,16,1537766,-16,2895,222,2896,789,0
20141229.145011,2895,20,1537786,-20,2895,200,2896,843,0
20141229.145012,2896,2,1537788,-2,2895,200,2896,784,1
20141229.145012,2895,2,1537790,-2,2895,202,2896,787,0
20141229.145013,2895,2,1537792,0,2895,213,2896,790,0
20141229.145014,2895,2,1537794,-2,2895,213,2896,789,0
20141229.145015,2896,28,1537822,-28,2895,264,2896,775,1
20141229.145015,2895,2,1537824,0,2895,277,2896,780,0
20141229.145016,2895,6,1537830,-6,2895,275,2896,774,0
20141229.145017,2895,42,1537872,-40,2895,265,2896,782,0
20141229.145018,2896,2,1537874,0,2895,265,2896,781,1
20141229.145018,2895,2,1537876,-2,2895,265,2896,781,0
20141229.145019,2895,102,1537978,-98,2895,217,2896,781,0
20141229.145021,2895,2,1537980,0,2895,222,2896,783,0
20141229.145022,2895,4,1537984,4,2895,220,2896,804,0
20141229.145022,2896,76,1538060,54,2895,214,2896,767,1
20141229.145023,2896,102,1538162,-50,2895,211,2896,719,1
20141229.145023,2896,354,1538516,0,2895,256,2896,543,1
20141229.145024,2896,372,1538888,0,2895,271,2896,340,1
20141229.145024,2896,636,1539524,-136,2895,295,2896,22,1
20141229.145025,2897,570,1540094,-124,2895,331,2897,557,1
20141229.145025,2897,8,1540102,-2,2896,82,2897,576,1
20141229.145026,2897,78,1540180,-28,2896,141,2897,537,1
20141229.145026,2897,4,1540184,-4,2896,141,2897,535,1
20141229.145027,2897,22,1540206,-22,2896,187,2897,524,1
20141229.145028,2897,2,1540208,0,2896,188,2897,523,1
20141229.145029,2896,2,1540210,2,2896,185,2897,523,0
20141229.14503,2897,6,1540216,-6,2896,153,2897,522,1
20141229.14503,2897,2,1540218,-2,2896,267,2897,521,1
20141229.145031,2896,200,1540418,86,2896,166,2897,531,0
20141229.145033,2896,4,1540422,0,2896,167,2897,546,0
20141229.145033,2897,4,1540426,-2,2896,170,2897,554,1
20141229.145034,2896,2,1540428,2,2896,173,2897,552,0
20141229.145035,2897,24,1540452,0,2896,190,2897,540,1
20141229.145036,2897,2,1540454,-2,2896,193,2897,539,1
20141229.145037,2897,2,1540456,0,2896,306,2897,546,1
20141229.145038,2897,2,1540458,0,2896,307,2897,554,1
20141229.14504,2897,32,1540490,-32,2896,311,2897,544,1
20141229.145041,2897,2,1540492,0,2896,346,2897,543,1
20141229.145042,2897,2,1540494,0,2896,346,2897,555,1
20141229.145044,2897,4,1540498,0,2896,385,2897,554,1
20141229.145045,2897,6,1540504,0,2896,429,2897,551,1
20141229.145047,2897,2,1540506,0,2896,432,2897,550,1
20141229.145048,2897,52,1540558,-14,2896,433,2897,527,1
20141229.145049,2897,22,1540580,-22,2896,434,2897,518,1
20141229.145049,2897,2,1540582,-2,2896,434,2897,518,1
20141229.14505,2897,2,1540584,0,2896,434,2897,517,1
20141229.14505,2897,16,1540600,-16,2896,439,2897,508,1
20141229.145051,2897,58,1540658,-58,2896,438,2897,479,1
20141229.145052,2897,34,1540692,-24,2896,439,2897,462,1
20141229.145052,2897,82,1540774,-78,2896,437,2897,423,1
20141229.145053,2897,48,1540822,-26,2896,440,2897,401,1
20141229.145054,2897,630,1541452,-304,2896,490,2898,553,1
20141229.145054,2898,236,1541688,150,2897,52,2898,503,1
20141229.145055,2897,14,1541702,6,2897,267,2898,281,0
20141229.145056,2898,4,1541706,-2,2897,269,2898,279,1
20141229.145056,2898,2,1541708,0,2897,347,2898,272,1
20141229.145057,2898,26,1541734,10,2897,347,2898,458,1
20141229.145057,2898,6,1541740,6,2897,346,2898,456,1
20141229.145058,2898,2,1541742,2,2897,346,2898,461,1
20141229.145059,2897,10,1541752,10,2897,344,2898,473,0
20141229.145059,2897,8,1541760,4,2897,343,2898,470,0
20141229.1451,2898,10,1541770,10,2897,347,2898,466,1
20141229.145101,2898,66,1541836,32,2897,351,2898,236,1
20141229.145101,2897,30,1541866,0,2897,336,2898,233,0
20141229.145102,2898,22,1541888,0,2897,222,2898,222,1
20141229.145103,2897,6,1541894,6,2897,225,2898,794,0
20141229.145103,2898,78,1541972,0,2897,216,2898,955,1
20141229.145104,2898,160,1542132,-16,2897,144,2898,962,1
20141229.145104,2897,36,1542168,-8,2897,164,2898,946,0
20141229.145105,2897,24,1542192,-20,2897,103,2898,887,0
20141229.145105,2897,16,1542208,10,2897,98,2898,885,0
20141229.145106,2897,4,1542212,-2,2897,104,2898,884,0
20141229.145106,2898,2,1542214,0,2897,104,2898,885,1
20141229.145107,2897,8,1542222,-4,2897,102,2898,698,0
20141229.145108,2898,2,1542224,-2,2897,102,2898,687,1
20141229.145108,2897,28,1542252,-20,2897,100,2898,733,0
20141229.145109,2897,4,1542256,-2,2897,109,2898,743,0
20141229.14511,2898,4,1542260,0,2897,138,2898,741,1
20141229.14511,2898,44,1542304,26,2897,122,2898,720,1
20141229.145111,2898,6,1542310,2,2897,127,2898,712,1
20141229.145113,2898,2,1542312,-2,2897,127,2898,721,1
20141229.145114,2898,400,1542712,-196,2897,139,2898,514,1
20141229.145115,2897,6,1542718,-6,2897,168,2898,526,0
20141229.145116,2898,10,1542728,0,2897,188,2898,511,1
20141229.145117,2898,2,1542730,2,2897,199,2898,530,1
20141229.145118,2897,218,1542948,-104,2897,91,2898,539,0
20141229.145118,2898,30,1542978,-6,2897,69,2898,543,1
20141229.145119,2898,12,1542990,0,2897,85,2898,518,1
20141229.145119,2898,14,1543004,0,2897,82,2898,568,1
20141229.14512,2898,50,1543054,-14,2897,72,2898,553,1
20141229.14512,2897,14,1543068,-8,2897,202,2898,550,0
20141229.145121,2898,28,1543096,0,2897,202,2898,539,1
20141229.145121,2898,16,1543112,0,2897,204,2898,532,1
20141229.145122,2898,18,1543130,0,2897,204,2898,533,1
20141229.145122,2898,820,1543950,-54,2897,287,2898,123,1
20141229.145123,2898,56,1544006,46,2897,408,2898,97,1
20141229.145123,2898,80,1544086,-52,2897,287,2898,58,1
20141229.145124,2898,74,1544160,0,2897,299,2898,40,1
20141229.145125,2898,22,1544182,-10,2897,303,2898,237,1
20141229.145125,2898,8,1544190,-4,2897,279,2898,238,1
20141229.145126,2898,6,1544196,-4,2897,309,2898,236,1
20141229.145127,2898,60,1544256,-24,2897,291,2898,249,1
20141229.145127,2898,50,1544306,-2,2897,295,2898,226,1
20141229.145128,2898,46,1544352,44,2897,308,2898,203,1
20141229.145128,2898,12,1544364,0,2897,311,2898,194,1
20141229.145129,2898,100,1544464,36,2897,318,2898,145,1
20141229.145129,2897,158,1544622,10,2897,318,2898,68,0
20141229.14513,2898,2,1544624,2,2897,318,2898,77,1
20141229.14513,2898,4,1544628,2,2897,346,2898,77,1
20141229.145131,2898,300,1544928,60,2897,359,2898,9,1
20141229.145132,2898,26,1544954,-6,2897,300,2898,347,1
20141229.145132,2898,64,1545018,-22,2897,263,2898,315,1
20141229.145133,2898,156,1545174,-56,2897,265,2898,409,1
20141229.145133,2898,2,1545176,-2,2897,265,2898,397,1
20141229.145133,2898,68,1545244,-28,2897,265,2898,363,1
20141229.145134,2898,60,1545304,-56,2897,261,2898,333,1
20141229.145135,2898,124,1545428,-122,2897,274,2898,289,1
20141229.145136,2898,32,1545460,-32,2897,278,2898,274,1
20141229.145136,2898,40,1545500,-38,2897,278,2898,276,1
20141229.145137,2898,66,1545566,-60,2897,278,2898,243,1
20141229.145137,2897,246,1545812,-50,2897,200,2898,214,0
20141229.145137,2898,10,1545822,2,2897,200,2898,240,1
20141229.145138,2898,32,1545854,0,2897,206,2898,250,1
20141229.145139,2898,84,1545938,40,2897,227,2898,302,1
20141229.145139,2898,8,1545946,0,2897,227,2898,298,1
20141229.14514,2898,28,1545974,0,2897,233,2898,284,1
20141229.14514,2898,10,1545984,2,2897,234,2898,280,1
20141229.145141,2898,44,1546028,2,2897,233,2898,291,1
20141229.145141,2898,24,1546052,4,2897,234,2898,280,1
20141229.145142,2898,16,1546068,0,2897,256,2898,272,1
20141229.145142,2898,24,1546092,0,2897,266,2898,267,1
20141229.145142,2898,20,1546112,-20,2897,268,2898,251,1
20141229.145143,2898,8,1546120,0,2897,268,2898,263,1
20141229.145144,2898,4,1546124,-4,2897,268,2898,264,1
20141229.145144,2898,104,1546228,14,2897,268,2898,212,1
20141229.145145,2898,2,1546230,0,2897,373,2898,211,1
20141229.145145,2898,2,1546232,-2,2897,379,2898,210,1
20141229.145146,2898,4,1546236,0,2897,384,2898,136,1
20141229.145146,2898,20,1546256,0,2897,439,2898,153,1
20141229.145147,2898,6,1546262,0,2897,439,2898,220,1
20141229.145148,2898,20,1546282,0,2897,439,2898,229,1
20141229.145148,2898,2,1546284,2,2897,439,2898,228,1
20141229.14515,2898,10,1546294,0,2897,449,2898,261,1
20141229.14515,2898,10,1546304,2,2897,449,2898,256,1
20141229.145151,2898,6,1546310,0,2897,448,2898,287,1
20141229.145151,2898,4,1546314,0,2897,403,2898,300,1
20141229.145152,2898,44,1546358,-12,2897,403,2898,279,1
20141229.145152,2898,40,1546398,10,2897,402,2898,287,1
20141229.145154,2898,4,1546402,0,2897,402,2898,295,1
20141229.145155,2898,10,1546412,8,2897,402,2898,304,1
20141229.145157,2898,66,1546478,-2,2897,420,2898,364,1
20141229.145157,2898,4,1546482,0,2897,420,2898,378,1
20141229.145158,2898,2,1546484,0,2897,421,2898,384,1
20141229.145158,2897,4,1546488,0,2897,419,2898,385,0
20141229.145159,2898,8,1546496,0,2897,419,2898,401,1
20141229.145201,2898,2,1546498,0,2897,418,2898,445,1
20141229.145202,2898,2,1546500,0,2897,428,2898,461,1
20141229.145204,2897,2,1546502,-2,2897,433,2898,461,0
20141229.145205,2898,2,1546504,2,2897,433,2898,460,1
20141229.145207,2898,264,1546768,-22,2897,309,2898,496,1
20141229.145208,2897,174,1546942,-142,2897,215,2898,608,0
20141229.145208,2897,270,1547212,-90,2896,798,2898,673,0
20141229.145209,2897,28,1547240,-24,2897,47,2898,887,0
20141229.14521,2897,98,1547338,-94,2896,845,2897,1,0
20141229.14521,2897,60,1547398,2,2896,857,2898,977,0
20141229.145211,2897,14,1547412,0,2896,857,2898,1057,0
20141229.145211,2897,64,1547476,2,2896,857,2898,1056,0
20141229.145212,2898,6,1547482,0,2897,1,2898,1052,1
20141229.145212,2897,46,1547528,-6,2896,866,2897,2,0
20141229.145213,2898,34,1547562,-32,2897,2,2898,924,1
20141229.145213,2898,8,1547570,-8,2897,2,2898,920,1
20141229.145216,2898,2,1547572,-2,2897,22,2898,998,1
20141229.145217,2897,50,1547622,38,2896,877,2897,191,0
20141229.145217,2897,32,1547654,0,2896,853,2897,176,0
20141229.145218,2897,52,1547706,2,2896,849,2897,155,0
20141229.145219,2897,292,1547998,292,2896,864,2897,10,0
20141229.145219,2897,60,1548058,-20,2896,910,2898,1046,0
20141229.14522,2898,8,1548066,-8,2897,7,2898,1047,1
20141229.14522,2898,2,1548068,0,2897,8,2898,1044,1
20141229.145221,2897,2,1548070,0,2897,233,2898,1048,0
20141229.145223,2897,6,1548076,0,2897,228,2898,994,0
20141229.145224,2897,16,1548092,0,2897,250,2898,902,0
20141229.145225,2897,20,1548112,0,2897,273,2898,911,0
20141229.145225,2897,10,1548122,0,2897,268,2898,911,0
20141229.145226,2898,4,1548126,-4,2897,268,2898,659,1
20141229.145226,2897,6,1548132,2,2897,265,2898,659,0
20141229.145228,2898,6,1548138,-4,2897,280,2898,666,1
20141229.14523,2898,42,1548180,-2,2897,287,2898,649,1
20141229.14523,2898,2,1548182,-2,2897,287,2898,648,1
20141229.145231,2898,10,1548192,0,2897,287,2898,632,1
20141229.145231,2898,2,1548194,0,2897,287,2898,643,1
20141229.145233,2898,62,1548256,32,2897,321,2898,597,1
20141229.145234,2898,2,1548258,2,2897,321,2898,577,1
20141229.145235,2897,2,1548260,0,2897,319,2898,574,0
20141229.145236,2897,14,1548274,-14,2897,328,2898,574,0
20141229.145237,2898,10,1548284,0,2897,335,2898,585,1
20141229.145238,2897,2,1548286,0,2897,334,2898,616,0
20141229.145239,2897,10,1548296,-2,2897,333,2898,888,0
20141229.14524,2897,4,1548300,-4,2897,337,2898,927,0
20141229.14524,2897,8,1548308,-8,2897,337,2898,947,0
20141229.145241,2898,2,1548310,0,2897,337,2898,949,1
20141229.145243,2898,4,1548314,-2,2897,343,2898,952,1
20141229.145243,2898,2,1548316,-2,2897,444,2898,956,1
20141229.145245,2897,4,1548320,-4,2897,493,2898,997,0
20141229.145245,2898,2,1548322,-2,2897,498,2898,1108,1
20141229.145248,2898,10,1548332,-10,2897,528,2898,1109,1
20141229.145248,2898,4,1548336,-2,2897,528,2898,1108,1
20141229.145249,2898,2,1548338,-2,2897,530,2898,1106,1
20141229.145251,2898,2,1548340,0,2897,572,2898,1103,1
20141229.145252,2897,20,1548360,0,2897,1063,2898,1084,0
20141229.145252,2897,100,1548460,-40,2897,1013,2898,1024,0
20141229.145253,2897,6,1548466,-2,2897,1011,2898,1041,0
20141229.145253,2898,20,1548486,-12,2897,1011,2898,1013,1
20141229.145254,2898,2,1548488,-2,2897,1071,2898,1046,1
20141229.145254,2898,2,1548490,0,2897,1071,2898,1076,1
20141229.145255,2897,2,1548492,-2,2897,1070,2898,1076,0
20141229.145256,2898,8,1548500,-8,2897,1070,2898,1092,1
20141229.145256,2898,2,1548502,-2,2897,1070,2898,1091,1
20141229.145257,2898,2,1548504,0,2897,1070,2898,1090,1
20141229.145257,2897,2,1548506,-2,2897,1069,2898,1091,0
20141229.145258,2898,18,1548524,-18,2897,1063,2898,1090,1
20141229.145259,2898,2,1548526,0,2897,1063,2898,1095,1
20141229.1453,2898,2,1548528,2,2897,1074,2898,1095,1
20141229.145301,2898,2,1548530,2,2897,1074,2898,1375,1
20141229.145302,2898,10,1548540,10,2897,1074,2898,1369,1
20141229.145302,2898,6,1548546,0,2897,1075,2898,1438,1
20141229.145304,2898,2,1548548,2,2897,1075,2898,1699,1
20141229.145306,2898,82,1548630,-14,2897,1081,2898,1908,1
20141229.145307,2898,4,1548634,-2,2897,1081,2898,1907,1
20141229.145309,2897,12,1548646,0,2897,1081,2898,2127,0
20141229.14531,2897,20,1548666,2,2897,1088,2898,2369,0
20141229.14531,2897,4,1548670,0,2897,1088,2898,2370,0
20141229.145311,2898,20,1548690,4,2897,1105,2898,2368,1
20141229.145311,2898,6,1548696,2,2897,1105,2898,2367,1
20141229.145312,2897,2,1548698,-2,2897,1104,2898,2368,0
20141229.145314,2898,8,1548706,0,2897,1104,2898,2614,1
20141229.145315,2897,12,1548718,0,2897,1103,2898,2609,0
20141229.145316,2897,10,1548728,-10,2897,1125,2898,2607,0
20141229.145317,2898,8,1548736,0,2897,1131,2898,2606,1
20141229.145317,2897,24,1548760,-24,2897,1119,2898,2596,0
20141229.145318,2898,6,1548766,0,2897,1119,2898,2592,1
20141229.145319,2898,10,1548776,10,2897,1119,2898,2588,1
20141229.14532,2897,320,1549096,-204,2897,970,2898,2578,0
20141229.145321,2898,6,1549102,0,2897,960,2898,2573,1
20141229.145321,2897,2,1549104,2,2897,959,2898,2573,0
20141229.145321,2897,2,1549106,0,2897,958,2898,2583,0
20141229.145322,2897,28,1549134,-6,2897,943,2898,2633,0
20141229.145323,2897,30,1549164,26,2897,929,2898,2647,0
20141229.145323,2897,480,1549644,-420,2897,689,2898,2647,0
20141229.145323,2897,1378,1551022,-872,2896,764,2897,109,0
20141229.145324,2897,108,1551130,-50,2896,689,2897,105,0
20141229.145325,2897,20,1551150,2,2896,681,2897,103,0
20141229.145326,2897,72,1551222,-62,2896,690,2897,121,0
20141229.145326,2897,64,1551286,-60,2896,690,2897,89,0
20141229.145326,2897,12,1551298,0,2896,690,2897,83,0
20141229.145327,2897,38,1551336,0,2896,690,2897,65,0
20141229.145328,2897,52,1551388,12,2896,685,2897,44,0
20141229.145328,2897,110,1551498,20,2897,101,2898,2260,0
20141229.145329,2897,202,1551700,-2,2896,810,2897,3,0
20141229.145329,2897,2,1551702,0,2896,810,2897,4,0
20141229.14533,2897,50,1551752,-10,2896,802,2897,9,0
20141229.145335,2897,66,1551818,-28,2896,730,2897,37,0
20141229.145336,2897,2,1551820,2,2896,691,2897,98,0
20141229.145337,2897,106,1551926,104,2896,687,2897,97,0
20141229.145337,2896,2,1551928,2,2896,687,2897,171,0
20141229.145338,2896,40,1551968,0,2896,665,2897,389,0
20141229.145341,2897,2,1551970,2,2896,674,2897,448,1
20141229.145342,2897,2,1551972,0,2896,685,2897,463,1
20141229.145345,2896,8,1551980,0,2896,682,2897,503,0
20141229.145348,2896,4,1551984,0,2896,731,2897,667,0
20141229.145348,2896,240,1552224,-70,2896,596,2897,667,0
20141229.145349,2896,18,1552242,0,2896,587,2897,667,0
20141229.145349,2896,2,1552244,0,2896,586,2897,668,0
20141229.14535,2896,424,1552668,-78,2896,475,2897,568,0
20141229.145351,2896,6,1552674,-2,2896,469,2897,570,0
20141229.145352,2897,2,1552676,0,2896,469,2897,603,1
20141229.145353,2896,10,1552686,-10,2896,466,2897,638,0
20141229.145354,2896,12,1552698,-12,2896,461,2897,639,0
20141229.145354,2896,12,1552710,-12,2896,455,2897,670,0
20141229.145356,2896,4,1552714,-4,2896,458,2897,689,0
20141229.145356,2897,4,1552718,4,2896,458,2897,687,1
20141229.145357,2896,2,1552720,-2,2896,457,2897,687,0
20141229.145358,2896,30,1552750,-30,2896,445,2897,688,0
20141229.145359,2897,2,1552752,0,2896,642,2897,687,1
20141229.145401,2897,44,1552796,20,2896,617,2897,683,1
20141229.145402,2897,2,1552798,2,2896,618,2897,682,1
20141229.145404,2896,22,1552820,-22,2896,607,2897,716,0
20141229.145404,2897,4,1552824,4,2896,627,2897,714,1
20141229.145405,2897,40,1552864,8,2896,627,2897,694,1
20141229.145406,2897,642,1553506,234,2896,708,2897,375,1
20141229.145406,2897,2,1553508,2,2896,748,2897,374,1
20141229.145406,2897,20,1553528,0,2896,748,2897,365,1
20141229.145407,2897,16,1553544,16,2896,754,2897,363,1
20141229.145408,2896,32,1553576,-22,2896,743,2897,360,0
20141229.145408,2896,32,1553608,-32,2896,727,2897,360,0
20141229.145409,2896,40,1553648,-40,2896,666,2897,561,0
20141229.14541,2897,6,1553654,2,2896,665,2897,560,1
20141229.145411,2897,12,1553666,0,2896,681,2897,578,1
20141229.145414,2897,20,1553686,0,2896,725,2897,469,1
20141229.145414,2897,70,1553756,-62,2896,694,2897,465,1
20141229.145417,2897,6,1553762,-6,2896,653,2897,765,1
20141229.145417,2897,20,1553782,-20,2896,653,2897,755,1
20141229.14542,2896,238,1554020,-228,2896,554,2897,811,0
20141229.145421,2897,10,1554030,-10,2896,557,2897,805,1
20141229.145422,2897,10,1554040,-10,2896,558,2897,801,1
20141229.145423,2896,60,1554100,-46,2896,531,2897,801,0
20141229.145424,2897,402,1554502,-166,2896,533,2897,600,1
20141229.145425,2897,2,1554504,2,2896,536,2897,726,1
20141229.145425,2897,16,1554520,-6,2896,529,2897,725,1
20141229.145426,2897,20,1554540,0,2896,529,2897,842,1
20141229.145428,2896,20,1554560,0,2896,532,2897,926,0
20141229.145431,2897,2,1554562,2,2896,569,2897,1027,1
20141229.145433,2896,8,1554570,8,2896,571,2897,1073,0
20141229.145434,2897,118,1554688,0,2896,574,2897,1014,1
20141229.145434,2897,2,1554690,2,2896,574,2897,1013,1
20141229.145436,2896,2,1554692,0,2896,561,2897,1012,0
20141229.145437,2896,10,1554702,10,2896,556,2897,1004,0
20141229.145438,2897,2,1554704,2,2896,558,2897,1006,1
20141229.14544,2897,76,1554780,38,2896,554,2897,999,1
20141229.14544,2897,8,1554788,0,2896,553,2897,996,1
20141229.145441,2897,2,1554790,2,2896,568,2897,996,1
20141229.145442,2897,2,1554792,2,2896,568,2897,995,1
20141229.145443,2896,120,1554912,-60,2896,507,2897,995,0
20141229.145444,2897,4,1554916,-4,2896,509,2897,1003,1
20141229.145445,2897,2,1554918,0,2896,509,2897,1002,1
20141229.145446,2896,2,1554920,0,2896,513,2897,1002,0
20141229.145446,2896,32,1554952,-24,2896,516,2897,987,0
20141229.145447,2896,2,1554954,2,2896,511,2897,988,0
20141229.145449,2896,2,1554956,2,2896,516,2897,990,0
20141229.145449,2896,220,1555176,-166,2896,416,2897,990,0
20141229.14545,2897,40,1555216,-40,2896,416,2897,970,1
20141229.145451,2896,12,1555228,0,2896,430,2897,967,0
20141229.145452,2897,30,1555258,-30,2896,430,2897,955,1
20141229.145454,2897,6,1555264,-2,2896,445,2897,954,1
20141229.145456,2897,2,1555266,0,2896,467,2897,954,1
20141229.145456,2897,6,1555272,0,2896,465,2897,951,1
20141229.145458,2897,16,1555288,-2,2896,460,2897,945,1
20141229.145458,2897,8,1555296,-8,2896,460,2897,941,1
20141229.145459,2896,40,1555336,0,2896,447,2897,951,0
20141229.1455,2896,40,1555376,-40,2896,436,2897,1003,0
20141229.145501,2897,132,1555508,-90,2896,392,2897,982,1
20141229.145501,2896,38,1555546,-38,2896,377,2897,982,0
20141229.145502,2896,24,1555570,-6,2896,380,2897,973,0
20141229.145502,2896,32,1555602,-16,2896,365,2897,973,0
20141229.145503,2896,28,1555630,0,2896,382,2897,994,0
20141229.145503,2896,4,1555634,-4,2896,401,2897,1000,0
20141229.145504,2896,22,1555656,-8,2896,396,2897,994,0
20141229.145504,2897,2,1555658,0,2896,407,2897,993,1
20141229.145505,2897,2,1555660,-2,2896,408,2897,992,1
20141229.145506,2897,14,1555674,-14,2896,408,2897,986,1
20141229.145506,2897,16,1555690,-4,2896,407,2897,978,1
20141229.145507,2896,14,1555704,-14,2896,406,2897,640,0
20141229.145508,2896,26,1555730,-26,2896,412,2897,983,0
20141229.145509,2896,2,1555732,0,2896,413,2897,983,0
20141229.145509,2897,40,1555772,-38,2896,715,2897,964,1
20141229.14551,2897,24,1555796,-24,2896,718,2897,952,1
20141229.145514,2897,30,1555826,-30,2896,728,2897,1146,1
20141229.145515,2897,4,1555830,-4,2896,768,2897,1146,1
20141229.145515,2897,2,1555832,0,2896,768,2897,1149,1
20141229.145517,2897,6,1555838,-6,2896,784,2897,1050,1
20141229.145518,2896,220,1556058,-142,2896,676,2897,1050,0
20141229.145519,2897,10,1556068,0,2896,676,2897,1045,1
20141229.145519,2897,10,1556078,0,2896,677,2897,1046,1
20141229.14552,2896,2,1556080,0,2896,682,2897,1047,0
20141229.145521,2897,10,1556090,0,2896,688,2897,1042,1
20141229.145522,2897,2,1556092,0,2896,688,2897,1044,1
20141229.145523,2897,106,1556198,-104,2896,688,2897,1011,1
20141229.145523,2897,2,1556200,-2,2896,688,2897,1010,1
20141229.145524,2896,4,1556204,-4,2896,686,2897,1010,0
20141229.145524,2897,4,1556208,0,2896,686,2897,1008,1
20141229.145525,2897,12,1556220,-10,2896,684,2897,1028,1
20141229.145526,2897,32,1556252,-2,2896,678,2897,1020,1
20141229.145527,2897,2,1556254,-2,2896,557,2897,1018,1
20141229.14553,2897,90,1556344,-90,2896,645,2897,973,1
20141229.145531,2897,2,1556346,0,2896,661,2897,984,1
20141229.145532,2897,48,1556394,-42,2896,653,2897,960,1
20141229.145533,2897,42,1556436,-2,2896,654,2897,937,1
20141229.145533,2897,16,1556452,-6,2896,658,2897,929,1
20141229.145534,2897,2,1556454,-2,2896,623,2897,1008,1
20141229.145536,2897,400,1556854,-258,2896,649,2897,809,1
20141229.145536,2897,2,1556856,-2,2896,689,2897,808,1
20141229.145539,2897,10,1556866,-10,2896,710,2897,805,1
20141229.14554,2897,28,1556894,-20,2896,725,2897,791,1
20141229.145541,2897,10,1556904,-10,2896,726,2897,786,1
20141229.145541,2897,2,1556906,-2,2896,726,2897,785,1
20141229.145542,2897,4,1556910,-2,2896,729,2897,783,1
20141229.145542,2897,2,1556912,-2,2896,728,2897,780,1
20141229.145544,2897,6,1556918,-6,2896,731,2897,777,1
20141229.145544,2897,16,1556934,-2,2896,731,2897,769,1
20141229.145545,2896,4,1556938,0,2896,729,2897,767,0
20141229.145545,2896,6,1556944,-4,2896,727,2897,767,0
20141229.145547,2897,2,1556946,-2,2896,732,2897,797,1
20141229.145548,2896,892,1557838,-826,2896,760,2897,414,0
20141229.145549,2897,192,1558030,40,2896,760,2897,334,1
20141229.14555,2897,676,1558706,-372,2897,60,2898,1643,1
20141229.14555,2898,30,1558736,-18,2897,81,2898,1526,1
20141229.145551,2898,4,1558740,-4,2897,112,2898,1524,1
20141229.145551,2897,6,1558746,4,2897,110,2898,1524,0
20141229.145553,2897,204,1558950,176,2897,91,2898,1535,0
20141229.145554,2897,20,1558970,0,2897,171,2898,1535,0
20141229.145556,2897,90,1559060,88,2897,133,2898,1535,0
20141229.145557,2897,18,1559078,18,2897,156,2898,1536,0
20141229.145558,2898,60,1559138,2,2897,194,2898,1406,1
20141229.145558,2898,20,1559158,-8,2897,200,2898,1396,1
20141229.145559,2898,6,1559164,0,2897,200,2898,1379,1
20141229.1456,2898,64,1559228,2,2897,193,2898,1373,1
20141229.145601,2898,22,1559250,22,2897,199,2898,1362,1
20141229.145601,2898,22,1559272,-2,2897,198,2898,1352,1
20141229.145602,2897,6,1559278,2,2897,167,2898,1358,0
20141229.145603,2897,10,1559288,2,2897,373,2898,1396,0
20141229.145603,2898,18,1559306,8,2897,371,2898,1391,1
20141229.145604,2898,16,1559322,6,2897,371,2898,1407,1
20141229.145604,2898,2002,1561324,-12,2897,342,2898,406,1
20141229.145605,2897,6,1561330,-6,2897,420,2898,390,0
20141229.145605,2897,4,1561334,-2,2897,476,2898,390,0
20141229.145607,2898,2,1561336,2,2897,477,2898,421,1
20141229.145607,2898,28,1561364,2,2897,540,2898,407,1
20141229.145608,2898,10,1561374,10,2897,541,2898,407,1
20141229.145608,2898,6,1561380,6,2897,541,2898,412,1
20141229.145609,2898,26,1561406,0,2897,541,2898,401,1
20141229.14561,2898,100,1561506,0,2897,543,2898,372,1
20141229.14561,2898,16,1561522,0,2897,588,2898,364,1
20141229.145611,2898,316,1561838,-84,2897,549,2898,265,1
20141229.145612,2898,224,1562062,-118,2897,549,2898,155,1
20141229.145612,2898,232,1562294,-122,2897,549,2898,69,1
20141229.145613,2898,6,1562300,2,2897,655,2898,67,1
20141229.145613,2898,202,1562502,184,2897,867,2899,2665,1
20141229.145614,2898,28,1562530,16,2897,884,2899,2651,1
20141229.145614,2898,6,1562536,6,2897,879,2899,2651,1
20141229.145615,2898,4,1562540,2,2897,880,2899,2651,1
20141229.145615,2897,28,1562568,-2,2897,913,2898,167,0
20141229.145617,2898,22,1562590,2,2897,946,2898,192,1
20141229.145617,2898,20,1562610,14,2897,967,2898,183,1
20141229.145618,2897,24,1562634,20,2897,967,2898,172,0
20141229.145618,2898,16,1562650,8,2897,917,2898,164,1
20141229.145619,2898,48,1562698,28,2897,960,2898,163,1
20141229.145619,2897,52,1562750,-10,2897,948,2898,218,0
20141229.14562,2898,42,1562792,-40,2897,948,2898,279,1
20141229.14562,2898,16,1562808,-14,2897,943,2898,279,1
20141229.145621,2898,230,1563038,-218,2897,937,2898,170,1
20141229.145621,2898,32,1563070,-18,2897,942,2898,156,1
20141229.145622,2898,8,1563078,4,2897,942,2898,324,1
20141229.145622,2898,10,1563088,-4,2897,941,2898,321,1
20141229.145623,2897,2,1563090,-2,2897,940,2898,368,0
20141229.145623,2898,12,1563102,6,2897,941,2898,434,1
20141229.145624,2898,6,1563108,6,2897,940,2898,593,1
20141229.145624,2898,138,1563246,-128,2897,876,2898,594,1
20141229.145625,2898,92,1563338,46,2897,855,2898,563,1
20141229.145625,2898,10,1563348,-4,2897,1156,2898,558,1
20141229.145626,2898,16,1563364,8,2897,1097,2898,552,1
20141229.145626,2898,6,1563370,2,2897,1096,2898,552,1
20141229.145627,2898,16,1563386,2,2897,1096,2898,545,1
20141229.145627,2898,58,1563444,54,2897,1098,2898,519,1
20141229.145628,2898,6,1563450,-2,2897,1096,2898,518,1
20141229.145628,2898,6,1563456,6,2897,1097,2898,616,1
20141229.145629,2898,10,1563466,10,2897,1099,2898,612,1
20141229.14563,2898,2,1563468,2,2897,1099,2898,611,1
20141229.14563,2898,26,1563494,12,2897,1098,2898,601,1
20141229.145631,2898,10,1563504,-6,2897,1099,2898,598,1
20141229.145632,2898,402,1563906,-340,2897,1101,2898,464,1
20141229.145633,2898,202,1564108,98,2897,1100,2898,354,1
20141229.145633,2898,2,1564110,-2,2897,1099,2898,378,1
20141229.145634,2898,4,1564114,0,2897,1123,2898,402,1
20141229.145634,2897,120,1564234,-120,2897,1065,2898,402,0
20141229.145635,2898,74,1564308,-16,2897,1069,2898,390,1
20141229.145635,2898,90,1564398,-50,2897,1045,2898,384,1
20141229.145637,2898,4,1564402,-4,2897,1048,2898,409,1
20141229.145637,2898,12,1564414,0,2897,1048,2898,434,1
20141229.145638,2898,14,1564428,-4,2897,1059,2898,451,1
20141229.145638,2898,14,1564442,-2,2897,1059,2898,444,1
20141229.145639,2898,8,1564450,-6,2897,1061,2898,440,1
20141229.145639,2898,6,1564456,-2,2897,1063,2898,440,1
20141229.14564,2898,496,1564952,-234,2897,1052,2898,192,1
20141229.145641,2898,6,1564958,2,2897,1054,2898,201,1
20141229.145641,2898,34,1564992,-10,2897,1063,2898,220,1
20141229.145642,2898,12,1565004,4,2897,1063,2898,357,1
20141229.145642,2898,32,1565036,6,2897,1064,2898,367,1
20141229.145643,2898,20,1565056,10,2897,1065,2898,382,1
20141229.145643,2898,8,1565064,0,2897,1020,2898,925,1
20141229.145644,2897,4,1565068,0,2897,1023,2898,962,0
20141229.145645,2898,4,1565072,0,2897,1030,2898,960,1
20141229.145645,2898,32,1565104,18,2897,1027,2898,958,1
20141229.145646,2898,200,1565304,-34,2897,1027,2898,888,1
20141229.145647,2897,12,1565316,2,2897,1022,2898,888,0
20141229.145647,2898,14,1565330,14,2897,1022,2898,902,1
20141229.145648,2898,6,1565336,0,2897,863,2898,906,1
20141229.145649,2898,4,1565340,2,2897,863,2898,904,1
20141229.145649,2897,6,1565346,-2,2897,861,2898,904,0
20141229.14565,2898,128,1565474,-12,2897,813,2898,908,1
20141229.145651,2898,2,1565476,2,2897,814,2898,937,1
20141229.145651,2898,2,1565478,2,2897,814,2898,936,1
20141229.145653,2898,10,1565488,-6,2897,809,2898,975,1
20141229.145653,2898,16,1565504,-8,2897,809,2898,967,1
20141229.145654,2898,82,1565586,52,2897,811,2898,926,1
20141229.145655,2897,6,1565592,-4,2897,808,2898,929,0
20141229.145656,2897,44,1565636,-44,2897,807,2898,913,0
20141229.145657,2898,10,1565646,0,2897,807,2898,911,1
20141229.145657,2898,140,1565786,-140,2897,812,2898,841,1
20141229.145658,2898,4,1565790,0,2897,842,2898,839,1
20141229.145659,2898,24,1565814,-4,2897,873,2898,828,1
20141229.1457,2898,116,1565930,56,2897,883,2898,792,1
20141229.1457,2898,44,1565974,30,2897,925,2898,778,1
20141229.145701,2897,6,1565980,-4,2897,922,2898,788,0
20141229.145701,2898,56,1566036,8,2897,905,2898,794,1
20141229.145702,2897,20,1566056,-8,2897,895,2898,807,0
20141229.145702,2897,2,1566058,0,2897,894,2898,805,0
20141229.145703,2898,12,1566070,0,2897,896,2898,826,1
20141229.145704,2898,14,1566084,0,2897,908,2898,823,1
20141229.145705,2897,60,1566144,-58,2897,879,2898,823,0
20141229.145706,2898,30,1566174,-16,2897,840,2898,808,1
20141229.145706,2897,2,1566176,-2,2897,864,2898,809,0
20141229.145707,2898,2,1566178,0,2897,864,2898,810,1
20141229.145708,2897,76,1566254,-74,2897,861,2898,780,0
20141229.145708,2898,10,1566264,-2,2897,864,2898,775,1
20141229.145709,2898,10,1566274,0,2897,864,2898,770,1
20141229.14571,2898,82,1566356,0,2897,866,2898,729,1
20141229.145711,2897,12,1566368,0,2897,860,2898,724,0
20141229.145712,2898,82,1566450,-56,2897,902,2898,684,1
20141229.145712,2898,128,1566578,-122,2897,839,2898,683,1
20141229.145713,2898,156,1566734,-154,2897,854,2898,593,1
20141229.145713,2897,4,1566738,-2,2897,917,2898,595,0
20141229.145714,2898,2,1566740,0,2897,914,2898,604,1
20141229.145714,2898,4,1566744,-4,2897,935,2898,604,1
20141229.145715,2898,18,1566762,-2,2897,935,2898,596,1
20141229.145716,2898,22,1566784,0,2897,935,2898,608,1
20141229.145716,2898,14,1566798,-4,2897,951,2898,606,1
20141229.145717,2897,248,1567046,-224,2897,831,2898,609,0
20141229.145717,2897,4,1567050,-4,2897,841,2898,609,0
20141229.145718,2897,10,1567060,-10,2897,838,2898,607,0
20141229.145718,2898,76,1567136,-14,2897,800,2898,639,1
20141229.145719,2898,14,1567150,0,2897,802,2898,632,1
20141229.14572,2897,86,1567236,-86,2897,741,2898,632,0
20141229.14572,2898,18,1567254,-16,2897,733,2898,631,1
20141229.145721,2897,106,1567360,-6,2897,687,2898,628,0
20141229.145722,2898,110,1567470,-60,2897,688,2898,572,1
20141229.145722,2898,4,1567474,-4,2897,678,2898,570,1
20141229.145723,2898,50,1567524,-40,2897,669,2898,566,1
20141229.145724,2898,1250,1568774,-760,2898,165,2899,2577,1
20141229.145724,2898,4,1568778,-4,2898,175,2899,2546,1
20141229.145725,2898,4,1568782,-2,2898,174,2899,2537,1
20141229.145726,2898,200,1568982,-200,2898,78,2899,2536,1
20141229.145726,2898,156,1569138,-136,2897,844,2898,1,1
20141229.145726,2898,32,1569170,0,2897,835,2899,2547,1
20141229.145727,2898,24,1569194,-10,2897,802,2898,3,1
20141229.145728,2898,12,1569206,0,2898,69,2899,2555,1
20141229.145728,2898,140,1569346,-140,2897,816,2899,2555,1
20141229.145729,2898,52,1569398,0,2898,200,2899,2546,1
20141229.14573,2899,86,1569484,-66,2898,179,2899,2547,1
20141229.145731,2899,138,1569622,-46,2898,210,2899,2478,1
20141229.145731,2899,4,1569626,0,2898,210,2899,2477,1
20141229.145732,2899,76,1569702,38,2898,221,2899,2440,1
20141229.145732,2899,42,1569744,38,2898,77,2899,2420,1
20141229.145732,2898,2,1569746,-2,2898,76,2899,2420,0
20141229.145733,2898,152,1569898,110,2898,219,2899,2338,0
20141229.145735,2899,132,1570030,40,2898,223,2899,2291,1
20141229.145736,2899,112,1570142,-96,2898,174,2899,2295,1
20141229.145737,2899,8,1570150,0,2898,203,2899,2291,1
20141229.145737,2899,198,1570348,84,2898,203,2899,2192,1
20141229.145738,2898,2,1570350,0,2898,202,2899,2192,0
20141229.145738,2898,46,1570396,22,2898,649,2899,2151,0
20141229.145739,2899,4,1570400,-2,2898,652,2899,2151,1
20141229.14574,2898,6,1570406,2,2898,655,2899,2117,0
20141229.14574,2898,2,1570408,-2,2898,654,2899,2158,0
20141229.145741,2899,24,1570432,0,2898,649,2899,2150,1
20141229.145742,2899,44,1570476,0,2898,654,2899,2141,1
20141229.145743,2899,42,1570518,2,2898,657,2899,2130,1
20141229.145745,2899,42,1570560,40,2898,673,2899,2113,1
20141229.145745,2899,220,1570780,20,2898,742,2899,1998,1
20141229.145746,2899,40,1570820,40,2898,753,2899,1970,1
20141229.145747,2899,20,1570840,20,2898,754,2899,1960,1
20141229.145747,2899,32,1570872,16,2898,754,2899,1925,1
20141229.145748,2899,32,1570904,2,2898,739,2899,1925,1
20141229.145748,2898,10,1570914,-10,2898,734,2899,1946,0
20141229.145749,2898,10,1570924,-10,2898,730,2899,1956,0
20141229.145749,2898,20,1570944,-20,2898,710,2899,1956,0
20141229.14575,2899,8,1570952,8,2898,712,2899,1963,1
20141229.14575,2898,120,1571072,-116,2898,652,2899,1962,0
20141229.145751,2899,132,1571204,30,2898,651,2899,1895,1
20141229.145752,2899,4,1571208,0,2898,652,2899,1894,1
20141229.145752,2899,46,1571254,44,2898,665,2899,1861,1
20141229.145753,2898,62,1571316,48,2898,664,2899,1831,0
20141229.145754,2899,8,1571324,0,2898,665,2899,1828,1
20141229.145754,2899,18,1571342,18,2898,665,2899,1817,1
20141229.145755,2899,68,1571410,4,2898,644,2899,1804,1
20141229.145755,2899,18,1571428,18,2898,645,2899,1792,1
20141229.145756,2899,8,1571436,6,2898,645,2899,1787,1
20141229.145757,2899,12,1571448,-2,2898,662,2899,1811,1
20141229.145757,2899,60,1571508,0,2898,662,2899,1784,1
20141229.145758,2899,10,1571518,0,2898,664,2899,1781,1
20141229.145759,2899,6,1571524,6,2898,665,2899,1777,1
20141229.145759,2899,6,1571530,4,2898,665,2899,1774,1
20141229.1458,2898,50,1571580,6,2898,644,2899,1778,0
20141229.145801,2898,58,1571638,-54,2898,617,2899,1777,0
20141229.145801,2898,64,1571702,-6,2898,601,2899,1750,0
20141229.145802,2899,20,1571722,20,2898,702,2899,1740,1
20141229.145802,2899,16,1571738,0,2898,704,2899,1739,1
20141229.145803,2899,6,1571744,6,2898,706,2899,1735,1
20141229.145803,2899,4,1571748,0,2898,706,2899,1735,1
20141229.145804,2899,6,1571754,0,2898,710,2899,1734,1
20141229.145804,2898,32,1571786,0,2898,711,2899,1735,0
20141229.145805,2899,16,1571802,8,2898,791,2899,1730,1
20141229.145806,2898,2,1571804,-2,2898,801,2899,1736,0
20141229.145806,2898,2,1571806,-2,2898,831,2899,1736,0
20141229.145807,2899,48,1571854,22,2898,830,2899,1714,1
20141229.145807,2899,18,1571872,18,2898,871,2899,1707,1
20141229.145808,2899,6,1571878,0,2898,883,2899,1707,1
20141229.145809,2899,20,1571898,10,2898,883,2899,1697,1
20141229.145809,2899,8,1571906,4,2898,924,2899,1695,1
20141229.14581,2899,10,1571916,0,2898,922,2899,1691,1
20141229.14581,2899,40,1571956,-18,2898,911,2899,1683,1
20141229.145811,2898,2,1571958,0,2898,911,2899,1684,0
20141229.145811,2899,24,1571982,10,2898,906,2899,1678,1
20141229.145812,2898,6,1571988,2,2898,906,2899,1677,0
20141229.145812,2898,134,1572122,-126,2898,878,2899,1676,0
20141229.145813,2898,2,1572124,0,2898,876,2899,1676,0
20141229.145813,2898,410,1572534,6,2898,636,2899,1670,0
20141229.145814,2898,20,1572554,-14,2898,641,2899,1672,0
20141229.145814,2898,6,1572560,0,2898,653,2899,1671,0
20141229.145815,2899,30,1572590,-8,2898,643,2899,1667,1
20141229.145815,2899,12,1572602,0,2898,644,2899,1662,1
20141229.145816,2899,252,1572854,-2,2898,641,2899,1538,1
20141229.145817,2898,12,1572866,-10,2898,666,2899,1541,0
20141229.145817,2898,2,1572868,-2,2898,630,2899,1653,0
20141229.145818,2898,64,1572932,-28,2898,543,2899,1643,0
20141229.145818,2899,438,1573370,338,2898,581,2899,1423,1
20141229.145819,2899,2,1573372,2,2898,581,2899,1424,1
20141229.145819,2898,2,1573374,0,2898,582,2899,1424,0
20141229.14582,2899,74,1573448,0,2898,583,2899,1387,1
20141229.14582,2899,2,1573450,2,2898,589,2899,1386,1
20141229.145821,2898,24,1573474,-18,2898,579,2899,1385,0
20141229.145821,2898,10,1573484,-4,2898,595,2899,1383,0
20141229.145822,2899,4,1573488,0,2898,586,2899,1388,1
20141229.145822,2898,4,1573492,2,2898,576,2899,1396,0
20141229.145823,2898,204,1573696,-196,2898,461,2899,1399,0
20141229.145824,2899,6,1573702,2,2898,481,2899,1411,1
20141229.145824,2898,26,1573728,6,2898,504,2899,1400,0
20141229.145825,2898,1654,1575382,1028,2897,857,2898,191,0
20141229.145825,2898,2,1575384,0,2897,856,2898,191,0
20141229.145826,2897,84,1575468,80,2897,845,2898,151,0
20141229.145826,2897,34,1575502,-8,2897,851,2898,140,0
20141229.145827,2897,60,1575562,44,2897,849,2898,114,0
20141229.145827,2898,58,1575620,22,2897,848,2898,97,1
20141229.145828,2898,58,1575678,18,2897,848,2898,80,1
20141229.145828,2898,12,1575690,12,2897,847,2898,75,1
20141229.145829,2898,36,1575726,2,2897,847,2898,57,1
20141229.145829,2898,48,1575774,20,2897,847,2898,33,1
20141229.14583,2898,70,1575844,-12,2898,1,2899,1512,1
20141229.14583,2898,30,1575874,-18,2898,21,2899,1494,1
20141229.145831,2898,156,1576030,-102,2897,895,2898,12,1
20141229.145831,2898,26,1576056,2,2897,893,2899,1499,1
20141229.145832,2898,14,1576070,-2,2897,900,2898,1,1
20141229.145832,2898,16,1576086,2,2897,899,2899,1494,1
20141229.145833,2897,6,1576092,-6,2897,898,2899,1515,0
20141229.145833,2898,8,1576100,0,2897,895,2899,1524,1
20141229.145834,2899,10,1576110,4,2897,897,2898,1,1
20141229.145835,2898,60,1576170,58,2898,20,2899,1628,0
20141229.145835,2898,42,1576212,38,2897,906,2898,2,0
20141229.145836,2899,1218,1577430,30,2898,41,2899,1042,1
20141229.145836,2898,208,1577638,204,2897,569,2899,963,0
20141229.145837,2898,400,1578038,400,2897,867,2898,6,0
20141229.145837,2897,14,1578052,-2,2897,866,2898,1,0
20141229.145838,2899,12,1578064,-4,2897,866,2899,963,1
20141229.145838,2898,16,1578080,4,2897,866,2898,22,0
20141229.145839,2898,56,1578136,-44,2898,1,2899,959,0
20141229.14584,2898,16,1578152,-4,2898,1,2899,1011,0
20141229.14584,2898,54,1578206,-8,2897,948,2898,14,0
20141229.14584,2898,12,1578218,0,2897,948,2898,8,0
20141229.145841,2898,16,1578234,2,2897,942,2898,3,0
20141229.145841,2899,44,1578278,16,2897,945,2899,1114,1
20141229.145842,2898,20,1578298,20,2897,947,2898,20,0
20141229.145843,2898,4,1578302,2,2897,947,2898,28,0
20141229.145844,2898,172,1578474,150,2898,23,2899,1163,0
20141229.145844,2898,14,1578488,2,2898,16,2899,1158,0
20141229.145845,2898,44,1578532,-22,2897,991,2898,9,0
20141229.145845,2898,48,1578580,-12,2897,982,2898,9,0
20141229.145846,2898,8,1578588,-6,2897,982,2898,5,0
20141229.145846,2898,2,1578590,-2,2897,985,2898,6,0
20141229.145847,2898,10,1578600,-6,2897,985,2898,3,0
20141229.145847,2898,8,1578608,-8,2898,7,2899,1374,0
20141229.145848,2898,18,1578626,-10,2897,943,2899,1382,0
20141229.145848,2898,4,1578630,2,2897,943,2899,1781,0
20141229.145849,2898,2,1578632,0,2897,943,2898,1,0
20141229.145849,2899,10,1578642,0,2897,949,2899,1470,1
20141229.14585,2899,10,1578652,2,2898,13,2899,1487,1
20141229.14585,2897,38,1578690,-4,2897,946,2898,52,0
20141229.145851,2898,6,1578696,0,2897,946,2898,52,1
20141229.145851,2898,36,1578732,-14,2897,964,2898,36,1
20141229.145852,2898,2,1578734,0,2897,964,2898,39,1
20141229.145852,2899,118,1578852,10,2898,20,2899,1484,1
20141229.145853,2898,44,1578896,-2,2897,938,2898,1,0
20141229.145853,2898,2,1578898,0,2898,1,2899,1494,0
20141229.145854,2898,2,1578900,-2,2897,994,2898,22,0
20141229.145854,2898,22,1578922,-8,2897,947,2898,13,0
20141229.145855,2898,88,1579010,36,2897,947,2898,7,0
20141229.145855,2898,14,1579024,0,2898,7,2899,1522,0
20141229.145856,2898,8,1579032,-4,2898,9,2899,1540,0
20141229.145856,2898,74,1579106,54,2898,9,2899,1473,0
20141229.145857,2899,48,1579154,-2,2898,7,2899,1452,1
20141229.145857,2898,2,1579156,-2,2898,7,2899,1452,0
20141229.145858,2899,26,1579182,18,2898,5,2899,1443,1
20141229.145858,2898,12,1579194,-2,2898,29,2899,1443,0
20141229.145859,2898,64,1579258,-46,2898,129,2899,1441,0
20141229.145859,2899,204,1579462,4,2898,125,2899,1431,1
20141229.1459,2898,18,1579480,0,2898,121,2899,1428,0
20141229.1459,2898,256,1579736,-60,2897,876,2899,1423,0
20141229.145901,2898,8,1579744,6,2897,876,2898,228,0
20141229.145901,2898,406,1580150,-180,2897,715,2898,152,0
20141229.145902,2898,242,1580392,-20,2897,676,2898,67,0
20141229.145902,2898,26,1580418,-26,2897,703,2898,69,0
20141229.145903,2898,188,1580606,-10,2897,646,2898,90,0
20141229.145904,2898,16,1580622,-2,2897,647,2898,128,0
20141229.145904,2898,16,1580638,0,2897,654,2898,150,0
20141229.145905,2898,4,1580642,-4,2897,654,2898,149,0
20141229.145905,2898,8,1580650,-2,2897,657,2898,177,0
20141229.145906,2898,10,1580660,-10,2897,653,2898,177,0
20141229.145906,2898,50,1580710,2,2897,644,2898,353,0
20141229.145907,2898,6,1580716,0,2897,648,2898,369,0
20141229.145908,2898,22,1580738,4,2897,635,2898,364,0
20141229.145908,2897,34,1580772,8,2897,648,2898,352,0
20141229.145909,2898,6,1580778,2,2897,676,2898,439,1
20141229.145909,2897,26,1580804,-2,2897,674,2898,428,0
20141229.14591,2898,18,1580822,8,2897,672,2898,456,1
20141229.14591,2897,30,1580852,28,2897,657,2898,456,0
20141229.145911,2897,6,1580858,0,2897,660,2898,479,0
20141229.145912,2898,22,1580880,8,2897,615,2898,761,1
20141229.145912,2897,2,1580882,2,2897,643,2898,778,0
20141229.145912,2898,604,1581486,-580,2897,643,2898,535,1
20141229.145913,2898,64,1581550,-4,2897,629,2898,522,1
20141229.145914,2897,6,1581556,0,2897,640,2898,542,0
20141229.145914,2898,6,1581562,0,2897,650,2898,539,1
20141229.145915,2897,164,1581726,-12,2897,592,2898,522,0
20141229.145915,2897,38,1581764,-12,2897,596,2898,512,0
20141229.145915,2898,4,1581768,-2,2897,595,2898,511,1
20141229.145916,2898,16,1581784,10,2897,590,2898,487,1
20141229.145917,2897,42,1581826,10,2897,581,2898,479,0
20141229.145918,2897,68,1581894,-52,2897,553,2898,477,0
20141229.145919,2897,136,1582030,-66,2897,571,2898,574,0
20141229.145919,2898,4,1582034,-4,2897,572,2898,581,1
20141229.14592,2897,212,1582246,136,2897,563,2898,521,0
20141229.145921,2898,106,1582352,-34,2897,513,2898,500,1
20141229.145921,2898,58,1582410,24,2897,512,2898,475,1
20141229.145922,2898,130,1582540,2,2897,509,2898,413,1
20141229.145922,2898,58,1582598,34,2897,501,2898,404,1
20141229.145923,2897,10,1582608,0,2897,527,2898,437,0
20141229.145924,2898,588,1583196,148,2897,700,2898,190,1
20141229.145925,2898,22,1583218,4,2897,781,2898,192,1
20141229.145925,2897,100,1583318,-10,2897,781,2898,192,0
20141229.145926,2897,108,1583426,-2,2897,780,2898,332,0
20141229.145926,2898,676,1584102,-648,2898,440,2899,891,1
20141229.145927,2898,20,1584122,-20,2898,599,2899,882,1
20141229.145927,2898,24,1584146,-24,2898,708,2899,883,1
20141229.145928,2898,70,1584216,-70,2898,676,2899,880,1
20141229.145928,2898,36,1584252,-36,2898,659,2899,674,1
20141229.145929,2898,4,1584256,-2,2898,656,2899,915,1
20141229.145929,2898,12,1584268,-2,2898,657,2899,856,1
20141229.14593,2899,60,1584328,-56,2898,633,2899,822,1
20141229.145931,2898,362,1584690,60,2898,630,2899,643,0
20141229.145931,2899,250,1584940,2,2898,609,2899,537,1
20141229.145932,2898,6,1584946,-6,2898,624,2899,785,0
20141229.145932,2899,94,1585040,-24,2898,704,2899,759,1
20141229.145933,2898,48,1585088,-6,2898,700,2899,725,0
20141229.145933,2898,12,1585100,-4,2898,698,2899,1178,0
20141229.145934,2898,218,1585318,66,2898,743,2899,1090,0
20141229.145934,2898,44,1585362,-44,2898,722,2899,1102,0
20141229.145935,2898,4,1585366,-2,2898,703,2899,1093,0
20141229.145935,2898,10,1585376,-8,2898,707,2899,1089,0
20141229.145936,2899,6,1585382,-6,2898,705,2899,1088,1
20141229.145936,2899,2,1585384,0,2898,806,2899,1086,1
20141229.145937,2898,66,1585450,-64,2898,817,2899,1145,0
20141229.145938,2898,2,1585452,-2,2898,820,2899,1165,0
20141229.145938,2899,12,1585464,-10,2898,820,2899,1166,1
20141229.145939,2898,42,1585506,-40,2898,862,2899,1151,0
20141229.14594,2899,26,1585532,-22,2898,881,2899,1149,1
20141229.14594,2898,8,1585540,-8,2898,879,2899,1156,0
20141229.145941,2899,26,1585566,-22,2898,879,2899,1143,1
20141229.145941,2898,14,1585580,-8,2898,903,2899,1146,0
20141229.145942,2899,88,1585668,-30,2898,906,2899,1104,1
20141229.145942,2898,20,1585688,-16,2898,894,2899,1103,0
20141229.145943,2899,110,1585798,-4,2898,886,2899,1054,1
20141229.145943,2898,10,1585808,0,2898,880,2899,1073,0
20141229.145944,2899,4,1585812,4,2898,887,2899,1072,1
20141229.145944,2899,12,1585824,12,2898,887,2899,1067,1
20141229.145945,2898,308,1586132,-124,2898,824,2899,1030,0
20141229.145945,2899,6,1586138,4,2898,832,2899,1033,1
20141229.145946,2898,54,1586192,-30,2898,765,2899,1022,0
20141229.145946,2899,104,1586296,0,2898,766,2899,970,1
20141229.145947,2898,2,1586298,-2,2898,766,2899,993,0
20141229.145948,2899,96,1586394,-10,2898,755,2899,953,1
20141229.145948,2898,38,1586432,-26,2898,740,2899,948,0
20141229.145948,2898,20,1586452,-20,2898,730,2899,948,0
20141229.145949,2899,24,1586476,16,2898,742,2899,938,1
20141229.14595,2899,34,1586510,20,2898,743,2899,923,1
20141229.14595,2899,136,1586646,6,2898,695,2899,1016,1
20141229.145951,2899,276,1586922,-44,2898,590,2899,279,1
20141229.145951,2899,22,1586944,22,2898,605,2899,268,1
20141229.145952,2899,290,1587234,-62,2898,389,2899,156,1
20141229.145952,2898,38,1587272,10,2898,391,2899,170,0
20141229.145953,2899,92,1587364,2,2898,375,2899,124,1
20141229.145953,2899,308,1587672,16,2898,225,2899,122,1
20141229.145954,2899,18,1587690,4,2898,213,2899,122,1
20141229.145954,2899,4,1587694,2,2898,257,2899,121,1
20141229.145955,2899,96,1587790,10,2898,180,2899,75,1
20141229.145955,2898,6,1587796,-4,2898,185,2899,79,0
20141229.145956,2898,22,1587818,-20,2898,280,2899,74,0
20141229.145956,2898,6,1587824,-4,2898,273,2899,78,0
20141229.145957,2899,30,1587854,-6,2898,280,2899,64,1
20141229.145957,2899,4,1587858,-2,2898,280,2899,64,1
20141229.145958,2899,200,1588058,-30,2898,194,2899,49,1
20141229.145958,2899,80,1588138,16,2898,190,2899,15,1
20141229.145959,2899,6,1588144,2,2898,188,2899,37,1
20141229.145959,2899,2,1588146,2,2898,188,2899,36,1
20141229.15,2899,14,1588160,8,2898,189,2899,29,1
20141229.15,2898,4,1588164,2,2898,217,2899,30,0
