20150105.205901,2816,784,784,2128754,2815,321,2816,196,1
20150105.21,2815,378,1162,242,2815,357,2816,100,0
20150105.210001,2818,1196,2358,248,2818,763,2819,317,1
20150105.210002,2819,1194,3552,600,2819,265,2820,932,1
20150105.210002,2819,478,4030,-116,2819,230,2820,747,1
20150105.210003,2819,1642,5672,-1078,2818,171,2819,92,1
20150105.210003,2818,132,5804,-26,2818,109,2819,135,0
20150105.210004,2818,104,5908,-36,2818,74,2819,122,0
20150105.210004,2819,144,6052,-6,2818,43,2819,119,1
20150105.210005,2819,198,6250,-82,2817,89,2818,1,1
20150105.210005,2818,124,6374,-28,2817,47,2818,34,0
20150105.210006,2815,2996,9370,1726,2815,205,2818,53,0
20150105.210006,2815,550,9920,444,2813,173,2815,907,0
20150105.210007,2815,134,10054,130,2813,66,2815,899,0
20150105.210007,2815,66,10120,58,2813,102,2815,870,0
20150105.210008,2814,36,10156,2,2813,140,2815,865,0
20150105.210008,2815,42,10198,28,2813,141,2815,854,1
20150105.210009,2815,18,10216,12,2813,140,2815,848,1
20150105.210009,2814,2018,12234,-420,2815,200,2817,30,0
20150105.21001,2815,294,12528,294,2815,54,2817,30,1
20150105.21001,2815,2,12530,2,2815,59,2817,32,1
20150105.210011,2815,12,12542,4,2815,90,2817,33,1
20150105.210011,2817,190,12732,74,2817,123,2818,84,1
20150105.210012,2818,116,12848,102,2817,98,2818,81,1
20150105.210012,2817,50,12898,40,2817,75,2818,83,0
20150105.210013,2817,26,12924,14,2817,75,2818,136,0
20150105.210013,2817,82,13006,20,2817,55,2818,104,0
20150105.210014,2818,24,13030,8,2817,58,2818,100,1
20150105.210014,2817,48,13078,-10,2817,37,2818,120,0
20150105.210015,2818,118,13196,48,2816,44,2817,42,1
20150105.210015,2818,366,13562,-160,2818,331,2819,119,1
20150105.210016,2818,50,13612,-26,2818,309,2819,116,1
20150105.210016,2819,82,13694,-66,2818,274,2819,112,1
20150105.210017,2818,164,13858,8,2818,202,2819,507,0
20150105.210017,2818,10,13868,-2,2818,201,2819,506,0
20150105.210018,2818,436,14304,-110,2818,66,2819,434,0
20150105.210018,2818,44,14348,-18,2818,108,2819,444,0
20150105.210019,2818,172,14520,-84,2818,44,2819,427,0
20150105.210019,2818,208,14728,10,2818,38,2819,330,0
20150105.21002,2818,74,14802,6,2818,8,2819,329,0
20150105.21002,2818,36,14838,4,2817,80,2818,5,0
20150105.210021,2817,22,14860,2,2817,98,2818,39,0
20150105.210021,2818,30,14890,22,2817,86,2818,205,1
20150105.210022,2818,26,14916,2,2817,85,2818,212,1
20150105.210022,2817,74,14990,60,2817,54,2818,231,0
20150105.210023,2818,54,15044,24,2817,29,2818,232,1
20150105.210023,2818,68,15112,-30,2817,18,2818,247,1
20150105.210024,2818,66,15178,52,2816,168,2818,249,1
20150105.210024,2818,504,15682,-210,2816,174,2818,35,1
20150105.210025,2818,36,15718,-26,2816,175,2818,34,1
20150105.210025,2818,50,15768,-38,2816,174,2818,17,1
20150105.210026,2818,154,15922,-82,2818,73,2819,539,1
20150105.210026,2818,24,15946,-12,2818,113,2819,547,1
20150105.210027,2818,10,15956,-4,2818,124,2819,560,1
20150105.210027,2818,174,16130,-58,2818,30,2819,512,1
20150105.210028,2818,426,16556,26,2818,30,2819,304,1
20150105.210028,2818,68,16624,-2,2817,73,2818,162,1
20150105.210029,2818,170,16794,-36,2816,273,2818,185,1
20150105.210029,2818,44,16838,-34,2817,6,2818,273,1
20150105.21003,2818,6,16844,0,2817,6,2818,334,1
20150105.21003,2817,54,16898,-2,2817,52,2818,315,0
20150105.210031,2818,4,16902,0,2817,174,2818,314,1
20150105.210032,2817,28,16930,0,2817,175,2818,344,0
20150105.210032,2818,458,17388,-250,2817,160,2818,138,1
20150105.210033,2817,34,17422,10,2817,154,2818,124,0
20150105.210033,2817,92,17514,-46,2817,166,2818,94,0
20150105.210034,2818,88,17602,-14,2817,162,2818,57,1
20150105.210034,2817,106,17708,4,2817,116,2818,58,0
20150105.210035,2818,2,17710,0,2817,128,2818,103,1
20150105.210035,2817,820,18530,-402,2817,126,2819,25,0
20150105.210036,2818,10,18540,-6,2817,128,2818,10,1
20150105.210036,2817,46,18586,-14,2817,129,2818,20,0
20150105.210037,2817,12,18598,-2,2817,130,2818,18,0
20150105.210037,2818,168,18766,-124,2818,108,2819,1,1
20150105.210038,2818,86,18852,-4,2818,155,2819,1,1
20150105.210038,2819,70,18922,-70,2818,128,2819,20,1
20150105.210039,2818,78,19000,-46,2818,144,2819,42,0
20150105.210039,2819,254,19254,134,2818,141,2819,1,1
20150105.21004,2818,428,19682,-124,2817,190,2818,111,0
20150105.210041,2817,6,19688,-2,2817,266,2818,98,0
20150105.210041,2818,124,19812,-4,2817,296,2818,247,1
20150105.210042,2818,26,19838,-20,2817,300,2818,246,1
20150105.210042,2817,6,19844,-6,2817,281,2818,252,0
20150105.210044,2819,1240,21084,-972,2818,3,2819,318,1
20150105.210044,2818,6,21090,2,2817,84,2818,37,0
20150105.210045,2817,8,21098,0,2817,96,2818,82,0
20150105.210045,2818,8,21106,-2,2817,100,2818,194,1
20150105.210046,2818,4,21110,0,2817,112,2818,244,1
20150105.210047,2818,12,21122,-4,2817,111,2818,249,1
20150105.210047,2817,72,21194,-62,2817,77,2818,252,0
20150105.210048,2818,4,21198,-2,2817,79,2818,251,1
20150105.210048,2818,20,21218,-20,2817,79,2818,242,1
20150105.210049,2818,6,21224,-4,2817,83,2818,281,1
20150105.210049,2818,508,21732,-252,2817,78,2818,111,1
20150105.21005,2818,6,21738,-4,2817,89,2818,117,1
20150105.210051,2818,18,21756,-8,2817,116,2818,151,1
20150105.210052,2818,14,21770,-2,2817,115,2818,261,1
20150105.210052,2817,30,21800,-2,2817,110,2818,271,0
20150105.210053,2818,560,22360,-462,2818,53,2819,334,1
20150105.210053,2818,32,22392,-28,2818,63,2819,304,1
20150105.210054,2818,38,22430,-36,2818,66,2819,305,1
20150105.210054,2818,134,22564,-104,2817,173,2818,1,1
20150105.210055,2819,12,22576,-10,2817,173,2819,347,1
20150105.210055,2819,6,22582,-2,2818,6,2819,347,1
20150105.210056,2819,114,22696,20,2817,213,2819,301,1
20150105.210056,2818,6,22702,-6,2817,214,2818,2,0
20150105.210057,2818,104,22806,4,2817,217,2818,2,0
20150105.210057,2818,6,22812,2,2818,19,2819,314,0
20150105.210058,2819,30,22842,18,2818,6,2819,269,1
20150105.210058,2818,26,22868,4,2818,91,2819,262,0
20150105.210059,2818,20,22888,0,2818,83,2819,265,0
20150105.210059,2818,52,22940,-42,2818,61,2819,415,0
20150105.2101,2818,14,22954,-2,2818,128,2819,412,0
20150105.2101,2818,52,23006,-36,2818,108,2819,409,0
20150105.210101,2818,12,23018,0,2818,129,2819,412,0
20150105.210101,2819,42,23060,2,2818,159,2819,417,1
20150105.210102,2818,370,23430,98,2817,316,2818,82,0
20150105.210102,2818,18,23448,-4,2817,366,2818,86,0
20150105.210103,2818,172,23620,-140,2818,1,2819,410,0
20150105.210103,2818,228,23848,-126,2817,373,2818,1,0
20150105.210104,2818,38,23886,-16,2817,373,2818,6,0
20150105.210104,2818,100,23986,34,2817,372,2819,409,0
20150105.210105,2819,32,24018,8,2817,317,2819,462,1
20150105.210106,2818,8,24026,-4,2817,317,2818,55,0
20150105.210106,2817,10,24036,-10,2817,312,2818,56,0
20150105.210107,2817,28,24064,-22,2817,310,2818,51,0
20150105.210107,2818,40,24104,20,2817,310,2818,38,1
20150105.210108,2818,4,24108,0,2817,311,2818,158,1
20150105.210108,2818,370,24478,-2,2818,24,2819,472,1
20150105.210109,2818,82,24560,-6,2817,317,2818,57,1
20150105.210109,2818,22,24582,22,2817,317,2818,62,1
20150105.21011,2818,8,24590,6,2817,316,2818,93,1
20150105.210111,2818,2,24592,0,2817,816,2818,122,1
20150105.210111,2818,234,24826,226,2817,816,2818,60,1
20150105.210112,2819,188,25014,166,2818,30,2819,458,1
20150105.210112,2818,2,25016,0,2818,42,2819,457,0
20150105.210113,2818,16,25032,6,2818,101,2819,478,0
20150105.210113,2818,34,25066,12,2818,137,2819,476,0
20150105.210114,2819,62,25128,18,2818,122,2819,472,1
20150105.210114,2819,264,25392,-216,2817,822,2818,1,1
20150105.210115,2818,10,25402,2,2818,3,2819,465,0
20150105.210115,2819,18,25420,8,2817,821,2819,469,1
20150105.210116,2818,288,25708,68,2817,821,2818,322,0
20150105.210116,2818,32,25740,8,2817,821,2818,312,0
20150105.210117,2818,4,25744,4,2817,823,2818,310,0
20150105.210117,2817,14,25758,4,2817,820,2818,305,0
20150105.210118,2817,2,25760,-2,2817,818,2818,307,0
20150105.210118,2818,62,25822,16,2817,817,2818,279,1
20150105.210119,2818,64,25886,26,2817,836,2818,257,1
20150105.210119,2818,8,25894,4,2817,845,2818,755,1
20150105.21012,2817,2,25896,2,2817,843,2818,757,0
20150105.21012,2818,2,25898,2,2817,845,2818,757,1
20150105.210121,2818,16,25914,16,2817,848,2818,750,1
20150105.210122,2818,10,25924,8,2817,843,2818,749,1
20150105.210122,2818,4,25928,2,2817,842,2818,749,1
20150105.210123,2817,40,25968,30,2817,827,2818,762,0
20150105.210123,2818,12,25980,10,2817,827,2818,763,1
20150105.210124,2817,14,25994,0,2817,825,2818,949,0
20150105.210124,2818,308,26302,8,2817,825,2818,804,1
20150105.210126,2817,116,26418,80,2817,785,2818,816,0
20150105.210126,2818,20,26438,14,2817,783,2818,818,1
20150105.210127,2817,12,26450,4,2817,774,2818,849,0
20150105.210128,2817,4,26454,2,2817,772,2818,860,0
20150105.210128,2817,8,26462,8,2817,768,2818,861,0
20150105.210129,2817,4,26466,2,2817,766,2818,860,0
20150105.21013,2817,26,26492,0,2817,758,2818,1071,0
20150105.210131,2817,6,26498,2,2817,736,2818,1077,0
20150105.210132,2817,2,26500,0,2817,730,2818,1098,0
20150105.210132,2817,4,26504,2,2817,1279,2818,1111,0
20150105.210133,2817,214,26718,36,2817,1173,2818,1116,0
20150105.210133,2817,12,26730,-12,2817,1169,2818,1121,0
20150105.210134,2818,20,26750,16,2817,1169,2818,1112,1
20150105.210134,2817,10,26760,-4,2817,1165,2818,1111,0
20150105.210135,2817,2,26762,-2,2817,1164,2818,1111,0
20150105.210136,2818,22,26784,18,2817,1170,2818,1116,1
20150105.210136,2817,2,26786,-2,2817,1175,2818,1216,0
20150105.210137,2817,2,26788,0,2817,1174,2818,1218,0
20150105.210138,2817,4,26792,-4,2817,1172,2818,1219,0
20150105.210139,2817,212,27004,-160,2817,1079,2818,1216,0
20150105.210139,2817,2,27006,-2,2817,1090,2818,1216,0
20150105.210139,2818,4,27010,4,2817,1090,2818,1215,1
20150105.21014,2817,10,27020,0,2817,1087,2818,1220,0
20150105.210141,2817,62,27082,-58,2817,1061,2818,1217,0
20150105.210141,2817,40,27122,-40,2817,1040,2818,1220,0
20150105.210142,2817,4,27126,0,2817,1038,2818,1122,0
20150105.210142,2817,200,27326,-200,2817,937,2818,1128,0
20150105.210143,2817,22,27348,-14,2817,926,2818,1139,0
20150105.210143,2818,12,27360,0,2817,921,2818,1135,1
20150105.210144,2817,14,27374,-4,2817,917,2818,1152,0
20150105.210144,2817,14,27388,-2,2817,911,2818,1193,0
20150105.210145,2817,6,27394,-6,2817,903,2818,1196,0
20150105.210145,2817,12,27406,-8,2817,937,2818,1201,0
20150105.210145,2817,6,27412,-4,2817,934,2818,1201,0
20150105.210146,2818,32,27444,14,2817,943,2818,1422,1
20150105.210147,2817,50,27494,-30,2817,926,2818,1423,0
20150105.210147,2817,58,27552,-10,2817,897,2818,1427,0
20150105.210148,2818,322,27874,-92,2817,768,2818,1407,1
20150105.210149,2818,96,27970,-52,2817,722,2818,1402,1
20150105.210149,2817,18,27988,0,2817,713,2818,1379,0
20150105.210149,2817,14,28002,-6,2817,715,2818,1379,0
20150105.21015,2817,2,28004,0,2817,720,2818,1376,0
20150105.210151,2817,4,28008,0,2817,719,2818,1390,0
20150105.210152,2818,8,28016,0,2817,718,2818,1392,1
20150105.210152,2818,18,28034,0,2817,739,2818,1389,1
20150105.210153,2818,26,28060,0,2817,728,2818,1388,1
20150105.210154,2817,10,28070,0,2817,755,2818,1384,0
20150105.210156,2817,6,28076,6,2817,754,2818,1385,0
20150105.210156,2818,2,28078,0,2817,255,2818,1388,1
20150105.210157,2817,64,28142,56,2817,324,2818,1387,0
20150105.210157,2817,82,28224,0,2817,284,2818,1393,0
20150105.210158,2817,614,28838,-348,2817,182,2818,1188,0
20150105.210158,2817,14,28852,10,2817,176,2818,1188,0
20150105.210159,2817,42,28894,-16,2817,165,2818,1178,0
20150105.210159,2817,64,28958,32,2817,145,2818,1178,0
20150105.2102,2818,18,28976,0,2817,145,2818,1169,1
20150105.2102,2817,28,29004,24,2817,136,2818,1172,0
20150105.210201,2817,4,29008,0,2817,135,2818,1172,0
20150105.210201,2817,94,29102,90,2817,125,2818,1182,0
20150105.210202,2817,16,29118,6,2817,117,2818,1176,0
20150105.210202,2818,32,29150,22,2817,106,2818,1185,1
20150105.210203,2817,82,29232,2,2817,108,2818,1153,0
20150105.210203,2817,2,29234,2,2817,107,2818,1153,0
20150105.210204,2817,2,29236,0,2817,106,2818,1158,0
20150105.210205,2817,4,29240,2,2817,105,2818,1178,0
20150105.210205,2818,10,29250,-6,2817,104,2818,1174,1
20150105.210206,2817,8,29258,0,2817,102,2818,1179,0
20150105.210206,2818,14,29272,0,2817,116,2818,1176,1
20150105.210207,2818,2,29274,0,2817,116,2818,1175,1
20150105.210208,2817,8,29282,0,2817,122,2818,1180,0
20150105.210209,2818,2,29284,0,2817,122,2818,1187,1
20150105.210209,2817,2,29286,2,2817,123,2818,1187,0
20150105.210209,2817,76,29362,-4,2817,105,2818,1167,0
20150105.21021,2818,4,29366,0,2817,105,2818,1169,1
20150105.210211,2817,10,29376,4,2817,103,2818,1166,0
20150105.210211,2818,4,29380,-4,2817,104,2818,1164,1
20150105.210212,2817,24,29404,14,2817,98,2818,1196,0
20150105.210213,2817,8,29412,-2,2817,94,2818,1201,0
20150105.210213,2817,4,29416,0,2817,93,2818,1201,0
20150105.210213,2818,144,29560,98,2817,22,2818,1210,1
20150105.210214,2817,4,29564,0,2817,21,2818,1262,0
20150105.210215,2818,90,29654,4,2817,20,2818,1219,1
20150105.210216,2817,48,29702,-6,2817,4,2818,1215,0
20150105.210216,2818,2,29704,0,2817,5,2818,1214,1
20150105.210217,2817,4,29708,2,2817,54,2818,1221,0
20150105.210218,2817,2,29710,0,2817,61,2818,1226,0
20150105.210219,2818,6,29716,-6,2817,63,2818,1238,1
20150105.210219,2818,568,30284,-86,2816,585,2818,1097,1
20150105.21022,2817,40,30324,-20,2817,1,2818,1166,0
20150105.21022,2816,10,30334,2,2816,584,2818,1166,0
20150105.210221,2817,24,30358,-22,2816,636,2817,11,1
20150105.210221,2817,30,30388,0,2817,10,2818,1087,1
20150105.210222,2817,22,30410,-4,2816,629,2817,24,1
20150105.210223,2817,2,30412,2,2816,630,2817,88,1
20150105.210223,2817,10,30422,8,2816,627,2817,95,1
20150105.210224,2817,24,30446,12,2816,618,2817,94,1
20150105.210225,2816,22,30468,2,2816,608,2817,112,0
20150105.210225,2817,28,30496,4,2816,608,2817,174,1
20150105.210226,2817,2,30498,0,2816,608,2817,173,1
20150105.210226,2817,10,30508,10,2816,605,2817,175,1
20150105.210227,2816,6,30514,4,2816,594,2817,177,0
20150105.210228,2816,20,30534,18,2816,586,2817,161,0
20150105.210229,2816,22,30556,16,2816,585,2817,159,0
20150105.21023,2817,8,30564,-2,2816,591,2817,132,1
20150105.21023,2816,2,30566,2,2816,526,2817,167,0
20150105.210231,2816,12,30578,2,2816,521,2817,230,0
20150105.210231,2816,32,30610,0,2816,511,2817,224,0
20150105.210232,2817,4,30614,0,2816,511,2817,225,1
20150105.210232,2816,2,30616,2,2816,508,2817,227,0
20150105.210233,2817,8,30624,-4,2816,506,2817,223,1
20150105.210233,2816,14,30638,-6,2816,597,2817,223,0
20150105.210234,2817,126,30764,2,2816,545,2817,218,1
20150105.210235,2816,12,30776,12,2816,540,2817,210,0
20150105.210235,2816,4,30780,0,2816,540,2817,210,0
20150105.210236,2816,6,30786,4,2816,539,2817,209,0
20150105.210236,2816,4,30790,4,2816,537,2817,220,0
20150105.210237,2816,86,30876,-66,2816,543,2817,254,0
20150105.210238,2816,70,30946,0,2816,508,2817,253,0
20150105.210238,2816,114,31060,0,2816,456,2817,259,0
20150105.210239,2816,8,31068,0,2816,453,2817,262,0
20150105.210239,2817,22,31090,4,2816,453,2817,252,1
20150105.21024,2816,126,31216,-82,2816,403,2817,269,0
20150105.21024,2816,76,31292,6,2816,403,2817,232,0
20150105.210241,2817,76,31368,46,2816,406,2817,201,1
20150105.210241,2817,10,31378,6,2816,406,2817,196,1
20150105.210242,2817,14,31392,6,2816,402,2817,212,1
20150105.210242,2816,4,31396,-4,2816,405,2817,211,0
20150105.210243,2816,4,31400,0,2816,406,2817,319,0
20150105.210244,2817,60,31460,60,2816,409,2817,290,1
20150105.210244,2817,32,31492,24,2816,404,2817,280,1
20150105.210245,2816,100,31592,-12,2816,355,2817,280,0
20150105.210245,2817,4,31596,4,2816,374,2817,280,1
20150105.210246,2816,80,31676,0,2816,346,2817,282,0
20150105.210246,2817,108,31784,20,2816,344,2817,230,1
20150105.210247,2817,34,31818,4,2816,468,2817,224,1
20150105.210248,2817,4,31822,4,2816,468,2817,423,1
20150105.210249,2817,60,31882,-2,2816,469,2817,397,1
20150105.21025,2817,8,31890,2,2816,470,2817,419,1
20150105.21025,2817,126,32016,-24,2816,408,2817,419,1
20150105.210251,2817,4,32020,-2,2816,418,2817,425,1
20150105.210251,2817,40,32060,12,2816,419,2817,407,1
20150105.210252,2816,2,32062,0,2816,428,2817,407,0
20150105.210253,2816,4,32066,0,2816,447,2817,407,0
20150105.210253,2817,4,32070,2,2816,446,2817,409,1
20150105.210254,2817,14,32084,6,2816,447,2817,402,1
20150105.210254,2816,106,32190,-48,2816,427,2817,422,0
20150105.210256,2817,6,32196,-2,2816,452,2817,426,1
20150105.210257,2817,26,32222,8,2816,453,2817,421,1
20150105.210258,2816,10,32232,0,2816,453,2817,417,0
20150105.210259,2816,100,32332,-38,2816,404,2817,420,0
20150105.210259,2817,6,32338,6,2816,404,2817,418,1
20150105.2103,2817,16,32354,10,2816,400,2817,418,1
20150105.2103,2817,26,32380,26,2816,400,2817,455,1
20150105.210301,2817,34,32414,10,2816,399,2817,440,1
20150105.210301,2817,8,32422,8,2816,398,2817,436,1
20150105.210302,2817,24,32446,20,2816,397,2817,430,1
20150105.210302,2817,14,32460,12,2816,400,2817,424,1
20150105.210303,2816,110,32570,2,2816,349,2817,421,0
20150105.210303,2817,8,32578,2,2816,350,2817,417,1
20150105.210304,2817,32,32610,20,2816,349,2817,405,1
20150105.210304,2817,228,32838,-102,2816,256,2817,394,1
20150105.210305,2816,26,32864,20,2816,257,2817,393,0
20150105.210305,2816,10,32874,10,2816,252,2817,393,0
20150105.210306,2817,420,33294,304,2816,255,2817,188,1
20150105.210306,2817,12,33306,4,2816,258,2817,189,1
20150105.210307,2816,2,33308,0,2816,258,2817,189,0
20150105.210307,2816,404,33712,-264,2816,58,2817,201,0
20150105.21031,2816,32,33744,10,2816,176,2817,234,0
20150105.210311,2817,20,33764,20,2816,193,2817,229,1
20150105.210311,2817,2,33766,2,2816,199,2817,232,1
20150105.210313,2816,206,33972,130,2816,100,2817,269,0
20150105.210313,2817,200,34172,188,2816,103,2817,172,1
20150105.210314,2817,2,34174,2,2816,118,2817,201,1
20150105.210314,2816,12,34186,4,2816,113,2817,201,0
20150105.210314,2816,4,34190,2,2816,114,2817,200,0
20150105.210315,2816,64,34254,2,2816,91,2817,171,0
20150105.210315,2816,2,34256,0,2816,92,2817,178,0
20150105.210316,2816,2,34258,0,2816,94,2817,189,0
20150105.210318,2817,6,34264,4,2816,101,2817,208,1
20150105.210318,2816,4,34268,0,2816,178,2817,241,0
20150105.210319,2816,52,34320,24,2816,175,2817,180,0
20150105.210319,2816,2,34322,2,2816,174,2817,180,0
20150105.21032,2816,52,34374,44,2816,150,2817,182,0
20150105.21032,2817,18,34392,14,2816,153,2817,175,1
20150105.210321,2817,6,34398,0,2816,153,2817,195,1
20150105.210322,2816,24,34422,10,2816,142,2817,251,0
20150105.210322,2817,2,34424,-2,2816,141,2817,250,1
20150105.210324,2816,14,34438,-6,2816,146,2817,261,0
20150105.210324,2817,20,34458,0,2816,149,2817,254,1
20150105.210325,2816,100,34558,38,2816,103,2817,284,0
20150105.210325,2816,2,34560,0,2816,103,2817,286,0
20150105.210326,2816,2,34562,0,2816,102,2817,288,0
20150105.210326,2817,2,34564,0,2816,104,2817,292,1
20150105.210327,2817,24,34588,-2,2816,112,2817,281,1
20150105.210328,2816,2,34590,-2,2816,117,2817,269,0
20150105.210329,2816,4,34594,-4,2816,148,2817,239,0
20150105.210329,2816,10,34604,-10,2816,144,2817,239,0
20150105.21033,2817,20,34624,10,2816,144,2817,228,1
20150105.21033,2816,2,34626,-2,2816,145,2817,229,0
20150105.210331,2816,6,34632,-6,2816,144,2817,273,0
20150105.210332,2816,272,34904,130,2816,32,2817,222,0
20150105.210332,2816,2,34906,2,2816,31,2817,221,0
20150105.210333,2817,2,34908,0,2816,32,2817,220,1
20150105.210334,2816,2,34910,0,2816,331,2817,248,0
20150105.210334,2816,8,34918,8,2816,328,2817,280,0
20150105.210335,2817,32,34950,12,2816,329,2817,233,1
20150105.210336,2817,102,35052,-100,2816,345,2817,185,1
20150105.210336,2816,2,35054,2,2816,346,2817,184,0
20150105.210337,2817,4,35058,4,2816,371,2817,182,1
20150105.210338,2817,10,35068,10,2816,384,2817,188,1
20150105.210338,2817,76,35144,-26,2816,381,2817,157,1
20150105.210339,2817,12,35156,12,2816,392,2817,154,1
20150105.210339,2816,20,35176,0,2816,395,2817,155,0
20150105.21034,2817,30,35206,30,2816,395,2817,142,1
20150105.21034,2817,16,35222,16,2816,394,2817,139,1
20150105.210341,2816,104,35326,-88,2816,376,2817,179,0
20150105.210342,2817,4,35330,4,2816,387,2817,177,1
20150105.210342,2817,108,35438,2,2816,387,2817,126,1
20150105.210343,2817,12,35450,6,2816,390,2817,121,1
20150105.210343,2817,102,35552,0,2816,354,2817,71,1
20150105.210344,2817,142,35694,74,2817,145,2818,1450,1
20150105.210344,2818,6,35700,0,2817,208,2818,1449,1
20150105.210346,2817,8,35708,8,2817,265,2818,1372,0
20150105.210346,2817,24,35732,0,2817,253,2818,1372,0
20150105.210347,2818,2,35734,0,2817,254,2818,1371,1
20150105.210347,2817,12,35746,2,2817,253,2818,1366,0
20150105.210348,2817,28,35774,0,2817,252,2818,1444,0
20150105.210349,2818,2,35776,0,2817,254,2818,1446,1
20150105.210349,2818,2,35778,-2,2817,255,2818,1440,1
20150105.21035,2818,8,35786,2,2817,266,2818,1474,1
20150105.210351,2818,4,35790,0,2817,266,2818,1473,1
20150105.210351,2817,6,35796,-2,2817,244,2818,1456,0
20150105.210351,2817,2,35798,0,2817,245,2818,1409,0
20150105.210352,2817,40,35838,40,2817,227,2818,1409,0
20150105.210352,2817,8,35846,-6,2817,226,2818,1406,0
20150105.210353,2818,24,35870,2,2817,220,2818,1400,1
20150105.210354,2818,86,35956,-62,2817,209,2818,1419,1
20150105.210354,2818,236,36192,-236,2817,209,2818,1302,1
20150105.210355,2818,314,36506,-256,2817,223,2818,1336,1
20150105.210356,2817,6,36512,2,2817,226,2818,1316,0
20150105.210357,2818,12,36524,2,2817,226,2818,1304,1
20150105.210358,2818,6,36530,6,2817,227,2818,1293,1
20150105.210358,2818,8,36538,-4,2817,233,2818,1287,1
20150105.210359,2817,6,36544,4,2817,240,2818,1275,0
20150105.2104,2817,4,36548,2,2817,258,2818,1269,0
20150105.210401,2818,2,36550,0,2817,279,2818,1269,1
20150105.210401,2818,8,36558,4,2817,281,2818,1255,1
20150105.210402,2818,8,36566,-6,2817,328,2818,1253,1
20150105.210403,2818,6,36572,0,2817,330,2818,1249,1
20150105.210404,2817,8,36580,0,2817,341,2818,1254,0
20150105.210405,2818,28,36608,6,2817,342,2818,1246,1
20150105.210405,2818,22,36630,0,2817,343,2818,1232,1
20150105.210406,2818,12,36642,2,2817,348,2818,1225,1
20150105.210407,2818,26,36668,2,2817,348,2818,1212,1
20150105.210407,2817,224,36892,-4,2817,238,2818,1249,0
20150105.210408,2817,6,36898,2,2817,237,2818,1247,0
20150105.210408,2818,14,36912,0,2817,228,2818,1184,1
20150105.210409,2818,46,36958,-40,2817,228,2818,1162,1
20150105.210409,2818,14,36972,0,2817,227,2818,1144,1
20150105.21041,2817,6,36978,2,2817,225,2818,1143,0
20150105.210411,2817,2,36980,2,2817,226,2818,1142,0
20150105.210412,2817,8,36988,-2,2817,225,2818,1139,0
20150105.210413,2817,2,36990,2,2817,224,2818,1138,0
20150105.210413,2818,4,36994,0,2817,224,2818,1136,1
20150105.210413,2818,32,37026,0,2817,209,2818,1132,1
20150105.210414,2817,2,37028,0,2817,208,2818,1131,0
20150105.210415,2818,2,37030,0,2817,208,2818,1132,1
20150105.210416,2817,2,37032,2,2817,208,2818,1132,0
20150105.210416,2818,2,37034,-2,2817,308,2818,1140,1
20150105.210417,2818,36,37070,-12,2817,308,2818,1109,1
20150105.210417,2817,10,37080,0,2817,304,2818,1112,0
20150105.210418,2817,144,37224,-30,2817,231,2818,1142,0
20150105.210418,2817,2,37226,0,2817,251,2818,1142,0
20150105.21042,2817,22,37248,0,2817,454,2818,1135,0
20150105.210421,2817,52,37300,-48,2817,454,2818,1105,0
20150105.210422,2817,12,37312,2,2817,454,2818,1101,0
20150105.210424,2817,4,37316,4,2817,464,2818,1097,0
20150105.210425,2817,120,37436,20,2817,482,2818,1071,0
20150105.210426,2817,2,37438,2,2817,481,2818,1071,0
20150105.210427,2817,2,37440,2,2817,480,2818,1072,0
20150105.210427,2817,2,37442,0,2817,479,2818,1080,0
20150105.210428,2817,12,37454,10,2817,576,2818,1085,0
20150105.210428,2817,132,37586,-82,2817,515,2818,1085,0
20150105.210429,2818,2,37588,0,2817,520,2818,1087,1
20150105.210429,2817,8,37596,8,2817,516,2818,1087,0
20150105.21043,2818,30,37626,-8,2817,510,2818,1080,1
20150105.21043,2818,38,37664,-20,2817,509,2818,1078,1
20150105.210431,2818,4,37668,2,2817,509,2818,1083,1
20150105.210432,2818,2,37670,0,2817,511,2818,1171,1
20150105.210434,2818,216,37886,-96,2817,416,2818,1267,1
20150105.210434,2817,40,37926,-40,2817,396,2818,1267,0
20150105.210435,2818,106,38032,-44,2817,344,2818,1305,1
20150105.210436,2817,2,38034,0,2817,393,2818,1350,0
20150105.210436,2817,8,38042,0,2817,396,2818,1351,0
20150105.210438,2818,6,38048,0,2817,394,2818,1633,1
20150105.210439,2817,2,38050,0,2817,393,2818,1634,0
20150105.21044,2817,70,38120,64,2817,367,2818,1631,0
20150105.210441,2817,2,38122,0,2817,366,2818,2682,0
20150105.210442,2817,8,38130,0,2817,376,2818,1652,0
20150105.210443,2817,2,38132,0,2817,375,2818,1652,0
20150105.210443,2818,20,38152,0,2817,375,2818,1643,1
20150105.210444,2818,6,38158,2,2817,376,2818,1631,1
20150105.210445,2818,2,38160,0,2817,374,2818,1640,1
20150105.210446,2817,10,38170,0,2817,368,2818,1642,0
20150105.210447,2817,78,38248,8,2817,332,2818,1629,0
20150105.210448,2817,6,38254,0,2817,336,2818,1669,0
20150105.210449,2817,8,38262,8,2817,333,2818,1672,0
20150105.21045,2818,4,38266,0,2817,334,2818,1618,1
20150105.21045,2818,8,38274,0,2817,334,2818,1614,1
20150105.210451,2817,4,38278,0,2817,332,2818,1614,0
20150105.210452,2817,2,38280,2,2817,331,2818,1622,0
20150105.210452,2817,4,38284,0,2817,329,2818,1642,0
20150105.210453,2818,12,38296,4,2817,329,2818,1637,1
20150105.210454,2818,8,38304,-8,2817,369,2818,1606,1
20150105.210454,2818,2,38306,0,2817,373,2818,1624,1
20150105.210455,2817,10,38316,0,2817,368,2818,1624,0
20150105.210455,2818,2,38318,0,2817,368,2818,1623,1
20150105.210456,2817,2,38320,2,2817,367,2818,1602,0
20150105.210457,2817,14,38334,10,2817,375,2818,1604,0
20150105.210458,2817,40,38374,0,2817,355,2818,1604,0
20150105.210458,2817,6,38380,6,2817,352,2818,1604,0
20150105.210459,2817,210,38590,8,2817,348,2818,1605,0
20150105.210459,2818,4,38594,2,2817,391,2818,1603,1
20150105.2105,2817,8,38602,0,2817,385,2818,1862,0
20150105.210501,2818,44,38646,44,2817,376,2818,1860,1
20150105.210501,2817,2,38648,2,2817,375,2818,1865,0
20150105.210501,2818,10,38658,4,2817,371,2818,1852,1
20150105.210502,2818,6,38664,0,2817,371,2818,1855,1
20150105.210504,2817,4,38668,2,2817,385,2818,1855,0
20150105.210505,2818,2,38670,0,2817,386,2818,1861,1
20150105.210506,2817,8,38678,0,2817,383,2818,1860,0
20150105.210506,2817,2,38680,2,2817,384,2818,1865,0
20150105.210507,2817,124,38804,108,2817,335,2818,1853,0
20150105.210507,2818,2,38806,0,2817,336,2818,1852,1
20150105.210508,2817,602,39408,-146,2817,36,2818,1856,0
20150105.210508,2817,74,39482,-10,2816,428,2817,20,0
20150105.210509,2817,22,39504,22,2816,428,2817,111,0
20150105.210509,2817,80,39584,-6,2816,528,2817,320,0
20150105.21051,2817,530,40114,-168,2816,527,2817,55,0
20150105.210511,2816,2,40116,0,2816,527,2817,67,0
20150105.210513,2817,2,40118,0,2816,530,2817,123,1
20150105.210514,2816,2,40120,-2,2816,530,2817,222,0
20150105.210516,2817,2,40122,0,2816,530,2817,292,1
20150105.210517,2817,2,40124,0,2816,544,2817,415,1
20150105.210518,2817,4,40128,2,2816,544,2817,420,1
20150105.210519,2817,2,40130,-2,2816,564,2817,416,1
20150105.210519,2817,30,40160,-8,2816,564,2817,411,1
20150105.210522,2816,4,40164,0,2816,1025,2817,385,0
20150105.210523,2816,2,40166,-2,2816,1024,2817,390,0
20150105.210523,2817,56,40222,-52,2816,997,2817,417,1
20150105.210524,2816,30,40252,-2,2816,992,2817,389,0
20150105.210525,2817,12,40264,12,2816,1015,2817,384,1
20150105.210526,2817,100,40364,-2,2816,1025,2817,334,1
20150105.210528,2816,2,40366,0,2816,1023,2817,418,0
20150105.21053,2816,14,40380,-4,2816,1020,2817,443,0
20150105.21053,2816,70,40450,0,2816,985,2817,443,0
20150105.210531,2817,2,40452,0,2816,990,2817,439,1
20150105.210531,2816,22,40474,-20,2816,980,2817,439,0
20150105.210532,2816,2,40476,0,2816,980,2817,434,0
20150105.210532,2816,10,40486,-2,2816,978,2817,436,0
20150105.210533,2817,4,40490,2,2816,977,2817,511,1
20150105.210533,2817,158,40648,-132,2816,987,2817,439,1
20150105.210535,2816,6,40654,0,2816,994,2817,445,0
20150105.210535,2816,2,40656,0,2816,993,2817,442,0
20150105.210536,2817,4,40660,-2,2816,994,2817,442,1
20150105.210536,2817,4,40664,0,2816,998,2817,441,1
20150105.210537,2816,32,40696,-32,2816,1277,2817,437,0
20150105.210538,2816,2,40698,-2,2816,1276,2817,445,0
20150105.210539,2817,2,40700,0,2816,1278,2817,438,1
20150105.21054,2816,4,40704,0,2816,1276,2817,456,0
20150105.210541,2816,8,40712,-6,2816,1274,2817,521,0
20150105.210543,2816,2,40714,0,2816,1271,2817,542,0
20150105.210543,2817,2,40716,0,2816,1271,2817,541,1
20150105.210544,2817,4,40720,-2,2816,1270,2817,539,1
20150105.210545,2816,100,40820,-100,2816,1220,2817,539,0
20150105.210545,2817,40,40860,0,2816,1220,2817,519,1
20150105.210546,2817,30,40890,0,2816,1209,2817,514,1
20150105.210546,2816,4,40894,-2,2816,1227,2817,507,0
20150105.210547,2817,676,41570,208,2816,1227,2817,169,1
20150105.210548,2816,10,41580,2,2816,1228,2817,165,0
20150105.210549,2816,18,41598,-10,2816,1221,2817,328,0
20150105.210549,2817,6,41604,-2,2816,1221,2817,330,1
20150105.210551,2817,4,41608,-2,2816,1221,2817,354,1
20150105.210551,2817,2,41610,0,2816,1222,2817,352,1
20150105.210552,2817,6,41616,4,2816,1227,2817,379,1
20150105.210552,2816,24,41640,-24,2816,1215,2817,380,0
20150105.210553,2817,18,41658,6,2816,1215,2817,381,1
20150105.210554,2817,10,41668,0,2816,1215,2817,379,1
20150105.210555,2816,20,41688,0,2816,1207,2817,380,0
20150105.210556,2817,80,41768,6,2816,1211,2817,392,1
20150105.210557,2816,16,41784,6,2816,1207,2817,407,0
20150105.210558,2817,802,42586,364,2817,337,2818,2127,1
20150105.210559,2817,100,42686,0,2817,487,2818,2127,1
20150105.2106,2817,156,42842,156,2817,434,2818,2107,1
20150105.210601,2817,8,42850,-2,2817,431,2818,2101,1
20150105.210602,2817,18,42868,2,2817,232,2818,2125,1
20150105.210602,2817,10,42878,-10,2817,230,2818,2124,1
20150105.210602,2817,2,42880,-2,2817,229,2818,2128,1
20150105.210603,2817,2,42882,0,2817,243,2818,2128,1
20150105.210604,2817,4,42886,0,2817,241,2818,2128,1
20150105.210604,2817,52,42938,0,2817,215,2818,2122,1
20150105.210605,2817,6,42944,0,2817,212,2818,2127,1
20150105.210606,2817,14,42958,-14,2817,206,2818,2132,1
20150105.210607,2817,2,42960,0,2817,205,2818,2132,1
20150105.210607,2817,4,42964,0,2817,204,2818,2131,1
20150105.210608,2817,2,42966,-2,2817,204,2818,2131,1
20150105.210608,2817,4,42970,-4,2817,203,2818,2136,1
20150105.210609,2817,4,42974,-4,2817,201,2818,2136,1
20150105.21061,2817,4,42978,0,2817,200,2818,2122,1
20150105.210611,2817,96,43074,-38,2817,167,2818,2124,1
20150105.210612,2817,44,43118,-14,2817,147,2818,2129,1
20150105.210612,2818,28,43146,-26,2817,144,2818,2129,1
20150105.210614,2818,2,43148,-2,2817,162,2818,2128,1
20150105.210614,2817,52,43200,-50,2817,136,2818,2129,0
20150105.210614,2818,120,43320,0,2817,86,2818,2218,1
20150105.210615,2817,4,43324,0,2817,85,2818,2218,0
20150105.210616,2818,30,43354,-28,2817,93,2818,2214,1
20150105.210617,2817,14,43368,4,2817,86,2818,2215,0
20150105.210617,2818,2,43370,0,2817,106,2818,2214,1
20150105.210618,2817,26,43396,0,2817,91,2818,2216,0
20150105.210618,2818,2,43398,-2,2817,93,2818,2213,1
20150105.210618,2818,2,43400,-2,2817,93,2818,2212,1
20150105.210619,2818,2,43402,0,2817,100,2818,2217,1
20150105.21062,2818,20,43422,-20,2817,103,2818,2207,1
20150105.210621,2817,148,43570,-48,2817,33,2818,2205,0
20150105.210623,2818,8,43578,6,2817,36,2818,2205,1
20150105.210623,2817,54,43632,-4,2817,9,2818,2205,0
20150105.210624,2818,2,43634,0,2817,9,2818,2209,1
20150105.210625,2818,20,43654,-20,2817,10,2818,2201,1
20150105.210627,2817,20,43674,20,2816,1219,2817,46,0
20150105.210627,2817,4,43678,4,2816,1220,2817,45,0
20150105.210629,2817,2,43680,0,2816,1210,2817,45,0
20150105.210629,2817,20,43700,20,2816,1211,2817,38,0
20150105.21063,2817,2,43702,2,2816,1212,2817,46,0
20150105.21063,2817,14,43716,14,2816,1212,2817,44,0
20150105.210631,2817,2,43718,0,2816,1211,2817,48,0
20150105.210631,2817,30,43748,0,2816,1216,2817,33,0
20150105.210632,2817,2,43750,2,2816,1216,2817,33,0
20150105.210633,2817,2,43752,0,2816,1218,2817,32,0
20150105.210634,2817,50,43802,0,2816,1221,2817,8,0
20150105.210634,2817,8,43810,0,2816,1222,2817,5,0
20150105.210636,2817,20,43830,-6,2817,36,2818,2227,0
20150105.210636,2817,94,43924,-94,2817,1,2818,2228,0
20150105.210637,2817,10,43934,-2,2817,194,2818,2229,0
20150105.210637,2817,346,44280,244,2817,22,2818,2213,0
20150105.210638,2817,2,44282,2,2817,26,2818,2214,0
20150105.210639,2817,4,44286,2,2817,46,2818,2214,0
20150105.210639,2817,4,44290,0,2817,44,2818,2214,0
20150105.210642,2818,2,44292,0,2817,291,2818,2198,1
20150105.210643,2818,12,44304,6,2817,581,2818,2193,1
20150105.210644,2817,2,44306,0,2817,580,2818,2191,0
20150105.210645,2817,10,44316,0,2817,593,2818,2193,0
20150105.210645,2818,2,44318,0,2817,694,2818,2180,1
20150105.210646,2818,4,44322,0,2817,698,2818,2177,1
20150105.210647,2817,10,44332,-4,2817,695,2818,2175,0
20150105.210648,2818,32,44364,2,2817,708,2818,2170,1
20150105.210648,2818,2,44366,0,2817,710,2818,2165,1
20150105.210651,2818,2,44368,0,2817,716,2818,2149,1
20150105.210651,2818,6,44374,0,2817,721,2818,2146,1
20150105.210652,2817,20,44394,12,2817,722,2818,2150,0
20150105.210656,2818,10,44404,0,2817,729,2818,2130,1
20150105.210656,2818,2,44406,0,2817,730,2818,2130,1
20150105.210658,2817,4,44410,0,2817,728,2818,2122,0
20150105.210659,2817,6,44416,2,2817,727,2818,2119,0
20150105.2107,2817,6,44422,-2,2817,725,2818,2124,0
20150105.210701,2818,4,44426,0,2817,724,2818,2159,1
20150105.210702,2818,2,44428,-2,2817,723,2818,2158,1
20150105.210703,2817,6,44434,6,2817,725,2818,2170,0
20150105.210703,2817,52,44486,32,2817,699,2818,2170,0
20150105.210704,2818,4,44490,0,2817,686,2818,2168,1
20150105.210704,2818,18,44508,0,2817,686,2818,2159,1
20150105.210705,2818,30,44538,-6,2817,708,2818,2156,1
20150105.210705,2818,2,44540,0,2817,808,2818,2155,1
20150105.210708,2818,1156,45696,-680,2817,1024,2818,1533,1
20150105.210709,2818,28,45724,-4,2817,1023,2818,1519,1
20150105.210709,2818,200,45924,-198,2817,1024,2818,1293,1
20150105.21071,2818,700,46624,-104,2817,1026,2818,840,1
20150105.210711,2818,346,46970,202,2817,980,2818,667,1
20150105.210711,2818,858,47828,188,2817,980,2818,237,1
20150105.210712,2818,26,47854,-20,2817,978,2818,225,1
20150105.210712,2818,110,47964,8,2817,977,2818,196,1
20150105.210713,2818,12,47976,0,2817,973,2818,194,1
20150105.210713,2818,40,48016,2,2817,972,2818,210,1
20150105.210713,2818,2,48018,0,2817,972,2818,224,1
20150105.210714,2818,162,48180,-18,2817,971,2818,161,1
20150105.210715,2818,154,48334,0,2817,971,2819,978,1
20150105.210715,2818,18,48352,0,2817,997,2819,978,1
20150105.210716,2818,8,48360,0,2817,997,2819,978,1
20150105.210716,2818,24,48384,22,2817,988,2819,1002,1
20150105.210717,2818,2,48386,2,2817,988,2818,69,1
20150105.210717,2818,2,48388,0,2817,989,2818,70,1
20150105.210718,2818,4,48392,0,2817,989,2818,68,1
20150105.210719,2818,22,48414,2,2817,989,2819,1005,1
20150105.21072,2818,12,48426,2,2817,988,2818,61,1
20150105.21072,2818,26,48452,4,2817,989,2819,1038,1
20150105.210722,2818,6,48458,0,2817,999,2819,1038,1
20150105.210723,2818,18,48476,4,2817,1000,2818,36,1
20150105.210724,2818,42,48518,16,2817,1019,2819,1051,1
20150105.210724,2817,174,48692,38,2817,934,2818,38,0
20150105.210724,2818,20,48712,20,2817,934,2818,29,1
20150105.210725,2817,24,48736,4,2817,925,2818,32,0
20150105.210726,2818,6,48742,0,2817,923,2818,45,1
20150105.210726,2818,2,48744,2,2817,928,2818,45,1
20150105.210727,2818,24,48768,12,2817,928,2818,33,1
20150105.210728,2818,8,48776,8,2817,937,2818,23,1
20150105.210729,2818,2,48778,2,2817,938,2818,22,1
20150105.210729,2818,14,48792,14,2817,938,2818,16,1
20150105.210729,2818,2,48794,-2,2817,938,2819,1104,1
20150105.21073,2818,6,48800,-2,2817,941,2819,1105,1
20150105.21073,2818,2,48802,0,2817,941,2819,1105,1
20150105.210731,2818,2,48804,-2,2817,941,2818,9,1
20150105.210732,2818,12,48816,-8,2817,941,2819,1107,1
20150105.210732,2818,4,48820,-2,2817,941,2819,1108,1
20150105.210733,2819,12,48832,2,2817,936,2819,1293,1
20150105.210734,2818,8,48840,-4,2817,936,2818,1,0
20150105.210734,2819,64,48904,0,2817,930,2819,1278,1
20150105.210735,2819,120,49024,-116,2817,872,2819,1273,1
20150105.210735,2818,110,49134,-100,2818,1,2819,1268,0
20150105.210736,2818,2,49136,-2,2817,873,2819,1270,0
20150105.210736,2818,16,49152,4,2817,875,2818,1,0
20150105.210737,2818,8,49160,0,2818,1,2819,1267,0
20150105.210737,2819,22,49182,0,2818,3,2819,1259,1
20150105.210738,2818,32,49214,-24,2817,878,2819,1265,0
20150105.210738,2819,6,49220,-2,2818,16,2819,1266,1
20150105.210739,2818,32,49252,-2,2817,875,2819,1276,0
20150105.210739,2818,2,49254,0,2817,876,2818,30,0
20150105.21074,2818,50,49304,-32,2817,878,2818,6,0
20150105.21074,2818,222,49526,4,2817,869,2818,6,0
20150105.210741,2818,2,49528,0,2817,870,2818,7,0
20150105.210741,2818,12,49540,2,2817,871,2818,19,0
20150105.210742,2818,10,49550,10,2817,872,2818,14,0
20150105.210742,2818,28,49578,4,2817,870,2818,31,0
20150105.210743,2818,4,49582,-2,2817,875,2818,66,0
20150105.210743,2818,10,49592,0,2817,877,2818,92,0
20150105.210744,2818,10,49602,0,2817,872,2818,89,0
20150105.210744,2818,6,49608,-6,2817,873,2818,96,0
20150105.210745,2818,2,49610,0,2817,873,2818,97,0
20150105.210745,2818,4,49614,0,2817,873,2818,97,0
20150105.210747,2818,60,49674,-58,2817,876,2818,72,0
20150105.210747,2818,20,49694,0,2817,981,2818,62,0
20150105.210747,2818,2,49696,-2,2817,981,2818,61,0
20150105.210748,2818,42,49738,-6,2817,985,2818,54,0
20150105.210748,2817,20,49758,0,2817,975,2818,105,0
20150105.21075,2818,4,49762,-2,2817,990,2818,148,1
20150105.210752,2818,114,49876,16,2817,999,2818,108,1
20150105.210752,2817,4,49880,0,2817,998,2818,109,0
20150105.210753,2818,16,49896,-16,2817,998,2818,101,1
20150105.210753,2817,42,49938,0,2817,982,2818,102,0
20150105.210754,2818,4,49942,-4,2817,982,2818,100,1
20150105.210754,2818,2,49944,0,2817,994,2818,111,1
20150105.210755,2818,6,49950,-6,2817,994,2818,108,1
20150105.210756,2818,14,49964,-12,2817,1003,2818,111,1
20150105.210756,2818,2,49966,-2,2817,999,2818,130,1
20150105.210757,2818,48,50014,-2,2817,1000,2818,114,1
20150105.210758,2818,2,50016,0,2817,1001,2818,114,1
20150105.210758,2818,2,50018,0,2817,1002,2818,289,1
20150105.210759,2818,2,50020,0,2817,1002,2818,289,1
20150105.2108,2818,2,50022,-2,2817,1005,2818,288,1
20150105.210801,2818,20,50042,2,2817,1006,2818,291,1
20150105.210801,2817,12,50054,-12,2817,1000,2818,291,0
20150105.210803,2818,22,50076,0,2817,992,2818,304,1
20150105.210803,2818,4,50080,0,2817,992,2818,309,1
20150105.210804,2818,4,50084,0,2817,992,2818,307,1
20150105.210804,2818,200,50284,114,2817,992,2818,207,1
20150105.210806,2818,4,50288,4,2817,1014,2818,477,1
20150105.210807,2817,2,50290,-2,2817,1015,2818,478,0
20150105.210807,2818,40,50330,0,2817,1018,2818,458,1
20150105.210808,2818,2,50332,2,2817,1019,2818,457,1
20150105.210808,2818,32,50364,4,2817,999,2818,455,1
20150105.21081,2818,4,50368,0,2817,1001,2818,455,1
20150105.210811,2818,2,50370,2,2817,1022,2818,454,1
20150105.210811,2817,16,50386,0,2817,1014,2818,457,0
20150105.210813,2818,6,50392,4,2817,1009,2818,454,1
20150105.210813,2818,4,50396,4,2817,1007,2818,453,1
20150105.210813,2818,2,50398,0,2817,1007,2818,452,1
20150105.210814,2818,2,50400,2,2817,1010,2818,451,1
20150105.210814,2818,10,50410,0,2817,1006,2818,446,1
20150105.210815,2818,112,50522,24,2817,994,2818,402,1
20150105.210816,2818,2,50524,2,2817,989,2818,402,1
20150105.210817,2818,2,50526,2,2817,989,2818,405,1
20150105.210818,2818,14,50540,4,2817,991,2818,398,1
20150105.210818,2818,2,50542,0,2817,845,2818,463,1
20150105.210818,2818,12,50554,12,2817,845,2818,459,1
20150105.210819,2817,2,50556,0,2817,844,2818,461,0
20150105.21082,2818,40,50596,40,2817,843,2818,442,1
20150105.210821,2818,2,50598,2,2817,843,2818,441,1
20150105.210822,2818,2,50600,2,2817,843,2818,441,1
20150105.210823,2818,12,50612,12,2817,844,2818,441,1
20150105.210823,2818,4,50616,4,2817,844,2818,441,1
20150105.210825,2818,2,50618,2,2817,845,2818,437,1
20150105.210826,2817,2,50620,-2,2817,844,2818,436,0
20150105.210827,2818,4,50624,4,2817,834,2818,459,1
20150105.210828,2818,20,50644,0,2817,834,2818,449,1
20150105.210828,2818,2,50646,0,2817,834,2818,450,1
20150105.21083,2818,40,50686,38,2817,834,2818,436,1
20150105.21083,2818,120,50806,82,2817,834,2818,375,1
20150105.210833,2817,12,50818,8,2817,835,2818,375,0
20150105.210835,2818,4,50822,2,2817,837,2818,402,1
20150105.210835,2818,2,50824,2,2817,837,2818,400,1
20150105.210836,2817,2,50826,-2,2817,837,2818,404,0
20150105.210836,2818,4,50830,4,2817,837,2818,402,1
20150105.210841,2818,2,50832,2,2817,852,2818,441,1
20150105.210842,2818,2,50834,0,2817,852,2818,440,1
20150105.210843,2817,40,50874,-40,2817,832,2818,457,0
20150105.210846,2818,8,50882,8,2817,834,2818,707,1
20150105.210847,2817,20,50902,0,2817,824,2818,702,0
20150105.210848,2818,2,50904,2,2817,819,2818,704,1
20150105.210852,2818,4,50908,4,2817,821,2818,705,1
20150105.210855,2818,44,50952,0,2817,807,2818,1092,1
20150105.210857,2818,20,50972,0,2817,805,2818,699,1
20150105.210858,2817,24,50996,16,2817,803,2818,692,0
20150105.210859,2818,2,50998,2,2817,803,2818,691,1
20150105.2109,2818,20,51018,20,2817,803,2818,680,1
20150105.210902,2817,2,51020,-2,2817,803,2818,677,0
20150105.210904,2818,12,51032,12,2817,804,2818,677,1
20150105.210905,2817,16,51048,0,2817,797,2818,676,0
20150105.210906,2818,182,51230,142,2817,797,2818,587,1
20150105.210907,2817,4,51234,-4,2817,795,2818,588,0
20150105.210907,2818,40,51274,0,2817,795,2818,573,1
20150105.210908,2818,10,51284,-8,2817,791,2818,574,1
20150105.210908,2818,2,51286,0,2817,791,2818,573,1
20150105.210909,2818,2,51288,-2,2817,792,2818,573,1
20150105.21091,2817,14,51302,0,2817,789,2818,570,0
20150105.21091,2818,2,51304,0,2817,790,2818,569,1
20150105.210911,2817,4,51308,-4,2817,798,2818,580,0
20150105.210912,2818,4,51312,-2,2817,800,2818,588,1
20150105.210913,2818,2,51314,0,2817,803,2818,579,1
20150105.210914,2818,22,51336,0,2817,803,2818,569,1
20150105.210915,2818,22,51358,0,2817,803,2818,560,1
20150105.210915,2817,102,51460,0,2817,802,2818,507,0
20150105.210917,2818,4,51464,0,2817,802,2818,506,1
20150105.21092,2818,204,51668,66,2817,805,2818,404,1
20150105.21092,2818,6,51674,0,2817,807,2818,401,1
20150105.21092,2817,2,51676,0,2817,808,2818,401,0
20150105.210921,2818,12,51688,4,2817,806,2818,397,1
20150105.210922,2817,2,51690,0,2817,812,2818,397,0
20150105.210922,2818,2,51692,2,2817,813,2818,396,1
20150105.210923,2818,2,51694,2,2817,813,2818,397,1
20150105.210924,2818,10,51704,0,2817,817,2818,390,1
20150105.210925,2818,20,51724,0,2817,816,2818,381,1
20150105.210926,2818,40,51764,12,2817,816,2818,374,1
20150105.210928,2818,10,51774,0,2817,816,2818,378,1
20150105.21093,2818,22,51796,2,2817,822,2818,388,1
20150105.210931,2818,36,51832,-36,2817,822,2818,370,1
20150105.210931,2817,38,51870,0,2817,804,2818,372,0
20150105.210932,2818,4,51874,0,2817,803,2818,371,1
20150105.210933,2818,20,51894,0,2817,804,2818,361,1
20150105.210933,2818,2,51896,0,2817,804,2818,361,1
20150105.210934,2818,4,51900,0,2817,808,2818,361,1
20150105.210935,2818,2,51902,0,2817,807,2818,362,1
20150105.210939,2818,6,51908,0,2817,809,2818,561,1
20150105.210939,2818,2,51910,0,2817,809,2818,563,1
20150105.210941,2817,14,51924,0,2817,802,2818,561,0
20150105.210941,2818,20,51944,0,2817,802,2818,561,1
20150105.210944,2818,6,51950,0,2817,803,2818,560,1
20150105.210947,2818,10,51960,0,2817,806,2818,561,1
20150105.210953,2818,10,51970,0,2817,812,2818,577,1
20150105.210954,2818,2,51972,0,2817,1211,2818,572,1
20150105.210955,2818,2,51974,0,2817,1211,2818,571,1
20150105.210959,2818,2,51976,0,2817,1232,2818,361,1
20150105.210959,2817,4,51980,-2,2817,1231,2818,362,0
20150105.211,2818,2,51982,-2,2817,1230,2818,362,1
20150105.211001,2818,10,51992,0,2817,1230,2818,357,1
20150105.211002,2818,4,51996,-4,2817,1225,2818,355,1
20150105.211003,2817,4,52000,-4,2817,1218,2818,316,0
20150105.211005,2817,2,52002,0,2817,1220,2818,327,0
20150105.211006,2818,14,52016,-8,2817,1317,2818,324,1
20150105.211006,2818,4,52020,0,2817,1317,2818,322,1
20150105.211007,2818,2,52022,0,2817,1317,2818,322,1
20150105.211008,2818,14,52036,0,2817,1317,2818,315,1
20150105.211009,2818,2,52038,0,2817,1317,2818,314,1
20150105.211011,2818,2,52040,0,2817,1365,2818,311,1
20150105.211012,2818,2,52042,0,2817,1368,2818,313,1
20150105.211014,2818,120,52162,0,2817,1266,2818,253,1
20150105.211016,2818,2,52164,0,2817,1257,2818,260,1
20150105.211017,2818,2,52166,0,2817,1257,2818,264,1
20150105.211017,2818,2,52168,0,2817,1257,2818,267,1
20150105.211018,2818,2,52170,0,2817,1258,2818,266,1
20150105.211018,2818,18,52188,-12,2817,1259,2818,257,1
20150105.211019,2818,2,52190,-2,2817,1259,2818,257,1
20150105.211021,2818,6,52196,-6,2817,1260,2818,256,1
20150105.211022,2818,6,52202,0,2817,1258,2818,254,1
20150105.211022,2818,32,52234,-12,2817,1247,2818,249,1
20150105.211023,2818,26,52260,0,2817,1247,2818,231,1
20150105.211025,2818,4,52264,-4,2817,1258,2818,226,1
20150105.211026,2817,200,52464,-130,2817,1137,2818,360,0
20150105.211027,2818,2,52466,0,2817,1137,2818,361,1
20150105.211027,2818,40,52506,0,2817,1137,2818,341,1
20150105.211029,2818,2,52508,0,2817,939,2818,384,1
20150105.21103,2818,16,52524,-4,2817,939,2818,377,1
20150105.21103,2817,2,52526,0,2817,938,2818,377,0
20150105.211031,2818,74,52600,-60,2817,938,2818,534,1
20150105.211032,2818,2,52602,2,2817,938,2818,522,1
20150105.211033,2818,2,52604,2,2817,938,2818,518,1
20150105.211033,2817,2,52606,2,2817,937,2818,518,0
20150105.211034,2818,8,52614,8,2817,937,2818,514,1
20150105.211035,2817,12,52626,0,2817,932,2818,513,0
20150105.211043,2818,6,52632,0,2817,934,2818,507,1
20150105.211043,2818,60,52692,-32,2817,954,2818,478,1
20150105.211044,2818,4,52696,0,2817,958,2818,433,1
20150105.211045,2818,6,52702,-6,2817,958,2818,429,1
20150105.211046,2818,2,52704,-2,2817,957,2818,428,1
20150105.211047,2817,4,52708,4,2817,955,2818,420,0
20150105.211047,2817,40,52748,40,2817,935,2818,420,0
20150105.211051,2818,4,52752,-2,2817,933,2818,419,1
20150105.211051,2818,4,52756,0,2817,933,2818,417,1
20150105.211054,2818,10,52766,2,2817,1423,2818,408,1
20150105.211057,2818,12,52778,0,2817,1423,2818,402,1
20150105.211058,2817,462,53240,-296,2817,1424,2819,1057,0
20150105.2111,2817,6,53246,6,2817,1422,2818,195,0
20150105.211101,2818,40,53286,40,2817,1422,2818,182,1
20150105.211103,2818,2,53288,0,2817,1425,2818,186,1
20150105.211103,2818,100,53388,50,2817,1425,2818,138,1
20150105.211104,2817,2,53390,0,2817,1425,2818,138,0
20150105.211104,2818,4,53394,-2,2817,1425,2819,1055,1
20150105.211105,2818,24,53418,0,2817,1425,2819,1055,1
20150105.211107,2818,2,53420,0,2817,1425,2819,1053,1
20150105.211107,2818,4,53424,0,2817,1424,2819,1053,1
20150105.211109,2818,100,53524,0,2817,1425,2819,1058,1
20150105.21111,2818,2,53526,-2,2817,1425,2819,1068,1
20150105.211111,2818,48,53574,42,2817,1404,2819,1070,1
20150105.211113,2818,20,53594,20,2817,1403,2818,845,1
20150105.211114,2818,2,53596,0,2817,1403,2818,839,1
20150105.211114,2817,2,53598,0,2817,1402,2818,839,0
20150105.211118,2817,2,53600,0,2817,1402,2818,947,0
20150105.211118,2817,100,53700,-10,2817,1352,2818,952,0
20150105.211122,2818,60,53760,0,2817,1353,2818,936,1
20150105.211123,2817,20,53780,0,2817,1344,2818,937,0
20150105.211123,2818,6,53786,2,2817,1342,2818,936,1
20150105.211126,2817,2,53788,2,2817,1352,2818,977,0
20150105.211126,2818,2,53790,2,2817,1351,2818,976,1
20150105.211127,2818,60,53850,60,2817,1351,2818,947,1
20150105.211128,2818,4,53854,4,2817,1351,2818,945,1
20150105.211129,2817,14,53868,12,2817,1345,2818,945,0
20150105.211129,2818,4,53872,4,2817,1345,2818,942,1
20150105.211133,2818,4,53876,4,2817,1342,2818,940,1
20150105.211134,2817,20,53896,20,2817,1332,2818,939,0
20150105.211134,2818,2,53898,2,2817,1332,2818,937,1
20150105.211135,2818,2,53900,2,2817,1332,2818,936,1
20150105.211135,2818,2,53902,0,2817,1333,2818,934,1
20150105.211136,2818,4,53906,4,2817,1343,2818,934,1
20150105.211138,2818,2,53908,2,2817,1342,2818,933,1
20150105.211139,2818,2,53910,2,2817,1342,2818,932,1
20150105.21114,2818,12,53922,0,2817,1342,2818,915,1
20150105.211143,2818,6,53928,6,2817,1339,2818,938,1
20150105.211143,2817,6,53934,0,2817,1336,2818,938,0
20150105.211145,2817,2,53936,2,2817,1335,2818,953,0
20150105.211147,2818,14,53950,14,2817,1333,2818,1147,1
20150105.211148,2817,30,53980,0,2817,1318,2818,1150,0
20150105.211148,2818,4,53984,4,2817,1318,2818,1147,1
20150105.211152,2817,2,53986,2,2817,1323,2818,1145,0
20150105.211152,2817,10,53996,0,2817,1318,2818,1145,0
20150105.211153,2818,2,53998,2,2817,1318,2818,1165,1
20150105.211153,2818,4,54002,4,2817,1318,2818,1159,1
20150105.211155,2818,14,54016,2,2817,1329,2818,1154,1
20150105.211157,2818,2,54018,2,2817,1330,2818,1154,1
20150105.211207,2818,20,54038,20,2817,1326,2818,1197,1
20150105.211207,2818,8,54046,2,2817,1326,2818,1152,1
20150105.211208,2818,12,54058,12,2817,1326,2818,1146,1
20150105.211208,2818,2,54060,2,2817,1325,2818,1145,1
20150105.211212,2818,2,54062,0,2817,926,2818,1146,1
20150105.211213,2817,22,54084,10,2817,921,2818,1153,0
20150105.211214,2818,20,54104,16,2817,919,2818,1144,1
20150105.211214,2818,4,54108,0,2817,919,2818,1142,1
20150105.211215,2818,4,54112,4,2817,919,2818,1126,1
20150105.211216,2818,6,54118,0,2817,919,2818,1123,1
20150105.211218,2818,22,54140,20,2817,909,2818,1123,1
20150105.211218,2817,2,54142,2,2817,909,2818,1123,0
20150105.211226,2818,2,54144,2,2817,908,2818,1100,1
20150105.211227,2818,6,54150,6,2817,908,2818,1097,1
20150105.211233,2817,6,54156,6,2817,922,2818,1131,0
20150105.211234,2817,4,54160,4,2817,922,2818,1137,0
20150105.211238,2817,8,54168,8,2817,919,2818,1178,0
20150105.211239,2817,2,54170,0,2817,918,2818,1180,0
20150105.21124,2817,10,54180,8,2817,913,2818,1180,0
20150105.211243,2817,40,54220,40,2817,892,2818,1375,0
20150105.211244,2817,10,54230,6,2817,887,2818,1375,0
20150105.211245,2817,4,54234,0,2817,888,2818,1377,0
20150105.211247,2817,6,54240,2,2817,888,2818,1379,0
20150105.211247,2818,24,54264,16,2817,886,2818,1389,1
20150105.211249,2817,6,54270,0,2817,884,2818,1392,0
20150105.21125,2818,4,54274,4,2817,884,2818,1389,1
20150105.211252,2817,2,54276,0,2817,898,2818,1390,0
20150105.211254,2817,200,54476,184,2817,799,2818,1389,0
20150105.211257,2817,260,54736,256,2817,769,2818,1291,0
20150105.211257,2817,12,54748,2,2817,763,2818,1291,0
20150105.211258,2817,10,54758,0,2817,758,2818,1291,0
20150105.211301,2817,2,54760,0,2817,761,2818,1291,0
20150105.211302,2818,172,54932,110,2817,676,2818,1290,1
20150105.211302,2817,28,54960,0,2817,663,2818,1289,0
20150105.211303,2817,1136,56096,-12,2817,95,2818,1330,0
20150105.211303,2817,190,56286,-48,2816,1451,2817,73,0
20150105.211304,2817,2,56288,0,2816,1451,2817,77,0
20150105.211304,2816,32,56320,28,2816,1424,2817,195,0
20150105.211305,2816,2,56322,0,2816,1423,2817,200,0
20150105.211305,2817,10,56332,8,2816,1423,2817,195,1
20150105.211306,2816,2,56334,0,2816,1422,2817,195,0
20150105.211309,2816,2,56336,2,2816,1420,2817,212,0
20150105.211309,2816,16,56352,16,2816,1412,2817,213,0
20150105.211311,2817,2,56354,2,2816,1412,2817,188,1
20150105.211313,2816,2,56356,-2,2816,1411,2817,186,0
20150105.211314,2816,20,56376,2,2816,1401,2817,184,0
20150105.211315,2816,84,56460,0,2816,1359,2817,187,0
20150105.211315,2817,40,56500,40,2816,1359,2817,168,1
20150105.211316,2817,2,56502,2,2816,1361,2817,278,1
20150105.211317,2817,2,56504,2,2816,1361,2817,280,1
20150105.211317,2817,260,56764,204,2816,1366,2817,151,1
20150105.211318,2817,304,57068,-224,2816,1226,2817,156,1
20150105.211319,2817,2,57070,-2,2816,1228,2817,157,1
20150105.211319,2816,24,57094,-12,2816,1217,2817,165,0
20150105.21132,2817,2,57096,0,2816,1217,2817,180,1
20150105.211321,2817,4,57100,0,2816,1217,2817,179,1
20150105.211322,2817,2,57102,0,2816,1217,2817,182,1
20150105.211322,2816,4,57106,-4,2816,1217,2817,185,0
20150105.211323,2816,10,57116,0,2816,1213,2817,187,0
20150105.211323,2816,2,57118,-2,2816,1213,2817,188,0
20150105.211324,2816,10,57128,0,2816,1207,2817,189,0
20150105.211324,2817,2,57130,0,2816,1207,2817,190,1
20150105.211326,2817,2,57132,0,2816,1218,2817,212,1
20150105.211327,2816,2,57134,-2,2816,1219,2817,213,0
20150105.211328,2816,6,57140,-6,2816,1217,2817,443,0
20150105.21133,2816,2,57142,0,2816,1217,2817,626,0
20150105.21133,2816,2,57144,-2,2816,1216,2817,626,0
20150105.211331,2817,2,57146,-2,2816,1217,2817,652,1
20150105.211332,2816,8,57154,-6,2816,1216,2817,677,0
20150105.211332,2816,2,57156,0,2816,1215,2817,688,0
20150105.211333,2816,2,57158,0,2816,1216,2817,688,0
20150105.211335,2816,4,57162,-2,2816,1216,2817,689,0
20150105.211335,2816,2,57164,-2,2816,1215,2817,689,0
20150105.211336,2816,2,57166,0,2816,1252,2817,692,0
20150105.211337,2816,6,57172,0,2816,1250,2817,708,0
20150105.211338,2816,2,57174,-2,2816,1249,2817,708,0
20150105.211338,2816,2,57176,-2,2816,1248,2817,708,0
20150105.211339,2817,28,57204,4,2816,1253,2817,690,1
20150105.211339,2816,20,57224,-20,2816,1243,2817,689,0
20150105.21134,2816,2,57226,-2,2816,1242,2817,805,0
20150105.211341,2816,2,57228,0,2816,1244,2817,805,0
20150105.211342,2816,102,57330,-2,2816,1188,2817,806,0
20150105.211342,2816,2286,59616,206,2816,44,2817,869,0
20150105.211343,2816,94,59710,-4,2815,293,2816,1114,0
20150105.211343,2815,48,59758,0,2815,244,2816,1210,0
20150105.211344,2815,36,59794,32,2815,226,2816,267,0
20150105.211345,2815,40,59834,12,2815,206,2816,276,0
20150105.211345,2815,6,59840,0,2815,204,2816,268,0
20150105.211346,2816,4,59844,2,2815,206,2816,297,1
20150105.211347,2815,154,59998,0,2815,129,2816,300,0
20150105.211347,2815,4,60002,-4,2815,131,2816,303,0
20150105.211348,2815,26,60028,-8,2815,131,2816,301,0
20150105.211349,2815,4,60032,-4,2815,159,2816,328,0
20150105.211349,2815,26,60058,-22,2815,147,2816,518,0
20150105.21135,2815,6,60064,2,2815,145,2816,518,0
20150105.21135,2815,2,60066,-2,2815,144,2816,518,0
20150105.211351,2815,2,60068,-2,2815,144,2816,517,0
20150105.211352,2815,34,60102,8,2815,127,2816,518,0
20150105.211352,2815,6,60108,0,2815,137,2816,518,0
20150105.211353,2815,102,60210,4,2815,86,2816,518,0
20150105.211354,2815,2,60212,0,2815,86,2816,520,0
20150105.211354,2815,142,60354,18,2815,215,2816,518,0
20150105.211355,2816,6,60360,4,2815,213,2816,482,1
20150105.211355,2815,22,60382,20,2815,207,2816,482,0
20150105.211356,2815,2,60384,0,2815,206,2816,483,0
20150105.211356,2815,16,60400,-8,2815,203,2816,511,0
20150105.211357,2815,60,60460,-60,2815,173,2816,534,0
20150105.211357,2815,150,60610,-148,2815,98,2816,518,0
20150105.211358,2816,178,60788,-20,2815,19,2816,512,1
20150105.211359,2815,38,60826,6,2814,150,2815,115,0
20150105.211359,2815,4,60830,4,2814,128,2815,120,0
20150105.2114,2815,16,60846,0,2814,129,2815,170,0
20150105.2114,2815,2,60848,0,2814,128,2815,203,0
20150105.211401,2815,6,60854,-2,2814,163,2815,232,0
20150105.211402,2815,2,60856,2,2814,171,2815,212,0
20150105.211402,2814,16,60872,0,2814,563,2815,212,0
20150105.211403,2815,12,60884,8,2814,555,2815,186,1
20150105.211403,2814,14,60898,8,2814,548,2815,188,0
20150105.211404,2814,2,60900,0,2814,553,2815,189,0
20150105.211404,2815,6,60906,-4,2814,544,2815,188,1
20150105.211405,2814,6,60912,-6,2814,544,2815,188,0
20150105.211405,2814,16,60928,-16,2814,537,2815,189,0
20150105.211406,2814,54,60982,22,2814,512,2815,279,0
20150105.211407,2814,2,60984,-2,2814,515,2815,357,0
20150105.211407,2814,6,60990,-4,2814,513,2815,353,0
20150105.211408,2814,82,61072,40,2814,472,2815,359,0
20150105.211409,2814,22,61094,20,2814,461,2815,369,0
20150105.211409,2815,24,61118,-10,2814,455,2815,369,1
20150105.21141,2814,20,61138,0,2814,445,2815,371,0
20150105.21141,2814,6,61144,-4,2814,444,2815,371,0
20150105.211411,2814,2,61146,0,2814,443,2815,475,0
20150105.211411,2814,4,61150,0,2814,451,2815,474,0
20150105.211412,2815,2,61152,2,2814,451,2815,474,1
20150105.211412,2814,22,61174,-16,2814,444,2815,736,0
20150105.211413,2814,16,61190,-6,2814,442,2815,746,0
20150105.211413,2814,4,61194,-4,2814,440,2815,745,0
20150105.211414,2814,54,61248,-40,2814,413,2815,745,0
20150105.211414,2815,4,61252,2,2814,413,2815,718,1
20150105.211415,2815,2,61254,0,2814,417,2815,717,1
20150105.211415,2814,4,61258,-4,2814,415,2815,717,0
20150105.211416,2815,58,61316,8,2814,387,2815,721,1
20150105.211416,2814,20,61336,0,2814,377,2815,717,0
20150105.211417,2814,200,61536,0,2814,287,2815,720,0
20150105.211418,2814,20,61556,-8,2814,282,2815,747,0
20150105.211419,2815,10,61566,-2,2814,279,2815,763,1
20150105.211421,2814,38,61604,-28,2814,263,2815,768,0
20150105.211421,2814,42,61646,-42,2814,242,2815,788,0
20150105.211422,2815,2,61648,2,2814,242,2815,808,1
20150105.211422,2814,22,61670,-20,2814,231,2815,830,0
20150105.211423,2814,38,61708,-38,2814,213,2815,814,0
20150105.211423,2814,2,61710,0,2814,216,2815,810,0
20150105.211424,2814,10,61720,-2,2814,242,2815,810,0
20150105.211425,2814,16,61736,0,2814,245,2815,817,0
20150105.211426,2815,2,61738,2,2814,253,2815,842,1
20150105.211427,2814,6,61744,0,2814,252,2815,840,0
20150105.211427,2814,12,61756,0,2814,246,2815,864,0
20150105.211428,2814,292,62048,-148,2814,100,2815,861,0
20150105.211428,2814,18,62066,-4,2814,91,2815,881,0
20150105.211429,2814,26,62092,-6,2814,81,2815,882,0
20150105.211429,2814,192,62284,148,2813,180,2814,156,0
20150105.21143,2814,10,62294,4,2813,180,2814,152,0
20150105.211431,2814,4,62298,0,2813,197,2814,171,0
20150105.211431,2814,4,62302,4,2813,210,2814,182,0
20150105.211432,2814,6,62308,2,2813,209,2814,190,0
20150105.211432,2814,4,62312,0,2813,209,2814,194,0
20150105.211433,2813,2,62314,2,2813,216,2814,198,0
20150105.211433,2814,72,62386,16,2813,194,2814,183,1
20150105.211434,2813,24,62410,14,2813,182,2814,180,0
20150105.211434,2813,8,62418,0,2813,182,2814,180,0
20150105.211435,2813,14,62432,10,2813,833,2814,180,0
20150105.211435,2813,2,62434,0,2813,832,2814,175,0
20150105.211436,2814,16,62450,16,2813,794,2814,148,1
20150105.211436,2813,4,62454,0,2813,796,2814,83,0
20150105.211437,2813,20,62474,-8,2813,788,2814,86,0
20150105.211437,2814,156,62630,-20,2813,848,2815,946,1
20150105.211438,2814,28,62658,-26,2814,61,2815,946,1
20150105.211438,2814,6,62664,2,2814,59,2815,943,1
20150105.211439,2814,4,62668,-2,2814,58,2815,943,1
20150105.21144,2815,10,62678,0,2814,69,2815,939,1
20150105.21144,2814,2,62680,0,2814,70,2815,945,0
20150105.21144,2815,2,62682,2,2814,70,2815,944,1
20150105.211441,2814,6,62688,-2,2814,71,2815,943,0
20150105.211441,2814,8,62696,0,2814,69,2815,943,0
20150105.211442,2815,30,62726,30,2814,72,2815,928,1
20150105.211442,2814,4,62730,0,2814,72,2815,928,0
20150105.211443,2814,28,62758,-4,2814,60,2815,927,0
20150105.211444,2814,130,62888,6,2813,482,2814,37,0
20150105.211444,2814,2,62890,0,2813,485,2814,36,0
20150105.211444,2814,2,62892,-2,2813,486,2814,50,0
20150105.211446,2814,12,62904,-4,2813,684,2814,57,0
20150105.211447,2814,12,62916,-4,2813,680,2814,55,0
20150105.211447,2814,2,62918,0,2813,680,2814,55,0
20150105.211448,2813,152,63070,-72,2813,641,2815,952,0
20150105.211448,2814,2,63072,2,2813,682,2815,952,1
20150105.211449,2814,26,63098,0,2813,671,2814,1,1
20150105.211449,2814,12,63110,0,2814,8,2815,955,1
20150105.211449,2814,16,63126,2,2814,50,2815,977,1
20150105.21145,2814,6,63132,0,2814,248,2815,978,1
20150105.21145,2814,2,63134,0,2814,247,2815,938,1
20150105.211451,2814,4,63138,-2,2814,246,2815,939,1
20150105.211452,2814,28,63166,0,2814,235,2815,951,1
20150105.211452,2814,10,63176,0,2814,235,2815,991,1
20150105.211453,2815,1000,64176,674,2814,237,2815,515,1
20150105.211453,2814,80,64256,-78,2814,198,2815,471,0
20150105.211454,2814,24,64280,-2,2814,187,2815,507,0
20150105.211455,2814,2,64282,0,2814,220,2815,502,0
20150105.211455,2814,2,64284,0,2814,246,2815,508,0
20150105.211456,2814,4,64288,-4,2814,244,2815,508,0
20150105.211457,2814,4,64292,0,2814,252,2815,514,0
20150105.211458,2814,2,64294,-2,2814,258,2815,516,0
20150105.211459,2815,66,64360,0,2814,276,2815,482,1
20150105.2115,2815,2,64362,2,2814,283,2815,480,1
20150105.211501,2815,2,64364,2,2814,293,2815,479,1
20150105.211502,2814,130,64494,0,2814,242,2815,485,0
20150105.211502,2815,2,64496,0,2814,252,2815,484,1
20150105.211503,2814,6,64502,4,2814,251,2815,482,0
20150105.211504,2814,2,64504,0,2814,251,2815,481,0
20150105.211504,2814,2,64506,-2,2814,252,2815,489,0
20150105.211505,2814,66,64572,-60,2814,222,2815,493,0
20150105.211505,2814,2,64574,-2,2814,221,2815,494,0
20150105.211506,2814,4,64578,0,2814,221,2815,503,0
20150105.211507,2814,6,64584,-6,2814,229,2815,501,0
20150105.211509,2815,2,64586,2,2814,240,2815,499,1
20150105.21151,2815,1000,65586,424,2815,2,2816,655,1
20150105.21151,2814,16,65602,-8,2814,325,2816,644,0
20150105.211511,2815,6,65608,-2,2814,329,2815,10,1
20150105.211511,2815,20,65628,0,2814,350,2816,613,1
20150105.211512,2815,18,65646,-16,2815,2,2816,619,1
20150105.211513,2815,16,65662,-12,2814,376,2815,1,1
20150105.211513,2815,2,65664,0,2814,376,2816,632,1
20150105.211514,2816,30,65694,8,2814,379,2816,629,1
20150105.211515,2815,8,65702,0,2814,424,2816,632,0
20150105.211516,2815,4,65706,0,2814,425,2816,627,0
20150105.211516,2816,2,65708,2,2815,2,2816,629,1
20150105.211517,2815,4,65712,0,2815,5,2816,629,0
20150105.211517,2815,12,65724,-8,2815,2,2816,630,0
20150105.211518,2814,46,65770,-42,2814,411,2815,14,0
20150105.211518,2814,16,65786,4,2814,421,2815,12,0
20150105.211519,2815,6,65792,6,2814,425,2815,17,1
20150105.211521,2815,14,65806,4,2814,450,2815,20,1
20150105.211521,2815,4,65810,2,2814,450,2815,18,1
20150105.211522,2815,10,65820,2,2814,453,2815,13,1
20150105.211522,2815,2,65822,0,2814,463,2815,72,1
20150105.211524,2815,10,65832,6,2814,425,2815,68,1
20150105.211525,2814,64,65896,-52,2814,398,2815,98,0
20150105.211526,2815,204,66100,-172,2815,290,2816,669,1
20150105.211526,2815,6,66106,0,2815,287,2816,669,1
20150105.211527,2815,6,66112,0,2815,284,2816,669,1
20150105.211528,2816,2,66114,2,2815,298,2816,648,1
20150105.211531,2815,4,66118,-2,2815,307,2816,643,0
20150105.211531,2815,10,66128,0,2815,307,2816,645,0
20150105.211532,2815,6,66134,0,2815,304,2816,645,0
20150105.211534,2816,4,66138,4,2815,325,2816,648,1
20150105.211535,2815,10,66148,0,2815,323,2816,656,0
20150105.211536,2815,2,66150,-2,2815,321,2816,656,0
20150105.21154,2816,2,66152,2,2815,535,2816,689,1
20150105.21154,2816,2,66154,0,2815,535,2816,688,1
20150105.211541,2816,2,66156,0,2815,536,2816,686,1
20150105.211543,2815,48,66204,-40,2815,521,2816,679,0
20150105.211545,2815,2,66206,0,2815,520,2816,681,0
20150105.211545,2815,10,66216,0,2815,515,2816,671,0
20150105.211547,2815,22,66238,2,2815,505,2816,675,0
20150105.211548,2815,8,66246,0,2815,501,2816,675,0
20150105.211549,2815,2,66248,0,2815,504,2816,675,0
20150105.21155,2815,20,66268,0,2815,494,2816,674,0
20150105.21155,2816,2,66270,2,2815,494,2816,672,1
20150105.211551,2815,2,66272,0,2815,493,2816,674,0
20150105.211554,2815,4,66276,0,2815,495,2816,666,0
20150105.211555,2815,20,66296,0,2815,487,2816,681,0
20150105.211556,2816,4,66300,4,2815,487,2816,679,1
20150105.211558,2815,2,66302,-2,2815,494,2816,705,0
20150105.2116,2815,12,66314,-10,2815,491,2816,705,0
20150105.2116,2816,2,66316,0,2815,491,2816,704,1
20150105.211601,2815,76,66392,2,2815,456,2816,737,0
20150105.211602,2816,10,66402,0,2815,457,2816,734,1
20150105.211605,2815,44,66446,-44,2815,445,2816,734,0
20150105.211606,2815,44,66490,0,2815,243,2816,735,0
20150105.211607,2815,20,66510,0,2815,234,2816,735,0
20150105.211607,2815,46,66556,20,2815,301,2816,934,0
20150105.211608,2815,26,66582,0,2815,288,2816,944,0
20150105.211608,2815,20,66602,0,2815,279,2816,944,0
20150105.21161,2815,4,66606,0,2815,279,2816,930,0
20150105.21161,2815,2,66608,-2,2815,278,2816,927,0
20150105.211613,2816,2,66610,0,2815,488,2816,946,1
20150105.211614,2815,2,66612,-2,2815,488,2816,943,0
20150105.211614,2815,2,66614,0,2815,487,2816,943,0
20150105.211615,2816,2,66616,0,2815,495,2816,941,1
20150105.211617,2816,6,66622,4,2815,504,2816,939,1
20150105.211618,2816,2,66624,2,2815,505,2816,935,1
20150105.211619,2815,12,66636,-12,2815,500,2816,918,0
20150105.211622,2815,2,66638,-2,2815,613,2816,969,0
20150105.211625,2816,2,66640,0,2815,693,2816,973,1
20150105.211625,2815,110,66750,2,2815,641,2816,971,0
20150105.211626,2815,2,66752,0,2815,643,2816,971,0
20150105.211627,2816,20,66772,0,2815,644,2816,961,1
20150105.21163,2815,2,66774,-2,2815,644,2816,960,0
20150105.211632,2816,2,66776,0,2815,648,2816,958,1
20150105.211633,2816,6,66782,6,2815,648,2816,955,1
20150105.211633,2816,2,66784,0,2815,648,2816,954,1
20150105.211635,2815,2,66786,0,2815,649,2816,954,0
20150105.211637,2816,4,66790,4,2815,659,2816,956,1
20150105.211638,2815,10,66800,6,2815,652,2816,959,0
20150105.21164,2816,8,66808,6,2815,652,2816,957,1
20150105.211641,2816,2,66810,2,2815,652,2816,955,1
20150105.211648,2816,16,66826,16,2815,662,2816,1149,1
20150105.211651,2816,6,66832,6,2815,668,2816,942,1
20150105.211652,2815,2,66834,2,2815,667,2816,946,0
20150105.211653,2816,200,67034,-2,2815,666,2816,846,1
20150105.211654,2815,4,67038,4,2815,657,2816,847,0
20150105.211655,2816,88,67126,4,2815,617,2816,845,1
20150105.211656,2816,4,67130,0,2815,614,2816,868,1
20150105.211656,2816,8,67138,0,2815,614,2816,864,1
20150105.211657,2815,2,67140,2,2815,613,2816,865,0
20150105.211659,2816,2,67142,2,2815,611,2816,865,1
20150105.211701,2815,2,67144,2,2815,610,2816,869,0
20150105.211705,2816,2,67146,0,2815,636,2816,868,1
20150105.211706,2815,4,67150,0,2815,637,2816,868,0
20150105.211707,2815,4,67154,0,2815,634,2816,868,0
20150105.211709,2815,2,67156,2,2815,637,2816,868,0
20150105.21171,2815,2,67158,2,2815,644,2816,869,0
20150105.211712,2815,20,67178,20,2815,627,2816,879,0
20150105.211713,2816,4,67182,4,2815,628,2816,878,1
20150105.211713,2815,300,67482,82,2815,486,2816,878,0
20150105.211715,2815,2,67484,0,2815,476,2816,880,0
20150105.211716,2815,2,67486,-2,2815,494,2816,880,0
20150105.211716,2815,200,67686,-200,2815,394,2816,880,0
20150105.211718,2815,4,67690,-4,2815,389,2816,885,0
20150105.211718,2815,158,67848,-24,2815,310,2816,885,0
20150105.211719,2815,106,67954,58,2815,258,2816,885,0
20150105.21172,2815,76,68030,0,2815,205,2816,889,0
20150105.211721,2815,8,68038,2,2815,203,2816,837,0
20150105.211723,2815,52,68090,-2,2815,177,2816,837,0
20150105.211723,2815,2,68092,0,2815,178,2816,837,0
20150105.211724,2815,4,68096,0,2815,174,2816,837,0
20150105.211724,2815,4,68100,-4,2815,172,2816,837,0
20150105.211725,2815,2,68102,0,2815,173,2816,840,0
20150105.211726,2815,2,68104,-2,2815,172,2816,840,0
20150105.211726,2815,10,68114,0,2815,167,2816,840,0
20150105.211732,2815,4,68118,-2,2815,214,2816,866,0
20150105.211732,2815,2,68120,-2,2815,213,2816,866,0
20150105.211733,2815,6,68126,-2,2815,161,2816,878,0
20150105.211734,2815,2,68128,2,2815,160,2816,878,0
20150105.211734,2815,2,68130,2,2815,159,2816,878,0
20150105.211735,2815,2,68132,0,2815,178,2816,885,0
20150105.211736,2815,2,68134,0,2815,180,2816,886,0
20150105.211738,2815,28,68162,8,2815,165,2816,888,0
20150105.211739,2816,8,68170,8,2815,166,2816,885,1
20150105.211741,2815,2,68172,-2,2815,162,2816,877,0
20150105.211742,2815,4,68176,2,2815,160,2816,882,0
20150105.211743,2815,4,68180,0,2815,162,2816,885,0
20150105.211743,2815,2,68182,0,2815,161,2816,887,0
20150105.211744,2815,26,68208,-4,2815,145,2816,881,0
20150105.211745,2815,20,68228,0,2815,130,2816,882,0
20150105.211748,2815,20,68248,-20,2815,123,2816,889,0
20150105.211748,2815,20,68268,12,2815,113,2816,873,0
20150105.21175,2815,4,68272,4,2815,112,2816,875,0
20150105.21175,2815,2,68274,2,2815,111,2816,875,0
20150105.211751,2815,20,68294,-10,2815,102,2816,924,0
20150105.211752,2815,4,68298,4,2815,101,2816,923,0
20150105.211754,2815,44,68342,0,2815,79,2816,971,0
20150105.211754,2815,42,68384,4,2815,58,2816,969,0
20150105.211755,2815,80,68464,6,2815,18,2816,973,0
20150105.211755,2815,4,68468,4,2815,16,2816,973,0
20150105.211756,2815,2,68470,0,2815,17,2816,1001,0
20150105.211756,2815,4,68474,0,2815,15,2816,951,0
20150105.211757,2815,6,68480,6,2815,12,2816,981,0
20150105.211757,2816,54,68534,0,2815,13,2816,954,1
20150105.211758,2815,22,68556,20,2815,5,2816,954,0
20150105.211759,2815,2,68558,0,2815,4,2816,955,0
20150105.2118,2815,8,68566,6,2814,589,2815,9,0
20150105.211801,2815,12,68578,-6,2814,589,2815,8,0
20150105.211802,2815,20,68598,-8,2814,828,2815,3,0
20150105.211803,2815,8,68606,-2,2814,828,2816,899,0
20150105.211804,2815,2,68608,0,2815,12,2816,937,0
20150105.211804,2815,24,68632,-2,2815,85,2816,898,0
20150105.211806,2816,54,68686,54,2815,151,2816,872,1
20150105.211806,2815,4,68690,-2,2815,154,2816,872,0
20150105.211807,2815,20,68710,0,2815,154,2816,872,0
20150105.211808,2815,2,68712,0,2815,154,2816,882,0
20150105.21181,2815,2,68714,0,2815,161,2816,893,0
20150105.211811,2815,2,68716,0,2815,166,2816,891,0
20150105.211812,2816,10,68726,10,2815,167,2816,886,1
20150105.211812,2815,2,68728,-2,2815,166,2816,886,0
20150105.211814,2815,4,68732,-4,2815,160,2816,888,0
20150105.211815,2815,2,68734,-2,2815,160,2816,887,0
20150105.211815,2815,4,68738,0,2815,158,2816,889,0
20150105.211816,2815,2,68740,0,2815,157,2816,889,0
20150105.211818,2815,2,68742,-2,2815,156,2816,886,0
20150105.211819,2815,2,68744,-2,2815,156,2816,882,0
20150105.21182,2815,4,68748,0,2815,154,2816,882,0
20150105.211821,2815,18,68766,-10,2815,146,2816,882,0
20150105.211822,2815,4,68770,-4,2815,146,2816,883,0
20150105.211823,2815,2,68772,-2,2815,145,2816,883,0
20150105.211824,2815,2,68774,0,2815,144,2816,893,0
20150105.211825,2815,6,68780,-2,2815,145,2816,898,0
20150105.211826,2815,48,68828,-2,2815,121,2816,898,0
20150105.211826,2815,2,68830,-2,2815,139,2816,932,0
20150105.211827,2815,16,68846,-14,2815,131,2816,996,0
20150105.211828,2815,62,68908,-2,2815,101,2816,1028,0
20150105.211828,2815,200,69108,44,2815,1,2816,940,0
20150105.211829,2815,4,69112,4,2814,761,2816,965,0
20150105.21183,2814,20,69132,2,2814,751,2815,113,0
20150105.211832,2814,18,69150,-10,2814,745,2815,139,0
20150105.211833,2815,2,69152,0,2814,545,2815,154,1
20150105.211834,2815,6,69158,0,2814,545,2815,152,1
20150105.211835,2814,2,69160,0,2814,544,2815,152,0
20150105.211836,2814,2,69162,-2,2814,537,2815,163,0
20150105.211837,2815,140,69302,132,2814,537,2815,93,1
20150105.211838,2814,4,69306,0,2814,637,2815,95,0
20150105.211839,2815,2,69308,2,2814,640,2815,97,1
20150105.211842,2814,2,69310,-2,2814,639,2815,118,0
20150105.211845,2814,2,69312,0,2814,646,2815,127,0
20150105.211847,2814,2,69314,-2,2814,587,2815,134,0
20150105.211849,2814,16,69330,-6,2814,577,2815,224,0
20150105.21185,2814,32,69362,-20,2814,560,2815,236,0
20150105.211852,2814,12,69374,0,2814,544,2815,248,0
20150105.211852,2814,2,69376,0,2814,543,2815,275,0
20150105.211855,2814,26,69402,2,2814,499,2815,282,0
20150105.211855,2814,202,69604,152,2814,396,2815,296,0
20150105.211856,2814,34,69638,20,2814,379,2815,296,0
20150105.211856,2814,2,69640,2,2814,378,2815,296,0
20150105.211857,2814,2,69642,2,2814,379,2815,307,0
20150105.211858,2814,4,69646,-4,2814,377,2815,313,0
20150105.211859,2814,2,69648,0,2814,377,2815,313,0
20150105.211859,2814,2,69650,-2,2814,360,2815,317,0
20150105.2119,2814,2,69652,-2,2814,359,2815,408,0
20150105.211901,2814,4,69656,-4,2814,357,2815,494,0
20150105.211902,2814,8,69664,-2,2814,352,2815,516,0
20150105.211903,2814,2,69666,0,2814,377,2815,443,0
20150105.211903,2814,26,69692,0,2814,363,2815,443,0
20150105.211905,2814,4,69696,2,2814,343,2815,454,0
20150105.211905,2815,2,69698,2,2814,343,2815,454,1
20150105.211906,2814,2,69700,2,2814,342,2815,455,0
20150105.211906,2814,2,69702,0,2814,344,2815,457,0
20150105.211908,2815,2,69704,2,2814,426,2815,460,1
20150105.211909,2814,4,69708,4,2814,374,2815,443,0
20150105.21191,2815,148,69856,-94,2814,301,2815,441,1
20150105.21191,2814,2,69858,0,2814,301,2815,441,0
20150105.211911,2814,192,70050,20,2814,195,2815,427,0
20150105.211912,2814,2,70052,0,2814,195,2815,428,0
20150105.211912,2814,18,70070,-2,2814,186,2815,429,0
20150105.211913,2814,8,70078,-4,2814,182,2815,435,0
20150105.211913,2814,2,70080,0,2814,182,2815,437,0
20150105.211914,2814,4,70084,-2,2814,173,2815,439,0
20150105.211915,2814,68,70152,-14,2814,154,2815,436,0
20150105.211915,2814,2,70154,2,2814,204,2815,436,0
20150105.211916,2814,38,70192,2,2814,302,2815,435,0
20150105.211917,2814,22,70214,2,2814,295,2815,432,0
20150105.211917,2814,2,70216,2,2814,293,2815,431,0
20150105.211918,2814,4,70220,0,2814,291,2815,437,0
20150105.211919,2814,14,70234,14,2814,304,2815,439,0
20150105.21192,2815,2,70236,0,2814,305,2815,438,1
20150105.211922,2814,22,70258,0,2814,293,2815,441,0
20150105.211923,2815,18,70276,16,2814,286,2815,471,1
20150105.211924,2814,16,70292,16,2814,278,2815,471,0
20150105.211925,2814,46,70338,6,2814,257,2815,470,0
20150105.211925,2814,4,70342,4,2814,255,2815,473,0
20150105.211928,2814,6,70348,4,2814,269,2815,480,0
20150105.21193,2814,20,70368,16,2814,276,2815,470,0
20150105.211931,2814,2,70370,2,2814,278,2815,520,0
20150105.211931,2814,2,70372,2,2814,275,2815,524,0
20150105.211932,2814,4,70376,4,2814,273,2815,524,0
20150105.211933,2814,16,70392,-8,2814,267,2815,526,0
20150105.211934,2814,100,70492,-98,2814,228,2815,531,0
20150105.211935,2814,10,70502,10,2814,215,2815,524,0
20150105.211935,2814,22,70524,12,2814,204,2815,524,0
20150105.211935,2815,10,70534,10,2814,204,2815,519,1
20150105.211937,2814,2,70536,2,2814,208,2815,540,0
20150105.211937,2814,6,70542,2,2814,244,2815,537,0
20150105.211938,2814,8,70550,0,2814,238,2815,537,0
20150105.211939,2815,22,70572,22,2814,436,2815,534,1
20150105.211942,2814,80,70652,44,2814,411,2815,532,0
20150105.211944,2814,4,70656,0,2814,412,2815,539,0
20150105.211946,2814,40,70696,0,2814,403,2815,536,0
20150105.211947,2814,2,70698,0,2814,402,2815,538,0
20150105.211948,2814,4,70702,0,2814,402,2815,534,0
20150105.21195,2814,66,70768,-20,2814,380,2815,533,0
20150105.211955,2814,6,70774,0,2814,355,2815,558,0
20150105.211957,2814,2,70776,0,2814,354,2815,559,0
20150105.211957,2814,2,70778,-2,2814,364,2815,559,0
20150105.211959,2814,2,70780,0,2814,364,2815,559,0
20150105.212,2814,4,70784,2,2814,183,2815,563,0
20150105.212002,2814,22,70806,2,2814,174,2815,554,0
20150105.212002,2815,10,70816,10,2814,174,2815,551,1
20150105.212003,2814,2,70818,2,2814,174,2815,551,0
20150105.212003,2815,6,70824,6,2814,176,2815,549,1
20150105.212004,2814,6,70830,6,2814,179,2815,549,0
20150105.212005,2814,2,70832,2,2814,179,2815,550,0
20150105.212008,2814,30,70862,-2,2814,204,2815,550,0
20150105.212008,2814,4,70866,2,2814,203,2815,549,0
20150105.212009,2814,2,70868,0,2814,202,2815,548,0
20150105.212012,2815,2,70870,2,2814,205,2815,560,1
20150105.212012,2814,2,70872,-2,2814,204,2815,560,0
20150105.212014,2814,204,71076,-34,2814,124,2815,564,0
20150105.212015,2814,10,71086,-4,2814,117,2815,563,0
20150105.212016,2814,4,71090,2,2814,117,2815,568,0
20150105.212016,2814,10,71100,10,2814,112,2815,570,0
20150105.212017,2815,2,71102,2,2814,123,2815,572,1
20150105.212018,2814,4,71106,2,2814,122,2815,575,0
20150105.212019,2815,6,71112,6,2814,237,2815,572,1
20150105.21202,2815,4,71116,0,2814,236,2815,571,1
20150105.212021,2814,4,71120,0,2814,241,2815,578,0
20150105.212023,2814,4,71124,0,2814,241,2815,580,0
20150105.212024,2814,2,71126,0,2814,245,2815,620,0
20150105.212025,2815,2,71128,2,2814,248,2815,619,1
20150105.212026,2814,6,71134,-2,2814,245,2815,618,0
20150105.212026,2814,6,71140,2,2814,245,2815,620,0
20150105.212027,2814,14,71154,14,2814,242,2815,620,0
20150105.212028,2814,4,71158,2,2814,240,2815,620,0
20150105.212029,2814,10,71168,2,2814,238,2815,620,0
20150105.212029,2814,24,71192,0,2814,228,2815,651,0
20150105.21203,2814,2,71194,0,2814,227,2815,652,0
20150105.21203,2814,4,71198,2,2814,226,2815,651,0
20150105.212033,2814,4,71202,4,2814,228,2815,669,0
20150105.212034,2814,6,71208,0,2814,277,2815,673,0
20150105.212038,2814,4,71212,-2,2814,644,2815,691,0
20150105.212045,2814,12,71224,-2,2814,762,2815,698,0
20150105.212046,2815,2,71226,0,2814,762,2815,698,1
20150105.212046,2814,2,71228,2,2814,763,2815,668,0
20150105.212049,2815,58,71286,-20,2814,794,2815,633,1
20150105.21205,2815,6,71292,6,2814,795,2815,630,1
20150105.212051,2814,16,71308,12,2814,800,2815,631,0
20150105.212054,2814,6,71314,6,2814,848,2815,620,0
20150105.212056,2815,2,71316,0,2814,852,2815,618,1
20150105.212056,2814,2,71318,2,2814,850,2815,618,0
20150105.212057,2815,4,71322,4,2814,849,2815,616,1
20150105.212057,2814,6,71328,6,2814,847,2815,614,0
20150105.212059,2814,46,71374,30,2814,846,2815,595,0
20150105.212059,2815,170,71544,-42,2814,850,2815,510,1
20150105.2121,2814,12,71556,4,2814,851,2815,506,0
20150105.212101,2814,2,71558,2,2814,852,2815,506,0
20150105.212102,2815,4,71562,4,2814,861,2815,515,1
20150105.212104,2814,12,71574,0,2814,865,2815,514,0
20150105.212105,2815,2,71576,2,2814,850,2815,513,1
20150105.212106,2814,4,71580,4,2814,903,2815,513,0
20150105.212107,2815,2,71582,2,2814,905,2815,511,1
20150105.212107,2815,2,71584,2,2814,905,2815,510,1
20150105.212108,2814,2,71586,2,2814,900,2815,510,0
20150105.212109,2815,50,71636,38,2814,899,2815,485,1
20150105.21211,2815,2,71638,2,2814,895,2815,490,1
20150105.212111,2815,12,71650,12,2814,926,2815,484,1
20150105.212111,2815,20,71670,20,2814,930,2815,474,1
20150105.212112,2815,2,71672,2,2814,929,2815,483,1
20150105.212112,2815,2,71674,2,2814,930,2815,482,1
20150105.212113,2815,4,71678,4,2814,935,2815,480,1
20150105.212114,2815,26,71704,20,2814,930,2815,470,1
20150105.212117,2815,2,71706,2,2814,931,2815,468,1
20150105.212117,2815,2,71708,2,2814,934,2815,467,1
20150105.212118,2815,2,71710,0,2814,934,2815,466,1
20150105.212118,2815,2,71712,2,2814,934,2815,465,1
20150105.212119,2815,44,71756,2,2814,934,2815,443,1
20150105.21212,2814,40,71796,0,2814,914,2815,443,0
20150105.21212,2814,46,71842,40,2814,894,2815,441,0
20150105.212121,2815,2,71844,2,2814,893,2815,440,1
20150105.212122,2815,880,72724,544,2814,565,2816,931,1
20150105.212124,2815,2,72726,2,2815,184,2816,932,1
20150105.212125,2815,32,72758,32,2815,171,2816,931,1
20150105.212126,2815,6,72764,6,2815,173,2816,934,1
20150105.212126,2815,8,72772,6,2815,250,2816,934,1
20150105.212127,2816,8,72780,0,2815,250,2816,930,1
20150105.212129,2816,8,72788,0,2815,300,2816,930,1
20150105.21213,2815,6,72794,6,2815,297,2816,932,0
20150105.212131,2815,2,72796,0,2815,296,2816,932,0
20150105.212131,2815,4,72800,0,2815,309,2816,931,0
20150105.212132,2815,2,72802,0,2815,309,2816,931,0
20150105.212133,2815,4,72806,0,2815,309,2816,931,0
20150105.212133,2815,8,72814,0,2815,307,2816,933,0
20150105.212134,2816,42,72856,2,2815,291,2816,1133,1
20150105.212135,2816,12,72868,2,2815,291,2816,1127,1
20150105.212136,2816,14,72882,10,2815,326,2816,1121,1
20150105.212136,2815,4,72886,-4,2815,324,2816,1120,0
20150105.212138,2815,6,72892,-4,2815,380,2816,1123,0
20150105.21214,2815,4,72896,-4,2815,385,2816,1132,0
20150105.212141,2815,4,72900,0,2815,383,2816,1135,0
20150105.212141,2815,20,72920,-16,2815,373,2816,1140,0
20150105.212142,2815,2,72922,-2,2815,373,2816,1140,0
20150105.212143,2815,4,72926,-4,2815,372,2816,1139,0
20150105.212144,2816,22,72948,2,2815,374,2816,1128,1
20150105.212145,2815,10,72958,-10,2815,379,2816,1130,0
20150105.212145,2815,2,72960,0,2815,380,2816,1150,0
20150105.212148,2815,10,72970,6,2815,376,2816,1152,0
20150105.212148,2815,6,72976,-2,2815,373,2816,1152,0
20150105.212151,2816,10,72986,0,2815,374,2816,1144,1
20150105.212153,2815,230,73216,-68,2815,259,2816,1144,0
20150105.212156,2815,4,73220,0,2815,258,2816,1137,0
20150105.212158,2815,2,73222,-2,2815,376,2816,1139,0
20150105.212159,2816,2,73224,0,2815,373,2816,1143,1
20150105.212202,2816,10,73234,0,2815,418,2816,1144,1
20150105.212204,2816,2,73236,2,2815,427,2816,1149,1
20150105.212206,2816,2,73238,2,2815,432,2816,1148,1
20150105.212207,2816,2,73240,2,2815,432,2816,1147,1
20150105.212208,2816,2,73242,2,2815,432,2816,1146,1
20150105.21221,2816,2,73244,0,2815,433,2816,1145,1
20150105.212213,2815,2,73246,0,2815,432,2816,1178,0
20150105.212215,2815,6,73252,0,2815,429,2816,1189,0
20150105.212216,2815,6,73258,4,2815,428,2816,1187,0
20150105.212216,2816,2,73260,2,2815,428,2816,1186,1
20150105.212217,2815,2,73262,0,2815,428,2816,1186,0
20150105.212218,2815,2,73264,0,2815,427,2816,1186,0
20150105.212218,2815,14,73278,0,2815,421,2816,1186,0
20150105.212219,2815,4,73282,-2,2815,420,2816,1187,0
20150105.21222,2815,2,73284,0,2815,421,2816,1185,0
20150105.21222,2815,2,73286,2,2815,420,2816,1185,0
20150105.212221,2815,6,73292,6,2815,417,2816,1195,0
20150105.212222,2815,2,73294,0,2815,416,2816,1195,0
20150105.212223,2815,64,73358,64,2815,412,2816,1165,0
20150105.212223,2816,2,73360,0,2815,423,2816,1164,1
20150105.212225,2815,2,73362,2,2815,422,2816,1174,0
20150105.212225,2815,2,73364,2,2815,421,2816,1174,0
20150105.212227,2815,4,73368,4,2815,419,2816,1180,0
20150105.212227,2815,2,73370,0,2815,418,2816,1180,0
20150105.21223,2816,10,73380,10,2815,419,2816,1181,1
20150105.212231,2815,2,73382,2,2815,418,2816,1178,0
20150105.212233,2815,4,73386,4,2815,419,2816,1173,0
20150105.212234,2815,2,73388,2,2815,418,2816,1174,0
20150105.212234,2815,4,73392,4,2815,416,2816,1174,0
20150105.212236,2815,12,73404,-6,2815,413,2816,1174,0
20150105.212236,2816,2,73406,2,2815,413,2816,1173,1
20150105.212237,2815,4,73410,0,2815,417,2816,1171,0
20150105.212239,2815,4,73414,-2,2815,415,2816,1172,0
20150105.212239,2815,2,73416,0,2815,414,2816,1167,0
20150105.212242,2815,2,73418,0,2815,414,2816,1167,0
20150105.212244,2815,2,73420,0,2815,416,2816,1163,0
20150105.212245,2815,2,73422,0,2815,417,2816,1163,0
20150105.212245,2815,8,73430,2,2815,416,2816,1161,0
20150105.212247,2815,20,73450,0,2815,415,2816,1146,0
20150105.212247,2815,6,73456,-4,2815,412,2816,1146,0
20150105.212248,2815,2,73458,0,2815,413,2816,1150,0
20150105.212248,2815,2,73460,0,2815,422,2816,1150,0
20150105.212251,2816,2,73462,0,2815,428,2816,1156,1
20150105.212251,2815,4,73466,0,2815,426,2816,1191,0
20150105.212253,2816,2,73468,0,2815,426,2816,1189,1
20150105.212254,2816,2,73470,2,2815,426,2816,1188,1
20150105.212255,2815,2,73472,-2,2815,425,2816,1203,0
20150105.212256,2816,200,73672,-110,2815,424,2816,1104,1
20150105.212258,2815,10,73682,-10,2815,431,2816,1104,0
20150105.212301,2815,2,73684,-2,2815,447,2816,1089,0
20150105.212301,2816,2,73686,2,2815,450,2816,1088,1
20150105.212302,2815,8,73694,0,2815,446,2816,1088,0
20150105.212303,2815,2,73696,-2,2815,445,2816,1088,0
20150105.212304,2816,2,73698,2,2815,446,2816,1087,1
20150105.212306,2816,2,73700,2,2815,458,2816,1089,1
20150105.212309,2816,2,73702,0,2815,462,2816,1095,1
20150105.212311,2815,2,73704,0,2815,488,2816,1098,0
20150105.212318,2816,40,73744,0,2815,528,2816,1085,1
20150105.212319,2816,20,73764,0,2815,528,2816,1075,1
20150105.212319,2815,10,73774,6,2815,523,2816,1075,0
20150105.21232,2816,130,73904,80,2815,458,2816,1011,1
20150105.212321,2816,8,73912,-4,2815,458,2816,1007,1
20150105.212321,2816,4,73916,4,2815,456,2816,1005,1
20150105.212322,2816,8,73924,8,2815,456,2816,1001,1
20150105.212323,2816,50,73974,8,2815,433,2816,986,1
20150105.212324,2815,34,74008,-4,2815,418,2816,972,0
20150105.212325,2816,16,74024,2,2815,418,2816,964,1
20150105.212325,2816,2,74026,0,2815,419,2816,963,1
20150105.212326,2816,6,74032,0,2815,419,2816,960,1
20150105.212327,2816,6,74038,6,2815,419,2816,954,1
20150105.212328,2816,2,74040,2,2815,424,2816,953,1
20150105.212329,2816,42,74082,0,2815,419,2816,932,1
20150105.212332,2816,72,74154,72,2815,517,2816,897,1
20150105.212334,2816,2,74156,2,2815,518,2816,896,1
20150105.212335,2816,4,74160,0,2815,519,2816,894,1
20150105.212335,2816,4,74164,4,2815,519,2816,892,1
20150105.212337,2816,2,74166,2,2815,523,2816,891,1
20150105.212339,2815,18,74184,2,2815,522,2816,881,0
20150105.21234,2816,2,74186,2,2815,542,2816,880,1
20150105.21234,2816,2,74188,2,2815,542,2816,879,1
20150105.212342,2816,4,74192,4,2815,578,2816,878,1
20150105.212344,2816,32,74224,32,2815,572,2816,874,1
20150105.212346,2816,10,74234,10,2815,571,2816,872,1
20150105.212347,2816,2,74236,0,2815,572,2816,871,1
20150105.212347,2815,4,74240,0,2815,570,2816,871,0
20150105.212354,2816,20,74260,0,2815,558,2816,1085,1
20150105.212355,2815,2,74262,2,2815,557,2816,1085,0
20150105.212356,2815,2,74264,0,2815,560,2816,1085,0
20150105.212357,2816,10,74274,10,2815,562,2816,1080,1
20150105.212357,2816,36,74310,0,2815,562,2816,1062,1
20150105.212358,2815,4,74314,4,2815,561,2816,1062,0
20150105.212358,2815,42,74356,-16,2815,540,2816,1062,0
20150105.212359,2816,2,74358,0,2815,540,2816,1061,1
20150105.2124,2816,6,74364,4,2815,547,2816,1059,1
20150105.212401,2816,2,74366,0,2815,547,2816,1058,1
20150105.212402,2816,10,74376,10,2815,563,2816,1052,1
20150105.212404,2815,8,74384,0,2815,561,2816,1051,0
20150105.212407,2815,2,74386,0,2815,560,2816,1061,0
20150105.21241,2815,16,74402,-8,2815,552,2816,1054,0
20150105.212411,2815,14,74416,14,2815,545,2816,1059,0
20150105.212412,2816,2,74418,2,2815,548,2816,1064,1
20150105.212416,2816,2,74420,0,2815,549,2816,1063,1
20150105.212418,2816,2,74422,2,2815,539,2816,1065,1
20150105.212418,2815,2,74424,2,2815,538,2816,1065,0
20150105.212419,2816,30,74454,20,2815,533,2816,1055,1
20150105.212425,2816,6,74460,0,2815,514,2816,1050,1
20150105.212427,2816,100,74560,0,2815,514,2816,1002,1
20150105.21243,2815,2,74562,0,2815,512,2816,1002,0
20150105.212432,2815,14,74576,0,2815,506,2816,1002,0
20150105.212432,2815,2,74578,2,2815,505,2816,1002,0
20150105.212433,2816,2,74580,0,2815,508,2816,1001,1
20150105.212434,2815,2,74582,2,2815,506,2816,1001,0
20150105.212435,2816,760,75342,-190,2815,507,2816,622,1
20150105.212436,2816,1248,76590,594,2816,387,2817,553,1
20150105.212439,2816,80,76670,0,2816,162,2817,524,1
20150105.21244,2816,2,76672,-2,2816,161,2817,525,1
20150105.212441,2816,2,76674,0,2816,171,2817,526,1
20150105.212443,2817,40,76714,24,2816,178,2817,505,1
20150105.212444,2817,22,76736,0,2816,180,2817,496,1
20150105.212445,2817,14,76750,0,2816,185,2817,489,1
20150105.212445,2817,2,76752,0,2816,185,2817,488,1
20150105.212447,2817,6,76758,0,2816,187,2817,485,1
20150105.212447,2817,2,76760,0,2816,187,2817,487,1
20150105.21245,2817,4,76764,0,2816,188,2817,494,1
20150105.21245,2816,2,76766,0,2816,187,2817,494,0
20150105.212451,2817,8,76774,2,2816,204,2817,490,1
20150105.212452,2817,10,76784,2,2816,206,2817,485,1
20150105.212453,2817,8,76792,0,2816,161,2817,482,1
20150105.212454,2817,20,76812,0,2816,136,2817,473,1
20150105.212455,2816,2,76814,0,2816,119,2817,473,0
20150105.212455,2817,4,76818,0,2816,120,2817,471,1
20150105.212456,2817,6,76824,6,2816,121,2817,472,1
20150105.212457,2817,4,76828,2,2816,124,2817,470,1
20150105.212458,2817,6,76834,6,2816,276,2817,467,1
20150105.212459,2816,12,76846,-12,2816,274,2817,497,0
20150105.212459,2817,8,76854,8,2816,274,2817,493,1
20150105.212501,2817,44,76898,0,2816,364,2817,464,1
20150105.212502,2817,6,76904,0,2816,457,2817,463,1
20150105.212503,2816,6,76910,2,2816,463,2817,464,0
20150105.212504,2816,10,76920,10,2816,460,2817,465,0
20150105.212505,2817,30,76950,30,2816,460,2817,450,1
20150105.212506,2817,20,76970,20,2816,463,2817,442,1
20150105.212507,2817,2,76972,2,2816,464,2817,441,1
20150105.212508,2817,10,76982,0,2816,468,2817,436,1
20150105.21251,2817,2,76984,2,2816,470,2817,488,1
20150105.212514,2816,2,76986,0,2816,481,2817,468,0
20150105.212515,2817,2,76988,2,2816,480,2817,467,1
20150105.212516,2817,2,76990,2,2816,480,2817,466,1
20150105.212516,2816,2,76992,0,2816,515,2817,466,0
20150105.212517,2817,4,76996,4,2816,516,2817,465,1
20150105.21252,2817,4,77000,0,2816,518,2817,465,1
20150105.21252,2817,2,77002,2,2816,527,2817,465,1
20150105.212522,2816,2,77004,2,2816,527,2817,468,0
20150105.212524,2816,4,77008,0,2816,527,2817,468,0
20150105.212525,2817,20,77028,20,2816,525,2817,459,1
20150105.212526,2816,2,77030,0,2816,524,2817,461,0
20150105.212528,2817,4,77034,4,2816,523,2817,490,1
20150105.212529,2816,4,77038,2,2816,520,2817,489,0
20150105.212531,2817,6,77044,4,2816,427,2817,729,1
20150105.212532,2816,852,77896,644,2815,446,2816,85,0
20150105.212533,2816,2,77898,2,2815,445,2816,124,0
20150105.212534,2816,8,77906,8,2815,445,2816,126,0
20150105.212536,2816,4,77910,4,2815,445,2816,126,0
20150105.212536,2816,10,77920,10,2815,445,2816,121,0
20150105.212538,2816,2,77922,2,2815,3444,2816,123,0
20150105.212538,2816,226,78148,-94,2815,3444,2817,722,0
20150105.212539,2816,2,78150,2,2816,31,2817,758,0
20150105.212541,2816,6,78156,0,2816,31,2817,756,0
20150105.212541,2817,14,78170,14,2816,31,2817,713,1
20150105.212542,2816,4,78174,0,2816,29,2817,712,0
20150105.212543,2816,2,78176,0,2816,204,2817,712,0
20150105.212543,2816,2,78178,0,2816,203,2817,713,0
20150105.212545,2816,430,78608,-352,2815,3456,2816,460,0
20150105.212545,2816,2,78610,0,2815,3456,2816,459,0
20150105.212547,2816,2,78612,0,2815,3458,2816,458,0
20150105.212548,2816,6,78618,0,2815,3457,2816,456,0
20150105.212549,2816,4,78622,-2,2815,3457,2816,455,0
20150105.212551,2816,2,78624,0,2815,3448,2816,470,0
20150105.212552,2816,20,78644,0,2815,3447,2816,460,0
20150105.212552,2816,2,78646,0,2815,3447,2816,459,0
20150105.212553,2816,4,78650,-2,2815,3448,2816,457,0
20150105.212554,2816,2,78652,-2,2815,3448,2816,456,0
20150105.212556,2816,6,78658,0,2815,3459,2816,455,0
20150105.212557,2816,2,78660,-2,2815,3459,2816,454,0
20150105.212558,2816,10,78670,-10,2815,3459,2816,449,0
20150105.212559,2816,4,78674,0,2815,3458,2816,447,0
20150105.212601,2816,40,78714,0,2815,3456,2816,430,0
20150105.212602,2816,68,78782,-34,2815,3456,2817,743,0
20150105.212602,2816,2,78784,0,2816,14,2817,743,0
20150105.212603,2815,230,79014,220,2815,3358,2817,744,0
20150105.212604,2816,20,79034,20,2815,3361,2816,5,1
20150105.212606,2816,56,79090,20,2815,3205,2817,740,1
20150105.212607,2817,4,79094,4,2816,22,2817,738,1
20150105.212608,2817,86,79180,0,2816,22,2817,725,1
20150105.212609,2816,100,79280,44,2815,3339,2816,11,0
20150105.212609,2816,22,79302,-22,2815,3339,2817,730,0
20150105.21261,2816,4,79306,4,2816,108,2817,715,0
20150105.212614,2816,2,79308,2,2816,198,2817,681,0
20150105.212615,2817,4,79312,4,2816,201,2817,695,1
20150105.212618,2817,2,79314,2,2816,132,2817,695,1
20150105.212619,2816,20,79334,20,2816,122,2817,696,0
20150105.212622,2817,260,79594,180,2816,569,2817,578,1
20150105.212623,2817,2,79596,2,2816,571,2817,595,1
20150105.212626,2817,20,79616,20,2816,603,2817,563,1
20150105.212627,2817,2,79618,0,2816,622,2817,562,1
20150105.212627,2817,2,79620,2,2816,620,2817,561,1
20150105.212629,2817,4,79624,4,2816,618,2817,561,1
20150105.212629,2817,20,79644,18,2816,618,2817,553,1
20150105.212632,2817,16,79660,14,2816,601,2817,561,1
20150105.212633,2817,6,79666,6,2816,603,2817,558,1
20150105.212634,2817,4,79670,4,2816,601,2817,556,1
20150105.212634,2817,1122,80792,264,2817,454,2818,1525,1
20150105.212635,2817,24,80816,22,2816,613,2817,4,1
20150105.212636,2817,2,80818,0,2816,624,2818,1537,1
20150105.212637,2818,8,80826,-6,2817,175,2818,1536,1
20150105.212638,2818,2,80828,2,2817,177,2818,1531,1
20150105.212638,2818,2,80830,0,2817,218,2818,1531,1
20150105.212639,2818,2,80832,0,2817,269,2818,1531,1
20150105.212639,2818,8,80840,8,2817,271,2818,1527,1
20150105.212642,2818,14,80854,14,2817,294,2818,1509,1
20150105.212642,2818,2,80856,0,2817,296,2818,1507,1
20150105.212643,2818,4,80860,2,2817,296,2818,1506,1
20150105.212644,2818,2,80862,2,2817,296,2818,1503,1
20150105.212646,2817,4,80866,-4,2817,297,2818,1508,0
20150105.212647,2818,12,80878,0,2817,312,2818,1504,1
20150105.212648,2817,4,80882,2,2817,313,2818,1506,0
20150105.212648,2818,8,80890,0,2817,313,2818,1502,1
20150105.212649,2817,2,80892,0,2817,312,2818,1484,0
20150105.212651,2818,6,80898,2,2817,311,2818,1480,1
20150105.212651,2818,2,80900,2,2817,315,2818,1500,1
20150105.212652,2817,2,80902,0,2817,319,2818,1499,0
20150105.212653,2817,42,80944,-40,2817,299,2818,1499,0
20150105.212654,2818,8,80952,0,2817,299,2818,1496,1
20150105.212655,2817,4,80956,0,2817,298,2818,1495,0
20150105.212656,2818,4,80960,4,2817,283,2818,1521,1
20150105.212658,2818,8,80968,0,2817,288,2818,1488,1
20150105.212659,2818,24,80992,0,2817,278,2818,1487,1
20150105.2127,2817,20,81012,-20,2817,270,2818,1488,0
20150105.212701,2817,8,81020,-8,2817,275,2818,1588,0
20150105.212702,2818,2,81022,2,2817,275,2818,1587,1
20150105.212704,2818,22,81044,20,2817,275,2818,1623,1
20150105.212704,2817,10,81054,0,2817,271,2818,1623,0
20150105.212705,2818,76,81130,0,2817,272,2818,1576,1
20150105.212707,2818,10,81140,0,2817,275,2818,1598,1
20150105.212708,2817,2,81142,-2,2817,278,2818,1587,0
20150105.212709,2817,42,81184,-42,2817,256,2818,1598,0
20150105.21271,2818,8,81192,0,2817,258,2818,1601,1
20150105.212711,2817,2,81194,-2,2817,259,2818,1602,0
20150105.212713,2818,4,81198,0,2817,270,2818,1621,1
20150105.212716,2817,554,81752,-290,2816,425,2817,727,0
20150105.212716,2817,2,81754,-2,2816,413,2817,742,0
20150105.212717,2817,10,81764,-10,2816,413,2817,747,0
20150105.212717,2817,2,81766,0,2816,413,2817,751,0
20150105.212719,2817,22,81788,0,2816,409,2817,1746,0
20150105.212723,2816,8,81796,0,2816,428,2817,1754,0
20150105.212725,2817,2,81798,0,2816,430,2817,1800,1
20150105.212728,2817,6,81804,0,2816,448,2817,1802,1
20150105.212731,2816,2,81806,2,2816,354,2817,1810,0
20150105.212733,2817,2,81808,0,2816,349,2817,1811,1
20150105.212733,2816,2,81810,2,2816,348,2817,1824,0
20150105.212734,2816,2,81812,2,2816,347,2817,1827,0
20150105.212734,2816,2,81814,0,2816,347,2817,1827,0
20150105.212735,2816,4,81818,2,2816,345,2817,1827,0
20150105.212739,2817,4,81822,0,2816,344,2817,1943,1
20150105.212742,2816,2,81824,2,2816,358,2817,1946,0
20150105.212744,2817,34,81858,-34,2816,361,2817,1947,1
20150105.212744,2817,2,81860,-2,2816,364,2817,1946,1
20150105.212746,2817,2,81862,-2,2816,5387,2817,930,1
20150105.212747,2816,4,81866,4,2816,5387,2817,930,0
20150105.212747,2817,202,82068,0,2816,5387,2817,829,1
20150105.212754,2817,2,82070,-2,2816,5376,2817,1363,1
20150105.212755,2817,2,82072,0,2816,5376,2817,1362,1
20150105.212756,2816,20,82092,0,2816,5376,2817,1362,0
20150105.212756,2817,40,82132,0,2816,5376,2817,1342,1
20150105.212757,2817,10,82142,0,2816,5376,2817,1337,1
20150105.2128,2817,10,82152,0,2816,5377,2817,1333,1
20150105.212801,2817,2,82154,0,2816,5378,2817,1333,1
20150105.212801,2817,10,82164,-8,2816,5377,2817,1333,1
20150105.212803,2816,4,82168,2,2816,5377,2817,1332,0
20150105.212806,2817,6,82174,-4,2816,5376,2817,1329,1
20150105.212807,2816,2000,84174,1942,2816,4376,2817,1329,0
20150105.212808,2817,2,84176,-2,2816,4374,2817,1330,1
20150105.212808,2816,2,84178,2,2816,31,2817,789,0
20150105.212809,2816,4,84182,4,2816,29,2817,787,0
20150105.212809,2816,20,84202,-10,2816,19,2817,787,0
20150105.212811,2816,8,84210,4,2816,22,2817,799,0
20150105.212812,2817,4,84214,0,2816,32,2817,799,1
20150105.212813,2816,2,84216,-2,2816,31,2817,800,0
20150105.212815,2817,2,84218,0,2816,31,2817,799,1
20150105.212815,2816,2,84220,2,2816,31,2817,802,0
20150105.212816,2817,66,84286,54,2815,396,2817,801,1
20150105.212816,2816,4,84290,0,2815,396,2817,801,0
20150105.21282,2817,2,84292,0,2815,396,2817,848,1
20150105.212823,2815,2,84294,0,2815,422,2816,12,0
20150105.212823,2815,6,84300,0,2815,419,2816,12,0
20150105.212824,2816,2,84302,2,2815,420,2816,66,1
20150105.212827,2816,2,84304,2,2815,424,2816,94,1
20150105.212828,2816,4,84308,4,2815,417,2816,1102,1
20150105.212829,2816,2,84310,2,2815,420,2816,1101,1
20150105.212831,2815,4,84314,2,2815,416,2816,2103,0
20150105.212831,2816,8,84322,8,2815,416,2816,2100,1
20150105.212833,2816,2,84324,2,2815,416,2816,2099,1
20150105.212834,2816,12,84336,8,2815,426,2816,2113,1
20150105.212835,2816,16,84352,2,2815,421,2816,2105,1
20150105.212835,2815,22,84374,2,2815,409,2816,2106,0
20150105.212836,2815,2,84376,2,2815,410,2816,2107,0
20150105.21284,2816,32,84408,-16,2815,411,2816,2095,1
20150105.212842,2815,12,84420,12,2815,408,2816,2096,0
20150105.212843,2815,4,84424,4,2815,408,2816,2096,0
20150105.212844,2816,2,84426,2,2815,418,2816,2095,1
20150105.212846,2815,2,84428,0,2815,467,2816,2095,0
20150105.212847,2816,2,84430,2,2815,469,2816,2095,1
20150105.212848,2816,2,84432,2,2815,475,2816,2094,1
20150105.212849,2815,2,84434,0,2815,476,2816,2094,0
20150105.212849,2815,26,84460,20,2815,463,2816,2094,0
20150105.212851,2815,2,84462,2,2815,464,2816,2096,0
20150105.212852,2815,2,84464,0,2815,464,2816,2096,0
20150105.212852,2815,6,84470,6,2815,462,2816,2095,0
20150105.212854,2816,2,84472,2,2815,5510,2816,2081,1
20150105.212858,2816,20,84492,20,2815,464,2816,2090,1
20150105.212859,2815,40,84532,40,2815,447,2816,2090,0
20150105.212859,2815,2,84534,-2,2815,446,2816,2088,0
20150105.212859,2815,2,84536,2,2815,459,2816,2088,0
20150105.212901,2816,2,84538,0,2815,499,2816,2088,1
20150105.212902,2816,4,84542,4,2815,499,2816,2086,1
20150105.212906,2815,2,84544,2,2815,549,2816,2089,0
20150105.212906,2815,2,84546,-2,2815,549,2816,2089,0
20150105.212907,2816,4,84550,0,2815,553,2816,2098,1
20150105.212908,2815,34,84584,0,2815,536,2816,2095,0
20150105.212912,2816,20,84604,20,2815,539,2816,2086,1
20150105.212913,2815,10,84614,4,2815,534,2816,2086,0
20150105.212914,2815,102,84716,-50,2815,533,2816,2042,0
20150105.212915,2815,10,84726,-10,2815,531,2816,2043,0
20150105.212917,2815,2,84728,0,2815,542,2816,2044,0
20150105.212918,2815,2,84730,0,2815,542,2816,2044,0
20150105.212919,2815,6,84736,-4,2815,550,2816,2043,0
20150105.21292,2815,86,84822,-34,2815,508,2816,2043,0
20150105.212921,2815,400,85222,-46,2815,309,2816,2043,0
20150105.212921,2815,54,85276,2,2815,284,2816,2042,0
20150105.212922,2815,570,85846,-220,2814,409,2815,715,0
20150105.212922,2815,8,85854,-2,2814,393,2815,730,0
20150105.212923,2815,2,85856,0,2814,394,2815,735,0
20150105.212924,2815,60,85916,0,2814,394,2815,708,0
20150105.212925,2815,2,85918,0,2814,396,2815,707,0
20150105.212926,2815,10,85928,0,2814,399,2815,704,0
20150105.212927,2814,6,85934,2,2814,396,2815,734,0
20150105.212928,2815,100,86034,0,2814,447,2815,670,1
20150105.212928,2814,8,86042,0,2814,445,2815,669,0
20150105.212931,2814,12,86054,0,2814,451,2815,669,0
20150105.212932,2815,10,86064,0,2814,451,2815,664,1
20150105.212932,2815,12,86076,0,2814,450,2815,659,1
20150105.212933,2814,14,86090,-12,2814,449,2815,657,0
20150105.212933,2815,2,86092,0,2814,449,2815,657,1
20150105.212934,2814,4,86096,-2,2814,470,2815,659,0
20150105.212935,2815,100,86196,-100,2814,485,2815,609,1
20150105.212936,2815,100,86296,-100,2814,485,2815,564,1
20150105.212937,2814,2,86298,0,2814,484,2815,565,0
20150105.212937,2815,2,86300,0,2814,485,2815,567,1
20150105.212938,2815,100,86400,-100,2814,487,2815,535,1
20150105.212939,2815,6,86406,-2,2814,491,2815,534,1
20150105.21294,2814,2,86408,0,2814,490,2815,534,0
20150105.212943,2815,2,86410,0,2814,521,2815,530,1
20150105.212943,2815,2,86412,0,2814,522,2815,534,1
20150105.212944,2814,20,86432,-20,2814,519,2815,534,0
20150105.212945,2815,2,86434,-2,2814,518,2815,525,1
20150105.212946,2814,100,86534,8,2814,469,2815,525,0
20150105.212947,2815,2,86536,0,2814,470,2815,524,1
20150105.212948,2814,4,86540,-2,2814,418,2815,545,0
20150105.21295,2814,20,86560,-16,2814,413,2815,550,0
20150105.212952,2814,12,86572,-12,2814,410,2815,550,0
20150105.212952,2814,2,86574,2,2814,408,2815,551,0
20150105.212953,2814,2,86576,2,2814,423,2815,561,0
20150105.212954,2815,200,86776,-200,2814,436,2815,461,1
20150105.212954,2814,10,86786,8,2814,431,2815,466,0
20150105.212955,2814,2,86788,2,2814,458,2815,466,0
20150105.212957,2815,180,86968,-180,2814,458,2815,376,1
20150105.212959,2815,2,86970,0,2814,461,2815,114,1
20150105.212959,2814,20,86990,20,2814,452,2815,115,0
20150105.213,2815,4,86994,-2,2814,541,2815,113,1
20150105.213001,2815,42,87036,40,2814,592,2815,97,1
20150105.213001,2815,194,87230,-92,2814,2591,2816,1107,1
20150105.213002,2815,44,87274,-20,2815,11,2816,1105,1
20150105.213004,2815,62,87336,-34,2815,54,2816,1105,1
20150105.213007,2815,10,87346,0,2815,123,2816,1103,1
20150105.213008,2815,4,87350,-2,2815,127,2816,1103,1
20150105.213009,2815,254,87604,-224,2814,4605,2815,324,1
20150105.21301,2815,168,87772,0,2814,4616,2815,240,1
20150105.21301,2815,480,88252,-200,2814,4616,2816,1100,1
20150105.213012,2815,22,88274,0,2814,617,2815,2,1
20150105.213013,2815,2,88276,0,2814,621,2815,28,1
20150105.213014,2815,2,88278,0,2814,621,2815,32,1
20150105.213015,2815,4,88282,0,2814,622,2815,30,1
20150105.213016,2815,2,88284,0,2814,627,2815,29,1
20150105.213017,2815,2,88286,0,2814,627,2815,28,1
20150105.213018,2815,6,88292,0,2814,639,2815,30,1
20150105.21302,2815,2,88294,0,2814,703,2815,30,1
20150105.21302,2815,4,88298,-4,2814,703,2815,28,1
20150105.213022,2814,2,88300,-2,2814,733,2815,29,0
20150105.213022,2815,6,88306,0,2814,736,2815,26,1
20150105.213022,2815,2,88308,-2,2814,737,2815,33,1
20150105.213025,2815,8,88316,0,2814,730,2815,31,1
20150105.213028,2815,2,88318,0,2814,733,2815,34,1
20150105.213029,2815,2,88320,2,2814,742,2815,34,1
20150105.21303,2815,2,88322,2,2814,748,2815,33,1
20150105.213031,2815,2,88324,2,2814,748,2815,32,1
20150105.213031,2815,14,88338,14,2814,748,2815,25,1
20150105.213032,2815,4,88342,2,2814,754,2815,25,1
20150105.213033,2815,2,88344,2,2814,754,2815,24,1
20150105.213034,2815,112,88456,80,2814,786,2816,1140,1
20150105.213035,2814,2,88458,2,2814,786,2815,31,0
20150105.213035,2815,2,88460,2,2814,788,2815,30,1
20150105.213037,2815,24,88484,0,2814,787,2815,19,1
20150105.213037,2815,2,88486,2,2814,786,2815,18,1
20150105.213039,2815,2,88488,2,2814,835,2815,17,1
20150105.21304,2815,1010,89498,662,2814,337,2815,27,1
20150105.213042,2815,4,89502,0,2814,359,2815,99,1
20150105.213045,2815,4,89506,0,2814,365,2815,100,1
20150105.213046,2815,2,89508,0,2814,369,2815,100,1
20150105.213046,2815,4,89512,0,2814,369,2815,98,1
20150105.213048,2815,22,89534,0,2814,369,2815,143,1
20150105.213049,2815,4,89538,0,2814,369,2815,141,1
20150105.213051,2815,2,89540,0,2814,375,2815,150,1
20150105.213052,2815,6,89546,0,2814,385,2815,147,1
20150105.213053,2815,50,89596,-16,2814,385,2815,123,1
20150105.213055,2815,10,89606,0,2814,387,2815,119,1
20150105.213056,2815,26,89632,0,2814,389,2815,106,1
20150105.213058,2814,4,89636,0,2814,389,2815,109,0
20150105.213059,2815,18,89654,0,2814,390,2815,101,1
20150105.2131,2815,2,89656,2,2814,392,2815,100,1
20150105.213104,2815,4,89660,4,2814,509,2815,104,1
20150105.213106,2815,52,89712,-6,2814,509,2815,78,1
20150105.213107,2814,4,89716,0,2814,509,2815,77,0
20150105.213107,2815,342,90058,-142,2815,31,2816,1169,1
20150105.213108,2815,62,90120,-58,2814,510,2816,1170,1
20150105.213109,2816,200,90320,200,2814,511,2816,1060,1
20150105.21311,2815,2,90322,0,2814,511,2815,13,0
20150105.213111,2815,6,90328,4,2814,512,2815,10,0
20150105.213111,2815,2,90330,0,2814,512,2815,9,0
20150105.213112,2815,4,90334,4,2814,518,2815,7,0
20150105.213113,2816,26,90360,-4,2814,518,2816,1055,1
20150105.213114,2815,4,90364,0,2814,518,2816,1056,0
20150105.213115,2815,4,90368,0,2815,1,2816,1057,0
20150105.213115,2815,2,90370,0,2814,519,2815,10,0
20150105.213117,2814,18,90388,0,2814,513,2815,12,0
20150105.213118,2814,2,90390,-2,2814,514,2815,13,0
20150105.213118,2815,4,90394,-4,2814,514,2815,13,1
20150105.21312,2815,6,90400,-6,2814,515,2815,10,1
20150105.213122,2815,62,90462,-20,2814,524,2816,1058,1
20150105.213122,2815,6,90468,0,2815,1,2816,1058,1
20150105.213123,2815,2,90470,0,2814,523,2816,1058,1
20150105.213124,2815,2,90472,0,2814,524,2816,1058,1
20150105.213124,2814,2,90474,2,2815,2,2816,1057,0
20150105.213125,2815,4,90478,0,2814,524,2816,1057,1
20150105.213129,2815,24,90502,20,2814,591,2815,1,1
20150105.21313,2815,2,90504,0,2815,3,2816,1054,1
20150105.21313,2815,2,90506,-2,2815,9,2816,1054,1
20150105.213136,2815,30,90536,-10,2814,573,2815,5,1
20150105.213137,2815,12,90548,0,2814,573,2816,1055,1
20150105.213137,2814,4,90552,4,2814,583,2816,1055,0
20150105.213141,2815,4,90556,4,2815,1,2816,1067,1
20150105.213141,2815,2,90558,0,2814,610,2816,1067,1
20150105.213142,2816,10,90568,10,2814,610,2815,1,1
20150105.213143,2815,4,90572,0,2814,730,2816,1083,0
20150105.213145,2815,4,90576,0,2815,19,2816,1078,0
20150105.213148,2815,4,90580,0,2815,79,2816,1074,0
20150105.213149,2816,4,90584,2,2815,82,2816,1072,1
20150105.213149,2815,2,90586,0,2815,81,2816,1072,0
20150105.213152,2815,2,90588,2,2815,79,2816,1055,0
20150105.213152,2816,2,90590,2,2815,79,2816,1054,1
20150105.213155,2816,2,90592,2,2815,89,2816,1051,1
20150105.213156,2815,16,90608,2,2815,85,2816,1048,0
20150105.213156,2816,2,90610,2,2815,86,2816,1047,1
20150105.213159,2815,2,90612,0,2815,86,2816,1048,0
20150105.213203,2815,6,90618,0,2815,85,2816,1048,0
20150105.213209,2816,2,90620,2,2815,87,2816,1059,1
20150105.213211,2815,4,90624,-4,2815,87,2816,1059,0
20150105.213212,2816,8,90632,4,2815,86,2816,1057,1
20150105.213215,2815,20,90652,-14,2815,90,2816,1058,0
20150105.213218,2816,26,90678,14,2815,98,2816,1033,1
20150105.213218,2815,2,90680,0,2815,98,2816,1033,0
20150105.213219,2816,2,90682,2,2815,99,2816,1032,1
20150105.213222,2815,2,90684,0,2815,99,2816,1032,0
20150105.213225,2815,20,90704,-20,2815,149,2816,1035,0
20150105.213225,2816,2,90706,2,2815,155,2816,1034,1
20150105.213227,2816,2,90708,2,2815,159,2816,1035,1
20150105.213234,2815,20,90728,-20,2815,157,2816,1056,0
20150105.213238,2815,2,90730,0,2815,158,2816,1066,0
20150105.213244,2815,2,90732,-2,2815,221,2816,1072,0
20150105.213247,2816,8,90740,0,2815,345,2816,1052,1
20150105.213248,2815,42,90782,0,2815,324,2816,1051,0
20150105.213253,2815,16,90798,6,2815,322,2816,1067,0
20150105.213259,2816,8,90806,0,2815,624,2816,1065,1
20150105.2133,2815,86,90892,70,2815,581,2816,1065,0
20150105.213301,2815,2,90894,0,2815,578,2816,1068,0
20150105.213302,2815,2,90896,2,2815,577,2816,1068,0
20150105.213303,2815,2,90898,2,2815,576,2816,1068,0
20150105.213305,2815,2,90900,-2,2815,576,2816,1068,0
20150105.213312,2816,10,90910,0,2815,577,2816,1064,1
20150105.213313,2816,2,90912,0,2815,595,2816,1063,1
20150105.213317,2816,2,90914,2,2815,594,2816,1063,1
20150105.213317,2816,2,90916,2,2815,594,2816,1062,1
20150105.213318,2815,4,90920,0,2815,592,2816,1062,0
20150105.213321,2816,2,90922,2,2815,592,2816,1076,1
20150105.213325,2816,102,91024,102,2815,581,2816,1015,1
20150105.213326,2816,2,91026,2,2815,583,2816,1014,1
20150105.213326,2815,20,91046,-8,2815,573,2816,1014,0
20150105.213327,2816,2,91048,2,2815,573,2816,1013,1
20150105.213327,2815,20,91068,0,2815,563,2816,1013,0
20150105.213328,2816,40,91108,40,2815,563,2816,992,1
20150105.213332,2816,2,91110,2,2815,565,2816,998,1
20150105.213333,2816,2,91112,2,2815,566,2816,997,1
20150105.213334,2815,6,91118,-6,2815,563,2816,1000,0
20150105.213337,2816,10,91128,0,2815,636,2816,995,1
20150105.21334,2816,2,91130,2,2815,640,2816,992,1
20150105.213344,2816,2,91132,0,2815,643,2816,989,1
20150105.213347,2816,2,91134,0,2815,652,2816,989,1
20150105.213349,2816,20,91154,0,2815,653,2816,981,1
20150105.213351,2816,10,91164,0,2815,708,2816,974,1
20150105.213351,2816,2,91166,2,2815,708,2816,973,1
20150105.213353,2815,40,91206,18,2815,699,2816,952,0
20150105.213354,2816,6,91212,0,2815,699,2816,934,1
20150105.213355,2815,2,91214,0,2815,702,2816,933,0
20150105.213357,2816,2,91216,0,2815,703,2816,932,1
20150105.213401,2816,4,91220,0,2815,703,2816,951,1
20150105.213402,2816,4,91224,4,2815,702,2816,951,1
20150105.213404,2816,6,91230,0,2815,662,2816,948,1
20150105.213405,2815,2,91232,-2,2815,661,2816,948,0
20150105.213408,2816,2,91234,0,2815,669,2816,1946,1
20150105.21341,2816,6,91240,0,2815,672,2816,1944,1
20150105.21341,2816,2,91242,0,2815,672,2816,1944,1
20150105.213411,2816,20,91262,20,2815,672,2816,1934,1
20150105.213412,2816,6,91268,0,2815,670,2816,1933,1
20150105.213414,2815,2,91270,0,2815,670,2816,1934,0
20150105.213415,2816,2,91272,2,2815,676,2816,1933,1
20150105.213416,2816,4,91276,4,2815,677,2816,1931,1
20150105.213424,2816,40,91316,0,2815,701,2816,1907,1
20150105.213429,2816,2,91318,2,2815,693,2816,1926,1
20150105.213431,2816,20,91338,20,2815,693,2816,1936,1
20150105.213432,2816,100,91438,0,2815,684,2816,1871,1
20150105.213433,2816,2,91440,2,2815,684,2816,1875,1
20150105.213435,2816,4,91444,0,2815,684,2816,1874,1
20150105.213436,2816,2,91446,2,2815,684,2816,1872,1
20150105.213436,2815,2,91448,2,2815,683,2816,1872,0
20150105.213437,2815,62,91510,0,2815,657,2816,1871,0
20150105.213439,2815,200,91710,-200,2815,558,2816,1886,0
20150105.21344,2816,82,91792,2,2815,558,2816,1846,1
20150105.213443,2816,2,91794,2,2815,558,2816,1845,1
20150105.213443,2816,8,91802,8,2815,558,2816,1841,1
20150105.213444,2816,4,91806,0,2815,558,2816,1840,1
20150105.213445,2816,2,91808,2,2815,558,2816,1839,1
20150105.213446,2815,10,91818,0,2815,555,2816,1842,0
20150105.21345,2816,2,91820,0,2815,557,2816,1843,1
20150105.213452,2816,4,91824,4,2815,557,2816,1841,1
20150105.213455,2816,8,91832,0,2815,568,2816,1837,1
20150105.213458,2816,100,91932,100,2815,568,2816,1784,1
20150105.213459,2816,4,91936,0,2815,570,2816,1782,1
20150105.213459,2815,8,91944,-6,2815,567,2816,1781,0
20150105.213504,2815,2,91946,0,2815,568,2816,1780,0
20150105.213505,2816,4,91950,0,2815,568,2816,1778,1
20150105.213507,2816,2,91952,2,2815,557,2816,1777,1
20150105.213508,2816,60,92012,8,2815,531,2816,1773,1
20150105.21351,2815,2,92014,0,2815,549,2816,1775,0
20150105.213514,2816,10,92024,10,2815,555,2816,1756,1
20150105.213516,2816,2,92026,0,2815,555,2816,1756,1
20150105.213518,2815,2,92028,0,2815,553,2816,1756,0
20150105.213521,2816,40,92068,40,2815,547,2816,1737,1
20150105.213524,2815,4,92072,2,2815,545,2816,1737,0
20150105.213525,2815,2,92074,0,2815,544,2816,1737,0
20150105.213525,2815,2,92076,2,2815,543,2816,1737,0
20150105.213529,2815,2,92078,0,2815,544,2816,1747,0
20150105.21353,2816,2,92080,2,2815,544,2816,1746,1
20150105.213531,2815,1088,93168,-174,2814,1159,2815,456,0
20150105.213532,2814,2,93170,0,2814,1123,2815,468,0
20150105.213533,2815,2,93172,0,2814,1078,2815,467,1
20150105.213534,2815,8,93180,-8,2814,1078,2815,463,1
20150105.213534,2815,12,93192,0,2814,1078,2815,464,1
20150105.213538,2815,2,93194,0,2814,1079,2815,466,1
20150105.213539,2814,8,93202,0,2814,1075,2815,466,0
20150105.213541,2815,2,93204,0,2814,1086,2815,472,1
20150105.213542,2814,6,93210,0,2814,1088,2815,472,0
20150105.213547,2815,6,93216,-2,2814,1156,2815,472,1
20150105.213548,2815,2,93218,0,2814,1156,2815,472,1
20150105.213556,2815,2,93220,0,2814,1112,2815,472,1
20150105.213558,2815,8,93228,-8,2814,1113,2815,469,1
20150105.213559,2815,4,93232,0,2814,1104,2815,467,1
20150105.213601,2815,2,93234,0,2814,1124,2815,468,1
20150105.213602,2815,6,93240,-6,2814,1121,2815,465,1
20150105.213602,2815,2,93242,0,2814,1124,2815,454,1
20150105.213608,2815,20,93262,-20,2814,1103,2815,445,1
20150105.21361,2814,12,93274,12,2814,1100,2815,453,0
20150105.213611,2814,2,93276,2,2814,1100,2815,455,0
20150105.213611,2814,4,93280,0,2814,1099,2815,454,0
20150105.213612,2815,20,93300,0,2814,1176,2815,444,1
20150105.213614,2815,4,93304,0,2814,1176,2815,442,1
20150105.213616,2814,2,93306,0,2814,1174,2815,442,0
20150105.213617,2814,4,93310,0,2814,1168,2815,442,0
20150105.213619,2815,2,93312,-2,2814,1153,2815,441,1
20150105.213622,2815,6,93318,0,2814,1151,2815,441,1
20150105.213622,2815,2,93320,0,2814,1151,2815,458,1
20150105.213625,2815,4,93324,0,2814,1153,2815,457,1
20150105.213626,2814,2,93326,0,2814,1161,2815,457,0
20150105.21363,2815,4,93330,0,2814,1168,2815,473,1
20150105.213632,2815,40,93370,0,2814,1155,2815,454,1
20150105.213632,2815,2,93372,0,2814,1155,2815,456,1
20150105.213637,2815,2,93374,0,2814,1155,2815,460,1
20150105.213638,2815,2,93376,-2,2814,1155,2815,459,1
20150105.21364,2815,2,93378,-2,2814,1154,2815,458,1
20150105.21364,2815,2,93380,0,2814,1154,2815,457,1
20150105.213642,2815,4,93384,0,2814,1154,2815,455,1
20150105.213644,2814,2,93386,0,2814,1252,2815,455,0
20150105.213644,2814,2,93388,0,2814,1251,2815,465,0
20150105.213648,2815,2,93390,0,2814,1266,2815,465,1
20150105.213648,2814,2,93392,0,2814,1265,2815,465,0
20150105.213649,2814,2,93394,0,2814,1263,2815,489,0
20150105.213651,2815,4,93398,0,2814,1262,2815,488,1
20150105.213651,2815,2,93400,-2,2814,1262,2815,487,1
20150105.213653,2815,8,93408,-8,2814,1262,2815,483,1
20150105.213653,2815,8,93416,0,2814,1262,2815,481,1
20150105.213655,2815,4,93420,0,2814,1266,2815,479,1
20150105.213657,2815,6,93426,0,2814,1252,2815,777,1
20150105.213659,2815,2,93428,-2,2814,1252,2815,776,1
20150105.2137,2815,2,93430,-2,2814,1253,2815,777,1
20150105.213701,2815,2,93432,0,2814,1254,2815,776,1
20150105.213702,2815,4,93436,0,2814,1254,2815,775,1
20150105.213703,2814,2,93438,0,2814,1254,2815,775,0
20150105.213703,2815,20,93458,0,2814,1254,2815,765,1
20150105.213704,2815,2,93460,-2,2814,1254,2815,765,1
20150105.213707,2815,2,93462,-2,2814,1304,2815,763,1
20150105.213708,2815,6,93468,-6,2814,1301,2815,760,1
20150105.21371,2815,2,93470,0,2814,1298,2815,774,1
20150105.213712,2814,14,93484,0,2814,1291,2815,774,0
20150105.213713,2815,2,93486,0,2814,1290,2815,795,1
20150105.213714,2815,10,93496,-10,2814,1300,2815,790,1
20150105.213716,2814,16,93512,12,2814,1294,2815,784,0
20150105.213716,2814,4,93516,4,2814,1292,2815,784,0
20150105.213718,2814,16,93532,16,2814,1284,2815,779,0
20150105.213719,2815,4,93536,0,2814,1294,2815,778,1
20150105.21372,2814,4,93540,4,2814,1297,2815,776,0
20150105.213722,2814,8,93548,8,2814,1293,2815,772,0
20150105.213723,2814,112,93660,0,2814,1287,2815,722,0
20150105.213724,2814,8,93668,2,2814,1285,2815,718,0
20150105.213725,2815,4,93672,0,2814,1281,2815,716,1
20150105.213725,2815,4,93676,0,2814,1281,2815,714,1
20150105.213727,2814,4,93680,0,2814,1280,2815,713,0
20150105.213728,2815,20,93700,0,2814,1280,2815,703,1
20150105.21373,2814,4,93704,-4,2814,1278,2815,703,0
20150105.213732,2815,2,93706,0,2814,1250,2815,703,1
20150105.213734,2814,2,93708,-2,2814,1264,2815,703,0
20150105.213737,2815,4,93712,-2,2814,1262,2815,703,1
20150105.213739,2815,10,93722,-8,2814,1259,2815,700,1
20150105.213739,2814,6,93728,2,2814,1248,2815,700,0
20150105.21374,2815,2,93730,0,2814,1248,2815,699,1
20150105.213743,2815,20,93750,0,2814,1235,2815,689,1
20150105.213748,2814,2,93752,0,2814,1236,2815,692,0
20150105.213749,2815,2,93754,0,2814,1236,2815,691,1
20150105.21375,2815,2,93756,-2,2814,1236,2815,690,1
20150105.21375,2814,2,93758,2,2814,1185,2815,689,0
20150105.213751,2815,2,93760,0,2814,1185,2815,688,1
20150105.213754,2814,8,93768,-4,2814,1196,2815,688,0
20150105.213757,2815,6,93774,0,2814,1196,2815,685,1
20150105.213758,2814,4,93778,0,2814,1194,2815,685,0
20150105.2138,2814,6,93784,0,2814,1193,2815,685,0
20150105.213801,2814,2,93786,0,2814,1192,2815,685,0
20150105.213806,2814,8,93794,8,2814,1214,2815,686,0
20150105.213809,2814,2,93796,0,2814,1210,2815,686,0
20150105.21381,2815,6,93802,0,2814,1211,2815,683,1
20150105.21381,2814,6,93808,-6,2814,1208,2815,683,0
20150105.213815,2815,2,93810,0,2814,1232,2815,685,1
20150105.213819,2815,10,93820,0,2814,1235,2815,674,1
20150105.213821,2814,2,93822,-2,2814,1236,2815,673,0
20150105.213824,2814,2,93824,-2,2814,1233,2815,676,0
20150105.213835,2815,10,93834,0,2814,1218,2815,676,1
20150105.213836,2815,4,93838,0,2814,1220,2815,681,1
20150105.213837,2815,2,93840,0,2814,1221,2815,680,1
20150105.213845,2815,12,93852,0,2814,1224,2815,690,1
20150105.213846,2815,100,93952,0,2814,1222,2815,641,1
20150105.213848,2814,20,93972,0,2814,1234,2815,641,0
20150105.21385,2815,2,93974,0,2814,1236,2815,657,1
20150105.213851,2815,2,93976,0,2814,1247,2815,656,1
20150105.213852,2814,2,93978,0,2814,1246,2815,656,0
20150105.213853,2815,4,93982,0,2814,1246,2815,654,1
20150105.213855,2814,2,93984,0,2814,1254,2815,645,0
20150105.213857,2815,4,93988,0,2814,1253,2815,642,1
20150105.213901,2815,2,93990,0,2814,1259,2815,651,1
20150105.213904,2815,2,93992,0,2814,1269,2815,651,1
20150105.213907,2814,2,93994,0,2814,1252,2815,651,0
20150105.213911,2815,2,93996,-2,2814,1253,2815,650,1
20150105.213914,2814,8,94004,-2,2814,1248,2815,649,0
20150105.213917,2815,40,94044,0,2814,1261,2815,631,1
20150105.21392,2814,20,94064,20,2814,1235,2815,647,0
20150105.213925,2815,2,94066,0,2814,1243,2815,633,1
20150105.213928,2814,2,94068,0,2814,1238,2815,635,0
20150105.21393,2814,10,94078,0,2814,1233,2815,650,0
20150105.21393,2814,2,94080,0,2814,1232,2815,635,0
20150105.213935,2814,22,94102,-20,2814,1245,2815,633,0
20150105.213938,2814,2,94104,0,2814,1232,2815,648,0
20150105.213939,2815,2,94106,-2,2814,1233,2815,647,1
20150105.213942,2815,2,94108,0,2814,1237,2815,647,1
20150105.213943,2814,4,94112,0,2814,1237,2815,648,0
20150105.213944,2815,400,94512,86,2814,1237,2815,448,1
20150105.213945,2815,10,94522,0,2814,1280,2815,443,1
20150105.213946,2814,2,94524,0,2814,1280,2815,443,0
20150105.213948,2814,2,94526,0,2814,1281,2815,449,0
20150105.213954,2815,2,94528,-2,2814,1288,2815,448,1
20150105.213955,2815,4,94532,0,2814,1287,2815,446,1
20150105.213959,2814,100,94632,-44,2814,1199,2815,446,0
20150105.214001,2815,2,94634,2,2814,1200,2815,433,1
20150105.214004,2815,40,94674,40,2814,1200,2815,413,1
20150105.214004,2815,4,94678,4,2814,1201,2815,411,1
20150105.214005,2815,2,94680,2,2814,1203,2815,411,1
20150105.214012,2815,4,94684,0,2814,1216,2815,409,1
20150105.214013,2815,2,94686,0,2814,1214,2815,408,1
20150105.214016,2815,400,95086,400,2814,1280,2815,207,1
20150105.214017,2815,414,95500,-12,2814,1279,2816,2305,1
20150105.214018,2815,2,95502,0,2815,11,2816,2305,1
20150105.214018,2815,6,95508,0,2815,13,2816,2303,1
20150105.214019,2815,16,95524,-4,2815,15,2816,2303,1
20150105.214024,2815,2,95526,-2,2815,22,2816,2303,1
20150105.214026,2815,2,95528,-2,2815,119,2816,2303,1
20150105.214028,2815,2,95530,-2,2815,119,2816,2301,1
20150105.214028,2816,20,95550,20,2815,119,2816,2293,1
20150105.21403,2815,4,95554,-4,2815,152,2816,2296,0
20150105.214033,2815,2,95556,2,2815,160,2816,2296,0
20150105.214034,2815,6,95562,0,2815,157,2816,2296,0
20150105.214037,2815,58,95620,24,2815,131,2816,2296,0
20150105.214039,2815,22,95642,0,2815,131,2816,2286,0
20150105.214041,2816,2,95644,2,2815,138,2816,2285,1
20150105.214041,2815,20,95664,-20,2815,128,2816,2285,0
20150105.214042,2816,2,95666,2,2815,128,2816,2284,1
20150105.214045,2816,2,95668,0,2815,148,2816,2283,1
20150105.214046,2816,4,95672,0,2815,148,2816,2281,1
20150105.214048,2816,2,95674,0,2815,150,2816,2280,1
20150105.214049,2815,2,95676,-2,2815,149,2816,2280,0
20150105.21405,2815,2,95678,-2,2815,147,2816,2280,0
20150105.214051,2816,2,95680,2,2815,149,2816,2279,1
20150105.214054,2816,2,95682,0,2815,154,2816,2279,1
20150105.214055,2816,8,95690,8,2815,163,2816,2275,1
20150105.214058,2816,34,95724,34,2815,300,2816,2258,1
20150105.214102,2815,46,95770,0,2815,279,2816,2460,0
20150105.214105,2816,4,95774,4,2815,278,2816,2259,1
20150105.214107,2815,4,95778,-4,2815,277,2816,2259,0
20150105.214111,2816,2,95780,2,2815,295,2816,2276,1
20150105.214114,2816,6,95786,4,2815,297,2816,2274,1
20150105.214118,2816,30,95816,0,2815,333,2816,2259,1
20150105.214119,2816,2,95818,2,2815,334,2816,2258,1
20150105.214119,2816,4,95822,2,2815,334,2816,2256,1
20150105.21412,2815,2,95824,0,2815,333,2816,2255,0
20150105.21412,2815,46,95870,-20,2815,323,2816,2242,0
20150105.214122,2815,80,95950,2,2815,299,2816,2242,0
20150105.214123,2815,14,95964,-14,2815,292,2816,2244,0
20150105.214125,2816,4,95968,4,2815,292,2816,2242,1
20150105.214125,2816,244,96212,188,2815,170,2816,2240,1
20150105.214126,2815,174,96386,0,2815,63,2816,2240,0
20150105.214127,2815,34,96420,-8,2815,48,2816,2240,0
20150105.214128,2815,96,96516,-36,2814,1295,2815,18,0
20150105.214129,2815,2,96518,0,2814,1299,2815,18,0
20150105.21413,2815,2,96520,0,2814,1300,2815,21,0
20150105.214132,2815,2,96522,0,2814,1299,2815,22,0
20150105.214133,2815,2,96524,0,2814,1299,2815,21,0
20150105.214135,2815,6,96530,-6,2814,1305,2815,27,0
20150105.21414,2815,14,96544,12,2814,1298,2815,26,0
20150105.21414,2815,52,96596,20,2815,26,2816,2254,0
20150105.214144,2815,2,96598,2,2815,28,2816,2255,0
20150105.214145,2815,2,96600,0,2815,27,2816,2255,0
20150105.214147,2816,2,96602,2,2815,27,2816,2254,1
20150105.214148,2815,40,96642,24,2815,8,2816,2255,0
20150105.214149,2815,10,96652,6,2815,8,2816,2255,0
20150105.214152,2815,2,96654,0,2815,15,2816,2260,0
20150105.214153,2815,2,96656,0,2815,16,2816,2260,0
20150105.214154,2815,2,96658,0,2815,25,2816,2261,0
20150105.214154,2815,10,96668,0,2815,20,2816,2261,0
20150105.214154,2815,2,96670,2,2815,21,2816,2262,0
20150105.214158,2815,2,96672,0,2815,25,2816,2261,0
20150105.214207,2815,4,96676,4,2815,56,2816,2761,0
20150105.214208,2815,6,96682,6,2815,55,2816,2762,0
20150105.214211,2815,60,96742,18,2815,27,2816,2766,0
20150105.214212,2815,2,96744,-2,2815,26,2816,2766,0
20150105.214213,2815,20,96764,0,2815,16,2816,2767,0
20150105.214213,2815,2,96766,0,2815,15,2816,2767,0
20150105.214219,2816,10,96776,10,2815,21,2816,2791,1
20150105.214219,2815,2,96778,2,2815,20,2816,2791,0
20150105.21422,2815,2,96780,0,2815,19,2816,2792,0
20150105.214227,2816,40,96820,40,2815,20,2816,2773,1
20150105.214228,2815,20,96840,16,2815,12,2816,2773,0
20150105.214229,2815,22,96862,18,2815,1,2816,2772,0
20150105.214229,2816,4,96866,4,2815,1,2816,2771,1
20150105.214231,2816,6,96872,6,2815,1,2816,2768,1
20150105.214231,2815,18,96890,18,2815,32,2816,2768,0
20150105.214233,2815,2,96892,2,2815,32,2816,2769,0
20150105.214234,2815,66,96958,0,2814,1286,2815,378,0
20150105.214235,2815,14,96972,-14,2814,1284,2815,374,0
20150105.214239,2815,2,96974,0,2814,1285,2815,374,0
20150105.21424,2815,220,97194,-220,2814,1252,2815,264,0
20150105.214242,2815,566,97760,-232,2814,1267,2815,1,0
20150105.214242,2815,2,97762,-2,2814,1228,2816,2770,0
20150105.214245,2815,16,97778,6,2814,1267,2815,17,0
20150105.214247,2815,34,97812,32,2814,1226,2816,2772,0
20150105.214248,2814,16,97828,0,2814,1238,2816,2772,0
20150105.214248,2815,4,97832,-4,2815,1,2816,2772,1
20150105.214249,2815,2,97834,0,2815,2,2816,2773,1
20150105.21425,2815,4,97838,0,2814,1239,2816,2772,1
20150105.214253,2815,10,97848,-4,2815,1,2816,2771,1
20150105.214254,2815,32,97880,0,2814,1240,2816,2772,1
20150105.214255,2815,6,97886,2,2815,11,2816,2771,1
20150105.214257,2815,22,97908,-20,2814,1275,2815,15,1
20150105.214258,2815,2,97910,0,2814,1282,2815,14,1
20150105.214259,2815,2,97912,-2,2814,1282,2815,13,1
20150105.2143,2815,8,97920,4,2814,1282,2815,9,1
20150105.2143,2815,18,97938,-2,2815,302,2816,3271,1
20150105.214302,2815,56,97994,-4,2815,277,2816,3271,1
20150105.214303,2815,4,97998,-4,2815,275,2816,3271,1
20150105.214304,2815,10,98008,-10,2815,270,2816,3272,1
20150105.214307,2815,20,98028,0,2815,263,2816,3272,1
20150105.214308,2815,26,98054,0,2815,250,2816,3272,1
20150105.214309,2815,4,98058,-4,2815,248,2816,3279,1
20150105.214309,2815,476,98534,-186,2814,1248,2816,3279,1
20150105.214311,2815,10,98544,-10,2815,25,2816,3288,1
20150105.214311,2815,54,98598,-8,2814,1250,2816,3288,1
20150105.214314,2815,4,98602,-4,2814,1305,2816,3292,1
20150105.214315,2815,4,98606,2,2814,1249,2816,3292,1
20150105.214315,2816,20,98626,20,2814,1249,2816,3281,1
20150105.214316,2815,6,98632,-6,2814,1304,2815,1,0
20150105.214316,2815,2,98634,-2,2814,1250,2816,3283,0
20150105.214318,2815,2,98636,0,2815,1,2816,3283,0
20150105.214318,2815,2,98638,0,2814,1251,2816,3283,0
20150105.214319,2815,4,98642,0,2814,1251,2816,3283,0
20150105.21432,2814,2,98644,-2,2814,1250,2816,3287,0
20150105.214321,2814,8,98652,4,2814,1263,2816,3287,0
20150105.214323,2815,6,98658,0,2814,1304,2815,2,1
20150105.214323,2815,4,98662,-4,2814,1250,2816,3297,1
20150105.214326,2815,14,98676,12,2814,1264,2816,3797,1
20150105.214327,2815,4,98680,0,2814,1249,2816,3797,1
20150105.21433,2815,6,98686,-6,2814,1304,2816,3794,1
20150105.214333,2815,4,98690,2,2814,1264,2816,3794,1
20150105.214334,2815,8,98698,-8,2814,1305,2815,1,1
20150105.214335,2815,6,98704,-2,2814,1290,2815,1,1
20150105.214335,2815,2,98706,0,2814,1251,2816,3804,1
20150105.214337,2815,42,98748,40,2814,1266,2816,3805,1
20150105.214338,2814,20,98768,-20,2814,1243,2816,3807,0
20150105.214339,2815,22,98790,20,2814,1243,2816,3807,1
20150105.21434,2815,4,98794,-2,2814,1297,2816,3806,1
20150105.214347,2815,84,98878,-84,2815,560,2816,3796,1
20150105.21435,2815,78,98956,0,2815,527,2816,3796,1
20150105.214351,2816,10,98966,0,2815,527,2816,3791,1
20150105.214354,2815,4,98970,0,2815,526,2816,3791,0
20150105.214356,2815,24,98994,-24,2815,515,2816,3791,0
20150105.214356,2816,2,98996,2,2815,515,2816,3790,1
20150105.2144,2816,2,98998,2,2815,538,2816,3791,1
20150105.214404,2815,22,99020,-2,2815,527,2816,3796,0
20150105.214404,2816,2,99022,2,2815,527,2816,3795,1
20150105.214407,2815,2,99024,0,2815,537,2816,3795,0
20150105.21441,2815,2,99026,0,2815,538,2816,3806,0
20150105.214413,2815,6,99032,-6,2815,545,2816,3806,0
20150105.214413,2815,12,99044,0,2815,539,2816,3806,0
20150105.214414,2815,200,99244,-200,2815,439,2816,3806,0
20150105.214414,2815,664,99908,-482,2815,107,2816,3806,0
20150105.214416,2815,52,99960,0,2815,92,2816,3801,0
20150105.214416,2815,10,99970,-10,2815,88,2816,3801,0
20150105.214417,2816,8,99978,2,2815,88,2816,3807,1
20150105.214418,2816,2,99980,0,2815,88,2816,3803,1
20150105.21442,2816,2,99982,2,2815,88,2816,3821,1
20150105.21442,2815,30,100012,-20,2815,73,2816,3821,0
20150105.214422,2815,2,100014,-2,2815,74,2816,3822,0
20150105.214424,2816,60,100074,60,2815,74,2816,3792,1
20150105.214426,2815,40,100114,-28,2815,64,2816,3792,0
20150105.214427,2816,30,100144,30,2815,65,2816,3777,1
20150105.214427,2815,10,100154,10,2815,60,2816,3777,0
20150105.214428,2815,2,100156,0,2815,59,2816,3777,0
20150105.214429,2816,20,100176,20,2815,59,2816,3767,1
20150105.214431,2815,2,100178,2,2815,59,2816,3767,0
20150105.214437,2816,2,100180,2,2815,61,2816,3773,1
20150105.214438,2815,10,100190,10,2815,56,2816,3773,0
20150105.214439,2815,2,100192,2,2815,57,2816,3773,0
20150105.21444,2815,2,100194,0,2815,56,2816,3773,0
20150105.214441,2815,20,100214,0,2815,46,2816,3873,0
20150105.214441,2815,8,100222,8,2815,42,2816,3873,0
20150105.214442,2815,84,100306,62,2814,1310,2816,3873,0
20150105.214442,2814,2,100308,0,2814,1309,2816,3873,0
20150105.214443,2816,2,100310,2,2814,1309,2816,3875,1
20150105.214443,2815,20,100330,0,2814,1324,2815,1,0
20150105.214444,2815,6,100336,-4,2814,1269,2816,3875,0
20150105.214445,2815,4,100340,2,2814,1284,2816,3875,0
20150105.214445,2815,32,100372,0,2814,1269,2816,3875,0
20150105.214446,2816,2,100374,2,2815,13,2816,3874,1
20150105.214446,2816,8,100382,0,2815,13,2816,3871,1
20150105.214447,2815,2,100384,-2,2815,12,2816,3871,0
20150105.214448,2816,4,100388,0,2815,12,2816,3869,1
20150105.214448,2816,4,100392,4,2815,12,2816,3867,1
20150105.214449,2815,2,100394,-2,2815,11,2816,3867,0
20150105.214449,2815,10,100404,-10,2815,6,2816,3867,0
20150105.214451,2816,2,100406,2,2815,6,2816,3867,1
20150105.214451,2815,2,100408,-2,2815,5,2816,3868,0
20150105.214452,2815,66,100474,2,2814,1308,2815,3,0
20150105.214453,2815,6,100480,0,2814,1308,2816,3868,0
20150105.214454,2816,40,100520,40,2815,12,2816,3849,1
20150105.214459,2815,2,100522,2,2815,17,2816,3849,0
20150105.2145,2816,4,100526,0,2815,37,2816,3833,1
20150105.214501,2815,2,100528,0,2815,36,2816,3833,0
20150105.214502,2816,4,100532,4,2815,52,2816,3731,1
20150105.214515,2815,32,100564,-20,2815,56,2816,3752,0
20150105.214516,2815,4,100568,0,2815,48,2816,3753,0
20150105.214519,2816,18,100586,18,2815,49,2816,3744,1
20150105.214524,2815,2,100588,0,2815,56,2816,3746,0
20150105.214525,2815,2,100590,2,2815,55,2816,3745,0
20150105.214526,2815,20,100610,0,2815,31,2816,3745,0
20150105.21453,2816,4,100614,4,2815,32,2816,3743,1
20150105.21453,2815,2,100616,-2,2815,31,2816,3743,0
20150105.214532,2816,2,100618,2,2815,30,2816,3744,1
20150105.214534,2815,6,100624,-6,2815,29,2816,3744,0
20150105.214536,2815,8,100632,-4,2815,32,2816,3744,0
20150105.214539,2815,2,100634,-2,2815,32,2816,3743,0
20150105.214543,2815,4,100638,2,2815,36,2816,3744,0
20150105.214543,2815,2,100640,0,2815,35,2816,3744,0
20150105.214546,2816,2,100642,2,2815,35,2816,3743,1
20150105.214547,2815,2,100644,-2,2815,34,2816,3743,0
20150105.214547,2816,2,100646,2,2815,34,2816,3743,1
20150105.214549,2815,2,100648,0,2815,33,2816,3742,0
20150105.214549,2815,2,100650,0,2815,32,2816,3742,0
20150105.21455,2815,2,100652,0,2815,32,2816,3742,0
20150105.214551,2816,2,100654,2,2815,33,2816,3745,1
20150105.214551,2815,10,100664,4,2815,29,2816,3743,0
20150105.214552,2816,2,100666,2,2815,30,2816,3743,1
20150105.214553,2816,2,100668,2,2815,29,2816,3742,1
20150105.214553,2815,2,100670,0,2815,28,2816,3742,0
20150105.214556,2815,20,100690,20,2815,24,2816,3742,0
20150105.214559,2816,2,100692,2,2815,24,2816,3740,1
20150105.214604,2815,2,100694,-2,2815,29,2816,3739,0
20150105.214605,2815,2,100696,0,2815,35,2816,3739,0
20150105.214609,2815,8,100704,6,2815,26,2816,3740,0
20150105.214614,2815,192,100896,14,2814,1310,2815,194,0
20150105.214614,2815,410,101306,-236,2815,4,2816,3716,0
20150105.214615,2816,4,101310,4,2815,15,2816,3699,1
20150105.21462,2816,10,101320,10,2815,39,2816,3704,1
20150105.214621,2816,4,101324,0,2815,39,2816,3702,1
20150105.214621,2816,120,101444,120,2815,39,2816,4142,1
20150105.214623,2816,2,101446,2,2815,38,2816,4141,1
20150105.214625,2816,2,101448,2,2815,39,2816,4140,1
20150105.214626,2815,86,101534,-20,2814,1313,2815,9,0
20150105.214626,2815,40,101574,4,2814,1353,2816,4153,0
20150105.214627,2816,14,101588,12,2814,1351,2816,4152,1
20150105.214627,2815,2,101590,0,2815,1,2816,4152,0
20150105.214631,2815,2,101592,0,2815,18,2816,4137,0
20150105.214634,2815,14,101606,-12,2815,12,2816,4137,0
20150105.214635,2815,2,101608,0,2815,12,2816,4137,0
20150105.214635,2816,120,101728,120,2815,12,2816,4077,1
20150105.214638,2816,2,101730,0,2815,18,2816,4086,1
20150105.214639,2815,4,101734,2,2815,17,2816,4085,0
20150105.21464,2816,4,101738,4,2815,17,2816,4084,1
20150105.214645,2816,10,101748,10,2815,46,2816,4087,1
20150105.214645,2815,8,101756,-6,2815,43,2816,4087,0
20150105.21465,2816,2,101758,0,2815,47,2816,4093,1
20150105.214651,2816,2,101760,2,2815,123,2816,4092,1
20150105.214653,2815,4,101764,2,2815,122,2816,4091,0
20150105.214654,2815,2,101766,2,2815,121,2816,4091,0
20150105.214654,2816,2,101768,2,2815,121,2816,4090,1
20150105.214656,2816,2,101770,2,2815,122,2816,4079,1
20150105.214657,2816,30,101800,30,2815,124,2816,4064,1
20150105.214658,2815,6,101806,0,2815,122,2816,4064,0
20150105.214701,2816,166,101972,80,2815,139,2816,3984,1
20150105.214702,2816,2,101974,0,2815,140,2816,3983,1
20150105.214705,2816,6,101980,-6,2815,149,2816,3981,1
20150105.214705,2816,6,101986,0,2815,149,2816,3978,1
20150105.214709,2816,24,102010,-24,2815,150,2816,3966,1
20150105.214711,2816,2,102012,0,2815,150,2816,3965,1
20150105.214711,2816,2,102014,0,2815,159,2816,3964,1
20150105.214713,2816,2,102016,0,2815,159,2816,3966,1
20150105.214714,2816,20,102036,0,2815,165,2816,3957,1
20150105.214718,2815,2,102038,0,2815,165,2816,3962,0
20150105.214731,2815,2,102040,0,2815,179,2816,4463,0
20150105.214735,2816,10,102050,0,2815,183,2816,4450,1
20150105.214742,2815,2,102052,0,2815,235,2816,4646,0
20150105.214744,2816,10,102062,0,2815,248,2816,4640,1
20150105.21475,2816,24,102086,0,2815,243,2816,4428,1
20150105.21475,2816,2,102088,0,2815,243,2816,4427,1
20150105.214754,2816,10,102098,2,2815,294,2816,4422,1
20150105.214755,2816,4,102102,0,2815,292,2816,4425,1
20150105.2148,2815,2,102104,0,2815,295,2816,4425,0
20150105.214804,2815,2,102106,2,2815,357,2816,4425,0
20150105.214807,2816,6,102112,-6,2815,358,2816,4422,1
20150105.214808,2816,2,102114,-2,2815,358,2816,4421,1
20150105.214809,2816,62,102176,20,2815,378,2816,4390,1
20150105.214812,2816,2,102178,2,2815,380,2816,4391,1
20150105.214814,2816,2,102180,2,2815,380,2816,4393,1
20150105.214815,2816,4,102184,0,2815,381,2816,4391,1
20150105.214818,2815,6,102190,0,2815,378,2816,4392,0
20150105.214819,2816,2,102192,2,2815,378,2816,4391,1
20150105.21482,2816,2,102194,2,2815,381,2816,4391,1
20150105.214821,2816,20,102214,20,2815,381,2816,4381,1
20150105.214828,2816,6,102220,0,2815,390,2816,4378,1
20150105.214828,2815,80,102300,-22,2815,350,2816,4378,0
20150105.214829,2816,6,102306,6,2815,340,2816,4375,1
20150105.214832,2815,2,102308,-2,2815,341,2816,4375,0
20150105.214833,2816,2,102310,0,2815,341,2816,4374,1
20150105.214839,2816,6,102316,6,2815,345,2816,4364,1
20150105.21484,2816,12,102328,0,2815,347,2816,4358,1
20150105.214845,2816,10,102338,10,2815,384,2816,4346,1
20150105.214846,2816,2,102340,2,2815,384,2816,4345,1
20150105.214847,2816,10,102350,10,2815,380,2816,4380,1
20150105.214848,2815,22,102372,20,2815,369,2816,4370,0
20150105.214849,2816,2,102374,2,2815,368,2816,4369,1
20150105.21485,2816,10,102384,10,2815,363,2816,4364,1
20150105.214853,2816,8,102392,8,2815,359,2816,4320,1
20150105.214853,2816,4,102396,4,2815,358,2816,4318,1
20150105.214855,2815,2,102398,-2,2815,358,2816,4319,0
20150105.214855,2816,2,102400,2,2815,357,2816,4318,1
20150105.214859,2816,10,102410,10,2815,356,2816,4314,1
20150105.214905,2815,8,102418,0,2815,408,2816,4317,0
20150105.214917,2816,22,102440,20,2815,431,2816,4306,1
20150105.214922,2816,2,102442,2,2815,434,2816,4304,1
20150105.214923,2816,2,102444,2,2815,449,2816,4303,1
20150105.214931,2816,2,102446,0,2815,446,2816,4321,1
20150105.214934,2815,2,102448,0,2815,444,2816,4319,0
20150105.214937,2816,14,102462,0,2815,439,2816,4315,1
20150105.214938,2815,2,102464,0,2815,439,2816,4315,0
20150105.21494,2815,24,102488,0,2815,427,2816,4355,0
20150105.214942,2816,2,102490,2,2815,427,2816,4374,1
20150105.214951,2815,2,102492,-2,2815,426,2816,4373,0
20150105.214951,2816,10,102502,10,2815,426,2816,4368,1
20150105.215004,2816,2,102504,0,2815,370,2816,4347,1
20150105.215007,2816,22,102526,2,2815,387,2816,4329,1
20150105.215009,2815,2,102528,-2,2815,388,2816,4329,0
20150105.215011,2816,4,102532,4,2815,388,2816,4327,1
20150105.215018,2815,40,102572,0,2815,381,2816,4297,0
20150105.215031,2815,2,102574,0,2815,381,2816,4296,0
20150105.215033,2815,16,102590,-16,2815,375,2816,4297,0
20150105.215033,2815,80,102670,-38,2815,335,2816,4297,0
20150105.215035,2816,2,102672,0,2815,339,2816,4336,1
20150105.215036,2815,2,102674,0,2815,338,2816,4336,0
20150105.215044,2815,2,102676,2,2815,336,2816,4340,0
20150105.215046,2815,2,102678,0,2815,335,2816,4340,0
20150105.215049,2816,2,102680,2,2815,337,2816,4842,1
20150105.215052,2815,2,102682,2,2815,336,2816,4842,0
20150105.215053,2815,2,102684,0,2815,335,2816,4842,0
20150105.2151,2815,2,102686,0,2815,385,2816,4860,0
20150105.215102,2816,4,102690,0,2815,386,2816,4877,1
20150105.215106,2815,2,102692,0,2815,385,2816,4875,0
20150105.215108,2815,6,102698,6,2815,382,2816,4876,0
20150105.21511,2816,4,102702,4,2815,382,2816,4876,1
20150105.215112,2815,50,102752,50,2815,357,2816,4874,0
20150105.215115,2815,40,102792,0,2815,338,2816,4874,0
20150105.215116,2815,2,102794,0,2815,337,2816,4874,0
20150105.21512,2816,2,102796,0,2815,337,2816,4873,1
20150105.215123,2816,50,102846,0,2815,336,2816,4848,1
20150105.215125,2815,4,102850,4,2815,366,2816,4878,0
20150105.215132,2815,2,102852,0,2815,340,2816,4880,0
20150105.215137,2816,2,102854,2,2815,341,2816,4879,1
20150105.215138,2815,4,102858,0,2815,339,2816,4880,0
20150105.215139,2816,12,102870,0,2815,339,2816,4874,1
20150105.215145,2816,2,102872,0,2815,341,2816,4889,1
20150105.215146,2815,2,102874,0,2815,341,2816,4890,0
20150105.215149,2815,4,102878,4,2815,341,2816,4882,0
20150105.215151,2815,2,102880,2,2815,356,2816,4931,0
20150105.215154,2816,24,102904,0,2815,356,2816,4919,1
20150105.215203,2815,20,102924,8,2815,349,2816,4921,0
20150105.215204,2816,2,102926,0,2815,358,2816,4920,1
20150105.215208,2815,4,102930,0,2815,368,2816,4922,0
20150105.215211,2815,2,102932,-2,2815,467,2816,4922,0
20150105.215217,2815,2,102934,-2,2815,465,2816,4876,0
20150105.215218,2816,40,102974,40,2815,466,2816,4856,1
20150105.21522,2816,2,102976,2,2815,467,2816,4857,1
20150105.215221,2815,2,102978,0,2815,466,2816,4857,0
20150105.215223,2815,2,102980,0,2815,475,2816,4857,0
20150105.215225,2815,2,102982,0,2815,474,2816,4857,0
20150105.215227,2815,2,102984,0,2815,474,2816,4857,0
20150105.215228,2815,2,102986,-2,2815,473,2816,4857,0
20150105.21523,2816,2,102988,2,2815,473,2816,4857,1
20150105.215237,2815,4,102992,-2,2815,471,2816,4860,0
20150105.215238,2816,2,102994,2,2815,472,2816,4859,1
20150105.215239,2816,10,103004,0,2815,472,2816,4854,1
20150105.215241,2816,2,103006,2,2815,472,2816,4854,1
20150105.215242,2816,2,103008,2,2815,472,2816,4853,1
20150105.215248,2815,2,103010,-2,2815,519,2816,4875,0
20150105.215252,2816,20,103030,20,2815,518,2816,4864,1
20150105.215258,2816,20,103050,20,2815,519,2816,4853,1
20150105.215303,2816,2,103052,0,2815,523,2816,4847,1
20150105.215304,2815,6,103058,-4,2815,520,2816,4847,0
20150105.215305,2815,2,103060,-2,2815,519,2816,4847,0
20150105.215308,2816,2,103062,2,2815,519,2816,4846,1
20150105.215309,2815,6,103068,-2,2815,517,2816,4845,0
20150105.215313,2815,50,103118,0,2815,499,2816,4847,0
20150105.215317,2816,2,103120,2,2815,500,2816,4846,1
20150105.215318,2815,26,103146,14,2815,487,2816,4845,0
20150105.215319,2816,2,103148,2,2815,487,2816,4845,1
20150105.21532,2815,12,103160,0,2815,482,2816,4845,0
20150105.215321,2815,14,103174,14,2815,475,2816,4845,0
20150105.215323,2815,12,103186,6,2815,475,2816,4854,0
20150105.215326,2815,2,103188,0,2815,474,2816,4853,0
20150105.215326,2815,2,103190,0,2815,473,2816,4853,0
20150105.215327,2815,2,103192,2,2815,472,2816,4853,0
20150105.215327,2815,2,103194,0,2815,471,2816,4853,0
20150105.21533,2816,2,103196,2,2815,472,2816,4853,1
20150105.215332,2815,2,103198,0,2815,471,2816,4853,0
20150105.215334,2816,4,103202,4,2815,471,2816,4852,1
20150105.215335,2815,2,103204,0,2815,470,2816,4855,0
20150105.215337,2815,2,103206,0,2815,469,2816,4854,0
20150105.215338,2816,2,103208,2,2815,469,2816,4853,1
20150105.21534,2815,4,103212,0,2815,464,2816,4853,0
20150105.215341,2816,2,103214,2,2815,464,2816,4852,1
20150105.215343,2815,4,103218,2,2815,464,2816,4852,0
20150105.215344,2816,2,103220,2,2815,464,2816,4852,1
20150105.215345,2815,2,103222,0,2815,464,2816,4853,0
20150105.215346,2815,62,103284,56,2815,434,2816,4853,0
20150105.215347,2815,2,103286,2,2815,434,2816,4853,0
20150105.215347,2815,2,103288,0,2815,433,2816,4853,0
20150105.215353,2815,2,103290,0,2815,434,2816,4853,0
20150105.215353,2815,4,103294,0,2815,432,2816,4853,0
20150105.215355,2816,2,103296,2,2815,432,2816,4857,1
20150105.215359,2815,8,103304,6,2815,431,2816,4857,0
20150105.215404,2816,2,103306,0,2815,431,2816,4853,1
20150105.215406,2815,48,103354,40,2815,407,2816,4854,0
20150105.215411,2815,24,103378,4,2815,396,2816,4853,0
20150105.215412,2815,22,103400,12,2815,390,2816,4853,0
20150105.215413,2815,2,103402,2,2815,390,2816,4853,0
20150105.215414,2816,2,103404,2,2815,390,2816,4852,1
20150105.215415,2815,2,103406,2,2815,389,2816,4851,0
20150105.215418,2815,28,103434,0,2815,377,2816,4851,0
20150105.215418,2815,4,103438,0,2815,375,2816,4851,0
20150105.215421,2816,6,103444,6,2815,372,2816,4848,1
20150105.215423,2815,18,103462,2,2815,364,2816,4837,0
20150105.215424,2815,2,103464,0,2815,363,2816,4837,0
20150105.215426,2815,2,103466,0,2815,363,2816,4835,0
20150105.215427,2816,4,103470,4,2815,363,2816,4833,1
20150105.215429,2815,8,103478,4,2815,361,2816,4833,0
20150105.215431,2815,42,103520,10,2815,340,2816,4833,0
20150105.215432,2815,2,103522,-2,2815,339,2816,4833,0
20150105.215433,2815,200,103722,-48,2815,239,2816,4833,0
20150105.215434,2815,20,103742,0,2815,229,2816,4833,0
20150105.215435,2815,22,103764,10,2815,218,2816,4833,0
20150105.215437,2815,4,103768,0,2815,217,2816,4833,0
20150105.215439,2815,2,103770,2,2815,216,2816,4832,0
20150105.215441,2815,2,103772,0,2815,214,2816,4832,0
20150105.215442,2815,4,103776,0,2815,213,2816,4832,0
20150105.215443,2815,4,103780,0,2815,211,2816,4832,0
20150105.215444,2815,2,103782,0,2815,210,2816,4842,0
20150105.215445,2815,108,103890,72,2815,159,2816,4841,0
20150105.215446,2815,2,103892,-2,2815,158,2816,4842,0
20150105.215447,2815,2,103894,-2,2815,157,2816,4842,0
20150105.215449,2815,102,103996,-90,2815,106,2816,4842,0
20150105.215449,2815,2,103998,-2,2815,105,2816,4842,0
20150105.215453,2815,2,104000,-2,2815,105,2816,4842,0
20150105.215454,2815,2,104002,-2,2815,104,2816,4842,0
20150105.215459,2815,2,104004,-2,2815,103,2816,4838,0
20150105.215459,2815,4,104008,-4,2815,101,2816,4808,0
20150105.2155,2815,2,104010,0,2815,100,2816,4808,0
20150105.215503,2815,12,104022,10,2815,96,2816,4808,0
20150105.215504,2815,2,104024,0,2815,95,2816,4808,0
20150105.215506,2816,20,104044,20,2815,100,2816,4798,1
20150105.215508,2816,2,104046,2,2815,99,2816,4796,1
20150105.215509,2815,6,104052,0,2815,96,2816,4796,0
20150105.215511,2815,20,104072,20,2815,87,2816,4796,0
20150105.215512,2815,2,104074,0,2815,86,2816,4796,0
20150105.215515,2815,6,104080,0,2815,134,2816,4801,0
20150105.215518,2815,2,104082,0,2815,135,2816,5001,0
20150105.215525,2816,4,104086,4,2815,133,2816,5002,1
20150105.215532,2815,2,104088,0,2815,136,2816,4992,0
20150105.215535,2815,4,104092,4,2815,134,2816,4992,0
20150105.215539,2816,2,104094,2,2815,135,2816,4960,1
20150105.21554,2815,4,104098,0,2815,133,2816,4960,0
20150105.215542,2815,10,104108,-10,2815,134,2816,4960,0
20150105.215543,2815,16,104124,-6,2815,140,2816,4960,0
20150105.215544,2815,2,104126,0,2815,140,2816,4960,0
20150105.215546,2815,2,104128,0,2815,139,2816,4960,0
20150105.21555,2815,20,104148,-6,2815,133,2816,4963,0
20150105.215551,2816,2,104150,2,2815,133,2816,4963,1
20150105.215552,2815,22,104172,-22,2815,122,2816,4963,0
20150105.215554,2816,2,104174,2,2815,124,2816,4961,1
20150105.215555,2816,6,104180,6,2815,123,2816,4959,1
20150105.215559,2816,2,104182,2,2815,124,2816,4958,1
20150105.2156,2815,2,104184,0,2815,124,2816,4958,0
20150105.215603,2815,24,104208,-24,2815,112,2816,4949,0
20150105.215608,2815,2,104210,-2,2815,114,2816,4948,0
20150105.215617,2815,4,104214,-4,2815,113,2816,4949,0
20150105.215618,2815,4,104218,0,2815,111,2816,4949,0
20150105.215622,2815,2,104220,0,2815,111,2816,4999,0
20150105.215625,2816,20,104240,20,2815,110,2816,4989,1
20150105.215629,2815,4,104244,-4,2815,108,2816,4989,0
20150105.21563,2815,4,104248,0,2815,105,2816,4989,0
20150105.215632,2815,2,104250,0,2815,110,2816,4990,0
20150105.215639,2816,6,104256,6,2815,112,2816,4992,1
20150105.215643,2815,2,104258,-2,2815,111,2816,5011,0
20150105.215645,2816,16,104274,0,2815,111,2816,5004,1
20150105.215653,2816,4,104278,0,2815,153,2816,4951,1
20150105.215654,2816,4,104282,4,2815,153,2816,4950,1
20150105.215657,2815,2,104284,0,2815,155,2816,4950,0
20150105.215657,2816,8,104292,8,2815,155,2816,4946,1
20150105.215658,2815,20,104312,-20,2815,145,2816,4947,0
20150105.215659,2815,2,104314,-2,2815,144,2816,4947,0
20150105.215703,2815,2,104316,0,2815,153,2816,4969,0
20150105.215704,2815,2,104318,0,2815,202,2816,4969,0
20150105.215709,2815,2,104320,0,2815,198,2816,4971,0
20150105.215709,2816,2,104322,2,2815,199,2816,4970,1
20150105.215712,2816,8,104330,8,2815,201,2816,4966,1
20150105.215719,2815,2,104332,0,2815,209,2816,4965,0
20150105.215721,2815,20,104352,0,2815,199,2816,4965,0
20150105.215724,2815,14,104366,-6,2815,692,2816,4965,0
20150105.215724,2816,2,104368,0,2815,692,2816,4964,1
20150105.215726,2816,6,104374,2,2815,792,2816,4961,1
20150105.215729,2815,20,104394,-12,2815,786,2816,4952,0
20150105.215733,2815,4,104398,4,2815,785,2816,4932,0
20150105.215733,2816,40,104438,40,2815,785,2816,4912,1
20150105.215735,2815,20,104458,-20,2815,775,2816,4912,0
20150105.215736,2816,40,104498,40,2815,775,2816,4892,1
20150105.215737,2816,2,104500,2,2815,778,2816,4890,1
20150105.21574,2816,6,104506,6,2815,783,2816,4886,1
20150105.215742,2816,4,104510,4,2815,782,2816,4884,1
20150105.215743,2816,202,104712,0,2815,782,2816,4783,1
20150105.215744,2815,2,104714,0,2815,786,2816,4783,0
20150105.215744,2815,10,104724,-10,2815,781,2816,4782,0
20150105.215747,2816,4,104728,0,2815,781,2816,4780,1
20150105.215748,2816,2,104730,2,2815,781,2816,4769,1
20150105.215751,2815,20,104750,-20,2815,776,2816,4769,0
20150105.215754,2816,10,104760,10,2815,777,2816,4765,1
20150105.215756,2816,4,104764,0,2815,802,2816,4766,1
20150105.215756,2816,20,104784,20,2815,803,2816,4756,1
20150105.215819,2815,6,104790,-6,2815,818,2816,4754,0
20150105.215827,2815,2,104792,0,2815,812,2816,4754,0
20150105.215844,2816,2,104794,0,2815,793,2816,4755,1
20150105.215848,2816,2,104796,0,2815,793,2816,4755,1
20150105.215855,2815,2,104798,0,2815,795,2816,4755,0
20150105.215856,2816,2,104800,2,2815,795,2816,4753,1
20150105.215856,2815,2,104802,0,2815,794,2816,4753,0
20150105.215902,2815,2,104804,2,2815,804,2816,4753,0
20150105.215904,2816,2,104806,2,2815,814,2816,4752,1
20150105.215905,2815,2,104808,2,2815,813,2816,4753,0
20150105.215906,2816,2,104810,0,2815,813,2816,4752,1
20150105.215907,2815,2,104812,2,2815,815,2816,4752,0
20150105.215908,2816,2,104814,2,2815,815,2816,4750,1
20150105.215912,2815,2,104816,0,2815,814,2816,4750,0
20150105.215916,2815,2,104818,2,2815,1814,2816,4750,0
20150105.215917,2816,4,104822,0,2815,1813,2816,4748,1
20150105.215919,2816,2,104824,2,2815,1813,2816,4755,1
20150105.215925,2816,2,104826,2,2815,1814,2816,4756,1
20150105.215931,2816,20,104846,2,2815,1815,2816,4746,1
20150105.215934,2815,4,104850,0,2815,1813,2816,4745,0
20150105.215935,2816,4,104854,0,2815,812,2816,4743,1
20150105.215944,2815,2,104856,2,2815,811,2816,4742,0
20150105.215947,2816,2,104858,2,2815,811,2816,4741,1
20150105.215948,2816,8,104866,8,2815,810,2816,4738,1
20150105.21595,2815,2,104868,2,2815,808,2816,4738,0
20150105.215951,2816,4,104872,0,2815,808,2816,4736,1
20150105.215959,2816,4,104876,4,2815,1808,2816,4735,1
20150105.22,2816,2,104878,0,2815,1808,2816,4734,1
20150105.220001,2816,2,104880,2,2815,1808,2816,4733,1
20150105.220004,2816,2,104882,0,2815,839,2816,4732,1
20150105.220005,2816,2,104884,2,2815,839,2816,4731,1
20150105.220008,2815,2,104886,2,2815,839,2816,4743,0
20150105.220012,2816,4,104890,4,2815,858,2816,4743,1
20150105.220027,2816,40,104930,40,2815,1961,2816,4761,1
20150105.220032,2816,40,104970,40,2815,1961,2816,4712,1
20150105.220035,2816,4,104974,0,2815,963,2816,4710,1
20150105.220035,2816,12,104986,0,2815,961,2816,4705,1
20150105.220038,2815,2,104988,2,2815,960,2816,4705,0
20150105.220039,2815,2,104990,0,2815,965,2816,4705,0
20150105.220041,2816,2,104992,2,2815,965,2816,4704,1
20150105.220043,2815,2,104994,2,2815,989,2816,4704,0
20150105.220047,2815,20,105014,-2,2815,989,2816,4705,0
20150105.220048,2815,4,105018,0,2815,987,2816,4705,0
20150105.220049,2816,4,105022,0,2815,987,2816,4703,1
20150105.220052,2816,4,105026,0,2815,988,2816,4733,1
20150105.220053,2815,6,105032,0,2815,985,2816,4733,0
20150105.220054,2815,2,105034,0,2815,1004,2816,4734,0
20150105.220055,2816,2,105036,2,2815,1009,2816,4706,1
20150105.220056,2815,1008,106044,570,2815,965,2816,4421,0
20150105.220058,2816,4,106048,4,2815,970,2816,4423,1
20150105.2201,2816,40,106088,0,2815,470,2816,4423,1
20150105.220101,2816,12,106100,12,2815,470,2816,4418,1
20150105.220102,2815,2,106102,2,2815,475,2816,4418,0
20150105.220108,2815,2,106104,0,2815,477,2816,4420,0
20150105.22011,2815,2,106106,2,2815,476,2816,4421,0
20150105.220111,2815,4,106110,0,2815,474,2816,4422,0
20150105.220114,2815,12,106122,12,2815,468,2816,4421,0
20150105.220116,2815,2,106124,2,2815,502,2816,4421,0
20150105.220119,2815,2,106126,0,2815,503,2816,4423,0
20150105.220123,2816,4,106130,0,2815,499,2816,4424,1
20150105.220125,2815,60,106190,60,2815,469,2816,4424,0
20150105.220126,2816,100,106290,100,2815,469,2816,4372,1
20150105.220129,2815,2,106292,0,2815,466,2816,4372,0
20150105.220131,2816,2,106294,2,2815,468,2816,4373,1
20150105.220134,2815,2,106296,0,2815,467,2816,4374,0
20150105.220135,2815,10,106306,8,2815,462,2816,4375,0
20150105.220138,2815,4,106310,-2,2815,475,2816,4375,0
20150105.220144,2815,2,106312,2,2815,468,2816,4376,0
20150105.220145,2815,4,106316,0,2815,470,2816,4376,0
20150105.220145,2815,2,106318,2,2815,464,2816,4376,0
20150105.220147,2815,2,106320,0,2815,479,2816,4376,0
20150105.220151,2815,4,106324,0,2815,474,2816,4387,0
20150105.220154,2815,10,106334,10,2815,464,2816,4402,0
20150105.220157,2815,2,106336,2,2815,466,2816,4402,0
20150105.220201,2816,2,106338,2,2815,466,2816,4420,1
20150105.220208,2815,10,106348,0,2815,461,2816,4474,0
20150105.220215,2815,24,106372,20,2815,464,2816,4474,0
20150105.220217,2815,2,106374,2,2815,464,2816,4474,0
20150105.220221,2816,2,106376,0,2815,464,2816,4455,1
20150105.220222,2816,40,106416,40,2815,465,2816,4435,1
20150105.220232,2815,2,106418,2,2815,464,2816,4534,0
20150105.220233,2816,8,106426,0,2815,447,2816,4530,1
20150105.220235,2815,50,106476,50,2815,427,2816,4530,0
20150105.220241,2815,26,106502,26,2815,408,2816,4547,0
20150105.220243,2815,122,106624,-4,2815,366,2816,4547,0
20150105.220244,2815,4,106628,0,2815,364,2816,4547,0
20150105.220245,2815,10,106638,0,2815,360,2816,4547,0
20150105.220245,2816,2,106640,0,2815,360,2816,4546,1
20150105.220246,2815,22,106662,2,2815,349,2816,4545,0
20150105.220246,2816,6,106668,6,2815,349,2816,4592,1
20150105.220246,2815,2,106670,0,2815,348,2816,4592,0
20150105.220247,2815,20,106690,16,2815,337,2816,4590,0
20150105.220248,2815,2,106692,0,2815,335,2816,4590,0
20150105.220248,2816,2,106694,2,2815,335,2816,4589,1
20150105.220249,2815,24,106718,2,2815,323,2816,4589,0
20150105.220257,2815,2,106720,0,2815,322,2816,4601,0
20150105.220301,2815,6,106726,0,2815,319,2816,4601,0
20150105.220303,2815,2,106728,2,2815,314,2816,4601,0
20150105.220304,2815,2,106730,2,2815,313,2816,4601,0
20150105.220306,2815,4,106734,0,2815,311,2816,4596,0
20150105.220306,2816,2,106736,2,2815,311,2816,4595,1
20150105.220307,2815,2,106738,2,2815,310,2816,4595,0
20150105.220311,2815,2,106740,2,2815,308,2816,4596,0
20150105.220312,2815,2,106742,2,2815,308,2816,4596,0
20150105.220312,2816,40,106782,40,2815,308,2816,4576,1
20150105.220316,2815,6,106788,0,2815,305,2816,4593,0
20150105.220317,2816,4,106792,0,2815,305,2816,4591,1
20150105.220318,2816,20,106812,20,2815,297,2816,4581,1
20150105.22032,2816,2,106814,0,2815,297,2816,4575,1
20150105.220322,2815,8,106822,0,2815,294,2816,4575,0
20150105.220326,2815,2,106824,0,2815,294,2816,4563,0
20150105.220328,2815,4,106828,2,2815,293,2816,4565,0
20150105.220329,2815,2,106830,0,2815,292,2816,4565,0
20150105.220331,2816,10,106840,10,2815,292,2816,4557,1
20150105.220334,2816,4,106844,0,2815,292,2816,4542,1
20150105.220336,2815,2,106846,0,2815,291,2816,4542,0
20150105.220336,2816,2,106848,0,2815,291,2816,4541,1
20150105.220346,2816,2,106850,0,2815,293,2816,4526,1
20150105.220347,2815,2,106852,2,2815,292,2816,4521,0
20150105.220348,2816,4,106856,0,2815,292,2816,4516,1
20150105.220351,2816,2,106858,0,2815,295,2816,4515,1
20150105.220352,2816,4,106862,0,2815,297,2816,4513,1
20150105.220352,2816,2,106864,0,2815,297,2816,4512,1
20150105.220354,2816,100,106964,70,2815,297,2816,4462,1
20150105.220355,2816,60,107024,60,2815,297,2816,4432,1
20150105.220359,2816,30,107054,14,2815,297,2816,4395,1
20150105.2204,2815,40,107094,-2,2815,291,2816,4330,0
20150105.220407,2815,20,107114,0,2815,293,2816,4430,0
20150105.22041,2816,6,107120,0,2815,414,2816,4427,1
20150105.220412,2816,8,107128,-4,2815,414,2816,4413,1
20150105.220416,2816,4,107132,0,2815,459,2816,4412,1
20150105.220418,2816,4,107136,4,2815,465,2816,4410,1
20150105.22042,2816,2,107138,2,2815,465,2816,4409,1
20150105.220421,2816,4,107142,4,2815,467,2816,4406,1
20150105.220422,2816,6,107148,6,2815,469,2816,4403,1
20150105.220423,2816,2,107150,2,2815,469,2816,4402,1
20150105.220425,2816,4,107154,4,2815,475,2816,4400,1
20150105.220427,2816,2,107156,2,2815,485,2816,4399,1
20150105.220427,2816,2,107158,2,2815,486,2816,4398,1
20150105.22043,2816,2,107160,0,2815,491,2816,4397,1
20150105.220433,2816,6,107166,0,2815,517,2816,4422,1
20150105.220434,2816,10,107176,0,2815,517,2816,4417,1
20150105.220436,2816,4,107180,4,2815,518,2816,4425,1
20150105.220437,2816,6,107186,6,2815,518,2816,4422,1
20150105.22044,2816,20,107206,20,2815,544,2816,4403,1
20150105.220442,2816,2,107208,2,2815,594,2816,4403,1
20150105.220443,2816,2,107210,2,2815,630,2816,4402,1
20150105.220444,2816,4,107214,4,2815,645,2816,4400,1
20150105.220446,2816,4,107218,4,2815,642,2816,4386,1
20150105.220452,2815,2,107220,2,2815,650,2816,4411,0
20150105.220452,2816,100,107320,100,2815,650,2816,4361,1
20150105.220457,2816,4,107324,4,2815,654,2816,4342,1
20150105.220458,2816,30,107354,30,2815,657,2816,4327,1
20150105.220459,2816,2,107356,2,2815,657,2816,4299,1
20150105.2205,2816,4,107360,4,2815,663,2816,4287,1
20150105.2205,2816,2,107362,2,2815,660,2816,4286,1
20150105.220501,2816,4,107366,4,2815,661,2816,4284,1
20150105.220503,2816,2,107368,2,2815,663,2816,4283,1
20150105.220503,2815,40,107408,40,2815,643,2816,4283,0
20150105.220504,2816,100,107508,40,2815,648,2816,4236,1
20150105.220506,2816,2,107510,2,2815,658,2816,4235,1
20150105.220507,2816,8,107518,0,2815,658,2816,4231,1
20150105.220507,2815,100,107618,100,2815,609,2816,4231,0
20150105.220508,2816,2,107620,2,2815,609,2816,4230,1
20150105.22051,2815,6,107626,0,2815,615,2816,4231,0
20150105.220514,2816,2,107628,2,2815,711,2816,4230,1
20150105.220516,2816,60,107688,60,2815,716,2816,4229,1
20150105.22052,2816,4,107692,4,2815,735,2816,4226,1
20150105.220523,2816,200,107892,200,2815,743,2816,4099,1
20150105.220524,2816,4,107896,0,2815,743,2816,4097,1
20150105.220525,2816,12,107908,0,2815,744,2816,4091,1
20150105.220527,2816,2,107910,2,2815,751,2816,4090,1
20150105.220528,2816,2,107912,0,2815,752,2816,4089,1
20150105.220528,2816,2,107914,2,2815,752,2816,4088,1
20150105.220531,2816,2,107916,2,2815,761,2816,4087,1
20150105.220533,2816,2,107918,0,2815,759,2816,4086,1
20150105.220534,2816,10,107928,10,2815,759,2816,4081,1
20150105.220536,2816,8,107936,8,2815,759,2816,4078,1
20150105.220538,2816,1000,108936,-112,2815,813,2816,3605,1
20150105.220538,2816,2,108938,2,2815,823,2816,3604,1
20150105.220539,2816,2410,111348,2334,2815,823,2816,2399,1
20150105.220539,2816,42,111390,42,2815,823,2816,2378,1
20150105.22054,2816,334,111724,156,2815,823,2816,2211,1
20150105.22054,2816,902,112626,-78,2815,823,2816,1760,1
20150105.220541,2816,2856,115482,2194,2815,823,2816,332,1
20150105.220541,2816,434,115916,-6,2815,852,2816,115,1
20150105.220542,2816,230,116146,-16,2815,850,2817,408,1
20150105.220542,2817,14,116160,-4,2816,508,2817,387,1
20150105.220543,2817,202,116362,-202,2816,532,2817,286,1
20150105.220543,2817,24,116386,-22,2816,535,2817,274,1
20150105.220544,2816,2,116388,2,2816,539,2817,275,0
20150105.220544,2817,550,116938,94,2817,55,2818,1963,1
20150105.220546,2817,164,117102,-14,2816,566,2817,329,1
20150105.220546,2817,38,117140,0,2816,570,2817,313,1
20150105.220547,2817,2,117142,0,2816,590,2817,365,1
20150105.220548,2817,126,117268,-124,2816,591,2817,302,1
20150105.220548,2817,10,117278,0,2816,91,2817,287,1
20150105.220549,2817,4,117282,-2,2816,168,2817,312,1
20150105.22055,2817,422,117704,-2,2816,236,2817,103,1
20150105.220551,2817,8,117712,-6,2816,387,2817,90,1
20150105.220551,2817,10,117722,-4,2816,387,2817,85,1
20150105.220552,2817,172,117894,-168,2817,18,2818,1938,1
20150105.220553,2817,40,117934,-34,2817,10,2818,2939,1
20150105.220553,2817,76,118010,10,2817,19,2818,2929,1
20150105.220554,2816,70,118080,10,2816,386,2817,5,0
20150105.220554,2817,4,118084,0,2816,386,2817,15,1
20150105.220555,2817,56,118140,16,2817,20,2818,1916,1
20150105.220556,2818,2,118142,0,2817,28,2818,1915,1
20150105.220556,2818,10,118152,0,2817,28,2818,1909,1
20150105.220557,2818,32,118184,0,2817,34,2818,1892,1
20150105.220557,2817,20,118204,0,2817,24,2818,1891,0
20150105.220558,2817,20,118224,0,2817,16,2818,1891,0
20150105.220558,2817,76,118300,2,2817,18,2818,1854,0
20150105.220559,2818,96,118396,96,2817,19,2818,1796,1
20150105.2206,2817,2,118398,0,2817,21,2818,1809,0
20150105.2206,2817,4,118402,2,2817,20,2818,1807,0
20150105.220601,2818,12,118414,10,2817,27,2818,1802,1
20150105.220601,2818,2,118416,2,2817,27,2818,1801,1
20150105.220602,2818,40,118456,0,2817,127,2818,1780,1
20150105.220602,2817,2,118458,0,2817,127,2818,1780,0
20150105.220603,2817,4,118462,0,2817,130,2818,1779,0
20150105.220603,2818,20,118482,20,2817,148,2818,1767,1
20150105.220604,2818,2,118484,0,2817,157,2818,1766,1
20150105.220605,2817,20,118504,-4,2817,193,2818,1767,0
20150105.220606,2818,2,118506,2,2817,199,2818,1780,1
20150105.220607,2818,4,118510,4,2817,201,2818,1758,1
20150105.220608,2818,10,118520,0,2817,225,2818,1753,1
20150105.22061,2817,6,118526,-2,2817,245,2818,1764,0
20150105.22061,2817,20,118546,-2,2817,457,2818,1747,0
20150105.220612,2818,2,118548,2,2817,471,2818,1776,1
20150105.220613,2818,2,118550,2,2817,487,2818,1768,1
20150105.220613,2817,2,118552,-2,2817,488,2818,1766,0
20150105.220614,2818,2,118554,0,2817,501,2818,1965,1
20150105.220614,2818,6,118560,6,2817,506,2818,2061,1
20150105.220615,2818,16,118576,-4,2817,503,2818,2063,1
20150105.220615,2817,2,118578,0,2817,503,2818,2059,0
20150105.220616,2818,2,118580,2,2817,507,2818,2058,1
20150105.220617,2818,4,118584,4,2817,508,2818,2056,1
20150105.220617,2817,4,118588,0,2817,516,2818,2056,0
20150105.220619,2817,108,118696,102,2817,538,2818,2021,0
20150105.22062,2817,2,118698,-2,2817,540,2818,2021,0
20150105.220621,2817,2,118700,-2,2817,542,2818,2040,0
20150105.220622,2817,2,118702,-2,2817,563,2818,2029,0
20150105.220622,2817,4,118706,0,2817,663,2818,2029,0
20150105.220622,2817,4,118710,0,2817,662,2818,2027,0
20150105.220623,2817,2,118712,-2,2817,666,2818,2020,0
20150105.220624,2818,2,118714,2,2817,672,2818,2021,1
20150105.220627,2818,10,118724,-6,2817,650,2818,2020,1
20150105.220628,2818,2,118726,2,2817,654,2818,2019,1
20150105.220628,2818,100,118826,100,2817,654,2818,1986,1
20150105.220629,2817,4,118830,0,2817,661,2818,1982,0
20150105.220632,2817,1402,120232,-196,2816,639,2817,320,0
20150105.220632,2817,2,120234,0,2816,639,2817,330,0
20150105.220633,2817,22,120256,-10,2816,639,2817,369,0
20150105.220633,2817,2,120258,-2,2816,639,2817,458,0
20150105.220634,2817,40,120298,0,2816,639,2817,439,0
20150105.220634,2817,102,120400,-100,2816,639,2817,390,0
20150105.220635,2817,4,120404,0,2816,679,2817,414,0
20150105.220636,2817,10,120414,0,2816,707,2817,409,0
20150105.220637,2817,4,120418,0,2816,707,2817,410,0
20150105.220637,2817,2,120420,-2,2816,707,2817,409,0
20150105.220638,2817,6,120426,-2,2816,707,2817,437,0
20150105.22064,2817,6,120432,0,2816,757,2817,438,0
20150105.220641,2817,8,120440,0,2816,759,2817,434,0
20150105.220641,2817,100,120540,0,2816,761,2817,386,0
20150105.220642,2817,16,120556,0,2816,761,2817,398,0
20150105.220643,2817,2,120558,0,2816,761,2817,398,0
20150105.220644,2816,34,120592,-4,2816,744,2817,398,0
20150105.220645,2817,2,120594,0,2816,744,2817,397,1
20150105.220646,2817,88,120682,-86,2816,565,2817,359,1
20150105.220648,2817,402,121084,20,2816,582,2817,170,1
20150105.220649,2817,2,121086,0,2816,583,2817,169,1
20150105.22065,2817,4,121090,0,2816,583,2817,167,1
20150105.22065,2817,30,121120,-4,2816,583,2817,153,1
20150105.220651,2817,24,121144,-10,2816,597,2817,141,1
20150105.220651,2817,6,121150,0,2816,597,2817,138,1
20150105.220652,2817,12,121162,-2,2816,599,2817,133,1
20150105.220654,2817,2,121164,0,2816,600,2817,134,1
20150105.220654,2817,2,121166,0,2816,600,2817,133,1
20150105.220654,2817,4,121170,0,2816,600,2817,131,1
20150105.220657,2817,10,121180,0,2816,682,2817,126,1
20150105.220658,2817,2,121182,-2,2816,683,2817,125,1
20150105.220659,2817,20,121202,-20,2816,684,2817,116,1
20150105.220701,2817,122,121324,0,2816,687,2817,61,1
20150105.220702,2817,122,121446,22,2816,687,2818,1975,1
20150105.220703,2817,2,121448,0,2817,84,2818,2015,1
20150105.220704,2816,800,122248,-342,2816,381,2817,24,0
20150105.220704,2817,60,122308,12,2816,381,2817,6,1
20150105.220705,2817,12,122320,8,2817,1,2818,1687,1
20150105.220705,2817,4,122324,0,2816,406,2818,1666,1
20150105.220706,2817,8,122332,0,2817,1,2818,1662,1
20150105.220707,2817,2,122334,0,2817,1,2818,1673,1
20150105.220707,2817,4,122338,-2,2816,414,2817,4,1
20150105.220708,2817,10,122348,0,2817,17,2818,1661,1
20150105.220709,2817,2,122350,0,2817,26,2818,1658,1
20150105.22071,2818,4,122354,2,2817,26,2818,1655,1
20150105.220711,2817,60,122414,-20,2817,1,2818,1657,0
20150105.220711,2817,2,122416,0,2816,427,2817,5,0
20150105.220712,2817,2,122418,0,2816,427,2817,5,0
20150105.220714,2817,2,122420,0,2816,437,2817,4,0
20150105.220714,2817,4,122424,0,2816,437,2817,2,0
20150105.220714,2817,2,122426,0,2816,434,2817,1,0
20150105.220715,2817,2,122428,0,2817,505,2818,1631,0
20150105.220715,2817,16,122444,0,2817,509,2818,1631,0
20150105.220719,2818,1000,123444,416,2817,527,2818,1161,1
20150105.22072,2817,6,123450,2,2817,528,2818,1159,0
20150105.22072,2818,2,123452,-2,2817,533,2818,1158,1
20150105.220721,2818,2,123454,0,2817,533,2818,1156,1
20150105.220723,2817,2,123456,0,2817,534,2818,1155,0
20150105.220724,2817,2,123458,0,2817,585,2818,1166,0
20150105.220726,2818,6,123464,-6,2817,585,2818,1150,1
20150105.220727,2818,2,123466,0,2817,588,2818,1145,1
20150105.220727,2817,8,123474,8,2817,580,2818,1145,0
20150105.22073,2817,2,123476,0,2817,588,2818,1101,0
20150105.220732,2818,10,123486,0,2817,589,2818,1090,1
20150105.220733,2818,2,123488,-2,2817,585,2818,1088,1
20150105.220734,2818,8,123496,-6,2817,588,2818,1086,1
20150105.220736,2818,12,123508,0,2817,590,2818,1081,1
20150105.220736,2818,8,123516,0,2817,598,2818,1076,1
20150105.220736,2818,12,123528,-6,2817,603,2818,1070,1
20150105.220737,2817,16,123544,-8,2817,599,2818,1065,0
20150105.220737,2818,40,123584,4,2817,600,2818,1045,1
20150105.220739,2818,8,123592,6,2817,585,2818,1072,1
20150105.220739,2818,18,123610,-10,2817,596,2818,1064,1
20150105.220741,2818,30,123640,-28,2817,601,2818,1047,1
20150105.220741,2818,2,123642,0,2817,601,2818,1046,1
20150105.220743,2818,2,123644,2,2817,603,2818,1046,1
20150105.220744,2818,2,123646,2,2817,606,2818,1045,1
20150105.220744,2818,4,123650,-2,2817,605,2818,1044,1
20150105.220745,2818,4,123654,-4,2817,605,2818,1042,1
20150105.220745,2818,2,123656,0,2817,606,2818,1041,1
20150105.220746,2818,2,123658,0,2817,603,2818,1040,1
20150105.220748,2817,10,123668,0,2817,598,2818,1046,0
20150105.220749,2818,6,123674,0,2817,600,2818,1043,1
20150105.220749,2818,10,123684,2,2817,604,2818,1037,1
20150105.22075,2817,240,123924,0,2817,496,2818,1037,0
20150105.220752,2817,20,123944,0,2817,487,2818,1037,0
20150105.220753,2817,82,124026,0,2817,451,2818,1045,0
20150105.220754,2818,2,124028,2,2817,452,2818,1044,1
20150105.220754,2817,724,124752,-466,2817,441,2818,696,0
20150105.220755,2818,20,124772,0,2817,441,2818,686,1
20150105.220755,2818,2,124774,-2,2817,441,2818,688,1
20150105.220757,2818,2,124776,-2,2817,474,2818,698,1
20150105.220758,2818,2,124778,0,2817,475,2818,702,1
20150105.220758,2818,6,124784,-4,2817,478,2818,699,1
20150105.2208,2817,2,124786,2,2817,489,2818,736,0
20150105.220801,2818,2,124788,-2,2817,489,2818,735,1
20150105.220802,2817,4,124792,0,2817,490,2818,735,0
20150105.220804,2818,2,124794,0,2817,492,2818,734,1
20150105.220807,2818,18,124812,-8,2817,494,2818,726,1
20150105.220808,2818,4,124816,0,2817,496,2818,724,1
20150105.220812,2818,2,124818,0,2817,498,2818,745,1
20150105.220813,2818,2,124820,0,2817,521,2818,755,1
20150105.220814,2818,2,124822,0,2817,521,2818,754,1
20150105.220815,2818,12,124834,0,2817,525,2818,748,1
20150105.220815,2818,2,124836,0,2817,525,2818,749,1
20150105.220818,2818,20,124856,0,2817,526,2818,786,1
20150105.220818,2818,2,124858,0,2817,526,2818,785,1
20150105.220819,2818,26,124884,-26,2817,527,2818,785,1
20150105.220821,2818,16,124900,0,2817,527,2818,771,1
20150105.220821,2817,4,124904,4,2817,525,2818,771,0
20150105.220824,2817,14,124918,8,2817,516,2818,771,0
20150105.220825,2818,56,124974,-10,2817,493,2818,755,1
20150105.220825,2817,102,125076,100,2817,446,2818,750,0
20150105.220826,2817,2,125078,2,2817,445,2818,750,0
20150105.220829,2817,4,125082,0,2817,445,2818,754,0
20150105.220834,2817,2,125084,2,2817,504,2818,775,0
20150105.220837,2818,2,125086,0,2817,508,2818,776,1
20150105.220842,2817,20,125106,0,2817,498,2818,787,0
20150105.220843,2818,2,125108,0,2817,495,2818,785,1
20150105.220846,2818,22,125130,10,2817,487,2818,782,1
20150105.220848,2818,2,125132,0,2817,496,2818,781,1
20150105.220848,2818,20,125152,-20,2817,496,2818,771,1
20150105.220849,2818,42,125194,0,2817,495,2818,761,1
20150105.220851,2818,20,125214,0,2817,495,2818,751,1
20150105.220854,2818,2,125216,0,2817,505,2818,749,1
20150105.220856,2817,20,125236,0,2817,497,2818,723,0
20150105.220856,2818,4,125240,-2,2817,497,2818,708,1
20150105.220859,2818,8,125248,-4,2817,497,2818,709,1
20150105.2209,2818,4,125252,2,2817,497,2818,707,1
20150105.220901,2818,2,125254,0,2817,497,2818,706,1
20150105.220903,2818,4,125258,0,2817,507,2818,704,1
20150105.220905,2818,4,125262,0,2817,595,2818,701,1
20150105.220905,2818,8,125270,2,2817,596,2818,698,1
20150105.220906,2817,8,125278,2,2817,596,2818,695,0
20150105.220907,2818,6,125284,0,2817,597,2818,884,1
20150105.220908,2818,4,125288,0,2817,597,2818,872,1
20150105.220909,2818,6,125294,0,2817,597,2818,855,1
20150105.220909,2818,2,125296,0,2817,597,2818,855,1
20150105.220912,2818,2,125298,0,2817,604,2818,836,1
20150105.220914,2818,6,125304,-6,2817,605,2818,838,1
20150105.220915,2818,2,125306,0,2817,604,2818,837,1
20150105.220916,2817,2,125308,0,2817,603,2818,818,0
20150105.220917,2817,2,125310,2,2817,617,2818,819,0
20150105.220917,2818,200,125510,0,2817,617,2818,719,1
20150105.220919,2818,2,125512,-2,2817,751,2818,722,1
20150105.220921,2818,210,125722,-206,2817,754,2818,616,1
20150105.220923,2818,20,125742,0,2817,754,2818,608,1
20150105.220923,2818,110,125852,0,2817,754,2818,553,1
20150105.220924,2818,32,125884,-8,2817,765,2818,536,1
20150105.220924,2818,2,125886,0,2817,765,2818,534,1
20150105.220925,2818,2,125888,-2,2817,765,2818,533,1
20150105.220926,2818,6,125894,0,2817,765,2818,530,1
20150105.220926,2818,86,125980,-62,2817,765,2818,486,1
20150105.220926,2818,40,126020,-18,2817,775,2818,468,1
20150105.220927,2818,8,126028,0,2817,775,2818,464,1
20150105.220928,2818,2,126030,0,2817,773,2818,430,1
20150105.220929,2818,6,126036,0,2817,773,2818,426,1
20150105.220931,2818,20,126056,0,2817,774,2818,384,1
20150105.220932,2818,4,126060,0,2817,774,2818,382,1
20150105.220932,2818,2,126062,0,2817,776,2818,381,1
20150105.220932,2818,2,126064,0,2817,776,2818,381,1
20150105.220933,2818,2,126066,0,2817,776,2818,380,1
20150105.220934,2818,4,126070,0,2817,776,2818,375,1
20150105.220936,2817,2,126072,0,2817,775,2818,472,0
20150105.220936,2818,30,126102,0,2817,776,2818,457,1
20150105.220938,2817,2,126104,0,2817,775,2818,460,0
20150105.22094,2818,6,126110,0,2817,774,2818,455,1
20150105.220941,2818,26,126136,16,2817,775,2818,440,1
20150105.220942,2817,6,126142,0,2817,773,2818,440,0
20150105.220942,2817,2,126144,2,2817,771,2818,441,0
20150105.220943,2818,200,126344,-138,2817,771,2818,341,1
20150105.220943,2818,2,126346,0,2817,772,2818,340,1
20150105.220944,2818,116,126462,-86,2817,775,2818,282,1
20150105.220945,2818,6,126468,-4,2817,776,2818,279,1
20150105.220946,2818,104,126572,12,2817,761,2818,227,1
20150105.220946,2818,22,126594,0,2817,761,2818,215,1
20150105.220946,2818,20,126614,8,2817,760,2818,235,1
20150105.220947,2818,6,126620,-2,2817,760,2818,222,1
20150105.220947,2818,24,126644,-2,2817,761,2818,210,1
20150105.220948,2818,10,126654,0,2817,761,2818,205,1
20150105.220948,2818,38,126692,-2,2817,761,2818,186,1
20150105.220949,2818,32,126724,2,2817,761,2818,170,1
20150105.22095,2818,340,127064,230,2818,45,2819,1197,1
20150105.22095,2818,58,127122,-28,2817,762,2818,23,1
20150105.220951,2818,10,127132,4,2817,769,2818,20,1
20150105.220951,2818,18,127150,16,2817,757,2818,11,1
20150105.220952,2818,4,127154,0,2817,757,2818,9,1
20150105.220952,2817,4,127158,4,2817,755,2818,19,0
20150105.220953,2818,42,127200,2,2817,748,2819,890,1
20150105.220954,2818,4,127204,0,2817,748,2819,1219,1
20150105.220954,2818,4,127208,-2,2817,748,2819,1219,1
20150105.220955,2818,16,127224,0,2817,748,2819,1219,1
20150105.220959,2819,4,127228,0,2817,738,2819,1217,1
20150105.221,2819,58,127286,-48,2817,738,2819,1178,1
20150105.221,2819,22,127308,-16,2818,2,2819,1168,1
20150105.221001,2819,20,127328,-20,2818,14,2819,1158,1
20150105.221001,2819,4,127332,-4,2818,15,2819,1156,1
20150105.221002,2818,4,127336,0,2818,13,2819,1156,0
20150105.221003,2819,20,127356,-20,2818,32,2819,1150,1
20150105.221003,2818,2,127358,-2,2818,37,2819,1150,0
20150105.221004,2819,368,127726,-8,2818,36,2819,973,1
20150105.221006,2818,402,128128,-16,2818,54,2819,955,0
20150105.221007,2819,12,128140,0,2818,54,2819,949,1
20150105.221008,2819,16,128156,-16,2818,56,2819,962,1
20150105.221009,2818,10,128166,0,2818,59,2819,962,0
20150105.221011,2818,4,128170,0,2818,61,2819,966,0
20150105.221013,2818,2,128172,2,2818,84,2819,993,0
20150105.221014,2818,2,128174,0,2818,88,2819,994,0
20150105.221015,2818,356,128530,30,2817,659,2818,125,0
20150105.221016,2818,6,128536,0,2817,659,2818,132,0
20150105.221018,2817,6,128542,2,2817,658,2818,162,0
20150105.221019,2818,34,128576,0,2817,656,2818,160,1
20150105.221019,2818,12,128588,12,2817,656,2818,155,1
20150105.22102,2818,70,128658,70,2817,622,2818,159,1
20150105.22102,2817,96,128754,0,2817,571,2818,164,0
20150105.221021,2817,2,128756,2,2817,570,2818,227,0
20150105.221021,2818,4,128760,2,2817,570,2818,211,1
20150105.221022,2818,264,129024,-26,2817,570,2818,86,1
20150105.221023,2818,30,129054,0,2817,574,2818,86,1
20150105.221023,2818,2,129056,0,2817,574,2818,288,1
20150105.221024,2818,2,129058,0,2817,574,2818,288,1
20150105.221024,2817,22,129080,-16,2817,574,2818,452,0
20150105.221025,2818,6,129086,6,2817,575,2818,472,1
20150105.221027,2818,2,129088,2,2817,575,2818,473,1
20150105.221028,2817,4,129092,0,2817,573,2818,468,0
20150105.221032,2818,10,129102,-8,2817,595,2818,631,1
20150105.221032,2818,6,129108,-6,2817,595,2818,628,1
20150105.221033,2818,2,129110,0,2817,597,2818,632,1
20150105.221036,2818,4,129114,-4,2817,599,2818,646,1
20150105.221037,2818,2,129116,0,2817,594,2818,667,1
20150105.221039,2818,8,129124,-8,2817,595,2818,667,1
20150105.221041,2818,4,129128,0,2817,594,2818,707,1
20150105.221045,2818,4,129132,0,2817,620,2818,732,1
20150105.221046,2818,4,129136,4,2817,622,2818,727,1
20150105.221047,2818,20,129156,-20,2817,622,2818,714,1
20150105.22105,2818,2,129158,0,2817,678,2818,873,1
20150105.221053,2817,2,129160,0,2817,676,2818,893,0
20150105.221055,2818,12,129172,-12,2817,683,2818,896,1
20150105.221102,2818,12,129184,0,2817,675,2818,906,1
20150105.221104,2817,2,129186,0,2817,675,2818,907,0
20150105.221104,2817,2,129188,0,2817,675,2818,907,0
20150105.22111,2818,100,129288,0,2817,674,2818,860,1
20150105.221111,2817,2,129290,0,2817,663,2818,865,0
20150105.221112,2818,2,129292,0,2817,663,2818,866,1
20150105.221117,2818,4,129296,-2,2817,685,2818,1070,1
20150105.221118,2817,2,129298,0,2817,685,2818,1071,0
20150105.22112,2818,2,129300,0,2817,685,2818,1071,1
20150105.221121,2818,2,129302,0,2817,683,2818,1070,1
20150105.221123,2817,4,129306,0,2817,682,2818,1081,0
20150105.221131,2817,2,129308,0,2817,715,2818,1092,0
20150105.221132,2818,2,129310,0,2817,720,2818,1089,1
20150105.221135,2818,6,129316,-6,2817,728,2818,758,1
20150105.221136,2817,62,129378,2,2817,699,2818,758,0
20150105.221139,2817,2,129380,2,2817,700,2818,759,0
20150105.221146,2817,2,129382,2,2817,697,2818,751,0
20150105.221149,2818,2,129384,0,2817,703,2818,771,1
20150105.221149,2818,18,129402,0,2817,705,2818,762,1
20150105.221149,2817,44,129446,0,2817,682,2818,762,0
20150105.221152,2817,10,129456,0,2817,677,2818,767,0
20150105.221156,2818,2,129458,0,2817,678,2818,820,1
20150105.221158,2818,4,129462,-2,2817,678,2818,819,1
20150105.2212,2818,4,129466,-2,2817,678,2818,821,1
20150105.221218,2818,2,129468,0,2817,702,2818,877,1
20150105.221223,2818,20,129488,-20,2817,702,2818,868,1
20150105.221225,2818,2,129490,0,2817,702,2818,868,1
20150105.221227,2818,2,129492,0,2817,702,2818,867,1
20150105.221229,2817,2,129494,0,2817,700,2818,869,0
20150105.22123,2818,2,129496,0,2817,700,2818,869,1
20150105.221234,2817,2,129498,2,2817,642,2818,889,0
20150105.221235,2817,60,129558,0,2817,612,2818,890,0
20150105.221236,2817,2,129560,0,2817,609,2818,890,0
20150105.221243,2817,2,129562,0,2817,631,2818,893,0
20150105.221243,2817,2,129564,-2,2817,631,2818,893,0
20150105.221244,2818,20,129584,0,2817,631,2818,883,1
20150105.221245,2817,2,129586,0,2817,625,2818,883,0
20150105.221251,2817,20,129606,-20,2817,624,2818,885,0
20150105.221258,2818,2,129608,-2,2817,625,2818,885,1
20150105.221259,2818,2,129610,0,2817,626,2818,884,1
20150105.221301,2818,6,129616,-6,2817,618,2818,881,1
20150105.221307,2818,2,129618,0,2817,618,2818,900,1
20150105.221313,2818,2,129620,-2,2817,618,2818,919,1
20150105.221314,2818,4,129624,0,2817,621,2818,917,1
20150105.221315,2817,656,130280,-164,2817,298,2818,917,0
20150105.221316,2817,30,130310,30,2817,283,2818,841,0
20150105.221316,2817,566,130876,-102,2816,344,2817,333,0
20150105.221317,2817,2,130878,0,2816,320,2817,342,0
20150105.221318,2817,2,130880,-2,2816,320,2817,349,0
20150105.221318,2817,2,130882,0,2816,320,2817,348,0
20150105.221319,2817,4,130886,0,2816,320,2817,347,0
20150105.22132,2817,2,130888,0,2816,320,2817,352,0
20150105.221322,2817,30,130918,0,2816,320,2817,337,0
20150105.221322,2816,6,130924,0,2816,318,2817,334,0
20150105.221323,2816,8,130932,6,2816,314,2817,344,0
20150105.221324,2816,12,130944,0,2816,308,2817,342,0
20150105.22133,2817,2,130946,0,2816,307,2817,344,1
20150105.221335,2816,2,130948,0,2816,313,2817,505,0
20150105.221336,2816,2,130950,0,2816,312,2817,505,0
20150105.221339,2816,2,130952,2,2816,261,2817,510,0
20150105.221339,2816,176,131128,-82,2816,173,2817,511,0
20150105.22134,2816,2,131130,0,2816,172,2817,513,0
20150105.221341,2816,26,131156,-4,2816,161,2817,511,0
20150105.221342,2816,312,131468,100,2815,443,2817,511,0
20150105.221343,2816,10,131478,-10,2815,797,2817,511,0
20150105.221343,2816,12,131490,2,2816,2,2817,521,0
20150105.221344,2816,2,131492,0,2816,12,2817,521,0
20150105.221344,2816,12,131504,-2,2816,6,2817,522,0
20150105.221345,2816,6,131510,-6,2816,21,2817,526,0
20150105.221346,2816,42,131552,-6,2815,659,2816,549,0
20150105.221347,2816,4,131556,-2,2815,479,2816,562,0
20150105.221347,2816,2,131558,0,2815,422,2816,561,0
20150105.221349,2816,202,131760,-8,2815,322,2816,593,0
20150105.22135,2815,12,131772,-4,2815,319,2816,593,0
20150105.221351,2815,16,131788,-10,2815,314,2816,590,0
20150105.221351,2815,46,131834,-12,2815,304,2816,595,0
20150105.221352,2816,12,131846,2,2815,299,2816,589,1
20150105.221352,2815,2,131848,0,2815,305,2816,589,0
20150105.221353,2816,2,131850,0,2815,524,2816,696,1
20150105.221353,2815,6,131856,-2,2815,624,2816,686,0
20150105.221354,2815,4,131860,0,2815,633,2816,716,0
20150105.221355,2815,2,131862,0,2815,632,2816,721,0
20150105.221355,2816,4,131866,0,2815,631,2816,720,1
20150105.221356,2815,4,131870,0,2815,650,2816,720,0
20150105.221356,2815,2,131872,0,2815,650,2816,723,0
20150105.221359,2816,4,131876,-4,2815,651,2816,721,1
20150105.2214,2816,2,131878,-2,2815,659,2816,720,1
20150105.221401,2815,2,131880,0,2815,658,2816,720,0
20150105.221401,2815,12,131892,-8,2815,653,2816,720,0
20150105.221402,2815,2,131894,2,2815,756,2816,723,0
20150105.221402,2815,2,131896,2,2815,759,2816,723,0
20150105.221405,2815,2,131898,2,2815,761,2816,723,0
20150105.221405,2815,2,131900,2,2815,760,2816,723,0
20150105.221407,2816,14,131914,-10,2815,766,2816,718,1
20150105.221408,2816,100,132014,0,2815,816,2816,661,1
20150105.22141,2815,2,132016,0,2815,817,2816,680,0
20150105.221411,2816,20,132036,0,2815,818,2816,671,1
20150105.221412,2816,4,132040,-4,2815,818,2816,669,1
20150105.221412,2816,2,132042,0,2815,819,2816,668,1
20150105.221414,2816,2,132044,0,2815,820,2816,682,1
20150105.22142,2816,2,132046,0,2815,842,2816,933,1
20150105.221421,2816,200,132246,-200,2815,850,2816,818,1
20150105.221422,2815,4,132250,0,2815,848,2816,833,0
20150105.221426,2816,40,132290,0,2815,868,2816,814,1
20150105.221426,2816,110,132400,-110,2815,870,2816,744,1
20150105.221428,2816,20,132420,0,2815,893,2816,749,1
20150105.221431,2816,100,132520,-100,2815,815,2816,687,1
20150105.221431,2816,200,132720,0,2815,816,2816,587,1
20150105.221434,2816,40,132760,0,2815,817,2816,462,1
20150105.221435,2816,6,132766,4,2815,825,2816,459,1
20150105.221435,2816,40,132806,0,2815,825,2816,439,1
20150105.221436,2816,200,133006,-22,2815,829,2816,339,1
20150105.221437,2816,2,133008,0,2815,815,2816,338,1
20150105.221437,2816,676,133684,70,2816,274,2817,420,1
20150105.221439,2817,2,133686,0,2816,58,2817,281,1
20150105.221444,2816,4,133690,0,2816,87,2817,382,0
20150105.221446,2816,2,133692,0,2816,86,2817,382,0
20150105.221447,2816,2,133694,0,2816,87,2817,382,0
20150105.221448,2816,100,133794,42,2816,39,2817,440,0
20150105.221453,2816,100,133894,78,2816,16,2817,451,0
20150105.221454,2816,32,133926,30,2816,3,2817,452,0
20150105.221455,2816,2,133928,2,2816,3,2817,452,0
20150105.221456,2816,2,133930,-2,2816,2,2817,452,0
20150105.221457,2816,2,133932,-2,2816,48,2817,453,0
20150105.221457,2816,104,134036,4,2815,1048,2816,9,0
20150105.221458,2816,18,134054,-8,2816,27,2817,454,0
20150105.221459,2817,4,134058,0,2816,42,2817,461,1
20150105.2215,2816,22,134080,-2,2816,33,2817,460,0
20150105.221501,2816,4,134084,2,2816,36,2817,460,0
20150105.221505,2816,2,134086,0,2816,38,2817,482,0
20150105.22151,2816,2,134088,0,2816,50,2817,482,0
20150105.221514,2816,28,134116,28,2816,41,2817,513,0
20150105.221516,2817,2,134118,0,2816,42,2817,512,1
20150105.221517,2816,4,134122,0,2816,40,2817,513,0
20150105.221518,2816,2,134124,0,2816,40,2817,513,0
20150105.221519,2817,2,134126,0,2816,41,2817,512,1
20150105.221521,2817,2,134128,0,2816,44,2817,512,1
20150105.221525,2816,2,134130,2,2816,46,2817,543,0
20150105.221527,2816,22,134152,2,2816,50,2817,543,0
20150105.221529,2816,14,134166,2,2816,43,2817,443,0
20150105.221529,2816,2,134168,2,2816,41,2817,423,0
20150105.221532,2817,4,134172,-4,2816,32,2817,541,1
20150105.221533,2816,66,134238,-10,2815,996,2816,409,0
20150105.221534,2816,12,134250,0,2815,996,2816,414,0
20150105.221534,2816,8,134258,0,2815,981,2816,410,0
20150105.221535,2816,4,134262,0,2815,981,2816,408,0
20150105.221535,2816,4,134266,0,2815,981,2816,406,0
20150105.221536,2816,28,134294,-20,2815,981,2816,392,0
20150105.221536,2816,12,134306,0,2815,981,2816,387,0
20150105.221537,2816,6,134312,0,2815,981,2816,384,0
20150105.221538,2816,12,134324,0,2815,981,2816,11,0
20150105.221538,2816,22,134346,-20,2815,981,2816,1,0
20150105.221538,2816,2,134348,-2,2816,13,2817,541,0
20150105.221539,2817,4,134352,0,2816,20,2817,540,1
20150105.22154,2816,8,134360,0,2816,17,2817,540,0
20150105.221546,2817,10,134370,4,2816,20,2817,568,1
20150105.221547,2816,16,134386,-2,2816,12,2817,569,0
20150105.221548,2817,2,134388,0,2816,12,2817,568,1
20150105.221549,2816,2,134390,0,2816,11,2817,568,0
20150105.221554,2817,6,134396,0,2816,36,2817,578,1
20150105.221556,2817,400,134796,-320,2816,36,2817,363,1
20150105.221602,2817,8,134804,0,2816,59,2817,376,1
20150105.221604,2817,2,134806,0,2816,69,2817,375,1
20150105.221612,2817,2,134808,0,2816,86,2817,385,1
20150105.221618,2817,2,134810,0,2816,106,2817,389,1
20150105.221634,2817,6,134816,-6,2816,100,2817,363,1
20150105.221643,2817,2,134818,0,2816,180,2817,364,1
20150105.221643,2817,20,134838,-20,2816,180,2817,354,1
20150105.22165,2817,2,134840,0,2816,185,2817,357,1
20150105.2217,2816,24,134864,14,2816,194,2817,361,0
20150105.2217,2816,24,134888,24,2816,182,2817,361,0
20150105.221705,2816,10,134898,0,2816,188,2817,362,0
20150105.221706,2816,2,134900,-2,2816,210,2817,362,0
20150105.221707,2816,2,134902,0,2816,204,2817,362,0
20150105.221713,2817,40,134942,0,2816,182,2817,330,1
20150105.221714,2817,40,134982,-40,2816,182,2817,310,1
20150105.221719,2816,2,134984,0,2816,184,2817,325,0
20150105.221721,2817,2,134986,0,2816,185,2817,324,1
20150105.221723,2816,20,135006,10,2816,176,2817,326,0
20150105.221732,2816,6,135012,4,2816,168,2817,334,0
20150105.221739,2816,2,135014,0,2816,178,2817,335,0
20150105.221741,2817,2,135016,-2,2816,179,2817,340,1
20150105.221748,2817,4,135020,0,2816,200,2817,343,1
20150105.221752,2817,2,135022,0,2816,184,2817,347,1
20150105.221755,2817,2,135024,0,2816,184,2817,346,1
20150105.221757,2816,2,135026,0,2816,195,2817,346,0
20150105.221803,2817,2,135028,0,2816,203,2817,362,1
20150105.221808,2816,2,135030,0,2816,204,2817,357,0
20150105.221815,2817,2,135032,0,2816,204,2817,357,1
20150105.221816,2816,2,135034,0,2816,203,2817,360,0
20150105.221827,2817,2,135036,0,2816,259,2817,345,1
20150105.221828,2816,2,135038,0,2816,258,2817,345,0
20150105.221829,2817,6,135044,0,2816,258,2817,342,1
20150105.22183,2817,2,135046,0,2816,258,2817,341,1
20150105.221833,2816,2,135048,0,2816,258,2817,347,0
20150105.221846,2817,2,135050,0,2816,262,2817,357,1
20150105.221851,2817,2,135052,0,2816,263,2817,355,1
20150105.221853,2816,2,135054,2,2816,262,2817,365,0
20150105.221856,2817,2,135056,0,2816,262,2817,365,1
20150105.221856,2817,10,135066,0,2816,262,2817,360,1
20150105.221857,2817,2,135068,0,2816,263,2817,359,1
20150105.221858,2817,2,135070,0,2816,262,2817,358,1
20150105.221859,2817,2,135072,-2,2816,262,2817,358,1
20150105.221901,2816,4,135076,-2,2816,271,2817,357,0
20150105.221903,2817,2,135078,0,2816,270,2817,361,1
20150105.221907,2817,2,135080,0,2816,292,2817,361,1
20150105.22191,2817,20,135100,0,2816,293,2817,346,1
20150105.221912,2817,2,135102,0,2816,294,2817,344,1
20150105.221913,2817,6,135108,-6,2816,294,2817,341,1
20150105.221915,2817,2,135110,-2,2816,294,2817,340,1
20150105.221932,2817,2,135112,-2,2816,331,2817,352,1
20150105.221934,2817,2,135114,-2,2816,331,2817,351,1
20150105.221935,2817,4,135118,2,2816,330,2817,351,1
20150105.221936,2817,2,135120,0,2816,330,2817,350,1
20150105.221937,2817,2,135122,-2,2816,330,2817,349,1
20150105.221937,2817,20,135142,-20,2816,331,2817,340,1
20150105.221938,2817,22,135164,-22,2816,331,2817,329,1
20150105.221939,2817,64,135228,-60,2816,331,2817,297,1
20150105.221939,2816,2,135230,0,2816,330,2817,297,0
20150105.221941,2817,2,135232,0,2816,334,2817,296,1
20150105.221947,2816,2,135234,2,2816,357,2817,296,0
20150105.221948,2817,20,135254,-16,2816,357,2817,286,1
20150105.22195,2817,4,135258,-4,2816,357,2817,279,1
20150105.221955,2816,2,135260,2,2816,406,2817,299,0
20150105.221956,2816,4,135264,0,2816,414,2817,298,0
20150105.221958,2816,2,135266,0,2816,413,2817,298,0
20150105.221959,2817,20,135286,0,2816,414,2817,289,1
20150105.222002,2817,20,135306,-20,2816,414,2817,285,1
20150105.222003,2817,60,135366,0,2816,415,2817,275,1
20150105.222003,2817,112,135478,0,2816,415,2817,219,1
20150105.222006,2817,2,135480,-2,2816,436,2817,218,1
20150105.222008,2817,2,135482,0,2816,414,2817,217,1
20150105.22201,2817,2,135484,0,2816,414,2817,216,1
20150105.22201,2817,20,135504,0,2816,414,2817,206,1
20150105.222011,2817,2,135506,-2,2816,414,2817,205,1
20150105.222012,2817,16,135522,-16,2816,414,2817,197,1
20150105.222013,2817,2,135524,0,2816,414,2817,196,1
20150105.222014,2817,10,135534,0,2816,415,2817,191,1
20150105.222015,2817,2,135536,0,2816,415,2817,190,1
20150105.222015,2817,2,135538,0,2816,427,2817,189,1
20150105.222016,2817,2,135540,0,2816,427,2817,189,1
20150105.222017,2817,2,135542,0,2816,427,2817,188,1
20150105.222018,2817,10,135552,-10,2816,427,2817,183,1
20150105.222019,2817,10,135562,0,2816,427,2817,179,1
20150105.222026,2816,2,135564,-2,2816,426,2817,190,0
20150105.222027,2817,40,135604,26,2816,426,2817,175,1
20150105.222029,2817,2,135606,0,2816,428,2817,183,1
20150105.222035,2817,2,135608,0,2816,459,2817,184,1
20150105.222038,2817,2,135610,0,2816,461,2817,183,1
20150105.222041,2817,4,135614,-4,2816,461,2817,181,1
20150105.222045,2817,2,135616,2,2816,461,2817,198,1
20150105.222046,2816,2,135618,0,2816,465,2817,198,0
20150105.222057,2817,20,135638,8,2816,468,2817,194,1
20150105.222058,2817,16,135654,-14,2816,468,2817,186,1
20150105.222058,2817,10,135664,0,2816,468,2817,181,1
20150105.222059,2817,90,135754,40,2816,463,2817,136,1
20150105.2221,2817,272,136026,-166,2817,3,2818,562,1
20150105.222101,2818,4,136030,0,2817,12,2818,561,1
20150105.222108,2817,2,136032,0,2817,33,2818,577,0
20150105.222111,2817,2,136034,0,2817,38,2818,577,0
20150105.222113,2818,10,136044,-8,2817,40,2818,579,1
20150105.222114,2817,4,136048,0,2817,38,2818,579,0
20150105.222114,2817,2,136050,0,2817,37,2818,585,0
20150105.222117,2818,2,136052,0,2817,48,2818,597,1
20150105.222119,2817,2,136054,2,2817,47,2818,598,0
20150105.222126,2818,4,136058,0,2817,159,2818,514,1
20150105.222127,2818,148,136206,10,2817,160,2818,453,1
20150105.222127,2818,278,136484,12,2817,174,2818,281,1
20150105.222128,2818,144,136628,40,2817,175,2818,201,1
20150105.222128,2818,148,136776,32,2817,276,2818,9,1
20150105.222129,2818,8,136784,8,2817,276,2818,5,1
20150105.222129,2818,10,136794,6,2818,18,2819,847,1
20150105.22213,2818,48,136842,-2,2817,276,2818,3,1
20150105.22213,2818,8,136850,0,2818,1,2819,821,1
20150105.222131,2819,6,136856,-2,2817,283,2819,820,1
20150105.222131,2817,6,136862,0,2817,281,2819,820,0
20150105.222132,2819,2,136864,-2,2817,280,2819,819,1
20150105.222132,2819,2,136866,0,2817,281,2819,818,1
20150105.222133,2819,10,136876,-10,2817,281,2819,823,1
20150105.222134,2819,22,136898,0,2818,5,2819,822,1
20150105.222134,2817,30,136928,20,2817,271,2819,816,0
20150105.222135,2818,4,136932,0,2817,271,2819,633,1
20150105.222138,2818,4,136936,-2,2817,276,2818,187,1
20150105.222138,2818,2,136938,2,2817,276,2818,199,1
20150105.222138,2818,6,136944,-2,2817,276,2818,196,1
20150105.22214,2818,40,136984,0,2817,278,2818,207,1
20150105.22214,2818,20,137004,0,2817,278,2818,197,1
20150105.222142,2818,22,137026,-22,2817,279,2818,237,1
20150105.222142,2818,4,137030,-2,2817,279,2818,241,1
20150105.222143,2818,2,137032,0,2817,279,2818,240,1
20150105.222145,2818,2,137034,0,2817,290,2818,282,1
20150105.222146,2818,2,137036,0,2817,289,2818,282,1
20150105.222149,2818,2,137038,0,2817,302,2818,289,1
20150105.22215,2818,4,137042,0,2817,307,2818,287,1
20150105.22215,2818,2,137044,0,2817,307,2818,286,1
20150105.222151,2818,2,137046,0,2817,307,2818,285,1
20150105.222151,2818,2,137048,0,2817,307,2818,284,1
20150105.222152,2818,14,137062,0,2817,307,2818,277,1
20150105.222153,2818,4,137066,-2,2817,340,2818,278,1
20150105.222154,2817,2,137068,2,2817,340,2818,283,0
20150105.222155,2818,2,137070,0,2817,347,2818,282,1
20150105.222157,2818,4,137074,-4,2817,367,2818,238,1
20150105.222158,2818,2,137076,0,2817,369,2818,265,1
20150105.222201,2817,2,137078,2,2817,368,2818,266,0
20150105.222204,2817,2,137080,0,2817,368,2818,276,0
20150105.222207,2817,2,137082,2,2817,367,2818,277,0
20150105.222208,2818,2,137084,0,2817,367,2818,286,1
20150105.222212,2818,2,137086,0,2817,386,2818,289,1
20150105.222213,2817,2,137088,0,2817,385,2818,291,0
20150105.222215,2818,2,137090,0,2817,386,2818,285,1
20150105.222217,2818,2,137092,0,2817,411,2818,285,1
20150105.222221,2817,2,137094,0,2817,323,2818,283,0
20150105.222224,2818,4,137098,0,2817,331,2818,279,1
20150105.222225,2818,6,137104,-6,2817,331,2818,276,1
20150105.222226,2817,16,137120,0,2817,323,2818,277,0
20150105.222235,2818,6,137126,-6,2817,372,2818,290,1
20150105.222238,2817,4,137130,-2,2817,367,2818,287,0
20150105.222244,2818,6,137136,0,2817,372,2818,539,1
20150105.222248,2818,2,137138,0,2817,351,2818,530,1
20150105.22225,2817,2,137140,0,2817,350,2818,490,0
20150105.222251,2818,6,137146,0,2817,350,2818,448,1
20150105.222252,2818,4,137150,-4,2817,350,2818,446,1
20150105.222253,2818,2,137152,0,2817,350,2818,445,1
20150105.222254,2817,4,137156,-4,2817,377,2818,445,0
20150105.222259,2818,2,137158,0,2817,411,2818,441,1
20150105.222302,2817,2,137160,0,2817,410,2818,455,0
20150105.222307,2818,60,137220,4,2817,412,2818,432,1
20150105.222312,2817,4,137224,2,2817,447,2818,430,0
20150105.222312,2817,2,137226,2,2817,446,2818,430,0
20150105.222319,2817,2,137228,0,2817,454,2818,435,0
20150105.222326,2817,2,137230,0,2817,445,2818,364,0
20150105.222343,2818,2,137232,-2,2817,473,2818,577,1
20150105.222401,2818,16,137248,-16,2817,497,2818,691,1
20150105.222406,2817,8,137256,-2,2817,493,2818,695,0
20150105.222409,2818,36,137292,-36,2817,493,2818,677,1
20150105.222413,2818,2,137294,0,2817,493,2818,679,1
20150105.222416,2818,6,137300,-6,2817,493,2818,677,1
20150105.222419,2817,4,137304,2,2817,491,2818,677,0
20150105.222421,2818,2,137306,-2,2817,491,2818,676,1
20150105.222425,2817,4,137310,2,2817,489,2818,681,0
20150105.222433,2818,4,137314,-4,2817,488,2818,677,1
20150105.222434,2817,2,137316,2,2817,488,2818,677,0
20150105.222438,2817,22,137338,0,2817,477,2818,680,0
20150105.222438,2817,6,137344,0,2817,474,2818,680,0
20150105.222439,2817,950,138294,-262,2816,293,2817,36,0
20150105.22244,2817,2,138296,0,2816,291,2817,35,0
20150105.222444,2816,2,138298,0,2816,290,2817,178,0
20150105.222446,2816,2,138300,0,2816,284,2817,280,0
20150105.222447,2816,10,138310,0,2816,279,2817,281,0
20150105.22245,2816,2,138312,2,2816,257,2817,293,0
20150105.222455,2817,12,138324,0,2816,240,2817,450,1
20150105.222455,2816,10,138334,10,2816,235,2817,450,0
20150105.222456,2816,32,138366,-30,2816,234,2817,385,0
20150105.222457,2817,2,138368,0,2816,242,2817,384,1
20150105.2225,2816,2,138370,2,2816,242,2817,417,0
20150105.2225,2817,4,138374,-2,2816,192,2817,415,1
20150105.222503,2816,2,138376,0,2816,191,2817,430,0
20150105.222506,2816,8,138384,0,2816,313,2817,440,0
20150105.22251,2817,2,138386,0,2816,387,2817,464,1
20150105.222511,2816,4,138390,2,2816,385,2817,464,0
20150105.222515,2816,2,138392,2,2816,386,2817,469,0
20150105.222518,2816,16,138408,12,2816,393,2817,469,0
20150105.222528,2816,20,138428,-6,2816,389,2817,430,0
20150105.22254,2817,10,138438,6,2816,387,2817,435,1
20150105.222541,2817,2,138440,0,2816,392,2817,432,1
20150105.222542,2816,2,138442,0,2816,393,2817,433,0
20150105.222554,2816,2,138444,0,2816,358,2817,400,0
20150105.222555,2816,20,138464,-4,2816,346,2817,400,0
20150105.222559,2816,2,138466,2,2816,408,2817,403,0
20150105.22262,2816,20,138486,-2,2816,407,2817,408,0
20150105.222621,2817,24,138510,-24,2816,407,2817,396,1
20150105.222624,2817,44,138554,0,2816,408,2817,374,1
20150105.222632,2817,28,138582,-16,2816,419,2817,412,1
20150105.222644,2816,8,138590,8,2816,419,2817,431,0
20150105.222644,2816,40,138630,28,2816,399,2817,431,0
20150105.222658,2817,2,138632,0,2816,407,2817,447,1
20150105.222659,2817,20,138652,-20,2816,407,2817,446,1
20150105.222704,2816,6,138658,0,2816,404,2817,453,0
20150105.222704,2816,6,138664,6,2816,401,2817,453,0
20150105.222707,2817,2,138666,-2,2816,401,2817,452,1
20150105.22271,2816,220,138886,-36,2816,294,2817,452,0
20150105.222711,2816,598,139484,-94,2815,1230,2816,70,0
20150105.222712,2816,4,139488,0,2815,1229,2816,93,0
20150105.222713,2816,186,139674,-186,2816,7,2817,475,0
20150105.222713,2816,38,139712,-16,2815,1230,2816,1,0
20150105.222714,2816,24,139736,0,2816,1,2817,471,0
20150105.222715,2816,30,139766,-4,2816,1,2817,471,0
20150105.222715,2816,2,139768,0,2815,1230,2816,17,0
20150105.222717,2816,6,139774,4,2815,1231,2816,27,0
20150105.222718,2816,6,139780,6,2815,1231,2816,24,0
20150105.222721,2816,24,139804,0,2815,1231,2816,12,0
20150105.222721,2816,8,139812,2,2815,1231,2816,115,0
20150105.222722,2816,2,139814,2,2815,1231,2816,120,0
20150105.222723,2815,10,139824,2,2815,1226,2816,143,0
20150105.222724,2816,24,139848,4,2815,1226,2816,131,1
20150105.222726,2816,2,139850,0,2815,1233,2816,139,1
20150105.222726,2816,2,139852,0,2815,1233,2816,138,1
20150105.22274,2816,2,139854,0,2815,1249,2816,283,1
20150105.222743,2816,2,139856,0,2815,1249,2816,283,1
20150105.222744,2816,2,139858,0,2815,1249,2816,292,1
20150105.222746,2816,10,139868,0,2815,1249,2816,291,1
20150105.22275,2816,20,139888,-20,2815,1252,2816,294,1
20150105.222751,2815,8,139896,-8,2815,1253,2816,294,0
20150105.222756,2816,2,139898,0,2815,1257,2816,294,1
20150105.222757,2816,20,139918,0,2815,1257,2816,284,1
20150105.2228,2816,2,139920,0,2815,1258,2816,283,1
20150105.222802,2815,2,139922,-2,2815,1287,2816,293,0
20150105.222805,2816,12,139934,-8,2815,1289,2816,288,1
20150105.222806,2816,2,139936,-2,2815,1289,2816,287,1
20150105.222808,2816,10,139946,0,2815,1289,2816,293,1
20150105.222809,2816,2,139948,0,2815,1289,2816,298,1
20150105.222812,2816,2,139950,0,2815,1286,2816,298,1
20150105.222813,2816,20,139970,-20,2815,1291,2816,288,1
20150105.222813,2816,90,140060,-90,2815,1291,2816,263,1
20150105.222816,2816,2,140062,0,2815,1292,2816,262,1
20150105.222823,2816,2,140064,0,2815,1300,2816,160,1
20150105.222824,2816,60,140124,6,2815,1305,2816,130,1
20150105.222826,2816,2,140126,-2,2815,1306,2816,131,1
20150105.222827,2815,10,140136,0,2815,1303,2816,131,0
20150105.22283,2816,2,140138,-2,2815,1302,2816,130,1
20150105.222835,2816,8,140146,0,2815,995,2816,156,1
20150105.222835,2815,200,140346,158,2815,895,2816,156,0
20150105.222836,2816,2,140348,0,2815,890,2816,156,1
20150105.222844,2816,2,140350,0,2815,886,2816,164,1
20150105.222847,2815,100,140450,100,2815,822,2816,164,0
20150105.222848,2815,4,140454,0,2815,835,2816,163,0
20150105.222849,2815,2,140456,0,2815,829,2816,173,0
20150105.22285,2815,6,140462,6,2815,826,2816,173,0
20150105.222855,2815,2,140464,2,2815,833,2816,255,0
20150105.222858,2815,2,140466,0,2815,827,2816,287,0
20150105.222859,2815,164,140630,-2,2815,730,2816,220,0
20150105.222859,2815,128,140758,100,2815,670,2816,216,0
20150105.2229,2815,44,140802,30,2815,684,2816,181,0
20150105.222901,2816,10,140812,10,2815,673,2816,177,1
20150105.222901,2815,2,140814,0,2815,671,2816,177,0
20150105.222904,2816,2,140816,2,2815,671,2816,155,1
20150105.222905,2816,120,140936,26,2815,681,2816,95,1
20150105.222909,2816,2,140938,0,2815,672,2816,106,1
20150105.222909,2816,52,140990,-16,2815,681,2816,81,1
20150105.222911,2816,2,140992,2,2815,682,2816,81,1
20150105.222912,2816,6,140998,6,2815,681,2816,78,1
20150105.222913,2815,2,141000,0,2815,679,2816,78,0
20150105.222914,2816,4,141004,4,2815,681,2816,76,1
20150105.222916,2815,2,141006,0,2815,680,2816,75,0
20150105.222919,2816,4,141010,4,2815,657,2816,169,1
20150105.222924,2815,10,141020,10,2815,669,2816,175,0
20150105.222926,2816,356,141376,-254,2816,822,2817,312,1
20150105.222926,2816,40,141416,-40,2816,811,2817,259,1
20150105.222927,2816,2,141418,0,2816,811,2817,259,1
20150105.222932,2817,10,141428,-10,2816,811,2817,196,1
20150105.222934,2816,2,141430,0,2816,855,2817,197,0
20150105.222938,2817,2,141432,0,2816,881,2817,196,1
20150105.22294,2817,2,141434,0,2816,881,2817,167,1
20150105.222941,2816,2,141436,0,2816,895,2817,188,0
20150105.223,2817,4,141440,0,2816,889,2817,241,1
20150105.223001,2817,2,141442,0,2816,889,2817,240,1
20150105.223001,2816,16,141458,-14,2816,892,2817,234,0
20150105.223002,2817,12,141470,0,2816,892,2817,228,1
20150105.223003,2816,10,141480,-10,2816,902,2817,213,0
20150105.223003,2816,202,141682,0,2816,801,2817,215,0
20150105.223004,2815,1824,143506,146,2815,544,2816,215,0
20150105.223004,2815,448,143954,126,2815,305,2816,250,0
20150105.223005,2815,440,144394,282,2815,85,2816,407,0
20150105.223005,2815,128,144522,0,2815,21,2816,408,0
20150105.223006,2815,42,144564,20,2814,935,2816,408,0
20150105.223007,2815,2,144566,0,2815,5,2816,432,0
20150105.223007,2815,6,144572,2,2815,13,2816,412,0
20150105.223008,2815,32,144604,-8,2815,28,2816,417,0
20150105.223009,2815,2,144606,0,2815,31,2816,417,0
20150105.22301,2815,2,144608,0,2815,30,2816,417,0
20150105.223011,2816,2,144610,2,2815,36,2816,245,1
20150105.223013,2815,2,144612,0,2815,38,2816,245,0
20150105.223015,2815,10,144622,0,2815,185,2816,246,0
20150105.223017,2816,2,144624,2,2815,187,2816,243,1
20150105.223019,2815,2,144626,-2,2815,189,2816,260,0
20150105.223025,2815,2,144628,0,2815,226,2816,285,0
20150105.223026,2815,74,144702,4,2815,188,2816,285,0
20150105.223027,2815,14,144716,-8,2815,183,2816,290,0
20150105.223028,2815,2,144718,-2,2815,184,2816,290,0
20150105.223032,2815,100,144818,0,2815,133,2816,291,0
20150105.223033,2816,4,144822,0,2815,132,2816,290,1
20150105.223036,2815,2,144824,0,2815,143,2816,295,0
20150105.223037,2815,2,144826,0,2815,143,2816,296,0
20150105.223037,2815,2,144828,-2,2815,142,2816,297,0
20150105.223038,2815,2,144830,-2,2815,141,2816,297,0
20150105.223039,2815,2,144832,0,2815,140,2816,303,0
20150105.223042,2815,2,144834,-2,2815,143,2816,304,0
20150105.223043,2815,2,144836,0,2815,142,2816,310,0
20150105.223047,2815,10,144846,-10,2815,160,2816,321,0
20150105.223048,2815,2,144848,-2,2815,159,2816,321,0
20150105.223049,2815,4,144852,0,2815,158,2816,321,0
20150105.223049,2816,702,145554,656,2816,651,2817,277,1
20150105.223049,2816,2,145556,0,2816,667,2817,238,1
20150105.22305,2817,40,145596,0,2816,14,2817,233,1
20150105.223051,2816,2,145598,2,2816,15,2817,246,0
20150105.223051,2817,4,145602,0,2816,52,2817,244,1
20150105.223053,2816,2,145604,2,2816,67,2817,252,0
20150105.223055,2816,6,145610,-4,2816,93,2817,257,0
20150105.223056,2817,2,145612,-2,2816,93,2817,256,1
20150105.223101,2817,42,145654,-42,2816,107,2817,250,1
20150105.223102,2816,2,145656,0,2816,106,2817,251,0
20150105.223103,2817,6,145662,0,2816,126,2817,233,1
20150105.223105,2817,2,145664,0,2816,100,2817,249,1
20150105.223105,2816,198,145862,-74,2815,225,2816,265,0
20150105.223106,2816,326,146188,0,2815,201,2816,102,0
20150105.223107,2815,18,146206,-2,2815,212,2816,27,0
20150105.223108,2816,4,146210,-4,2815,237,2816,34,1
20150105.22311,2816,20,146230,0,2815,239,2816,29,1
20150105.223112,2816,10,146240,0,2815,250,2816,34,1
20150105.223113,2816,2,146242,0,2815,269,2816,63,1
20150105.223114,2816,2,146244,0,2815,258,2816,62,1
20150105.223114,2816,2,146246,0,2815,258,2816,62,1
20150105.223115,2816,2,146248,0,2815,290,2816,63,1
20150105.223118,2816,2,146250,0,2815,313,2816,67,1
20150105.223119,2816,6,146256,0,2815,311,2816,66,1
20150105.223119,2816,2,146258,0,2815,312,2816,65,1
20150105.22312,2816,2,146260,0,2815,313,2816,64,1
20150105.223121,2816,8,146268,0,2815,332,2816,65,1
20150105.223122,2816,2,146270,0,2815,335,2816,64,1
20150105.223122,2816,4,146274,0,2815,335,2816,62,1
20150105.223123,2816,6,146280,0,2815,335,2816,59,1
20150105.223124,2816,4,146284,0,2815,335,2816,58,1
20150105.223124,2816,6,146290,0,2815,335,2816,58,1
20150105.223126,2816,4,146294,-2,2815,335,2816,55,1
20150105.223126,2816,2,146296,2,2815,435,2816,54,1
20150105.223127,2816,2,146298,2,2815,395,2816,92,1
20150105.223128,2816,18,146316,16,2815,395,2816,100,1
20150105.223128,2815,182,146498,-6,2815,290,2816,118,0
20150105.223129,2815,610,147108,490,2814,1020,2815,695,0
20150105.22313,2815,104,147212,0,2814,823,2815,697,0
20150105.223131,2815,10,147222,6,2814,837,2815,52,0
20150105.223131,2815,22,147244,22,2814,830,2815,68,0
20150105.223132,2815,2,147246,2,2814,837,2815,67,0
20150105.223132,2815,10,147256,10,2814,837,2815,151,0
20150105.223133,2815,8,147264,8,2814,837,2815,198,0
20150105.223133,2815,6,147270,0,2814,836,2815,196,0
20150105.223134,2814,30,147300,-26,2814,821,2815,196,0
20150105.223134,2814,6,147306,-4,2814,818,2815,196,0
20150105.223135,2814,56,147362,-54,2814,800,2815,197,0
20150105.223135,2815,2,147364,2,2814,799,2815,196,1
20150105.223136,2814,4,147368,0,2814,797,2815,196,0
20150105.223136,2814,2,147370,0,2814,796,2815,196,0
20150105.223137,2814,20,147390,0,2814,746,2815,196,0
20150105.223137,2815,394,147784,-44,2815,819,2816,199,1
20150105.223138,2816,24,147808,0,2815,808,2816,174,1
20150105.223139,2815,4,147812,-2,2815,806,2816,165,0
20150105.22314,2815,4,147816,0,2815,804,2816,166,0
20150105.22314,2815,2,147818,-2,2815,803,2816,166,0
20150105.223141,2815,2,147820,0,2815,803,2816,187,0
20150105.223142,2815,2,147822,0,2815,787,2816,202,0
20150105.223142,2815,50,147872,0,2815,762,2816,202,0
20150105.223143,2815,40,147912,-40,2815,742,2816,202,0
20150105.223144,2815,42,147954,0,2815,723,2816,207,0
20150105.223145,2815,90,148044,-74,2815,693,2816,196,0
20150105.223146,2815,424,148468,-424,2815,466,2816,219,0
20150105.223147,2815,20,148488,-20,2815,471,2816,205,0
20150105.223148,2815,52,148540,-4,2815,445,2816,205,0
20150105.223148,2815,920,149460,38,2814,711,2815,10,0
20150105.223148,2814,22,149482,-20,2814,700,2815,12,0
20150105.223149,2814,22,149504,0,2814,689,2815,41,0
20150105.22315,2815,48,149552,28,2814,672,2815,34,1
20150105.223151,2814,402,149954,-124,2814,471,2815,61,0
20150105.223151,2814,2,149956,-2,2814,471,2815,61,0
20150105.223152,2814,428,150384,326,2814,257,2815,53,0
20150105.223153,2815,20,150404,20,2814,273,2815,44,1
20150105.223153,2815,2,150406,2,2814,273,2815,43,1
20150105.223154,2814,2,150408,2,2814,259,2815,167,0
20150105.223155,2814,522,150930,392,2813,331,2814,16,0
20150105.223155,2813,22,150952,-2,2813,346,2815,218,0
20150105.223156,2813,122,151074,-14,2813,272,2814,26,0
20150105.223156,2813,40,151114,4,2813,267,2814,21,0
20150105.223157,2813,256,151370,200,2813,125,2814,26,0
20150105.223157,2814,22,151392,0,2813,125,2814,17,1
20150105.223158,2813,280,151672,212,2812,197,2813,17,0
20150105.223158,2813,44,151716,2,2812,212,2813,21,0
20150105.223159,2813,20,151736,0,2812,237,2813,11,0
20150105.2232,2813,62,151798,2,2813,10,2814,46,0
20150105.2232,2813,2,151800,2,2813,30,2814,57,0
20150105.2232,2814,62,151862,46,2813,48,2814,46,1
20150105.223201,2813,32,151894,24,2813,86,2814,42,0
20150105.223202,2812,272,152166,100,2812,224,2813,6,0
20150105.223202,2812,152,152318,-36,2812,179,2813,12,0
20150105.223202,2812,50,152368,12,2812,157,2814,120,0
20150105.223203,2812,60,152428,-48,2812,127,2813,15,0
20150105.223203,2813,30,152458,8,2813,12,2814,161,1
20150105.223204,2813,12,152470,12,2813,8,2814,162,1
20150105.223204,2813,36,152506,20,2812,154,2814,152,1
20150105.223205,2813,30,152536,-10,2812,144,2814,152,1
20150105.223206,2812,44,152580,4,2812,148,2813,1,0
20150105.223206,2813,2,152582,0,2812,149,2814,153,1
20150105.223207,2812,46,152628,10,2812,150,2814,147,0
20150105.223207,2812,2,152630,2,2812,156,2813,3,0
20150105.223207,2813,6,152636,4,2813,3,2814,149,1
20150105.223208,2812,18,152654,12,2812,151,2813,4,0
20150105.223209,2813,14,152668,0,2812,149,2813,3,1
20150105.223209,2813,16,152684,6,2813,5,2814,151,1
20150105.22321,2813,10,152694,8,2812,147,2813,6,1
20150105.22321,2813,12,152706,-2,2812,244,2813,6,1
20150105.223211,2813,12,152718,0,2812,248,2814,162,1
20150105.223211,2813,2,152720,2,2813,20,2814,162,1
20150105.223212,2813,2,152722,0,2813,27,2814,187,1
20150105.223212,2813,14,152736,6,2813,23,2814,187,1
20150105.223213,2813,8,152744,2,2813,69,2814,178,1
20150105.223213,2813,32,152776,-4,2813,53,2814,178,1
20150105.223214,2813,118,152894,-116,2812,144,2813,193,1
20150105.223214,2813,44,152938,-40,2812,137,2813,183,1
20150105.223215,2812,2,152940,-2,2812,147,2813,188,0
20150105.223215,2813,10,152950,0,2812,154,2813,183,1
20150105.223216,2812,56,153006,-54,2812,152,2813,158,0
20150105.223217,2813,38,153044,-28,2812,149,2813,197,1
20150105.223217,2813,4,153048,0,2812,150,2813,195,1
20150105.223217,2813,52,153100,0,2812,140,2813,189,1
20150105.223218,2812,2,153102,0,2812,140,2813,189,0
20150105.223218,2813,4,153106,0,2812,149,2813,196,1
20150105.223219,2812,20,153126,0,2812,141,2813,75,0
20150105.22322,2813,250,153376,-108,2812,18,2813,74,1
20150105.223221,2812,64,153440,34,2811,328,2812,265,0
20150105.223222,2812,4,153444,4,2811,334,2812,263,0
20150105.223222,2812,12,153456,-8,2811,339,2812,264,0
20150105.223223,2811,4,153460,0,2811,342,2812,267,0
20150105.223223,2812,14,153474,8,2811,339,2812,263,1
20150105.223224,2811,70,153544,-44,2811,308,2812,259,0
20150105.223224,2812,8,153552,6,2811,306,2812,257,1
20150105.223225,2812,34,153586,14,2811,314,2812,251,1
20150105.223225,2811,48,153634,2,2811,301,2812,241,0
20150105.223226,2811,4,153638,4,2811,299,2812,242,0
20150105.223226,2812,24,153662,4,2811,283,2812,248,1
20150105.223227,2812,14,153676,2,2811,290,2812,243,1
20150105.223228,2811,6,153682,6,2811,287,2812,243,0
20150105.223228,2812,516,154198,-118,2812,743,2813,106,1
20150105.223229,2812,24,154222,0,2812,733,2813,94,1
20150105.223229,2813,2,154224,0,2812,749,2813,93,1
20150105.22323,2812,4,154228,-2,2812,13,2813,109,0
20150105.22323,2812,50,154278,-10,2811,367,2813,126,0
20150105.223231,2812,16,154294,-14,2811,367,2813,129,0
20150105.223232,2813,6,154300,6,2811,382,2813,138,1
20150105.223232,2812,8,154308,2,2811,390,2812,1,0
20150105.223233,2811,8,154316,0,2811,388,2813,179,0
20150105.223234,2812,2,154318,2,2811,379,2812,6,1
20150105.223234,2812,16,154334,6,2811,368,2813,186,1
20150105.223235,2811,2,154336,0,2812,14,2813,191,0
20150105.223235,2812,28,154364,-2,2812,2,2813,192,1
20150105.223236,2812,2,154366,2,2812,92,2813,193,1
20150105.223236,2812,12,154378,-6,2812,96,2813,199,1
20150105.223237,2812,2,154380,0,2812,105,2813,209,1
20150105.223237,2812,10,154390,-2,2812,108,2813,209,1
20150105.223239,2812,8,154398,0,2812,107,2813,208,1
20150105.22324,2812,4,154402,-2,2812,102,2813,186,1
20150105.22324,2812,6,154408,0,2812,102,2813,185,1
20150105.223241,2812,22,154430,-22,2812,242,2813,185,1
20150105.223242,2812,20,154450,-20,2812,234,2813,155,1
20150105.223242,2813,20,154470,18,2812,249,2813,137,1
20150105.223243,2813,304,154774,-122,2813,849,2814,129,1
20150105.223243,2813,76,154850,-2,2813,811,2814,121,1
20150105.223244,2813,50,154900,-50,2813,801,2814,121,1
20150105.223245,2813,8,154908,-4,2812,262,2813,5,1
20150105.223245,2813,30,154938,-30,2812,261,2813,1,1
20150105.223246,2813,22,154960,0,2812,266,2814,132,1
20150105.223246,2813,2,154962,0,2812,268,2813,1,1
20150105.223247,2813,4,154966,-2,2812,269,2814,134,1
20150105.223248,2813,4,154970,0,2812,269,2813,1,1
20150105.223248,2813,2,154972,0,2812,270,2814,137,1
20150105.223249,2813,2,154974,0,2812,269,2814,137,1
20150105.223249,2814,36,155010,16,2812,270,2813,1,1
20150105.22325,2813,92,155102,30,2812,272,2814,144,0
20150105.22325,2813,2,155104,0,2812,271,2814,153,0
20150105.223251,2814,12,155116,8,2812,271,2814,150,1
20150105.223251,2812,42,155158,-2,2812,285,2814,152,0
20150105.223252,2813,28,155186,-6,2812,301,2814,159,1
20150105.223253,2814,28,155214,28,2813,15,2814,145,1
20150105.223254,2813,2,155216,-2,2813,14,2814,144,0
20150105.223254,2813,6,155222,6,2813,36,2814,142,0
20150105.223255,2813,12,155234,12,2813,30,2814,142,0
20150105.223255,2813,42,155276,40,2813,9,2814,143,0
20150105.223256,2813,6,155282,6,2813,33,2814,195,0
20150105.223257,2813,70,155352,12,2812,316,2813,3,0
20150105.223257,2814,12,155364,10,2813,7,2814,195,1
20150105.223258,2813,2,155366,-2,2813,9,2814,195,0
20150105.223258,2813,4,155370,2,2813,13,2814,195,0
20150105.223259,2813,8,155378,4,2813,11,2814,197,0
20150105.2233,2814,2,155380,0,2813,26,2814,225,1
20150105.223301,2813,4,155384,2,2813,36,2814,229,0
20150105.223303,2813,20,155404,16,2813,73,2814,226,0
20150105.223303,2813,2,155406,0,2813,77,2814,226,0
20150105.223305,2814,386,155792,-178,2814,622,2815,191,1
20150105.223305,2814,26,155818,-4,2814,609,2815,191,1
20150105.223306,2813,204,156022,10,2813,249,2814,4,0
20150105.223307,2814,30,156052,-8,2813,250,2815,175,1
20150105.22331,2814,2,156054,-2,2814,43,2815,199,1
20150105.223311,2814,8,156062,8,2814,40,2815,199,1
20150105.223312,2814,4,156066,4,2814,58,2815,200,1
20150105.223313,2814,2,156068,0,2814,59,2815,204,1
20150105.223313,2814,18,156086,6,2814,51,2815,204,1
20150105.223314,2815,514,156600,-160,2815,44,2816,257,1
20150105.223314,2815,4,156604,-2,2815,79,2816,208,1
20150105.223315,2815,70,156674,-12,2815,49,2816,177,1
20150105.223316,2815,2,156676,-2,2815,48,2816,177,1
20150105.223316,2815,18,156694,2,2815,44,2816,111,1
20150105.223317,2815,4,156698,0,2815,42,2816,111,1
20150105.223317,2816,28,156726,2,2815,79,2816,110,1
20150105.223317,2815,4,156730,-2,2815,77,2816,113,0
20150105.223318,2816,8,156738,0,2815,76,2816,110,1
20150105.223319,2815,12,156750,-10,2815,96,2816,117,0
20150105.22332,2815,8,156758,-8,2815,92,2816,117,0
20150105.223322,2815,6,156764,2,2815,102,2816,3149,0
20150105.223323,2815,94,156858,16,2815,92,2816,5113,0
20150105.223323,2815,184,157042,20,2814,165,2815,2,0
20150105.223323,2815,14,157056,6,2815,10,2816,111,0
20150105.223324,2815,22,157078,18,2814,133,2815,3,0
20150105.223325,2815,12,157090,0,2815,553,2816,128,0
20150105.223326,2815,2,157092,-2,2815,553,2816,145,0
20150105.223328,2816,6,157098,-2,2815,561,2816,175,1
20150105.22333,2816,2,157100,0,2815,561,2816,223,1
20150105.22333,2815,2,157102,0,2815,560,2816,225,0
20150105.223331,2816,12,157114,6,2815,559,2816,221,1
20150105.223332,2815,2,157116,-2,2815,582,2816,224,0
20150105.223336,2815,22,157138,0,2815,585,2816,284,0
20150105.223337,2815,60,157198,-34,2815,580,2816,299,0
20150105.223338,2816,2,157200,0,2815,580,2816,300,1
20150105.223339,2815,2,157202,-2,2815,579,2816,302,0
20150105.223339,2816,58,157260,-56,2815,579,2816,275,1
20150105.22334,2816,6,157266,0,2815,577,2816,276,1
20150105.22334,2816,2,157268,0,2815,577,2816,277,1
20150105.223341,2815,2,157270,-2,2815,578,2816,278,0
20150105.223342,2816,26,157296,-20,2815,578,2816,285,1
20150105.223344,2815,2,157298,-2,2815,577,2816,275,0
20150105.223344,2815,6,157304,-4,2815,575,2816,285,0
20150105.223345,2816,16,157320,-2,2815,575,2816,284,1
20150105.223345,2816,4,157324,0,2815,573,2816,287,1
20150105.223347,2815,2,157326,0,2815,572,2816,287,0
20150105.223347,2816,10,157336,-10,2815,557,2816,277,1
20150105.223348,2815,2,157338,0,2815,561,2816,278,0
20150105.223349,2816,32,157370,-14,2815,561,2816,263,1
20150105.223351,2816,26,157396,-26,2815,566,2816,260,1
20150105.223351,2815,4,157400,0,2815,564,2816,262,0
20150105.223358,2815,2,157402,0,2815,585,2816,259,0
20150105.223358,2816,52,157454,-52,2815,570,2816,239,1
20150105.223359,2816,10,157464,2,2815,585,2816,220,1
20150105.2234,2816,512,157976,-200,2816,258,2817,458,1
20150105.2234,2816,6,157982,-2,2816,255,2817,448,1
20150105.223401,2816,2,157984,-2,2816,262,2817,448,1
20150105.223403,2817,10,157994,0,2816,264,2817,444,1
20150105.223404,2816,8,158002,-4,2816,312,2817,445,0
20150105.223404,2816,2,158004,-2,2816,311,2817,448,0
20150105.223404,2816,4,158008,-2,2816,309,2817,448,0
20150105.223405,2816,18,158026,-18,2816,301,2817,448,0
20150105.223406,2816,16,158042,0,2816,304,2817,448,0
20150105.223406,2817,2,158044,-2,2816,306,2817,460,1
20150105.223408,2816,300,158344,0,2816,146,2817,463,0
20150105.223409,2816,2,158346,-2,2816,145,2817,463,0
20150105.223409,2816,42,158388,-40,2816,124,2817,463,0
20150105.22341,2817,2,158390,-2,2816,124,2817,462,1
20150105.22341,2816,28,158418,-26,2816,110,2817,464,0
20150105.22341,2816,36,158454,0,2816,92,2817,464,0
20150105.223411,2816,26,158480,0,2816,80,2817,463,0
20150105.223411,2816,58,158538,2,2816,52,2817,459,0
20150105.223412,2816,10,158548,-6,2816,58,2817,468,0
20150105.223412,2817,2,158550,-2,2816,58,2817,467,1
20150105.223413,2816,4,158554,0,2816,61,2817,467,0
20150105.223413,2816,6,158560,0,2816,65,2817,468,0
20150105.223414,2817,8,158568,-8,2816,63,2817,467,1
20150105.223415,2816,64,158632,-48,2816,42,2817,474,0
20150105.223416,2816,10,158642,2,2816,41,2817,462,0
20150105.223417,2816,2,158644,0,2816,42,2817,461,0
20150105.223417,2816,2,158646,0,2816,41,2817,472,0
20150105.223417,2816,2,158648,0,2816,40,2817,476,0
20150105.223418,2816,4,158652,-4,2816,77,2817,476,0
20150105.223419,2816,6,158658,2,2816,74,2817,477,0
20150105.223419,2816,10,158668,-10,2816,69,2817,478,0
20150105.223421,2816,4,158672,0,2816,72,2817,600,0
20150105.223422,2816,4,158676,-2,2816,70,2817,506,0
20150105.223424,2816,2,158678,0,2816,66,2817,501,0
20150105.223425,2816,8,158686,-4,2816,65,2817,498,0
20150105.223425,2816,6,158692,0,2816,62,2817,504,0
20150105.223426,2816,2,158694,0,2816,61,2817,503,0
20150105.223427,2816,4,158698,-4,2816,59,2817,507,0
20150105.223427,2816,2,158700,-2,2816,58,2817,508,0
20150105.223428,2816,42,158742,-22,2816,38,2817,512,0
20150105.223429,2817,2,158744,-2,2816,94,2817,522,1
20150105.22343,2816,2,158746,0,2816,94,2817,527,0
20150105.223431,2817,4,158750,0,2816,243,2817,524,1
20150105.223436,2816,2,158752,0,2816,242,2817,528,0
20150105.223436,2816,6,158758,-6,2816,240,2817,530,0
20150105.223437,2817,2,158760,0,2816,240,2817,529,1
20150105.22344,2816,4,158764,2,2816,255,2817,507,0
20150105.223444,2817,20,158784,-18,2816,246,2817,534,1
20150105.223445,2817,20,158804,-20,2816,262,2817,509,1
20150105.223445,2817,1018,159822,112,2817,502,2818,1270,1
20150105.223447,2817,4,159826,0,2817,79,2818,1270,1
20150105.223448,2817,2,159828,0,2817,88,2818,1271,1
20150105.223449,2817,14,159842,-12,2817,86,2818,1272,1
20150105.22345,2817,8,159850,-8,2817,82,2818,1273,1
20150105.22345,2818,2,159852,0,2817,83,2818,1272,1
20150105.223451,2818,26,159878,-6,2817,83,2818,1245,1
20150105.223451,2818,14,159892,0,2817,88,2818,1253,1
20150105.223452,2818,262,160154,0,2817,116,2818,1105,1
20150105.223453,2817,8,160162,-2,2817,125,2818,1122,0
20150105.223455,2818,48,160210,20,2817,290,2818,1086,1
20150105.223455,2817,2014,162224,460,2817,304,2819,667,0
20150105.223456,2819,40,162264,0,2818,3,2819,647,1
20150105.223457,2819,76,162340,-66,2818,24,2819,642,1
20150105.223457,2819,16,162356,-14,2818,75,2819,632,1
20150105.223457,2819,4,162360,-4,2818,75,2819,629,1
20150105.223458,2819,124,162484,-112,2818,188,2819,568,1
20150105.223459,2819,24,162508,-14,2818,195,2819,545,1
20150105.223459,2818,4,162512,0,2818,195,2819,544,0
20150105.223459,2819,2,162514,0,2818,195,2819,543,1
20150105.2235,2819,106,162620,-100,2818,212,2819,475,1
20150105.223501,2819,18,162638,-12,2818,199,2819,466,1
20150105.223501,2818,6,162644,0,2818,198,2819,464,0
20150105.223502,2818,518,163162,-94,2818,129,2819,227,0
20150105.223502,2819,4,163166,2,2818,129,2819,226,1
20150105.223502,2819,6,163172,-2,2818,128,2819,222,1
20150105.223503,2819,6,163178,4,2818,129,2819,249,1
20150105.223504,2819,34,163212,-28,2818,154,2819,231,1
20150105.223504,2819,18,163230,-14,2818,153,2819,201,1
20150105.223505,2819,62,163292,-20,2818,137,2819,388,1
20150105.223505,2819,22,163314,4,2818,144,2819,403,1
20150105.223506,2819,24,163338,0,2818,190,2819,404,1
20150105.223506,2819,136,163474,-30,2818,150,2819,389,1
20150105.223507,2819,28,163502,-12,2818,150,2819,397,1
20150105.223508,2818,44,163546,-42,2818,130,2819,523,0
20150105.223509,2819,18,163564,-2,2818,130,2819,527,1
20150105.223509,2819,4,163568,0,2818,130,2819,655,1
20150105.223509,2818,258,163826,-134,2817,77,2819,697,0
20150105.22351,2819,2,163828,0,2817,62,2818,15,1
20150105.223511,2818,2,163830,2,2817,213,2818,59,0
20150105.223512,2817,20,163850,-16,2817,204,2818,98,0
20150105.223512,2818,32,163882,2,2817,206,2818,85,1
20150105.223513,2818,10,163892,0,2817,206,2818,81,1
20150105.223513,2818,26,163918,-6,2817,206,2818,69,1
20150105.223514,2818,54,163972,-12,2817,206,2818,45,1
20150105.223514,2818,92,164064,4,2818,20,2819,718,1
20150105.223514,2818,8,164072,0,2818,31,2819,720,1
20150105.223515,2819,10,164082,2,2818,31,2819,737,1
20150105.223516,2818,4,164086,0,2818,148,2819,738,0
20150105.223516,2818,10,164096,8,2818,153,2819,698,0
20150105.223517,2819,22,164118,-4,2818,154,2819,689,1
20150105.223518,2818,2,164120,-2,2818,158,2819,698,0
20150105.223518,2818,2,164122,0,2818,160,2819,700,0
20150105.223519,2818,20,164142,10,2818,154,2819,702,0
20150105.223519,2818,10,164152,8,2818,140,2819,701,0
20150105.22352,2819,238,164390,-206,2818,142,2819,582,1
20150105.223521,2819,2,164392,0,2818,145,2819,579,1
20150105.223521,2818,10,164402,10,2818,142,2819,580,0
20150105.223522,2819,4,164406,0,2818,141,2819,580,1
20150105.223522,2819,4,164410,0,2818,141,2819,579,1
20150105.223523,2819,74,164484,0,2818,158,2819,543,1
20150105.223523,2819,2,164486,0,2818,158,2819,540,1
20150105.223524,2818,12,164498,-10,2818,153,2819,540,0
20150105.223525,2819,100,164598,0,2818,154,2819,500,1
20150105.223525,2818,2,164600,-2,2818,158,2819,641,0
20150105.223526,2819,4,164604,-4,2818,173,2819,642,1
20150105.223527,2818,246,164850,-144,2818,170,2819,524,0
20150105.223527,2819,242,165092,-220,2818,169,2819,408,1
20150105.223528,2818,124,165216,-4,2818,110,2819,361,0
20150105.223529,2818,10,165226,0,2818,94,2819,415,0
20150105.223529,2819,4,165230,-2,2818,101,2819,403,1
20150105.22353,2819,50,165280,-28,2818,105,2819,479,1
20150105.223531,2818,8,165288,-8,2818,102,2819,480,0
20150105.223531,2819,2,165290,2,2818,105,2819,479,1
20150105.223532,2819,4,165294,2,2818,104,2819,479,1
20150105.223534,2818,2,165296,0,2818,107,2819,483,0
20150105.223535,2818,226,165522,144,2817,241,2818,57,0
20150105.223536,2818,10,165532,10,2817,241,2818,53,0
20150105.223537,2818,6,165538,4,2817,240,2818,52,0
20150105.223537,2818,32,165570,32,2817,241,2818,37,0
20150105.223538,2818,2,165572,2,2817,241,2818,36,0
20150105.223538,2818,72,165644,68,2818,1,2819,493,0
20150105.223539,2818,46,165690,44,2817,241,2819,498,0
20150105.223539,2818,22,165712,0,2817,241,2818,10,0
20150105.22354,2818,20,165732,18,2817,241,2819,604,0
20150105.22354,2818,2,165734,0,2818,10,2819,607,0
20150105.223541,2818,20,165754,20,2818,22,2819,646,0
20150105.223541,2818,58,165812,-4,2817,219,2819,641,0
20150105.223542,2818,32,165844,28,2817,220,2818,727,0
20150105.223542,2817,4,165848,0,2817,217,2818,743,0
20150105.223543,2817,20,165868,-14,2817,207,2818,743,0
20150105.223544,2817,420,166288,-346,2816,403,2817,791,0
20150105.223545,2817,124,166412,0,2816,382,2817,746,0
20150105.223545,2816,602,167014,382,2816,81,2817,17,0
20150105.223546,2816,2,167016,-2,2816,122,2817,2,0
20150105.223546,2817,6,167022,-6,2817,48,2818,789,1
20150105.223547,2817,2,167024,-2,2817,62,2818,792,1
20150105.223548,2817,2,167026,-2,2817,63,2818,764,1
20150105.223549,2817,2,167028,-2,2817,72,2818,766,1
20150105.22355,2818,2,167030,-2,2817,85,2818,750,1
20150105.223551,2818,2,167032,0,2817,106,2818,753,1
20150105.223552,2818,2,167034,0,2817,93,2818,768,1
20150105.223552,2817,2,167036,0,2817,119,2818,768,0
20150105.223553,2818,4,167040,0,2817,123,2818,765,1
20150105.223554,2817,60,167100,-4,2817,102,2818,763,0
20150105.223555,2817,2,167102,0,2817,102,2818,752,0
20150105.223555,2818,6,167108,0,2817,98,2818,765,1
20150105.223557,2817,2,167110,0,2817,148,2818,773,0
20150105.223558,2817,4,167114,-2,2817,200,2818,773,0
20150105.223558,2818,6,167120,-2,2817,198,2818,772,1
20150105.2236,2817,252,167372,-110,2817,75,2818,759,0
20150105.223601,2818,116,167488,-44,2817,20,2818,757,1
20150105.223601,2817,10,167498,0,2817,15,2818,772,0
20150105.223603,2818,20,167518,-20,2817,17,2818,764,1
20150105.223604,2817,2,167520,2,2817,21,2818,764,0
20150105.223604,2817,2,167522,2,2817,20,2818,765,0
20150105.223605,2817,10,167532,10,2817,38,2818,802,0
20150105.223606,2817,2,167534,2,2817,48,2818,913,0
20150105.223607,2817,2,167536,2,2817,51,2818,913,0
20150105.223607,2817,2,167538,0,2817,50,2818,913,0
20150105.223608,2817,2,167540,0,2817,50,2818,917,0
20150105.223609,2818,10,167550,0,2817,103,2818,912,1
20150105.22361,2818,10,167560,0,2817,105,2818,907,1
20150105.22361,2817,44,167604,4,2817,103,2818,917,0
20150105.223611,2818,422,168026,-202,2817,204,2818,692,1
20150105.223612,2818,4,168030,0,2817,263,2818,692,1
20150105.223613,2818,14,168044,-12,2817,269,2818,685,1
20150105.223613,2818,12,168056,0,2817,266,2818,694,1
20150105.223614,2818,2,168058,-2,2817,275,2818,693,1
20150105.223614,2818,202,168260,-202,2817,288,2818,577,1
20150105.223615,2818,690,168950,-400,2817,303,2818,232,1
20150105.223615,2818,42,168992,34,2817,313,2818,211,1
20150105.223616,2818,48,169040,6,2817,273,2818,203,1
20150105.223616,2818,366,169406,-158,2817,289,2818,8,1
20150105.223617,2818,16,169422,-8,2818,21,2819,611,1
20150105.223617,2819,20,169442,6,2818,27,2819,593,1
20150105.223618,2819,4,169446,-2,2818,27,2819,590,1
20150105.223618,2819,4,169450,-4,2818,52,2819,588,1
20150105.22362,2818,6,169456,-2,2818,206,2819,582,0
20150105.223621,2819,6,169462,-2,2818,219,2819,551,1
20150105.223622,2819,1102,170564,586,2819,450,2820,2054,1
20150105.223622,2818,4,170568,-2,2819,1,2820,1998,0
20150105.223623,2819,62,170630,-18,2818,191,2819,9,1
20150105.223623,2819,26,170656,20,2819,45,2820,2082,1
20150105.223624,2819,92,170748,0,2819,40,2820,2041,1
20150105.223625,2819,4,170752,-2,2819,91,2820,2040,1
20150105.223626,2819,6,170758,2,2819,91,2820,2191,1
20150105.223627,2819,4,170762,2,2819,89,2820,2189,1
20150105.223627,2819,42,170804,40,2819,74,2820,2190,1
20150105.223628,2819,8,170812,2,2819,73,2820,2190,1
20150105.223628,2819,2,170814,0,2819,72,2820,2189,1
20150105.223629,2819,144,170958,-20,2818,265,2819,928,1
20150105.223629,2819,60,171018,-20,2818,231,2819,917,1
20150105.22363,2819,20,171038,0,2818,231,2819,1139,1
20150105.223632,2819,402,171440,-344,2818,221,2819,112,1
20150105.223633,2819,122,171562,0,2818,248,2819,24,1
20150105.223633,2819,32,171594,0,2818,298,2819,39,1
20150105.223634,2819,44,171638,28,2818,298,2819,23,1
20150105.223634,2819,12,171650,12,2818,300,2819,27,1
20150105.223635,2819,14,171664,14,2818,297,2819,28,1
20150105.223635,2819,2,171666,2,2818,307,2819,27,1
20150105.223636,2819,4,171670,4,2818,308,2819,33,1
20150105.223637,2819,12,171682,2,2818,333,2819,44,1
20150105.223637,2819,16,171698,0,2818,332,2819,40,1
20150105.223638,2819,6,171704,-2,2818,333,2819,1104,1
20150105.223638,2819,20,171724,-10,2818,334,2819,1097,1
20150105.22364,2819,4,171728,2,2818,329,2819,1204,1
20150105.223641,2819,12,171740,-6,2818,325,2819,1205,1
20150105.223641,2819,2,171742,0,2818,327,2819,1230,1
20150105.223642,2819,6,171748,-2,2818,327,2819,1296,1
20150105.223642,2819,60,171808,-58,2818,327,2819,1266,1
20150105.223642,2818,22,171830,-2,2818,351,2819,1263,0
20150105.223643,2819,20,171850,0,2818,350,2819,1304,1
20150105.223644,2819,2,171852,0,2818,354,2819,1305,1
20150105.223644,2819,2,171854,0,2818,374,2819,1304,1
20150105.223645,2819,2,171856,0,2818,374,2819,1303,1
20150105.223646,2819,2,171858,0,2818,373,2819,1311,1
20150105.223646,2819,2,171860,0,2818,373,2819,1312,1
20150105.223647,2819,2,171862,-2,2818,373,2819,1314,1
20150105.223648,2819,4,171866,0,2818,386,2819,1304,1
20150105.223649,2818,2,171868,2,2818,384,2819,1310,0
20150105.223651,2819,40,171908,-40,2818,371,2819,1304,1
20150105.223651,2819,40,171948,0,2818,371,2819,1275,1
20150105.223652,2818,4,171952,0,2818,371,2819,1285,0
20150105.223654,2819,10,171962,-6,2818,1390,2819,1377,1
20150105.223656,2819,8,171970,-6,2818,1390,2819,394,1
20150105.223656,2819,2,171972,0,2818,1390,2819,393,1
20150105.223657,2819,64,172036,6,2818,1390,2819,363,1
20150105.223657,2819,14,172050,0,2818,1365,2819,186,1
20150105.223658,2819,4,172054,0,2818,1365,2819,184,1
20150105.223658,2819,14,172068,0,2818,1364,2819,178,1
20150105.223659,2819,10,172078,-6,2818,1364,2819,185,1
20150105.223659,2819,20,172098,0,2818,1360,2819,176,1
20150105.2237,2819,6,172104,0,2818,1358,2819,174,1
20150105.2237,2819,2,172106,0,2818,1358,2819,173,1
20150105.223701,2819,146,172252,20,2818,1358,2819,100,1
20150105.223701,2819,22,172274,20,2818,1348,2819,101,1
20150105.223703,2819,18,172292,-8,2818,1348,2819,105,1
20150105.223704,2819,16,172308,0,2818,1348,2819,117,1
20150105.223704,2819,12,172320,0,2818,1348,2819,111,1
20150105.223705,2819,4,172324,-2,2818,1347,2819,136,1
20150105.223706,2819,2,172326,0,2818,1347,2819,142,1
20150105.223706,2819,8,172334,0,2818,1346,2819,148,1
20150105.223706,2819,4,172338,2,2818,1346,2819,149,1
20150105.223707,2819,2,172340,2,2818,1346,2819,150,1
20150105.223708,2819,58,172398,0,2818,1346,2819,121,1
20150105.223708,2819,2,172400,2,2818,1346,2819,122,1
20150105.223709,2819,294,172694,90,2819,877,2820,2060,1
20150105.223709,2819,22,172716,0,2819,36,2820,2042,1
20150105.22371,2820,2,172718,0,2819,80,2820,2091,1
20150105.22371,2820,46,172764,-40,2819,122,2820,2071,1
20150105.223711,2820,58,172822,-58,2819,138,2820,1995,1
20150105.223711,2820,24,172846,-24,2819,180,2820,1985,1
20150105.223713,2820,46,172892,0,2819,243,2820,1983,1
20150105.223714,2819,6,172898,-6,2819,240,2820,1982,0
20150105.223715,2819,6,172904,-6,2819,198,2820,1958,0
20150105.223715,2820,2,172906,0,2819,221,2820,1957,1
20150105.223716,2820,8,172914,-4,2819,230,2820,1866,1
20150105.223716,2820,52,172966,10,2819,245,2820,1847,1
20150105.223717,2820,2,172968,0,2819,231,2820,1955,1
20150105.223718,2819,4,172972,2,2819,230,2820,1945,0
20150105.223718,2819,8,172980,0,2819,233,2820,1950,0
20150105.223719,2820,2,172982,0,2819,233,2820,1949,1
20150105.223719,2820,418,173400,-416,2819,233,2820,1734,1
20150105.22372,2819,6,173406,-4,2819,230,2820,1734,0
20150105.22372,2820,4,173410,0,2819,230,2820,1733,1
20150105.223721,2820,60,173470,-60,2819,299,2820,1703,1
20150105.223721,2820,90,173560,0,2819,318,2820,1649,1
20150105.223722,2820,14,173574,2,2819,318,2820,1643,1
20150105.223722,2820,2,173576,-2,2819,305,2820,1651,1
20150105.223723,2820,6,173582,-2,2819,320,2820,1640,1
20150105.223724,2820,44,173626,-4,2819,306,2820,1628,1
20150105.223724,2820,6,173632,-6,2819,306,2820,1625,1
20150105.223725,2819,4,173636,0,2819,306,2820,1624,0
20150105.223725,2820,2,173638,0,2819,306,2820,1623,1
20150105.223726,2820,410,174048,-400,2819,303,2820,1415,1
20150105.223726,2820,404,174452,36,2819,368,2820,1215,1
20150105.223727,2820,8,174460,0,2819,353,2820,1220,1
20150105.223727,2820,20,174480,10,2819,350,2820,1210,1
20150105.223728,2820,6,174486,6,2819,352,2820,1208,1
20150105.223728,2820,60,174546,-20,2819,313,2820,1179,1
20150105.223729,2820,54,174600,0,2819,319,2820,1142,1
20150105.22373,2820,10,174610,-10,2819,319,2820,1146,1
20150105.22373,2820,2,174612,-2,2819,320,2820,1135,1
20150105.22373,2820,110,174722,30,2819,379,2820,1074,1
20150105.223731,2820,2,174724,2,2819,380,2820,1076,1
20150105.223732,2820,20,174744,10,2819,380,2820,1066,1
20150105.223732,2819,40,174784,22,2819,360,2820,1066,0
20150105.223732,2819,2,174786,-2,2819,346,2820,1126,0
20150105.223733,2820,68,174854,10,2819,449,2820,1093,1
20150105.223733,2820,4,174858,4,2819,449,2820,990,1
20150105.223734,2819,8,174866,2,2819,448,2820,987,0
20150105.223734,2820,126,174992,-12,2819,449,2820,925,1
20150105.223735,2820,82,175074,-2,2819,436,2820,885,1
20150105.223735,2820,2,175076,0,2819,436,2820,885,1
20150105.223736,2820,18,175094,0,2819,437,2820,880,1
20150105.223737,2820,4,175098,-2,2819,456,2820,871,1
20150105.223737,2820,6,175104,-2,2819,441,2820,869,1
20150105.223737,2820,8,175112,-8,2819,441,2820,865,1
20150105.223738,2820,202,175314,-74,2819,345,2820,873,1
20150105.223739,2820,22,175336,2,2819,345,2820,869,1
20150105.22374,2820,2,175338,0,2819,361,2820,862,1
20150105.22374,2820,2,175340,2,2819,361,2820,861,1
20150105.223741,2820,1724,177064,-934,2820,154,2821,638,1
20150105.223741,2820,8,177072,-8,2820,156,2821,638,1
20150105.223742,2820,70,177142,-68,2820,188,2821,634,1
20150105.223742,2821,2,177144,0,2820,181,2821,633,1
20150105.223743,2820,58,177202,-48,2820,185,2821,606,0
20150105.223743,2821,20,177222,-16,2820,196,2821,599,1
20150105.223744,2820,412,177634,-358,2819,420,2820,211,0
20150105.223744,2820,28,177662,-22,2819,422,2820,198,0
20150105.223745,2820,152,177814,-48,2819,414,2820,149,0
20150105.223745,2820,12,177826,-10,2819,415,2820,146,0
20150105.223746,2820,2,177828,0,2819,1415,2820,146,0
20150105.223746,2820,42,177870,-2,2819,4415,2820,130,0
20150105.223747,2820,280,178150,-8,2820,33,2821,660,0
20150105.223748,2820,160,178310,-64,2819,4416,2820,921,0
20150105.223748,2820,230,178540,-40,2819,4412,2820,822,0
20150105.223749,2820,4,178544,0,2819,4412,2820,828,0
20150105.22375,2820,8,178552,0,2819,4412,2820,831,0
20150105.22375,2820,72,178624,-12,2819,4412,2820,795,0
20150105.223751,2820,324,178948,-320,2819,4424,2820,624,0
20150105.223751,2820,16,178964,0,2819,4425,2820,626,0
20150105.223752,2820,8,178972,0,2819,4425,2820,632,0
20150105.223753,2820,6,178978,-2,2819,4440,2820,629,0
20150105.223753,2820,4,178982,0,2819,4440,2820,627,0
20150105.223753,2820,92,179074,-10,2819,4439,2820,603,0
20150105.223754,2820,104,179178,-4,2819,4439,2820,553,0
20150105.223754,2820,4,179182,-2,2819,4439,2820,556,0
20150105.223755,2820,210,179392,-12,2819,4440,2820,451,0
20150105.223755,2820,4,179396,0,2819,4440,2820,449,0
20150105.223756,2820,2,179398,0,2819,4440,2820,448,0
20150105.223756,2820,16,179414,-6,2819,4440,2820,440,0
20150105.223757,2820,106,179520,0,2819,4446,2820,396,0
20150105.223758,2820,40,179560,-20,2819,4446,2820,376,0
20150105.223758,2820,2,179562,0,2819,4433,2820,377,0
20150105.223759,2820,16,179578,0,2819,4433,2820,372,0
20150105.223759,2820,8,179586,0,2819,4433,2820,368,0
20150105.2238,2820,32,179618,-2,2819,4439,2820,352,0
20150105.223801,2820,14,179632,-10,2819,4449,2820,497,0
20150105.223801,2820,30,179662,0,2819,4455,2820,482,0
20150105.223802,2820,4,179666,-2,2819,4455,2820,481,0
20150105.223802,2821,982,180648,-938,2820,536,2821,684,1
20150105.223803,2820,2,180650,-2,2820,535,2821,704,0
20150105.223803,2820,18,180668,-18,2820,567,2821,704,0
20150105.223804,2821,2,180670,-2,2820,570,2821,672,1
20150105.223804,2821,22,180692,-22,2820,581,2821,667,1
20150105.223805,2820,16,180708,-14,2820,565,2821,651,0
20150105.223806,2821,32,180740,-26,2820,654,2821,616,1
20150105.223806,2821,40,180780,0,2820,685,2821,585,1
20150105.223807,2820,4,180784,0,2820,685,2821,593,0
20150105.223807,2820,2,180786,0,2820,686,2821,595,0
20150105.223808,2820,20,180806,-20,2820,687,2821,548,0
20150105.223808,2820,2,180808,-2,2820,693,2821,551,0
20150105.223809,2820,2,180810,-2,2820,712,2821,542,0
20150105.223809,2821,404,181214,240,2820,716,2821,341,1
20150105.22381,2821,2,181216,2,2820,716,2821,337,1
20150105.22381,2821,2,181218,2,2820,719,2821,335,1
20150105.223811,2821,32,181250,-2,2820,720,2821,319,1
20150105.223812,2820,32,181282,0,2820,717,2821,304,0
20150105.223813,2820,4,181286,0,2820,721,2821,312,0
20150105.223814,2821,4,181290,4,2820,749,2821,278,1
20150105.223814,2821,30,181320,4,2820,773,2821,283,1
20150105.223815,2821,16,181336,-10,2820,782,2821,284,1
20150105.223816,2821,22,181358,8,2820,844,2821,376,1
20150105.223816,2820,18,181376,-14,2820,838,2821,377,0
20150105.223817,2821,4,181380,0,2820,838,2821,379,1
20150105.223817,2821,14,181394,0,2820,838,2821,373,1
20150105.223817,2821,50,181444,0,2820,842,2821,348,1
20150105.223819,2821,10,181454,0,2820,848,2821,350,1
20150105.22382,2821,2,181456,0,2820,845,2821,351,1
20150105.22382,2821,18,181474,-18,2820,845,2821,351,1
20150105.223821,2821,200,181674,0,2820,845,2821,252,1
20150105.223821,2821,4,181678,-4,2820,845,2821,252,1
20150105.223822,2821,52,181730,28,2820,847,2821,237,1
20150105.223822,2821,18,181748,0,2820,850,2821,234,1
20150105.223823,2821,42,181790,22,2820,850,2821,213,1
20150105.223823,2821,34,181824,-30,2820,850,2821,199,1
20150105.223824,2821,2,181826,0,2820,850,2821,198,1
20150105.223824,2821,134,181960,-106,2820,799,2821,182,1
20150105.223825,2821,2,181962,-2,2820,799,2821,182,1
20150105.223825,2821,376,182338,232,2821,15,2822,2094,1
20150105.223826,2821,36,182374,0,2821,1,2822,2095,1
20150105.223826,2822,22,182396,-20,2820,821,2822,2084,1
20150105.223827,2822,38,182434,-24,2821,3,2822,2069,1
20150105.223827,2820,50,182484,-38,2820,817,2821,864,0
20150105.223828,2821,20,182504,-18,2820,816,2821,858,1
20150105.223828,2821,20,182524,-14,2820,816,2821,860,1
20150105.223829,2821,116,182640,-4,2820,813,2821,811,1
20150105.22383,2821,14,182654,-2,2820,813,2821,823,1
20150105.223831,2821,12,182666,-4,2820,813,2821,820,1
20150105.223831,2820,2,182668,0,2820,812,2821,820,0
20150105.223832,2821,10,182678,0,2820,812,2821,817,1
20150105.223832,2821,2,182680,0,2820,796,2821,850,1
20150105.223833,2820,24,182704,-4,2820,784,2821,841,0
20150105.223833,2821,30,182734,0,2820,784,2821,826,1
20150105.223834,2821,22,182756,0,2820,798,2821,815,1
20150105.223834,2820,22,182778,0,2820,797,2821,809,0
20150105.223835,2821,2,182780,-2,2820,793,2821,814,1
20150105.223835,2821,8,182788,0,2820,793,2821,911,1
20150105.223836,2820,14,182802,-10,2820,789,2821,913,0
20150105.223836,2821,20,182822,0,2820,789,2821,909,1
20150105.223837,2820,24,182846,-22,2820,790,2821,902,0
20150105.223837,2821,2,182848,0,2820,790,2821,900,1
20150105.223838,2821,20,182868,0,2820,791,2821,890,1
20150105.223838,2821,268,183136,-246,2820,668,2821,944,1
20150105.223839,2821,1844,184980,58,2821,92,2822,2100,1
20150105.22384,2821,40,185020,0,2821,83,2822,2094,1
20150105.22384,2821,2,185022,2,2821,83,2822,2094,1
20150105.22384,2821,166,185188,0,2821,2,2822,2053,1
20150105.223841,2821,16,185204,-6,2820,677,2821,7,1
20150105.223842,2820,44,185248,-4,2820,676,2821,25,0
20150105.223842,2821,8,185256,0,2820,693,2821,22,1
20150105.223843,2821,6,185262,0,2820,695,2821,28,1
20150105.223843,2821,4,185266,-2,2820,698,2821,28,1
20150105.223844,2821,4,185270,0,2820,699,2821,28,1
20150105.223844,2821,224,185494,4,2821,322,2822,2079,1
20150105.223845,2821,14,185508,0,2821,328,2822,2084,1
20150105.223845,2822,22,185530,-2,2821,319,2822,1889,1
20150105.223846,2821,654,186184,232,2820,702,2821,13,0
20150105.223846,2821,2,186186,0,2820,702,2821,112,0
20150105.223847,2821,14,186200,12,2820,702,2821,123,0
20150105.223848,2821,6,186206,6,2820,704,2821,138,0
20150105.223849,2821,28,186234,-6,2820,705,2821,132,0
20150105.223849,2820,2,186236,0,2820,704,2821,144,0
20150105.22385,2821,10,186246,0,2820,705,2821,141,1
20150105.223851,2821,2,186248,0,2820,757,2821,152,1
20150105.223851,2821,40,186288,0,2820,782,2821,141,1
20150105.223852,2821,2,186290,0,2820,783,2821,161,1
20150105.223853,2821,12,186302,0,2820,784,2821,173,1
20150105.223853,2821,20,186322,0,2820,784,2821,165,1
20150105.223854,2821,26,186348,0,2820,784,2821,164,1
20150105.223854,2821,42,186390,-18,2820,785,2821,147,1
20150105.223855,2821,100,186490,-100,2820,785,2821,111,1
20150105.223855,2820,4,186494,-2,2820,784,2821,265,0
20150105.223857,2821,4,186498,4,2820,785,2821,280,1
20150105.223858,2821,22,186520,0,2820,786,2821,272,1
20150105.223859,2820,2,186522,0,2820,787,2821,388,0
20150105.223901,2821,6,186528,0,2820,789,2821,447,1
20150105.223902,2820,14,186542,-6,2820,782,2821,487,0
20150105.223902,2820,44,186586,-44,2820,761,2821,487,0
20150105.223903,2820,410,186996,-200,2820,547,2821,521,0
20150105.223903,2821,4,187000,0,2820,546,2821,536,1
20150105.223904,2821,2,187002,-2,2820,546,2821,550,1
20150105.223905,2821,44,187046,2,2820,545,2821,533,1
20150105.223905,2821,24,187070,-2,2820,569,2821,523,1
20150105.223905,2820,2,187072,-2,2820,564,2821,524,0
20150105.223906,2821,60,187132,-54,2820,519,2821,535,1
20150105.223907,2820,4,187136,0,2820,517,2821,535,0
20150105.223907,2820,2,187138,0,2820,517,2821,541,0
20150105.223908,2821,30,187168,-18,2820,532,2821,515,1
20150105.223909,2820,252,187420,116,2820,410,2821,510,0
20150105.223909,2821,10,187430,10,2820,446,2821,514,1
20150105.22391,2820,296,187726,134,2820,298,2821,588,0
20150105.22391,2820,42,187768,-2,2820,277,2821,588,0
20150105.223911,2820,12,187780,-10,2820,271,2821,597,0
20150105.223911,2820,10,187790,-10,2820,270,2821,589,0
20150105.223912,2820,2,187792,-2,2820,271,2821,600,0
20150105.223912,2820,4,187796,-4,2820,270,2821,600,0
20150105.223913,2820,24,187820,-8,2820,258,2821,599,0
20150105.223914,2821,10,187830,8,2820,258,2821,594,1
20150105.223914,2820,18,187848,16,2820,254,2821,597,0
20150105.223915,2820,2,187850,0,2820,265,2821,605,0
20150105.223915,2821,20,187870,-2,2820,268,2821,588,1
20150105.223916,2820,270,188140,124,2820,134,2821,598,0
20150105.223916,2820,268,188408,-56,2819,316,2821,599,0
20150105.223917,2819,200,188608,-90,2819,216,2821,599,0
20150105.223918,2820,8,188616,-6,2819,211,2820,34,1
20150105.223918,2820,4,188620,2,2819,216,2820,39,1
20150105.223919,2820,6,188626,2,2819,216,2820,37,1
20150105.223919,2820,8,188634,8,2819,216,2820,63,1
20150105.22392,2819,2,188636,0,2819,216,2820,64,0
20150105.223921,2819,2,188638,0,2819,217,2820,65,0
20150105.223921,2820,130,188768,-60,2820,246,2821,503,1
20150105.223922,2820,2,188770,0,2820,264,2821,503,1
20150105.223922,2820,6,188776,2,2820,262,2821,502,1
20150105.223923,2820,8,188784,-8,2820,258,2821,500,1
20150105.223923,2820,446,189230,-6,2820,35,2821,503,1
20150105.223925,2820,4,189234,-4,2820,8,2821,526,1
20150105.223926,2820,24,189258,-2,2819,252,2821,697,1
20150105.223927,2820,18,189276,-16,2820,13,2821,708,1
20150105.223927,2820,26,189302,-22,2819,252,2820,12,1
20150105.223927,2820,12,189314,-12,2819,248,2820,31,1
20150105.223928,2820,2,189316,-2,2819,243,2820,30,1
20150105.223929,2819,2,189318,0,2819,242,2820,42,0
20150105.223929,2820,2,189320,0,2819,242,2820,44,1
20150105.22393,2820,8,189328,-4,2819,243,2820,46,1
20150105.22393,2820,16,189344,4,2819,244,2820,39,1
20150105.223931,2820,2,189346,0,2819,244,2820,38,1
20150105.223931,2819,6,189352,0,2819,241,2820,48,0
20150105.223933,2820,4,189356,0,2819,246,2820,245,1
20150105.223933,2820,6,189362,-2,2819,234,2820,246,1
20150105.223935,2820,8,189370,-8,2819,244,2820,380,1
20150105.223936,2819,2,189372,-2,2819,258,2820,388,0
20150105.223939,2820,4,189376,-2,2819,365,2820,424,1
20150105.223939,2819,2,189378,0,2819,365,2820,423,0
20150105.22394,2820,2,189380,0,2819,416,2820,422,1
20150105.22394,2819,20,189400,-20,2819,391,2820,431,0
20150105.223941,2820,2,189402,-2,2819,392,2820,422,1
20150105.223942,2820,10,189412,0,2819,401,2820,427,1
20150105.223944,2820,200,189612,36,2819,420,2820,325,1
20150105.223944,2819,60,189672,-60,2819,390,2820,327,0
20150105.223945,2819,38,189710,-38,2819,471,2820,293,0
20150105.223946,2820,2,189712,0,2819,472,2820,242,1
20150105.223946,2820,272,189984,-150,2819,473,2820,110,1
20150105.223947,2821,308,190292,74,2820,18,2821,739,1
20150105.223947,2821,8,190300,2,2820,70,2821,737,1
20150105.223949,2820,2,190302,0,2820,200,2821,708,0
20150105.22395,2820,2,190304,0,2820,199,2821,708,0
20150105.223951,2820,24,190328,20,2820,247,2821,678,0
20150105.223951,2820,122,190450,-40,2820,197,2821,651,0
20150105.223952,2821,36,190486,-14,2820,290,2821,641,1
20150105.223952,2820,4,190490,0,2820,296,2821,631,0
20150105.223953,2821,2,190492,-2,2820,296,2821,630,1
20150105.223953,2821,42,190534,4,2820,301,2821,609,1
20150105.223954,2821,24,190558,4,2820,317,2821,597,1
20150105.223954,2821,2,190560,0,2820,317,2821,596,1
20150105.223955,2821,48,190608,10,2820,318,2821,493,1
20150105.223956,2821,74,190682,66,2820,300,2821,469,1
20150105.223956,2821,410,191092,-70,2820,100,2821,465,1
20150105.223957,2821,410,191502,138,2820,151,2821,222,1
20150105.223957,2821,24,191526,16,2820,166,2821,191,1
20150105.223958,2821,390,191916,84,2821,221,2822,1919,1
20150105.223959,2822,6,191922,-2,2821,229,2822,1942,1
20150105.223959,2821,10,191932,-10,2821,231,2822,1912,0
20150105.224,2822,2,191934,0,2821,239,2822,1910,1
20150105.224,2822,4,191938,0,2821,239,2822,1909,1
20150105.224001,2821,282,192220,-274,2821,104,2822,1900,0
20150105.224001,2821,32,192252,-32,2821,97,2822,1912,0
20150105.224002,2822,10,192262,-6,2821,93,2822,1908,1
20150105.224002,2821,146,192408,-144,2821,20,2822,1921,0
20150105.224003,2822,48,192456,-10,2820,264,2822,1926,1
20150105.224003,2821,16,192472,6,2820,264,2821,8,0
20150105.224004,2822,32,192504,18,2820,264,2821,23,1
20150105.224004,2821,50,192554,-2,2821,33,2822,1923,0
20150105.224005,2822,42,192596,0,2821,39,2822,1904,1
20150105.224006,2822,4,192600,0,2821,67,2822,1903,1
20150105.224007,2822,2,192602,0,2821,155,2822,1882,1
20150105.224008,2822,40,192642,-40,2821,244,2822,1842,1
20150105.224008,2821,376,193018,-24,2821,94,2822,1807,0
20150105.224009,2821,22,193040,2,2821,97,2822,1801,0
20150105.224009,2821,8,193048,0,2821,102,2822,1856,0
20150105.22401,2822,604,193652,-602,2821,118,2822,1541,1
20150105.22401,2822,42,193694,-40,2821,107,2822,1536,1
20150105.224011,2821,114,193808,70,2821,93,2822,1513,0
20150105.224012,2822,146,193954,2,2821,107,2822,1431,1
20150105.224013,2821,4,193958,0,2821,94,2822,1446,0
20150105.224013,2822,6,193964,-6,2821,102,2822,1444,1
20150105.224014,2822,2,193966,0,2821,107,2822,1444,1
20150105.224014,2822,40,194006,-20,2821,108,2822,1423,1
20150105.224015,2822,100,194106,-100,2821,109,2822,1359,1
20150105.224015,2821,280,194386,-36,2820,271,2822,1370,0
20150105.224016,2822,2,194388,0,2821,10,2822,1430,1
20150105.224016,2821,112,194500,-64,2820,271,2821,2,0
20150105.224017,2822,204,194704,-178,2820,271,2822,1348,1
20150105.224017,2821,24,194728,0,2820,271,2821,63,0
20150105.224018,2821,20,194748,0,2820,273,2821,55,0
20150105.224018,2821,8,194756,0,2820,273,2821,51,0
20150105.224019,2821,50,194806,0,2820,284,2821,45,0
20150105.224019,2821,4,194810,0,2820,286,2821,44,0
20150105.22402,2821,64,194874,-60,2820,286,2821,13,0
20150105.22402,2821,2,194876,0,2820,299,2821,13,0
20150105.224021,2821,8,194884,-6,2820,294,2821,9,0
20150105.224022,2821,4,194888,-4,2820,294,2821,109,0
20150105.224022,2821,4,194892,0,2820,297,2821,111,0
20150105.224023,2821,2,194894,0,2820,299,2821,304,0
20150105.224024,2821,12,194906,-2,2820,253,2821,321,0
20150105.224024,2821,2,194908,2,2820,271,2821,316,0
20150105.224025,2821,84,194992,84,2820,276,2821,275,0
20150105.224025,2821,6,194998,6,2820,276,2821,274,0
20150105.224026,2820,6,195004,-6,2820,260,2821,283,0
20150105.224027,2820,2,195006,0,2820,264,2821,298,0
20150105.224028,2820,6,195012,-6,2820,293,2821,295,0
20150105.224029,2820,6,195018,4,2820,294,2821,353,0
20150105.22403,2821,806,195824,-650,2821,11,2822,1333,1
20150105.22403,2821,22,195846,-22,2820,289,2821,1,1
20150105.22403,2821,16,195862,0,2820,336,2821,10,1
20150105.224033,2821,2,195864,0,2820,327,2821,23,1
20150105.224033,2821,10,195874,0,2820,327,2821,19,1
20150105.224035,2821,224,196098,198,2820,328,2821,11,1
20150105.224035,2821,4,196102,2,2820,359,2821,35,1
20150105.224036,2820,26,196128,20,2820,369,2821,23,0
20150105.224036,2821,42,196170,22,2820,372,2821,3,1
20150105.224037,2821,12,196182,-4,2821,70,2822,1330,1
20150105.224038,2821,32,196214,2,2821,111,2822,1311,1
20150105.224039,2821,10,196224,-2,2821,132,2822,1310,1
20150105.22404,2821,4,196228,4,2821,130,2822,1300,1
20150105.224041,2822,200,196428,0,2821,115,2822,1209,1
20150105.224042,2821,2,196430,2,2821,116,2822,1209,0
20150105.224042,2821,122,196552,112,2821,77,2822,1208,0
20150105.224043,2821,22,196574,20,2821,66,2822,1208,0
20150105.224044,2821,2,196576,0,2821,69,2822,1208,0
20150105.224045,2821,14,196590,10,2821,64,2822,1205,0
20150105.224046,2822,6,196596,0,2821,136,2822,1252,1
20150105.224047,2821,106,196702,-30,2821,84,2822,1201,0
20150105.224049,2821,22,196724,2,2821,85,2822,1223,0
20150105.224049,2822,194,196918,-56,2820,380,2822,1227,1
20150105.22405,2821,24,196942,0,2820,420,2822,1241,0
20150105.224051,2821,24,196966,4,2820,423,2822,1228,0
20150105.224052,2820,446,197412,268,2820,201,2822,1228,0
20150105.224052,2820,2,197414,0,2820,200,2822,1228,0
20150105.224053,2821,18,197432,6,2820,199,2822,1234,1
20150105.224054,2821,4,197436,4,2820,199,2821,32,1
20150105.224055,2821,66,197502,62,2821,13,2822,1246,1
20150105.224055,2821,14,197516,0,2821,38,2822,1292,1
20150105.224056,2821,24,197540,12,2821,98,2822,1280,1
20150105.224056,2821,40,197580,10,2821,94,2822,1259,1
20150105.224057,2821,14,197594,12,2821,87,2822,1253,1
20150105.224057,2821,16,197610,12,2821,79,2822,1253,1
20150105.224058,2821,4,197614,2,2821,78,2822,1255,1
20150105.224058,2821,2,197616,2,2821,63,2822,1255,1
20150105.224059,2821,2,197618,2,2821,62,2822,1255,1
20150105.224059,2821,2,197620,0,2821,61,2822,1256,1
20150105.224101,2821,14,197634,2,2821,77,2822,1237,1
20150105.224101,2821,36,197670,0,2821,59,2822,1246,1
20150105.224102,2821,2,197672,0,2821,77,2822,1245,1
20150105.224102,2821,4,197676,2,2821,75,2822,1258,1
20150105.224103,2821,2,197678,0,2821,101,2822,1258,1
20150105.224104,2821,2026,199704,722,2821,125,2822,228,1
20150105.224104,2822,2,199706,0,2821,112,2822,236,1
20150105.224105,2822,2,199708,0,2821,154,2822,291,1
20150105.224106,2821,316,200024,-78,2820,423,2822,335,0
20150105.224106,2822,4,200028,0,2820,423,2822,362,1
20150105.224107,2821,118,200146,116,2820,423,2822,366,0
20150105.224107,2822,24,200170,20,2821,14,2822,361,1
20150105.224108,2821,2,200172,2,2821,114,2822,353,0
20150105.224109,2822,10,200182,6,2821,115,2822,339,1
20150105.224109,2821,294,200476,-94,2820,427,2822,290,0
20150105.22411,2822,888,201364,184,2821,19,2823,912,1
20150105.22411,2821,4,201368,2,2821,47,2822,36,0
20150105.224111,2822,2,201370,0,2821,109,2822,107,1
20150105.224112,2822,6,201376,0,2821,121,2822,254,1
20150105.224112,2822,30,201406,2,2821,122,2822,276,1
20150105.224112,2822,34,201440,4,2821,122,2822,260,1
20150105.224113,2822,12,201452,0,2821,127,2822,267,1
20150105.224114,2822,2,201454,0,2821,129,2822,278,1
20150105.224115,2821,20,201474,-16,2821,120,2822,278,0
20150105.224115,2822,594,202068,284,2821,146,2823,861,1
20150105.224116,2821,4,202072,-2,2821,189,2823,876,0
20150105.224117,2822,4,202076,-2,2821,195,2822,10,1
20150105.224118,2822,8,202084,0,2821,196,2822,26,1
20150105.224118,2822,4,202088,-4,2821,196,2822,26,1
20150105.224119,2822,2,202090,0,2821,198,2822,25,1
20150105.224119,2822,8,202098,2,2821,199,2822,29,1
20150105.22412,2822,6,202104,-2,2821,202,2822,31,1
20150105.22412,2822,12,202116,-10,2821,219,2822,25,1
20150105.224121,2821,2,202118,0,2821,218,2822,26,0
20150105.224121,2822,4,202122,0,2821,218,2822,27,1
20150105.224122,2822,66,202188,12,2822,969,2823,792,1
20150105.224122,2822,34,202222,2,2822,968,2823,777,1
20150105.224123,2822,68,202290,2,2822,934,2823,784,1
20150105.224124,2822,4,202294,4,2821,294,2822,23,1
20150105.224124,2821,64,202358,10,2821,279,2822,28,0
20150105.224125,2822,56,202414,34,2822,13,2823,805,1
20150105.224125,2823,6,202420,0,2822,16,2823,815,1
20150105.224126,2823,36,202456,-2,2822,165,2823,797,1
20150105.224126,2823,290,202746,-254,2822,171,2823,673,1
20150105.224127,2823,6,202752,-2,2822,172,2823,671,1
20150105.224127,2823,6,202758,0,2822,191,2823,668,1
20150105.224128,2822,2,202760,0,2822,192,2823,667,0
20150105.224128,2822,2,202762,0,2822,206,2823,669,0
20150105.224129,2822,146,202908,0,2822,138,2823,669,0
20150105.22413,2822,4,202912,0,2822,122,2823,671,0
20150105.22413,2822,22,202934,-18,2822,123,2823,669,0
20150105.224131,2822,264,203198,156,2822,107,2823,669,0
20150105.224132,2822,22,203220,-2,2822,120,2823,675,0
20150105.224133,2822,6,203226,6,2822,117,2823,715,0
20150105.224133,2822,2,203228,2,2822,138,2823,717,0
20150105.224134,2822,12,203240,0,2822,144,2823,714,0
20150105.224134,2822,2,203242,0,2822,144,2823,715,0
20150105.224135,2822,30,203272,10,2822,130,2823,727,0
20150105.224136,2822,4,203276,0,2822,141,2823,733,0
20150105.224137,2823,6,203282,-2,2822,155,2823,734,1
20150105.224137,2822,286,203568,62,2821,279,2822,120,0
20150105.224138,2822,252,203820,0,2822,875,2823,745,0
20150105.224138,2823,2,203822,0,2822,902,2823,743,1
20150105.224139,2823,30,203852,-20,2822,897,2823,735,1
20150105.224139,2823,76,203928,0,2822,898,2823,698,1
20150105.22414,2822,2,203930,-2,2822,897,2823,697,0
20150105.22414,2823,28,203958,-2,2822,946,2823,693,1
20150105.224141,2823,22,203980,-20,2822,946,2823,681,1
20150105.224142,2823,2,203982,0,2822,961,2823,682,1
20150105.224142,2823,16,203998,-8,2822,957,2823,678,1
20150105.224143,2823,2,204000,-2,2822,957,2823,572,1
20150105.224143,2822,20,204020,0,2822,948,2823,578,0
20150105.224144,2823,30,204050,-26,2822,948,2823,564,1
20150105.224144,2823,64,204114,-24,2822,1000,2823,532,1
20150105.224145,2823,12,204126,-4,2822,998,2823,529,1
20150105.224145,2823,44,204170,14,2822,999,2823,510,1
20150105.224146,2823,358,204528,-26,2822,1000,2823,382,1
20150105.224146,2823,10,204538,0,2822,1015,2823,377,1
20150105.224147,2823,18,204556,-18,2822,1012,2823,370,1
20150105.224147,2823,84,204640,8,2822,1024,2823,329,1
20150105.224148,2823,12,204652,-4,2822,1024,2823,326,1
20150105.224148,2823,48,204700,4,2822,1025,2823,302,1
20150105.224149,2823,4,204704,0,2822,1025,2823,301,1
20150105.224149,2823,44,204748,0,2822,1031,2823,290,1
20150105.22415,2823,442,205190,-100,2822,1032,2823,73,1
20150105.22415,2823,44,205234,-16,2822,1029,2823,57,1
20150105.224151,2823,54,205288,18,2822,1025,2823,81,1
20150105.224151,2823,64,205352,-38,2822,1013,2823,60,1
20150105.224152,2823,54,205406,-2,2822,1013,2823,188,1
20150105.224152,2823,116,205522,2,2822,1014,2823,532,1
20150105.224153,2823,2,205524,0,2822,1019,2823,1571,1
20150105.224153,2823,66,205590,-8,2822,1017,2823,1542,1
20150105.224154,2823,104,205694,-2,2822,1027,2823,1494,1
20150105.224156,2823,18,205712,-6,2822,1037,2823,1523,1
20150105.224156,2823,14,205726,0,2822,1053,2823,1517,1
20150105.224157,2822,24,205750,2,2822,1053,2823,1506,0
20150105.224157,2822,266,206016,-264,2822,923,2823,1496,0
20150105.224158,2823,2,206018,2,2822,938,2823,1495,1
20150105.224159,2823,2,206020,0,2822,935,2823,1506,1
20150105.224159,2822,4,206024,-2,2822,919,2823,508,0
20150105.2242,2823,2,206026,-2,2822,934,2823,511,1
20150105.2242,2823,6,206032,-2,2822,933,2823,511,1
20150105.224201,2823,126,206158,0,2822,933,2823,455,1
20150105.224201,2823,6,206164,0,2822,931,2823,454,1
20150105.224202,2823,2,206166,-2,2822,937,2823,458,1
20150105.224202,2823,74,206240,-10,2822,912,2823,421,1
20150105.224203,2823,30,206270,0,2822,926,2823,523,1
20150105.224204,2823,42,206312,-40,2822,926,2823,509,1
20150105.224204,2823,2,206314,0,2822,925,2823,509,1
20150105.224205,2822,336,206650,0,2822,902,2823,413,0
20150105.224205,2823,30,206680,-2,2822,899,2823,402,1
20150105.224205,2823,56,206736,-2,2822,900,2823,375,1
20150105.224206,2823,56,206792,-8,2822,887,2823,351,1
20150105.224207,2823,16,206808,-4,2822,886,2823,357,1
20150105.224207,2823,22,206830,-16,2822,884,2823,354,1
20150105.224208,2823,290,207120,-290,2822,741,2823,354,1
20150105.224208,2823,418,207538,42,2822,741,2823,159,1
20150105.224208,2822,20,207558,-20,2822,731,2823,159,0
20150105.224209,2823,334,207892,-302,2823,355,2824,674,1
20150105.22421,2823,36,207928,-32,2823,325,2824,694,1
20150105.22421,2823,688,208616,-670,2822,746,2823,657,1
20150105.224211,2822,82,208698,-44,2822,747,2823,621,0
20150105.224211,2823,14,208712,-6,2822,732,2823,703,1
20150105.224212,2823,22,208734,0,2822,732,2823,698,1
20150105.224212,2823,44,208778,-44,2822,732,2823,699,1
20150105.224213,2823,10,208788,0,2822,733,2823,698,1
20150105.224214,2823,8,208796,0,2822,753,2823,608,1
20150105.224215,2822,298,209094,-296,2822,606,2823,632,0
20150105.224216,2823,34,209128,0,2822,607,2823,622,1
20150105.224216,2823,12,209140,-12,2822,606,2823,607,1
20150105.224217,2823,54,209194,0,2822,601,2823,585,1
20150105.224218,2823,214,209408,0,2822,601,2823,494,1
20150105.224218,2822,76,209484,-60,2822,571,2823,487,0
20150105.224219,2823,40,209524,0,2822,571,2823,504,1
20150105.224219,2823,128,209652,-24,2822,546,2823,466,1
20150105.22422,2823,1414,211066,464,2823,210,2824,728,1
20150105.224221,2824,2,211068,2,2823,212,2824,728,1
20150105.224221,2824,8,211076,2,2823,233,2824,705,1
20150105.224222,2824,196,211272,-32,2823,159,2824,702,1
20150105.224222,2823,12,211284,4,2823,159,2824,699,0
20150105.224223,2824,352,211636,-302,2823,148,2824,547,1
20150105.224224,2823,4,211640,0,2823,160,2824,558,0
20150105.224224,2823,14,211654,2,2823,153,2824,558,0
20150105.224225,2823,4,211658,2,2823,167,2824,558,0
20150105.224225,2824,6,211664,-4,2823,201,2824,471,1
20150105.224226,2823,208,211872,-20,2823,105,2824,471,0
20150105.224226,2824,22,211894,0,2823,125,2824,516,1
20150105.224227,2824,20,211914,-10,2823,131,2824,498,1
20150105.224228,2823,4,211918,4,2823,125,2824,502,0
20150105.224228,2824,2,211920,-2,2823,125,2824,507,1
20150105.224229,2824,8,211928,0,2823,133,2824,506,1
20150105.224229,2823,108,212036,-48,2823,81,2824,504,0
20150105.22423,2823,168,212204,-34,2822,622,2823,21,0
20150105.22423,2823,6,212210,4,2822,622,2824,474,0
20150105.224231,2824,8,212218,2,2823,504,2824,525,1
20150105.224231,2824,22,212240,-2,2823,496,2824,514,1
20150105.224232,2824,10,212250,-8,2823,492,2824,545,1
20150105.224232,2824,70,212320,-2,2823,553,2824,537,1
20150105.224233,2824,326,212646,-294,2823,401,2824,462,1
20150105.224233,2823,6,212652,0,2823,415,2824,462,0
20150105.224234,2824,2,212654,0,2823,417,2824,462,1
20150105.224234,2824,2,212656,0,2823,417,2824,461,1
20150105.224235,2823,12,212668,0,2823,421,2824,457,0
20150105.224235,2823,12,212680,-10,2823,419,2824,458,0
20150105.224236,2824,1054,213734,-816,2824,3,2825,1524,1
20150105.224236,2825,56,213790,-36,2823,431,2825,1524,1
20150105.224237,2825,244,214034,-94,2824,3,2825,1484,1
20150105.224237,2825,248,214282,-136,2824,2,2825,1427,1
20150105.224238,2824,50,214332,-6,2823,420,2824,797,0
20150105.224238,2823,16,214348,-6,2823,419,2824,838,0
20150105.224239,2823,64,214412,0,2823,388,2824,811,0
20150105.224239,2824,76,214488,-14,2823,390,2824,925,1
20150105.22424,2824,6,214494,0,2823,398,2824,926,1
20150105.22424,2824,244,214738,-16,2823,280,2824,961,1
20150105.224241,2823,6,214744,-2,2823,279,2824,995,0
20150105.224241,2824,62,214806,0,2823,280,2824,964,1
20150105.224242,2824,24,214830,0,2823,275,2824,1027,1
20150105.224242,2824,24,214854,0,2823,288,2824,1018,1
20150105.224243,2823,12,214866,-4,2823,287,2824,1004,0
20150105.224243,2823,4,214870,-2,2823,305,2824,1018,0
20150105.224244,2823,114,214984,-6,2823,302,2824,968,0
20150105.224245,2824,2,214986,0,2823,372,2824,978,1
20150105.224245,2824,10,214996,-10,2823,381,2824,978,1
20150105.224246,2824,10,215006,-6,2823,384,2824,985,1
20150105.224247,2823,106,215112,-102,2823,334,2824,996,0
20150105.224247,2824,4,215116,0,2823,358,2824,1027,1
20150105.224248,2824,6,215122,-6,2823,363,2824,991,1
20150105.224248,2824,4,215126,-2,2823,349,2824,989,1
20150105.224249,2823,10,215136,-2,2823,549,2824,989,0
20150105.224249,2824,16,215152,-4,2823,548,2824,991,1
20150105.224251,2824,8,215160,-6,2823,550,2824,997,1
20150105.224251,2824,4,215164,-2,2823,551,2824,1008,1
20150105.224252,2824,18,215182,-14,2823,581,2824,1006,1
20150105.224253,2824,34,215216,-10,2823,592,2824,1045,1
20150105.224254,2824,2,215218,0,2823,593,2824,1063,1
20150105.224254,2824,4,215222,0,2823,593,2824,1038,1
20150105.224255,2824,2,215224,0,2823,592,2824,1038,1
20150105.224255,2823,4,215228,-4,2823,593,2824,1042,0
20150105.224255,2824,2,215230,0,2823,608,2824,1049,1
20150105.224256,2823,6,215236,0,2823,607,2824,1048,0
20150105.224257,2824,2,215238,0,2823,608,2824,1057,1
20150105.224258,2824,106,215344,-2,2823,628,2824,1004,1
20150105.224258,2823,6,215350,-4,2823,611,2824,994,0
20150105.224259,2824,12,215362,-2,2823,610,2824,986,1
20150105.2243,2824,120,215482,0,2823,625,2824,932,1
20150105.2243,2824,18,215500,-2,2823,652,2824,924,1
20150105.224301,2823,2,215502,-2,2823,636,2824,925,0
20150105.224301,2824,14,215516,-4,2823,640,2824,929,1
20150105.224302,2824,100,215616,0,2823,640,2824,879,1
20150105.224302,2823,2,215618,-2,2823,654,2824,879,0
20150105.224303,2823,8,215626,-2,2823,652,2824,953,0
20150105.224304,2823,16,215642,-12,2823,645,2824,962,0
20150105.224304,2823,8,215650,0,2823,641,2824,945,0
20150105.224305,2823,4,215654,0,2823,640,2824,944,0
20150105.224305,2823,228,215882,-216,2823,634,2824,838,0
20150105.224306,2823,2,215884,0,2823,633,2824,840,0
20150105.224307,2823,24,215908,-12,2823,624,2824,836,0
20150105.224307,2823,2,215910,0,2823,678,2824,847,0
20150105.224308,2823,4,215914,-2,2823,677,2824,839,0
20150105.224308,2823,2,215916,2,2823,696,2824,851,0
20150105.224309,2823,60,215976,0,2823,868,2824,849,0
20150105.224309,2823,100,216076,-50,2823,838,2824,849,0
20150105.22431,2823,104,216180,-2,2823,835,2824,802,0
20150105.22431,2824,106,216286,-60,2823,773,2824,807,1
20150105.224311,2823,58,216344,-10,2823,763,2824,809,0
20150105.224312,2823,48,216392,-44,2823,740,2824,821,0
20150105.224313,2823,78,216470,-48,2823,707,2824,868,0
20150105.224314,2823,160,216630,70,2823,627,2824,868,0
20150105.224314,2823,886,217516,-114,2823,184,2824,872,0
20150105.224315,2823,338,217854,-78,2822,952,2823,38,0
20150105.224315,2822,6,217860,-2,2822,950,2823,134,0
20150105.224316,2823,4,217864,4,2822,900,2823,163,1
20150105.224316,2823,60,217924,8,2822,876,2823,179,1
20150105.224317,2823,10,217934,0,2822,876,2823,186,1
20150105.224318,2822,40,217974,-40,2822,856,2823,189,0
20150105.224319,2822,2,217976,0,2822,1053,2823,267,0
20150105.224319,2823,28,218004,4,2822,1047,2823,289,1
20150105.22432,2823,62,218066,52,2822,1036,2823,275,1
20150105.224321,2823,44,218110,-4,2822,1009,2823,267,1
20150105.224321,2823,212,218322,-54,2822,1009,2823,163,1
20150105.224322,2823,34,218356,-6,2822,1009,2823,246,1
20150105.224324,2823,128,218484,-62,2822,1039,2823,200,1
20150105.224324,2822,22,218506,-22,2822,1032,2823,200,0
20150105.224325,2822,8,218514,-6,2822,1017,2823,210,0
20150105.224326,2823,478,218992,-374,2823,49,2824,827,1
20150105.224326,2823,6,218998,6,2823,242,2824,830,1
20150105.224327,2823,30,219028,2,2823,301,2824,830,1
20150105.224327,2823,4,219032,2,2823,309,2824,829,1
20150105.224328,2824,4,219036,0,2823,367,2824,829,1
20150105.224328,2824,54,219090,52,2823,341,2824,831,1
20150105.224329,2823,24,219114,0,2823,340,2824,821,0
20150105.224329,2823,24,219138,-22,2823,328,2824,821,0
20150105.22433,2823,22,219160,-20,2823,317,2824,822,0
20150105.224331,2824,2,219162,-2,2823,317,2824,821,1
20150105.224331,2823,8,219170,0,2823,334,2824,820,0
20150105.224333,2823,12,219182,0,2823,339,2824,793,0
20150105.224334,2824,22,219204,-20,2823,323,2824,786,1
20150105.224334,2823,2,219206,0,2823,337,2824,787,0
20150105.224334,2823,22,219228,-2,2823,337,2824,778,0
20150105.224335,2823,6,219234,0,2823,396,2824,808,0
20150105.224336,2823,10,219244,0,2823,391,2824,811,0
20150105.224336,2823,16,219260,-2,2823,369,2824,818,0
20150105.224337,2823,4,219264,0,2823,368,2824,820,0
20150105.224337,2823,2,219266,0,2823,376,2824,821,0
20150105.224337,2823,4,219270,0,2823,374,2824,822,0
20150105.224338,2823,6,219276,-4,2823,414,2824,826,0
20150105.224339,2823,4,219280,-4,2823,412,2824,836,0
20150105.224339,2823,2,219282,0,2823,411,2824,840,0
20150105.22434,2823,42,219324,-36,2823,412,2824,887,0
20150105.22434,2823,4,219328,-2,2823,397,2824,890,0
20150105.224341,2823,10,219338,-10,2823,407,2824,890,0
20150105.224342,2823,2,219340,0,2823,390,2824,987,0
20150105.224342,2824,4,219344,0,2823,390,2824,1053,1
20150105.224343,2823,42,219386,-42,2823,369,2824,1074,0
20150105.224343,2824,1002,220388,-468,2823,384,2824,577,1
20150105.224344,2823,2,220390,-2,2823,387,2824,597,0
20150105.224344,2823,40,220430,-40,2823,367,2824,607,0
20150105.224345,2824,18,220448,-16,2823,360,2824,605,1
20150105.224346,2823,22,220470,-20,2823,354,2824,568,0
20150105.224347,2824,6,220476,0,2823,354,2824,564,1
20150105.224347,2824,20,220496,10,2823,354,2824,553,1
20150105.224348,2823,12,220508,-10,2823,349,2824,556,0
20150105.224349,2824,4,220512,2,2823,348,2824,562,1
20150105.224349,2824,16,220528,4,2823,347,2824,555,1
20150105.22435,2823,8,220536,2,2823,345,2824,564,0
20150105.224351,2824,4,220540,4,2823,345,2824,579,1
20150105.224351,2823,2,220542,-2,2823,338,2824,584,0
20150105.224352,2824,4,220546,2,2823,338,2824,591,1
20150105.224352,2824,2,220548,2,2823,338,2824,599,1
20150105.224353,2823,102,220650,-26,2823,337,2824,551,0
20150105.224355,2823,24,220674,0,2823,327,2824,597,0
20150105.224356,2824,20,220694,20,2823,407,2824,603,1
20150105.224357,2823,2,220696,0,2823,408,2824,606,0
20150105.224357,2824,6,220702,6,2823,410,2824,643,1
20150105.224358,2823,60,220762,-20,2823,380,2824,648,0
20150105.224359,2823,30,220792,-8,2823,362,2824,649,0
20150105.2244,2824,4,220796,4,2823,362,2824,654,1
20150105.224401,2824,2,220798,2,2823,362,2824,652,1
20150105.224402,2823,2,220800,0,2823,363,2824,651,0
20150105.224402,2823,2,220802,0,2823,362,2824,651,0
20150105.224402,2823,2,220804,-2,2823,571,2824,656,0
20150105.224403,2823,18,220822,0,2823,569,2824,657,0
20150105.224404,2824,206,221028,92,2823,566,2824,559,1
20150105.224404,2824,2,221030,0,2823,566,2824,560,1
20150105.224405,2823,2,221032,-2,2823,576,2824,560,0
20150105.224406,2823,2,221034,0,2823,575,2824,560,0
20150105.224407,2824,1050,222084,-630,2823,579,2825,2162,1
20150105.224407,2824,2,222086,0,2823,579,2825,2163,1
20150105.224408,2824,44,222130,-16,2823,568,2824,12,1
20150105.224408,2824,34,222164,-12,2824,22,2825,2163,1
20150105.224409,2825,20,222184,12,2824,34,2825,2152,1
20150105.224409,2824,2,222186,0,2824,53,2825,2142,0
20150105.22441,2823,226,222412,-170,2823,507,2824,4,0
20150105.22441,2824,14,222426,2,2823,506,2824,9,1
20150105.224411,2824,22,222448,16,2823,506,2825,2146,1
20150105.224411,2824,4,222452,0,2823,507,2825,2146,1
20150105.224412,2824,26,222478,2,2824,13,2825,2144,1
20150105.224413,2824,42,222520,-32,2824,15,2825,2144,1
20150105.224413,2824,306,222826,-172,2823,543,2825,1977,1
20150105.224414,2824,4,222830,0,2823,543,2825,1976,1
20150105.224414,2824,58,222888,-36,2823,543,2825,1977,1
20150105.224415,2825,8,222896,0,2823,544,2824,2,1
20150105.224415,2823,352,223248,-130,2823,571,2824,3,0
20150105.224416,2824,8,223256,0,2823,571,2824,3,1
20150105.224416,2824,40,223296,-36,2823,572,2825,2172,1
20150105.224417,2824,4,223300,0,2824,1,2825,2172,1
20150105.224417,2824,16,223316,-2,2823,572,2824,1,1
20150105.224418,2824,370,223686,-310,2824,9,2825,2178,1
20150105.224418,2824,20,223706,-18,2823,415,2825,1981,1
20150105.224419,2824,22,223728,0,2823,417,2824,10,1
20150105.224419,2824,24,223752,2,2824,11,2825,2182,1
20150105.22442,2824,22,223774,-22,2823,416,2825,2183,1
20150105.22442,2825,242,224016,-38,2823,308,2824,61,1
20150105.224421,2823,6,224022,0,2823,322,2824,56,0
20150105.224421,2824,114,224136,38,2823,322,2825,1977,1
20150105.224422,2824,2,224138,0,2823,322,2824,23,1
20150105.224422,2824,6,224144,-6,2823,322,2824,22,1
20150105.224423,2824,20,224164,2,2823,332,2824,9,1
20150105.224423,2823,216,224380,-38,2823,224,2824,30,0
20150105.224424,2824,32,224412,0,2823,214,2824,26,1
20150105.224425,2824,14,224426,0,2823,218,2824,92,1
20150105.224426,2824,40,224466,30,2823,253,2824,91,1
20150105.224428,2824,2,224468,2,2823,266,2824,103,1
20150105.224428,2823,2,224470,-2,2823,265,2824,122,0
20150105.224429,2824,2,224472,2,2823,266,2824,146,1
20150105.224429,2824,4,224476,2,2823,266,2824,153,1
20150105.22443,2823,564,225040,216,2822,862,2823,219,0
20150105.224432,2823,42,225082,42,2822,862,2823,218,0
20150105.224432,2823,4,225086,4,2822,862,2823,198,0
20150105.224433,2823,6,225092,4,2822,861,2823,219,0
20150105.224434,2823,572,225664,390,2822,794,2824,325,0
20150105.224434,2824,4,225668,4,2822,797,2823,20,1
20150105.224435,2823,26,225694,-6,2822,799,2823,7,0
20150105.224435,2823,2,225696,-2,2822,801,2823,6,0
20150105.224436,2823,18,225714,-18,2823,10,2824,518,0
20150105.224436,2823,6,225720,-2,2823,7,2824,482,0
20150105.224437,2824,2,225722,2,2823,157,2824,483,1
20150105.224438,2823,22,225744,-22,2823,147,2824,488,0
20150105.224438,2823,6,225750,0,2823,145,2824,490,0
20150105.224439,2823,2,225752,0,2823,145,2824,463,0
20150105.224439,2823,8,225760,0,2823,141,2824,907,0
20150105.22444,2824,2,225762,2,2823,141,2824,886,1
20150105.22444,2823,2,225764,0,2823,140,2824,890,0
20150105.224441,2823,2,225766,0,2823,145,2824,894,0
20150105.224442,2823,76,225842,68,2823,143,2824,878,0
20150105.224443,2824,4,225846,4,2823,143,2824,886,1
20150105.224443,2823,20,225866,-12,2823,148,2824,904,0
20150105.224444,2823,4,225870,-2,2823,149,2824,979,0
20150105.224446,2823,24,225894,10,2823,151,2824,922,0
20150105.224446,2823,304,226198,54,2822,851,2823,126,0
20150105.224448,2822,2,226200,0,2822,851,2823,136,0
20150105.224448,2822,200,226400,-96,2822,751,2823,136,0
20150105.224448,2823,110,226510,0,2822,751,2823,82,1
20150105.224449,2822,4,226514,-2,2822,749,2823,82,0
20150105.22445,2823,2,226516,2,2822,750,2823,82,1
20150105.224451,2822,420,226936,-44,2822,550,2823,73,0
20150105.224451,2823,4,226940,4,2822,552,2823,71,1
20150105.224451,2823,50,226990,50,2822,552,2823,46,1
20150105.224452,2823,14,227004,14,2822,553,2823,40,1
20150105.224453,2823,2,227006,2,2822,557,2823,39,1
20150105.224454,2823,100,227106,68,2823,10,2824,1102,1
20150105.224454,2823,2,227108,2,2823,20,2824,1096,1
20150105.224455,2823,46,227154,-20,2822,555,2823,207,1
20150105.224455,2822,2,227156,0,2822,555,2823,209,0
20150105.224458,2822,64,227220,22,2822,657,2824,968,0
20150105.224501,2823,2,227222,0,2822,661,2823,192,1
20150105.224501,2823,20,227242,20,2822,667,2823,183,1
20150105.224502,2823,48,227290,10,2822,663,2824,989,1
20150105.224502,2823,2,227292,-2,2822,663,2824,989,1
20150105.224503,2823,16,227308,0,2822,663,2824,987,1
20150105.224505,2823,6,227314,0,2822,663,2824,990,1
20150105.224505,2823,6,227320,-2,2822,667,2824,993,1
20150105.224507,2822,102,227422,-66,2822,617,2823,104,0
20150105.224508,2823,36,227458,14,2822,627,2823,164,1
20150105.224509,2823,12,227470,12,2822,627,2823,159,1
20150105.22451,2822,2,227472,-2,2822,626,2823,157,0
20150105.224511,2823,44,227516,44,2822,638,2823,132,1
20150105.224512,2823,22,227538,20,2822,638,2823,120,1
20150105.224514,2823,2,227540,2,2822,639,2823,125,1
20150105.224514,2823,2,227542,2,2822,639,2823,127,1
20150105.224515,2823,4,227546,0,2822,659,2823,129,1
20150105.224516,2823,40,227586,34,2822,659,2823,124,1
20150105.224517,2822,20,227606,-20,2822,649,2823,125,0
20150105.224517,2823,2,227608,-2,2822,649,2823,127,1
20150105.224518,2822,2,227610,0,2822,648,2823,127,0
20150105.224518,2823,2,227612,0,2822,649,2823,127,1
20150105.22452,2822,2,227614,-2,2822,654,2823,140,0
20150105.224521,2823,4,227618,0,2822,654,2823,138,1
20150105.224521,2822,2,227620,-2,2822,653,2823,139,0
20150105.224523,2823,2,227622,0,2822,654,2823,186,1
20150105.224524,2823,638,228260,-568,2823,208,2824,1256,1
20150105.224525,2823,402,228662,-402,2823,9,2824,1237,1
20150105.224526,2824,4,228666,0,2823,53,2824,1236,1
20150105.224526,2823,106,228772,-86,2822,654,2824,1237,0
20150105.224527,2823,8,228780,-8,2822,654,2823,22,0
20150105.224527,2824,80,228860,-76,2822,654,2824,1239,1
20150105.224528,2823,2,228862,-2,2822,654,2824,1239,0
20150105.224529,2823,4,228866,0,2822,656,2824,1241,0
20150105.224529,2823,2,228868,-2,2823,1,2824,1245,0
20150105.224529,2823,6,228874,-4,2822,656,2823,2,0
20150105.22453,2823,6,228880,-2,2823,11,2824,1254,0
20150105.22453,2823,6,228886,4,2823,19,2824,1254,0
20150105.224531,2823,38,228924,-2,2822,670,2824,1106,0
20150105.224531,2823,50,228974,0,2822,671,2824,1136,0
20150105.224533,2822,2,228976,-2,2822,672,2824,1136,0
20150105.224533,2823,2,228978,-2,2822,672,2823,164,1
20150105.224537,2823,4,228982,0,2822,678,2823,168,1
20150105.224537,2823,4,228986,2,2822,678,2823,166,1
20150105.224538,2823,332,229318,-332,2823,371,2824,1186,1
20150105.224538,2823,124,229442,-124,2823,309,2824,1162,1
20150105.224539,2823,4,229446,-2,2823,307,2824,1162,1
20150105.224539,2823,6,229452,0,2823,304,2824,1162,1
20150105.22454,2823,8,229460,-8,2823,300,2824,1161,1
20150105.224541,2823,2,229462,-2,2823,300,2824,1164,1
20150105.224542,2823,2,229464,-2,2823,299,2824,1164,1
20150105.224542,2823,8,229472,-6,2823,296,2824,1146,1
20150105.224543,2823,6,229478,-2,2823,293,2824,1146,1
20150105.224543,2823,4,229482,0,2823,296,2824,1141,1
20150105.224544,2823,2,229484,0,2823,295,2824,1139,1
20150105.224545,2823,4,229488,-2,2823,333,2824,1139,1
20150105.224545,2823,2,229490,-2,2823,332,2824,1144,1
20150105.224546,2823,40,229530,-40,2823,312,2824,1144,1
20150105.224547,2823,2,229532,-2,2823,311,2824,1145,1
20150105.224547,2823,2,229534,0,2823,310,2824,1146,1
20150105.224548,2823,40,229574,-40,2823,290,2824,1145,1
20150105.224551,2823,40,229614,-40,2823,472,2824,1145,1
20150105.224551,2823,2,229616,-2,2823,471,2824,1146,1
20150105.224552,2823,20,229636,-20,2823,461,2824,1147,1
20150105.224553,2823,4,229640,0,2823,460,2824,1125,1
20150105.224553,2823,4,229644,-4,2823,459,2824,1125,1
20150105.224555,2824,4,229648,-4,2823,462,2824,1129,1
20150105.224556,2823,10,229658,-10,2823,457,2824,1129,0
20150105.224556,2824,2,229660,0,2823,457,2824,1128,1
20150105.224557,2823,914,230574,-762,2822,487,2823,180,0
20150105.224557,2823,40,230614,0,2822,473,2823,162,0
20150105.224559,2823,88,230702,0,2822,473,2823,113,0
20150105.224559,2823,226,230928,-88,2822,542,2824,1123,0
20150105.2246,2823,12,230940,10,2822,542,2823,21,0
20150105.224601,2823,42,230982,22,2823,14,2824,1127,0
20150105.224602,2823,2,230984,0,2823,28,2824,1141,0
20150105.224603,2823,2,230986,2,2823,59,2824,1141,0
20150105.224603,2823,10,230996,-8,2823,55,2824,1152,0
20150105.224604,2823,10,231006,-10,2823,50,2824,1153,0
20150105.224606,2823,6,231012,-4,2823,48,2824,1155,0
20150105.224607,2823,16,231028,6,2823,41,2824,1155,0
20150105.224608,2823,78,231106,12,2823,36,2824,1125,0
20150105.224608,2823,4,231110,-4,2823,35,2824,1125,0
20150105.224609,2823,4,231114,-2,2823,34,2824,1125,0
20150105.22461,2823,36,231150,-16,2823,16,2824,1143,0
20150105.224611,2824,10,231160,10,2823,16,2824,1138,1
20150105.224612,2823,2,231162,0,2823,15,2824,1139,0
20150105.224612,2823,2,231164,-2,2823,149,2824,1139,0
20150105.224613,2824,100,231264,-58,2823,169,2824,1089,1
20150105.224614,2823,34,231298,-32,2823,165,2824,1092,0
20150105.224615,2823,40,231338,20,2823,789,2824,1084,0
20150105.224616,2823,2010,233348,444,2823,791,2824,76,0
20150105.224617,2824,60,233408,-50,2823,807,2825,1618,1
20150105.224618,2824,4,233412,0,2823,807,2825,1618,1
20150105.22462,2823,2,233414,2,2823,814,2825,1618,0
20150105.224621,2824,6,233420,6,2823,883,2824,55,1
20150105.224623,2824,2,233422,2,2823,883,2824,56,1
20150105.224624,2824,112,233534,22,2824,12,2825,1678,1
20150105.224625,2824,2,233536,0,2824,17,2825,1678,1
20150105.224626,2824,2,233538,-2,2824,21,2825,1678,1
20150105.224627,2824,24,233562,2,2824,9,2825,1678,1
20150105.224627,2824,18,233580,10,2823,885,2824,2,1
20150105.224628,2824,244,233824,-212,2823,890,2824,2,1
20150105.224629,2824,2,233826,-2,2823,893,2824,12,1
20150105.22463,2824,6,233832,0,2823,893,2824,10,1
20150105.224631,2825,1220,235052,706,2823,893,2825,985,1
20150105.224632,2824,20,235072,-20,2824,6,2825,984,0
20150105.224632,2825,2,235074,2,2824,21,2825,983,1
20150105.224633,2824,4,235078,-2,2824,20,2825,981,0
20150105.224633,2824,4,235082,0,2824,19,2825,981,0
20150105.224634,2824,40,235122,-12,2823,904,2825,920,0
20150105.224635,2825,16,235138,12,2823,1104,2825,958,1
20150105.224635,2825,2,235140,2,2824,1,2825,956,1
20150105.224637,2824,12,235152,0,2824,236,2825,951,0
20150105.224637,2824,2,235154,0,2824,260,2825,936,0
20150105.224637,2825,4,235158,2,2824,260,2825,925,1
20150105.224638,2824,2,235160,0,2824,245,2825,940,0
20150105.22464,2825,36,235196,10,2824,350,2825,920,1
20150105.22464,2824,2,235198,0,2824,354,2825,914,0
20150105.224641,2824,2,235200,-2,2824,354,2825,914,0
20150105.224642,2824,2,235202,-2,2824,355,2825,909,0
20150105.224642,2825,2,235204,2,2824,357,2825,908,1
20150105.224643,2824,2,235206,-2,2824,281,2825,908,0
20150105.224644,2824,2,235208,0,2824,269,2825,1094,0
20150105.224645,2824,134,235342,-114,2824,218,2825,1170,0
20150105.224645,2825,2,235344,2,2824,223,2825,1190,1
20150105.224647,2824,2,235346,0,2824,222,2825,1192,0
20150105.224648,2825,2,235348,2,2824,222,2825,1193,1
20150105.224649,2824,66,235414,0,2824,193,2825,1192,0
20150105.224649,2824,150,235564,0,2824,118,2825,1125,0
20150105.22465,2825,8,235572,0,2824,100,2825,1122,1
20150105.22465,2824,200,235772,-92,2823,543,2824,911,0
20150105.224651,2823,2,235774,2,2823,539,2824,987,0
20150105.224653,2824,14,235788,-10,2823,536,2824,993,1
20150105.224653,2823,24,235812,-16,2823,534,2824,983,0
20150105.224654,2824,2,235814,0,2823,534,2824,1148,1
20150105.224656,2824,72,235886,-72,2823,545,2824,1100,1
20150105.224658,2823,4,235890,2,2823,561,2824,1105,0
20150105.224659,2824,8,235898,0,2823,561,2824,1123,1
20150105.224659,2823,4,235902,4,2823,559,2824,1124,0
20150105.2247,2823,150,236052,150,2823,485,2824,989,0
20150105.224701,2824,1200,237252,-1200,2823,457,2824,389,1
20150105.224702,2824,10,237262,0,2823,460,2824,155,1
20150105.224703,2824,310,237572,52,2823,470,2825,1269,1
20150105.224703,2824,4,237576,0,2823,470,2825,1266,1
20150105.224704,2824,6,237582,0,2823,478,2824,11,1
20150105.224705,2824,26,237608,0,2823,452,2824,190,1
20150105.224706,2824,2,237610,0,2823,453,2824,191,1
20150105.224707,2824,10,237620,2,2823,453,2824,186,1
20150105.224707,2824,2,237622,2,2823,453,2824,187,1
20150105.224711,2824,2,237624,2,2823,457,2824,254,1
20150105.224712,2824,2,237626,2,2823,457,2824,255,1
20150105.224714,2824,6,237632,6,2823,459,2824,273,1
20150105.224716,2824,22,237654,-10,2823,462,2824,289,1
20150105.224718,2823,2,237656,0,2823,461,2824,278,0
20150105.224719,2824,2,237658,2,2823,460,2824,277,1
20150105.224719,2824,10,237668,-8,2823,460,2824,275,1
20150105.224723,2824,2,237670,-2,2823,467,2824,277,1
20150105.224724,2823,2,237672,0,2823,466,2824,378,0
20150105.224725,2824,2,237674,0,2823,465,2824,417,1
20150105.224726,2824,406,238080,76,2823,466,2824,214,1
20150105.22473,2823,50,238130,0,2823,467,2824,209,0
20150105.224731,2824,2,238132,0,2823,468,2824,210,1
20150105.224732,2824,44,238176,-40,2823,468,2824,192,1
20150105.224732,2824,22,238198,0,2823,468,2824,181,1
20150105.224734,2823,2,238200,0,2823,468,2824,182,0
20150105.224735,2823,4,238204,-2,2823,467,2824,181,0
20150105.224735,2824,4,238208,-4,2823,467,2824,179,1
20150105.224736,2824,2,238210,0,2823,468,2824,176,1
20150105.224736,2824,2,238212,0,2823,467,2824,175,1
20150105.224737,2823,8,238220,0,2823,464,2824,176,0
20150105.22474,2824,54,238274,0,2823,514,2824,144,1
20150105.22474,2823,2,238276,0,2823,512,2824,144,0
20150105.224741,2823,4,238280,0,2823,521,2824,143,0
20150105.224741,2824,20,238300,16,2823,522,2824,133,1
20150105.224742,2823,120,238420,58,2823,497,2824,81,0
20150105.224743,2824,72,238492,54,2823,471,2824,45,1
20150105.224744,2824,2,238494,2,2823,472,2824,46,1
20150105.224745,2824,2,238496,0,2823,473,2824,253,1
20150105.224746,2824,24,238520,18,2823,466,2824,245,1
20150105.224749,2824,2,238522,0,2823,472,2824,149,1
20150105.224749,2824,2,238524,2,2823,473,2824,88,1
20150105.22475,2823,20,238544,20,2823,453,2824,89,0
20150105.224751,2824,2,238546,2,2823,525,2824,77,1
20150105.224752,2824,2,238548,2,2823,527,2824,84,1
20150105.224753,2823,20,238568,20,2823,517,2824,84,0
20150105.224754,2824,60,238628,-34,2823,516,2824,55,1
20150105.224754,2823,6,238634,-2,2823,514,2824,53,0
20150105.224755,2824,6,238640,-6,2823,521,2824,52,1
20150105.224756,2824,2,238642,0,2823,520,2824,56,1
20150105.224757,2823,2,238644,0,2823,469,2824,58,0
20150105.224757,2824,10,238654,4,2823,471,2824,53,1
20150105.224758,2824,2,238656,-2,2823,471,2824,61,1
20150105.224758,2824,12,238668,-2,2823,471,2824,56,1
20150105.224759,2824,4,238672,0,2823,470,2824,66,1
20150105.2248,2823,2,238674,0,2823,829,2824,66,0
20150105.224801,2824,4,238678,2,2823,828,2824,64,1
20150105.224802,2824,8,238686,0,2823,754,2824,526,1
20150105.224804,2823,2,238688,0,2823,760,2824,511,0
20150105.224805,2824,8,238696,-8,2823,760,2824,510,1
20150105.224805,2824,6,238702,0,2823,759,2824,510,1
20150105.224806,2824,60,238762,-20,2823,759,2824,483,1
20150105.224807,2824,10,238772,-6,2823,752,2824,503,1
20150105.224808,2823,26,238798,10,2823,739,2824,660,0
20150105.224809,2823,40,238838,-40,2823,723,2824,708,0
20150105.224811,2824,2,238840,0,2823,728,2824,695,1
20150105.224812,2824,24,238864,2,2823,729,2824,541,1
20150105.224813,2823,6,238870,0,2823,748,2824,540,0
20150105.224814,2823,28,238898,-28,2823,734,2824,538,0
20150105.224815,2823,4,238902,-2,2823,734,2824,537,0
20150105.224816,2823,4,238906,-2,2823,732,2824,537,0
20150105.224816,2824,6,238912,0,2823,732,2824,534,1
20150105.224816,2823,2,238914,0,2823,731,2824,534,0
20150105.224817,2823,6,238920,-6,2823,728,2824,542,0
20150105.224818,2824,6,238926,-6,2823,728,2824,547,1
20150105.224818,2823,6,238932,-6,2823,725,2824,547,0
20150105.224819,2824,2,238934,-2,2823,795,2824,103,1
20150105.224819,2824,10,238944,-4,2823,805,2824,98,1
20150105.22482,2824,66,239010,2,2823,805,2824,70,1
20150105.224823,2824,6,239016,0,2823,805,2824,67,1
20150105.224824,2824,2,239018,-2,2823,811,2824,71,1
20150105.224825,2824,4,239022,-4,2823,812,2824,70,1
20150105.224826,2824,4,239026,0,2823,804,2824,532,1
20150105.224828,2823,82,239108,-82,2823,764,2824,633,0
20150105.224828,2823,80,239188,0,2823,884,2824,638,0
20150105.224829,2824,2,239190,0,2823,884,2824,637,1
20150105.22483,2823,2,239192,0,2823,890,2824,175,0
20150105.224831,2824,350,239542,-74,2824,826,2825,1169,1
20150105.224831,2824,10,239552,-10,2824,821,2825,1169,1
20150105.224832,2824,42,239594,-42,2824,800,2825,1160,1
20150105.224832,2824,10,239604,0,2824,795,2825,1160,1
20150105.224833,2824,2,239606,-2,2824,799,2825,1160,1
20150105.224834,2824,2,239608,-2,2824,798,2825,1160,1
20150105.224834,2824,2,239610,-2,2824,797,2825,1161,1
20150105.224835,2824,2,239612,0,2824,796,2825,1161,1
20150105.224836,2824,4,239616,-4,2824,794,2825,1161,1
20150105.224837,2824,2,239618,-2,2824,793,2825,1161,1
20150105.224837,2824,2,239620,-2,2824,793,2825,1161,1
20150105.224838,2824,2,239622,-2,2824,792,2825,1171,1
20150105.224839,2824,124,239746,-120,2824,731,2825,1170,1
20150105.22484,2824,10,239756,-8,2824,726,2825,1170,1
20150105.224841,2824,4,239760,0,2824,883,2825,1157,1
20150105.224841,2824,10,239770,-8,2824,879,2825,1156,1
20150105.224843,2824,12,239782,-10,2824,886,2825,1156,1
20150105.224845,2825,4,239786,0,2824,920,2825,1149,1
20150105.224845,2824,2,239788,0,2824,918,2825,1149,0
20150105.224846,2824,32,239820,-10,2824,902,2825,1149,0
20150105.224846,2824,22,239842,20,2824,900,2825,1139,0
20150105.224847,2825,22,239864,0,2824,890,2825,1139,1
20150105.224847,2824,2,239866,0,2824,894,2825,1139,0
20150105.224848,2824,2,239868,0,2824,893,2825,1143,0
20150105.224848,2824,2,239870,0,2824,892,2825,1143,0
20150105.224849,2825,2,239872,0,2824,891,2825,1142,1
20150105.224849,2825,6,239878,6,2824,891,2825,1139,1
20150105.22485,2824,2,239880,0,2824,895,2825,1140,0
20150105.224853,2824,20,239900,0,2824,887,2825,1142,0
20150105.224854,2825,4,239904,0,2824,886,2825,1147,1
20150105.224857,2825,6,239910,-4,2824,899,2825,1144,1
20150105.224858,2824,8,239918,0,2824,895,2825,1145,0
20150105.224859,2824,2,239920,0,2824,894,2825,1145,0
20150105.224859,2824,400,240320,-200,2824,694,2825,1145,0
20150105.2249,2824,2,240322,0,2824,693,2825,1145,0
20150105.2249,2825,2,240324,-2,2824,693,2825,1145,1
20150105.224901,2825,400,240724,52,2824,693,2825,933,1
20150105.224902,2824,2,240726,0,2824,693,2825,933,0
20150105.224902,2825,10,240736,0,2824,693,2825,928,1
20150105.224903,2824,6,240742,-4,2824,698,2825,926,0
20150105.224904,2824,6,240748,-4,2824,682,2825,939,0
20150105.224904,2825,20,240768,-20,2824,689,2825,929,1
20150105.224905,2824,16,240784,-2,2824,691,2825,922,0
20150105.224905,2824,164,240948,6,2824,616,2825,917,0
20150105.224906,2825,6,240954,6,2824,617,2825,914,1
20150105.224907,2824,2,240956,-2,2824,616,2825,914,0
20150105.224908,2824,4,240960,-2,2824,614,2825,913,0
20150105.224909,2824,24,240984,-2,2824,615,2825,907,0
20150105.22491,2824,4,240988,0,2824,628,2825,907,0
20150105.224912,2825,2,240990,2,2824,490,2825,985,1
20150105.224913,2824,100,241090,0,2824,427,2825,910,0
20150105.224914,2824,24,241114,-4,2824,415,2825,911,0
20150105.224914,2825,12,241126,-6,2824,426,2825,893,1
20150105.224915,2824,20,241146,0,2824,417,2825,893,0
20150105.224915,2824,4,241150,0,2824,485,2825,913,0
20150105.224916,2824,4,241154,0,2824,483,2825,918,0
20150105.224916,2824,2,241156,0,2824,482,2825,919,0
20150105.224917,2824,2,241158,0,2824,481,2825,919,0
20150105.224917,2824,10,241168,-6,2824,476,2825,920,0
20150105.224918,2824,6,241174,0,2824,474,2825,921,0
20150105.224918,2824,6,241180,-2,2824,471,2825,925,0
20150105.224918,2825,32,241212,-28,2824,471,2825,909,1
20150105.224919,2824,6,241218,-6,2824,453,2825,927,0
20150105.22492,2824,108,241326,0,2824,407,2825,926,0
20150105.22492,2824,478,241804,-206,2824,187,2825,921,0
20150105.224921,2824,12,241816,12,2824,162,2825,922,0
20150105.224921,2825,76,241892,-50,2824,126,2825,923,1
20150105.224922,2824,70,241962,28,2824,93,2825,921,0
20150105.224922,2824,190,242152,-6,2823,828,2824,372,0
20150105.224923,2824,10,242162,-10,2823,821,2824,415,0
20150105.224923,2824,16,242178,0,2823,816,2824,414,0
20150105.224924,2823,10,242188,-10,2823,811,2824,423,0
20150105.224925,2824,4,242192,0,2823,810,2824,440,1
20150105.224927,2824,40,242232,0,2823,811,2824,422,1
20150105.224928,2824,2,242234,0,2823,806,2824,426,1
20150105.224929,2824,6,242240,0,2823,806,2824,439,1
20150105.22493,2824,2,242242,0,2823,806,2824,438,1
20150105.224931,2824,4,242246,0,2823,787,2824,436,1
20150105.224931,2824,12,242258,-10,2823,788,2824,831,1
20150105.224933,2823,4,242262,0,2823,794,2824,847,0
20150105.224934,2824,4,242266,-4,2823,794,2824,848,1
20150105.224935,2824,2,242268,0,2823,794,2824,844,1
20150105.224935,2824,2,242270,0,2823,794,2824,846,1
20150105.224938,2823,4,242274,-2,2823,799,2824,448,0
20150105.224939,2823,8,242282,-8,2823,795,2824,451,0
20150105.22494,2824,2,242284,0,2823,795,2824,451,1
20150105.224941,2823,300,242584,-178,2823,638,2824,466,0
20150105.224942,2824,2,242586,-2,2823,646,2824,466,1
20150105.224945,2824,40,242626,0,2823,646,2824,524,1
20150105.224946,2823,2,242628,0,2823,643,2824,536,0
20150105.224948,2823,42,242670,-16,2823,626,2824,551,0
20150105.224951,2823,20,242690,-20,2823,610,2824,572,0
20150105.224952,2823,20,242710,0,2823,600,2824,572,0
20150105.224953,2823,4,242714,-2,2823,609,2824,558,0
20150105.224955,2823,200,242914,-200,2823,501,2824,674,0
20150105.224956,2823,12,242926,-4,2823,501,2824,761,0
20150105.224956,2823,10,242936,-2,2823,549,2824,777,0
20150105.224957,2823,10,242946,0,2823,544,2824,778,0
20150105.224957,2823,2,242948,-2,2823,543,2824,878,0
20150105.224958,2823,108,243056,-108,2823,489,2824,880,0
20150105.224959,2823,4,243060,-4,2823,487,2824,869,0
20150105.225,2823,2,243062,-2,2823,486,2824,887,0
20150105.225,2823,10,243072,-10,2823,481,2824,887,0
20150105.225,2823,208,243280,-208,2823,377,2824,883,0
20150105.225001,2823,22,243302,0,2823,366,2824,885,0
20150105.225001,2823,60,243362,-60,2823,336,2824,895,0
20150105.225002,2823,82,243444,2,2823,295,2824,898,0
20150105.225003,2823,24,243468,18,2823,282,2824,898,0
20150105.225003,2823,70,243538,8,2823,247,2824,898,0
20150105.225004,2823,26,243564,22,2823,162,2824,617,0
20150105.225004,2822,326,243890,-262,2822,500,2823,122,0
20150105.225005,2823,22,243912,-2,2822,500,2823,135,1
20150105.225005,2823,4,243916,-2,2822,507,2823,169,1
20150105.225007,2822,6,243922,4,2822,504,2823,172,0
20150105.225008,2823,28,243950,4,2822,507,2823,160,1
20150105.225008,2822,10,243960,2,2822,487,2823,161,0
20150105.225009,2822,8,243968,0,2822,498,2823,163,0
20150105.225011,2822,2,243970,0,2822,494,2823,234,0
20150105.225012,2822,4,243974,2,2822,494,2823,253,0
20150105.225014,2822,4,243978,2,2822,497,2823,233,0
20150105.225015,2822,68,244046,-58,2822,448,2823,233,0
20150105.225015,2822,10,244056,-2,2822,457,2823,235,0
20150105.225016,2822,2,244058,-2,2822,456,2823,236,0
20150105.225018,2822,2,244060,0,2822,455,2823,241,0
20150105.225018,2822,2,244062,-2,2822,454,2823,256,0
20150105.225019,2823,6,244068,-6,2822,454,2823,248,1
20150105.225019,2822,12,244080,-12,2822,449,2823,247,0
20150105.22502,2822,4,244084,-4,2822,447,2823,247,0
20150105.225022,2822,4,244088,-4,2822,431,2823,366,0
20150105.225022,2823,20,244108,-20,2822,432,2823,356,1
20150105.225023,2822,204,244312,128,2822,332,2823,354,0
20150105.225024,2823,2,244314,0,2822,332,2823,371,1
20150105.225025,2822,14,244328,2,2822,325,2823,373,0
20150105.225026,2822,16,244344,16,2822,333,2823,374,0
20150105.225027,2822,2,244346,2,2822,332,2823,381,0
20150105.225028,2823,2,244348,0,2822,332,2823,382,1
20150105.22503,2822,4,244352,4,2822,331,2823,384,0
20150105.22503,2822,12,244364,0,2822,376,2823,385,0
20150105.225032,2823,8,244372,0,2822,376,2823,382,1
20150105.225033,2822,2,244374,2,2822,376,2823,384,0
20150105.225033,2822,6,244380,6,2822,373,2823,384,0
20150105.225034,2822,6,244386,0,2822,370,2823,384,0
20150105.225034,2823,12,244398,2,2822,369,2823,385,1
20150105.225036,2822,8,244406,2,2822,366,2823,387,0
20150105.225036,2822,20,244426,0,2822,357,2823,386,0
20150105.225037,2822,2,244428,-2,2822,356,2823,387,0
20150105.225037,2823,20,244448,0,2822,343,2823,380,1
20150105.225038,2822,8,244456,-4,2822,342,2823,381,0
20150105.225038,2822,12,244468,-4,2822,336,2823,383,0
20150105.225039,2823,12,244480,0,2822,336,2823,377,1
20150105.22504,2822,2,244482,0,2822,335,2823,379,0
20150105.225041,2822,2,244484,2,2822,335,2823,384,0
20150105.225041,2822,4,244488,4,2822,333,2823,387,0
20150105.225044,2822,202,244690,-94,2822,231,2823,407,0
20150105.225045,2822,14,244704,-14,2822,224,2823,427,0
20150105.225045,2822,46,244750,-38,2822,242,2823,418,0
20150105.225046,2823,20,244770,-20,2822,242,2823,408,1
20150105.225048,2822,4,244774,0,2822,233,2823,406,0
20150105.22505,2822,2,244776,-2,2822,272,2823,407,0
20150105.225052,2822,2,244778,-2,2822,308,2823,403,0
20150105.225052,2822,2,244780,-2,2822,308,2823,403,0
20150105.225053,2822,200,244980,38,2822,192,2823,413,0
20150105.225054,2822,12,244992,-12,2822,217,2823,414,0
20150105.225055,2822,200,245192,-124,2822,120,2823,414,0
20150105.225055,2822,28,245220,-10,2822,108,2823,414,0
20150105.225056,2822,22,245242,-22,2822,97,2823,413,0
20150105.225056,2822,12,245254,4,2822,93,2823,413,0
20150105.225057,2822,10,245264,4,2822,142,2823,413,0
20150105.225057,2822,4,245268,4,2822,141,2823,418,0
20150105.225058,2822,4,245272,0,2822,138,2823,418,0
20150105.2251,2822,32,245304,-12,2822,343,2823,621,0
20150105.225101,2823,4,245308,-4,2822,344,2823,620,1
20150105.225101,2823,18,245326,0,2822,358,2823,611,1
20150105.225102,2822,2,245328,0,2822,360,2823,611,0
20150105.225106,2823,2,245330,-2,2822,262,2823,618,1
20150105.225106,2822,36,245366,12,2822,250,2823,618,0
20150105.225108,2822,2,245368,0,2822,255,2823,617,0
20150105.225109,2822,10,245378,-10,2822,243,2823,597,0
20150105.22511,2822,2,245380,-2,2822,242,2823,597,0
20150105.22511,2823,2,245382,0,2822,253,2823,595,1
20150105.225111,2822,2,245384,-2,2822,242,2823,603,0
20150105.225112,2823,8,245392,-8,2822,244,2823,599,1
20150105.225112,2822,2,245394,-2,2822,248,2823,613,0
20150105.225113,2822,48,245442,-46,2822,227,2823,614,0
20150105.225113,2822,30,245472,-26,2822,212,2823,615,0
20150105.225115,2823,6,245478,0,2822,209,2823,612,1
20150105.225116,2822,2,245480,0,2822,211,2823,610,0
20150105.225116,2822,10,245490,-10,2822,209,2823,610,0
20150105.225117,2822,4,245494,-4,2822,208,2823,609,0
20150105.225119,2823,4,245498,-4,2822,236,2823,612,1
20150105.225122,2822,2,245500,-2,2822,237,2823,627,0
20150105.225123,2823,4,245504,-2,2822,164,2823,626,1
20150105.225126,2823,4,245508,-4,2822,169,2823,625,1
20150105.225126,2822,2,245510,-2,2822,169,2823,625,0
20150105.225128,2822,2,245512,0,2822,177,2823,626,0
20150105.225129,2822,2,245514,0,2822,254,2823,626,0
20150105.225129,2822,4,245518,-4,2822,252,2823,628,0
20150105.22513,2823,2,245520,2,2822,252,2823,627,1
20150105.225133,2822,24,245544,-14,2822,260,2823,634,0
20150105.225134,2822,2,245546,0,2822,259,2823,614,0
20150105.225134,2822,64,245610,18,2822,212,2823,629,0
20150105.225135,2822,10,245620,0,2822,208,2823,648,0
20150105.225136,2822,2,245622,0,2822,207,2823,649,0
20150105.225137,2822,2,245624,-2,2822,208,2823,650,0
20150105.225138,2822,2,245626,-2,2822,207,2823,655,0
20150105.225138,2822,2,245628,-2,2822,206,2823,655,0
20150105.22514,2822,2,245630,-2,2822,205,2823,675,0
20150105.225141,2822,2,245632,-2,2822,207,2823,675,0
20150105.225142,2822,30,245662,-24,2822,192,2823,676,0
20150105.225142,2822,2,245664,0,2822,191,2823,676,0
20150105.225144,2822,6,245670,-2,2822,188,2823,656,0
20150105.225144,2822,204,245874,-154,2822,101,2823,657,0
20150105.225145,2822,2,245876,0,2822,100,2823,657,0
20150105.225145,2822,44,245920,-14,2821,230,2823,673,0
20150105.225146,2822,112,246032,-110,2822,17,2823,673,0
20150105.225146,2822,10,246042,-10,2821,230,2823,675,0
20150105.225147,2822,2,246044,-2,2821,230,2823,675,0
20150105.225148,2822,24,246068,-2,2821,290,2822,30,0
20150105.225148,2822,2,246070,0,2821,290,2822,29,0
20150105.225149,2821,610,246680,362,2820,388,2821,597,0
20150105.225149,2820,10,246690,0,2820,371,2821,598,0
20150105.22515,2820,8,246698,2,2820,371,2821,597,0
20150105.225151,2820,50,246748,10,2820,354,2821,213,0
20150105.225152,2821,2,246750,0,2820,362,2821,197,1
20150105.225153,2821,394,247144,138,2820,362,2822,138,1
20150105.225154,2821,2,247146,0,2821,16,2822,131,1
20150105.225154,2821,6,247152,-2,2821,14,2822,138,1
20150105.225155,2822,22,247174,0,2821,17,2822,128,1
20150105.225156,2821,22,247196,-18,2821,55,2822,129,0
20150105.225157,2821,180,247376,172,2820,439,2821,13,0
20150105.225157,2821,4,247380,4,2820,444,2821,13,0
20150105.225158,2821,26,247406,-4,2820,444,2822,136,0
20150105.225158,2821,6,247412,0,2820,445,2822,146,0
20150105.225159,2821,4,247416,2,2820,446,2822,148,0
20150105.2252,2821,2,247418,0,2821,23,2822,148,0
20150105.225201,2821,2,247420,0,2821,23,2822,148,0
20150105.225201,2821,6,247426,0,2821,20,2822,149,0
20150105.225202,2821,4,247430,2,2821,18,2822,150,0
20150105.225202,2821,6,247436,2,2821,97,2822,151,0
20150105.225203,2821,16,247452,8,2821,106,2822,133,0
20150105.225204,2821,2,247454,0,2821,106,2822,136,0
20150105.225205,2822,4,247458,0,2821,107,2822,135,1
20150105.225206,2821,2,247460,0,2821,95,2822,152,0
20150105.225207,2821,18,247478,18,2821,94,2822,152,0
20150105.225207,2821,2,247480,0,2821,93,2822,152,0
20150105.225208,2821,4,247484,0,2821,91,2822,164,0
20150105.225209,2821,8,247492,2,2821,87,2822,167,0
20150105.22521,2821,10,247502,-10,2821,83,2822,175,0
20150105.22521,2821,2,247504,-2,2821,82,2822,175,0
20150105.225211,2821,20,247524,-10,2821,75,2822,180,0
20150105.225211,2821,172,247696,-30,2820,488,2821,2,0
20150105.225212,2821,12,247708,-6,2820,489,2821,5,0
20150105.225213,2820,2,247710,2,2820,493,2821,16,0
20150105.225214,2821,12,247722,2,2820,495,2821,10,1
20150105.225215,2821,2,247724,-2,2820,496,2821,29,1
20150105.225216,2820,2,247726,0,2820,502,2821,30,0
20150105.225216,2820,4,247730,0,2820,501,2821,29,0
20150105.225217,2821,8,247738,-2,2820,494,2821,48,1
20150105.225218,2821,2,247740,0,2820,494,2821,49,1
20150105.225218,2820,2,247742,0,2820,493,2821,65,0
20150105.225219,2820,8,247750,4,2820,489,2821,68,0
20150105.22522,2820,2,247752,2,2820,491,2821,73,0
20150105.225222,2821,20,247772,2,2820,515,2821,67,1
20150105.225223,2820,20,247792,20,2820,511,2821,70,0
20150105.225224,2821,2,247794,-2,2820,511,2821,72,1
20150105.225225,2821,4,247798,-4,2820,525,2821,70,1
20150105.225226,2820,2,247800,0,2820,525,2821,72,0
20150105.225228,2821,42,247842,2,2820,550,2821,52,1
20150105.225229,2821,104,247946,4,2820,532,2822,274,1
20150105.225229,2820,4,247950,4,2821,5,2822,274,0
20150105.22523,2821,14,247964,0,2821,27,2822,275,1
20150105.225231,2821,54,248018,-2,2820,545,2822,276,1
20150105.225231,2821,4,248022,-2,2820,615,2821,49,1
20150105.225232,2820,10,248032,6,2820,595,2821,126,0
20150105.225232,2821,2,248034,2,2820,596,2821,136,1
20150105.225233,2821,2,248036,2,2820,596,2821,135,1
20150105.225234,2821,6,248042,-2,2820,595,2821,202,1
20150105.225234,2821,2,248044,2,2820,596,2821,203,1
20150105.225235,2820,104,248148,-4,2820,546,2821,201,0
20150105.225236,2821,4,248152,4,2820,546,2821,200,1
20150105.225237,2821,2,248154,2,2820,546,2821,214,1
20150105.225238,2821,2,248156,2,2820,547,2821,219,1
20150105.225239,2820,2,248158,2,2820,548,2821,220,0
20150105.225239,2820,6,248164,4,2820,546,2821,219,0
20150105.22524,2820,10,248174,6,2820,545,2821,216,0
20150105.22524,2821,2,248176,0,2820,545,2821,215,1
20150105.225241,2820,2,248178,2,2820,552,2821,205,0
20150105.225244,2821,4,248182,4,2820,556,2821,212,1
20150105.225244,2821,10,248192,10,2820,559,2821,207,1
20150105.225246,2820,20,248212,20,2820,542,2821,220,0
20150105.225248,2820,20,248232,0,2820,560,2821,254,0
20150105.22525,2821,2,248234,2,2820,568,2821,254,1
20150105.225251,2820,4,248238,4,2820,566,2821,255,0
20150105.225251,2821,2,248240,0,2820,566,2821,254,1
20150105.225251,2821,30,248270,0,2820,574,2821,239,1
20150105.225252,2820,4,248274,0,2820,572,2821,239,0
20150105.225253,2820,100,248374,-46,2820,508,2821,240,0
20150105.225254,2820,4,248378,4,2820,513,2821,242,0
20150105.225255,2820,20,248398,-2,2820,496,2821,257,0
20150105.225256,2821,34,248432,22,2820,497,2821,256,1
20150105.225257,2821,2,248434,2,2820,497,2821,250,1
20150105.225257,2820,14,248448,12,2820,490,2821,250,0
20150105.225301,2821,14,248462,6,2820,497,2821,350,1
20150105.225301,2820,34,248496,10,2820,483,2821,360,0
20150105.225303,2820,6,248502,0,2820,490,2821,361,0
20150105.225304,2820,2,248504,0,2820,489,2821,362,0
20150105.225304,2821,402,248906,-332,2820,497,2821,146,1
20150105.225308,2821,102,249008,42,2820,599,2821,251,1
20150105.225314,2821,2,249010,-2,2820,623,2821,257,1
20150105.225314,2821,2,249012,0,2820,624,2821,258,1
20150105.225315,2821,120,249132,-100,2820,620,2821,211,1
20150105.225315,2820,4,249136,0,2820,620,2821,211,0
20150105.225316,2821,120,249256,8,2820,613,2821,155,1
20150105.225317,2821,60,249316,-16,2820,596,2821,147,1
20150105.225318,2821,26,249342,2,2820,707,2821,136,1
20150105.225319,2821,232,249574,24,2820,710,2821,20,1
20150105.225319,2820,42,249616,-30,2820,711,2822,309,0
20150105.22532,2821,46,249662,-44,2821,44,2822,287,1
20150105.225321,2821,4,249666,4,2821,43,2822,287,1
20150105.225322,2821,2,249668,0,2821,44,2822,287,1
20150105.225323,2821,4,249672,4,2821,42,2822,287,1
20150105.225326,2821,4,249676,0,2821,42,2822,287,1
20150105.225327,2821,2,249678,2,2821,42,2822,287,1
20150105.225328,2821,2,249680,2,2821,43,2822,288,1
20150105.225329,2821,2,249682,0,2821,46,2822,288,1
20150105.225337,2821,8,249690,8,2821,162,2822,291,1
20150105.225338,2821,40,249730,34,2821,142,2822,291,1
20150105.225339,2821,2,249732,0,2821,141,2822,291,1
20150105.22534,2821,2,249734,0,2821,140,2822,291,1
20150105.225344,2821,2,249736,0,2821,149,2822,302,1
20150105.225345,2821,6,249742,0,2821,147,2822,304,1
20150105.225346,2822,2,249744,-2,2821,150,2822,303,1
20150105.225349,2822,2,249746,-2,2821,156,2822,329,1
20150105.225349,2822,2,249748,0,2821,156,2822,330,1
20150105.225352,2821,12,249760,-2,2821,153,2822,335,0
20150105.225353,2821,10,249770,2,2821,148,2822,336,0
20150105.225358,2821,296,250066,56,2820,774,2821,120,0
20150105.2254,2821,10,250076,0,2820,766,2821,127,0
20150105.2254,2821,10,250086,10,2820,698,2821,124,0
20150105.225402,2821,4,250090,4,2820,681,2821,255,0
20150105.225404,2821,124,250214,74,2820,579,2821,276,0
20150105.225405,2820,10,250224,-10,2820,473,2821,266,0
20150105.225406,2820,946,251170,598,2819,933,2820,326,0
20150105.225407,2820,80,251250,20,2819,719,2820,327,0
20150105.225408,2819,20,251270,10,2819,713,2820,337,0
20150105.225408,2819,4,251274,0,2819,691,2820,378,0
20150105.225409,2819,18,251292,0,2819,684,2820,378,0
20150105.225409,2819,16,251308,-8,2819,679,2820,378,0
20150105.22541,2819,4,251312,-4,2819,677,2820,378,0
20150105.225411,2819,4,251316,0,2819,676,2820,377,0
20150105.225411,2819,2,251318,0,2819,666,2820,377,0
20150105.225412,2820,20,251338,0,2819,666,2820,368,1
20150105.225412,2820,14,251352,-10,2819,657,2820,368,1
20150105.225413,2819,10,251362,-10,2819,651,2820,370,0
20150105.225414,2820,4,251366,4,2819,644,2820,469,1
20150105.225414,2819,16,251382,-6,2819,641,2820,494,0
20150105.225415,2819,14,251396,-14,2819,465,2820,494,0
20150105.225416,2820,10,251406,10,2819,466,2820,489,1
20150105.225417,2819,4,251410,-4,2819,469,2820,489,0
20150105.225417,2820,6,251416,0,2819,468,2820,472,1
20150105.225418,2819,44,251460,-34,2819,447,2820,488,0
20150105.225418,2820,34,251494,0,2819,431,2820,486,1
20150105.225419,2819,50,251544,-16,2819,412,2820,483,0
20150105.22542,2819,8,251552,0,2819,408,2820,483,0
20150105.225421,2820,2,251554,2,2819,414,2820,584,1
20150105.225422,2819,2,251556,0,2819,418,2820,585,0
20150105.225423,2819,12,251568,0,2819,421,2820,589,0
20150105.225425,2819,2,251570,-2,2819,422,2820,613,0
20150105.225426,2820,12,251582,0,2819,428,2820,610,1
20150105.225427,2819,6,251588,0,2819,497,2820,611,0
20150105.225428,2819,200,251788,32,2819,404,2820,635,0
20150105.225429,2820,10,251798,-6,2819,407,2820,627,1
20150105.22543,2819,2,251800,-2,2819,406,2820,627,0
20150105.225432,2820,4,251804,2,2819,407,2820,615,1
20150105.225432,2820,2,251806,2,2819,422,2820,619,1
20150105.225433,2819,4,251810,-4,2819,420,2820,619,0
20150105.225434,2820,94,251904,0,2819,420,2820,572,1
20150105.225436,2819,2,251906,0,2819,414,2820,590,0
20150105.225436,2819,8,251914,-8,2819,411,2820,597,0
20150105.225437,2820,22,251936,22,2819,411,2820,591,1
20150105.225439,2820,2,251938,2,2819,411,2820,591,1
20150105.22544,2819,20,251958,8,2819,408,2820,596,0
20150105.225444,2819,6,251964,0,2819,455,2820,625,0
20150105.225445,2819,2,251966,-2,2819,454,2820,625,0
20150105.225445,2820,1058,253024,-328,2819,554,2820,97,1
20150105.225445,2820,194,253218,-50,2819,555,2821,422,1
20150105.225448,2820,2,253220,2,2820,70,2821,423,1
20150105.225449,2820,20,253240,-2,2820,60,2821,423,1
20150105.22545,2820,10,253250,0,2820,65,2821,444,1
20150105.225451,2820,60,253310,60,2820,35,2821,444,1
20150105.225453,2820,2,253312,0,2820,98,2821,487,1
20150105.225455,2820,2,253314,0,2820,204,2821,487,1
20150105.225456,2820,2,253316,2,2820,206,2821,487,1
20150105.225457,2820,2,253318,0,2820,209,2821,487,1
20150105.225458,2821,2,253320,2,2820,209,2821,467,1
20150105.225459,2820,2,253322,0,2820,206,2821,467,0
20150105.2255,2820,100,253422,100,2820,157,2821,467,0
20150105.225501,2820,2,253424,2,2820,156,2821,467,0
20150105.225502,2820,2,253426,2,2820,155,2821,468,0
20150105.225503,2820,100,253526,98,2820,125,2821,509,0
20150105.225503,2821,20,253546,20,2820,125,2821,499,1
20150105.225509,2821,14,253560,14,2820,136,2821,504,1
20150105.225509,2820,14,253574,2,2820,144,2821,499,0
20150105.225513,2821,2,253576,2,2820,155,2821,548,1
20150105.225514,2821,2,253578,0,2820,155,2821,547,1
20150105.225516,2820,4,253582,0,2820,155,2821,566,0
20150105.225518,2821,2,253584,2,2820,156,2821,596,1
20150105.225519,2821,10,253594,8,2820,162,2821,595,1
20150105.225519,2821,2,253596,2,2820,163,2821,594,1
20150105.22552,2821,4,253600,2,2820,175,2821,592,1
20150105.22552,2821,4,253604,4,2820,175,2821,590,1
20150105.225521,2821,4,253608,0,2820,195,2821,588,1
20150105.225522,2821,4,253612,4,2820,195,2821,586,1
20150105.225531,2820,10,253622,10,2820,211,2821,582,0
20150105.225535,2820,2,253624,0,2820,214,2821,585,0
20150105.225536,2821,2,253626,2,2820,214,2821,584,1
20150105.225537,2820,4,253630,4,2820,217,2821,584,0
20150105.225538,2821,40,253670,0,2820,217,2821,564,1
20150105.225541,2820,8,253678,0,2820,243,2821,567,0
20150105.225542,2820,4,253682,4,2820,242,2821,567,0
20150105.225543,2820,2,253684,2,2820,241,2821,567,0
20150105.225549,2820,18,253702,0,2820,244,2821,567,0
20150105.22555,2820,26,253728,20,2820,249,2821,549,0
20150105.225551,2821,2,253730,0,2820,249,2821,548,1
20150105.225551,2821,2,253732,2,2820,249,2821,547,1
20150105.225553,2821,2,253734,2,2820,249,2821,546,1
20150105.225554,2821,4,253738,4,2820,260,2821,544,1
20150105.225554,2821,208,253946,198,2820,260,2821,434,1
20150105.225558,2820,20,253966,0,2820,252,2821,429,0
20150105.225559,2821,2,253968,2,2820,253,2821,430,1
20150105.225559,2821,2,253970,0,2820,254,2821,429,1
20150105.225601,2821,4,253974,4,2820,255,2821,435,1
20150105.225603,2821,2,253976,2,2820,255,2821,433,1
20150105.225604,2821,2,253978,2,2820,254,2821,432,1
20150105.225606,2821,6,253984,4,2820,254,2821,429,1
20150105.225606,2820,2,253986,0,2820,253,2821,429,0
20150105.225608,2820,188,254174,62,2820,194,2821,430,0
20150105.225608,2820,12,254186,12,2820,191,2821,430,0
20150105.225617,2820,22,254208,20,2820,274,2821,313,0
20150105.225617,2821,10,254218,10,2820,274,2821,308,1
20150105.225618,2821,100,254318,24,2820,278,2821,258,1
20150105.225619,2821,2,254320,0,2820,278,2821,257,1
20150105.22562,2820,2,254322,0,2820,277,2821,257,0
20150105.225622,2821,2,254324,0,2820,262,2821,256,1
20150105.225628,2821,2,254326,0,2820,373,2821,255,1
20150105.225629,2820,10,254336,10,2820,368,2821,255,0
20150105.225631,2821,4,254340,0,2820,379,2821,258,1
20150105.225632,2820,42,254382,32,2820,360,2821,258,0
20150105.225634,2821,2,254384,0,2820,362,2821,259,1
20150105.225634,2821,20,254404,0,2820,362,2821,252,1
20150105.225636,2820,4,254408,-4,2820,364,2821,252,0
20150105.225636,2820,2,254410,0,2820,363,2821,252,0
20150105.225639,2821,2,254412,0,2820,367,2821,251,1
20150105.22564,2821,2,254414,0,2820,367,2821,250,1
20150105.225642,2821,76,254490,2,2820,380,2821,213,1
20150105.225644,2821,2,254492,0,2820,391,2821,212,1
20150105.225647,2820,26,254518,-26,2820,389,2821,219,0
20150105.225648,2821,2,254520,0,2820,388,2821,218,1
20150105.225652,2821,20,254540,0,2820,385,2821,209,1
20150105.225654,2821,360,254900,-226,2821,221,2822,466,1
20150105.225654,2821,2,254902,-2,2821,222,2822,442,1
20150105.225657,2821,10,254912,-8,2821,1,2822,452,1
20150105.225657,2821,4,254916,-2,2820,447,2822,452,1
20150105.225659,2821,20,254936,0,2821,46,2822,453,1
20150105.2257,2821,4,254940,0,2821,155,2822,446,1
20150105.225701,2821,2,254942,0,2821,154,2822,447,1
20150105.225701,2821,2,254944,0,2821,154,2822,452,1
20150105.225702,2821,2,254946,2,2821,153,2822,453,1
20150105.225702,2822,2,254948,0,2821,153,2822,452,1
20150105.225704,2821,2,254950,-2,2821,153,2822,456,0
20150105.225705,2821,98,255048,20,2821,108,2822,479,0
20150105.225705,2821,186,255234,186,2821,15,2822,479,0
20150105.225707,2821,6,255240,6,2821,13,2822,479,0
20150105.225707,2821,4,255244,0,2821,11,2822,498,0
20150105.225709,2821,2,255246,2,2821,45,2822,509,0
20150105.22571,2822,6,255252,0,2821,44,2822,508,1
20150105.225712,2821,2,255254,0,2821,44,2822,508,0
20150105.225713,2822,2,255256,0,2821,45,2822,507,1
20150105.225714,2821,92,255348,-8,2820,461,2821,67,0
20150105.225714,2821,30,255378,0,2820,461,2821,52,0
20150105.225714,2821,2,255380,0,2820,461,2821,51,0
20150105.225715,2821,2,255382,0,2820,461,2821,51,0
20150105.225717,2821,42,255424,0,2820,460,2821,40,0
20150105.225717,2821,80,255504,-26,2820,461,2822,510,0
20150105.225719,2822,2,255506,0,2821,5,2822,510,1
20150105.225719,2821,12,255518,12,2820,555,2821,10,0
20150105.22572,2821,4,255522,4,2820,555,2821,9,0
20150105.22572,2821,18,255540,14,2820,555,2822,527,0
20150105.225721,2822,6,255546,0,2821,33,2822,524,1
20150105.225722,2822,30,255576,-20,2821,35,2822,509,1
20150105.225724,2821,4,255580,2,2821,33,2822,529,0
20150105.225728,2821,42,255622,-10,2821,18,2822,548,0
20150105.225731,2821,120,255742,-32,2821,42,2822,550,0
20150105.225733,2822,4,255746,2,2821,47,2822,552,1
20150105.225737,2821,4,255750,0,2821,80,2822,557,0
20150105.225738,2822,2,255752,0,2821,83,2822,556,1
20150105.225741,2821,2,255754,0,2821,162,2822,538,0
20150105.225742,2821,2,255756,2,2821,166,2822,523,0
20150105.225745,2822,1066,256822,290,2822,468,2823,377,1
20150105.225745,2822,2,256824,-2,2821,199,2822,99,1
20150105.225747,2822,2,256826,-2,2821,202,2822,13,1
20150105.225747,2822,36,256862,12,2822,3,2823,368,1
20150105.225748,2822,6,256868,0,2822,1,2823,368,1
20150105.225748,2822,2,256870,0,2821,229,2822,13,1
20150105.225749,2822,22,256892,18,2821,229,2822,2,1
20150105.22575,2822,6,256898,4,2822,17,2823,373,1
20150105.225751,2822,36,256934,0,2821,235,2822,19,1
20150105.225752,2822,80,257014,-36,2821,237,2823,377,1
20150105.225754,2822,6,257020,-4,2821,238,2822,7,1
20150105.225755,2822,2,257022,0,2821,238,2822,7,1
20150105.225755,2822,62,257084,8,2821,238,2823,373,1
20150105.225758,2822,4,257088,0,2821,239,2823,374,1
20150105.225758,2822,22,257110,2,2822,33,2823,374,1
20150105.225759,2822,68,257178,-2,2821,240,2822,2,1
20150105.225759,2823,172,257350,-64,2821,240,2823,322,1
20150105.2258,2823,28,257378,0,2822,4,2823,308,1
20150105.2258,2822,16,257394,-6,2821,239,2822,2,0
20150105.225802,2822,26,257420,22,2822,18,2823,318,0
20150105.225803,2823,12,257432,0,2822,13,2823,317,1
20150105.225804,2822,2,257434,2,2822,26,2823,318,0
20150105.225805,2822,2,257436,0,2822,192,2823,318,0
20150105.225807,2822,22,257458,-20,2822,190,2823,305,0
20150105.225809,2822,28,257486,-2,2822,204,2823,320,0
20150105.225809,2823,40,257526,-40,2822,204,2823,301,1
20150105.22581,2822,2,257528,2,2822,205,2823,403,0
20150105.225811,2823,2,257530,0,2822,240,2823,417,1
20150105.225812,2823,2,257532,-2,2822,255,2823,402,1
20150105.225816,2822,2,257534,2,2822,248,2823,404,0
20150105.225816,2822,2,257536,2,2822,263,2823,414,0
20150105.225818,2823,2,257538,0,2822,263,2823,445,1
20150105.225818,2822,2,257540,2,2822,265,2823,445,0
20150105.225819,2823,40,257580,0,2822,265,2823,425,1
20150105.225822,2823,12,257592,0,2822,268,2823,424,1
20150105.225823,2822,2,257594,0,2822,252,2823,441,0
20150105.225825,2822,4,257598,2,2822,254,2823,573,0
20150105.225829,2823,30,257628,-20,2822,354,2823,569,1
20150105.22583,2823,2,257630,-2,2822,354,2823,568,1
20150105.225831,2823,2,257632,0,2822,358,2823,566,1
20150105.225834,2822,10,257642,10,2822,356,2823,566,0
20150105.225834,2822,6,257648,0,2822,361,2823,564,0
20150105.225836,2822,274,257922,-90,2822,225,2823,565,0
20150105.225837,2822,132,258054,80,2822,163,2823,562,0
20150105.225837,2822,6,258060,0,2822,160,2823,562,0
20150105.225838,2822,320,258380,-206,2821,161,2822,381,0
20150105.225839,2822,4,258384,0,2821,118,2822,433,0
20150105.225839,2822,12,258396,0,2821,118,2822,429,0
20150105.225845,2822,14,258410,-4,2821,115,2822,441,0
20150105.225847,2822,202,258612,106,2821,19,2822,440,0
20150105.225847,2822,2,258614,0,2821,19,2822,440,0
20150105.225849,2822,4,258618,-4,2821,19,2822,439,0
20150105.225851,2822,2,258620,2,2821,19,2822,79,0
20150105.225855,2822,2,258622,0,2821,126,2822,68,0
20150105.225856,2821,78,258700,-6,2821,87,2822,85,0
20150105.2259,2822,8,258708,0,2821,64,2822,117,1
20150105.225904,2822,2,258710,-2,2821,64,2822,119,1
20150105.225904,2822,4,258714,0,2821,66,2822,117,1
20150105.225909,2822,196,258910,-120,2821,4148,2823,516,1
20150105.225911,2821,2,258912,0,2821,136,2822,15,0
20150105.225914,2822,4,258916,4,2821,139,2822,14,1
20150105.225915,2822,2,258918,2,2821,140,2822,163,1
20150105.225915,2822,100,259018,92,2821,140,2822,117,1
20150105.225924,2822,10,259028,0,2821,227,2822,121,1
20150105.225926,2822,2,259030,0,2821,226,2822,135,1
20150105.225928,2822,2,259032,2,2821,226,2822,134,1
20150105.225929,2822,2,259034,2,2821,227,2822,149,1
20150105.22593,2822,8,259042,8,2821,208,2822,150,1
20150105.22593,2822,16,259058,16,2821,208,2822,150,1
20150105.225931,2822,10,259068,10,2821,208,2822,149,1
20150105.225932,2822,8,259076,8,2821,208,2822,150,1
20150105.225933,2822,2,259078,2,2821,209,2822,149,1
20150105.225936,2822,6,259084,6,2821,228,2822,150,1
20150105.225938,2822,2,259086,2,2821,232,2822,151,1
20150105.225938,2822,24,259110,24,2821,232,2822,141,1
20150105.225942,2822,2,259112,2,2821,232,2822,99,1
20150105.225945,2822,200,259312,154,2822,700,2823,588,1
20150105.225945,2822,10,259322,0,2822,696,2823,587,1
20150105.225948,2822,20,259342,20,2822,688,2823,589,1
20150105.225948,2822,10,259352,10,2822,683,2823,589,1
20150105.225948,2822,14,259366,14,2822,676,2823,589,1
20150105.225951,2823,2,259368,-2,2822,676,2823,579,1
20150105.225953,2822,2,259370,0,2822,682,2823,590,0
20150105.225957,2823,6,259376,2,2822,682,2823,594,1
20150105.225958,2823,2,259378,-2,2822,682,2823,599,1
20150105.225959,2823,6,259384,2,2822,682,2823,596,1
20150105.230005,2823,14,259398,0,2822,679,2823,609,1
20150105.23001,2823,4,259402,-4,2822,686,2823,568,1
20150105.23001,2823,424,259826,-60,2822,686,2823,356,1
20150105.230011,2823,2,259828,0,2822,686,2823,355,1
20150105.230012,2823,44,259872,0,2822,686,2823,364,1
20150105.230013,2823,92,259964,-32,2822,686,2823,318,1
20150105.230014,2823,2,259966,-2,2822,726,2823,317,1
20150105.230015,2823,2,259968,0,2822,726,2823,316,1
20150105.230016,2823,4,259972,-2,2822,727,2823,275,1
20150105.230017,2823,16,259988,-4,2822,687,2823,268,1
20150105.230018,2823,540,260528,-276,2823,41,2824,762,1
20150105.230018,2823,4,260532,-4,2823,50,2824,763,1
20150105.23002,2823,2,260534,0,2823,84,2824,683,1
20150105.230022,2823,2,260536,-2,2823,93,2824,685,1
20150105.230023,2823,10,260546,-8,2823,88,2824,685,1
20150105.230024,2823,10,260556,0,2823,87,2824,701,1
20150105.230025,2823,2,260558,-2,2823,86,2824,713,1
20150105.230026,2823,172,260730,-138,2822,684,2824,713,1
20150105.230026,2823,24,260754,-24,2822,684,2823,11,1
20150105.230027,2824,222,260976,82,2822,684,2824,613,1
20150105.230028,2824,2,260978,0,2823,13,2824,610,1
20150105.230029,2823,4,260982,-2,2823,11,2824,593,0
20150105.230032,2823,20,261002,-20,2823,1,2824,581,0
20150105.230033,2823,6,261008,0,2822,689,2823,1,0
20150105.230034,2823,6,261014,6,2822,690,2824,611,0
20150105.230035,2823,2,261016,0,2822,689,2824,612,0
20150105.230035,2824,4,261020,0,2822,689,2824,612,1
20150105.230036,2823,26,261046,-2,2822,689,2824,615,0
20150105.230037,2823,2,261048,0,2823,1,2824,616,0
20150105.230037,2823,4,261052,0,2822,689,2824,616,0
20150105.230039,2823,10,261062,0,2822,790,2824,618,0
20150105.230041,2823,2,261064,0,2822,792,2823,375,0
20150105.230041,2823,2,261066,-2,2822,792,2823,374,0
20150105.230047,2823,2,261068,0,2822,798,2823,384,0
20150105.230051,2823,6,261074,0,2822,691,2823,400,0
20150105.230054,2823,30,261104,-30,2822,691,2823,384,0
20150105.230059,2823,18,261122,-18,2822,724,2823,364,0
20150105.230105,2823,50,261172,-50,2822,717,2823,366,0
20150105.230105,2823,50,261222,0,2822,717,2823,341,0
20150105.230107,2823,2,261224,0,2822,717,2823,341,0
20150105.230108,2822,14,261238,-10,2822,715,2823,336,0
20150105.230109,2822,4,261242,0,2822,713,2823,339,0
20150105.230109,2822,2,261244,0,2822,712,2823,339,0
20150105.230111,2823,4,261248,-4,2822,719,2823,325,1
20150105.230112,2822,2,261250,2,2822,718,2823,325,0
20150105.230114,2822,2,261252,0,2822,717,2823,352,0
20150105.230114,2822,4,261256,0,2822,715,2823,354,0
20150105.230117,2823,2,261258,-2,2822,715,2823,364,1
20150105.23012,2823,10,261268,0,2822,715,2823,373,1
20150105.230123,2823,2,261270,0,2822,716,2823,377,1
20150105.230125,2823,34,261304,-32,2822,715,2823,382,1
20150105.230126,2822,10,261314,10,2822,710,2823,382,0
20150105.230131,2823,2,261316,-2,2822,47,2823,462,1
20150105.230132,2822,94,261410,-44,2821,169,2822,15,0
20150105.230133,2822,2,261412,-2,2821,159,2822,33,0
20150105.230135,2821,2,261414,0,2821,158,2822,64,0
20150105.230136,2822,24,261438,0,2821,158,2822,36,1
20150105.230137,2822,58,261496,-38,2821,165,2822,17,1
20150105.230138,2821,2,261498,0,2821,157,2822,20,0
20150105.230139,2822,2,261500,0,2821,2164,2822,20,1
20150105.23014,2822,2,261502,0,2821,6165,2822,20,1
20150105.230142,2821,40,261542,0,2821,144,2822,34,0
20150105.230144,2821,2,261544,0,2821,147,2822,176,0
20150105.230149,2821,4,261548,0,2821,154,2822,351,0
20150105.230151,2821,8,261556,0,2821,153,2822,347,0
20150105.230151,2822,2,261558,-2,2821,153,2822,346,1
20150105.230152,2822,6,261564,4,2821,161,2822,353,1
20150105.230154,2822,8,261572,0,2821,161,2822,355,1
20150105.230154,2821,4,261576,0,2821,159,2822,355,0
20150105.230159,2822,30,261606,14,2821,156,2822,332,1
20150105.230201,2821,2,261608,0,2821,159,2822,346,0
20150105.230209,2821,2,261610,0,2821,163,2822,349,0
20150105.230211,2822,2,261612,2,2821,163,2822,378,1
20150105.230217,2821,2,261614,0,2821,167,2822,370,0
20150105.230218,2822,2,261616,0,2821,167,2822,371,1
20150105.230233,2821,10,261626,0,2821,169,2822,352,0
20150105.230234,2821,8,261634,0,2821,168,2822,335,0
20150105.230238,2821,6,261640,0,2821,165,2822,349,0
20150105.230241,2821,20,261660,16,2821,160,2822,352,0
20150105.230242,2821,2,261662,0,2821,159,2822,352,0
20150105.230244,2821,2,261664,0,2821,160,2822,350,0
20150105.230245,2821,4,261668,0,2821,158,2822,355,0
20150105.230246,2822,2,261670,0,2821,158,2822,354,1
20150105.23025,2822,2,261672,2,2821,158,2822,373,1
20150105.230251,2822,2,261674,2,2821,158,2822,373,1
20150105.230252,2822,2,261676,2,2821,158,2822,372,1
20150105.230253,2821,316,261992,94,2820,397,2821,330,0
20150105.230253,2821,2,261994,2,2820,397,2821,331,0
20150105.230255,2821,358,262352,346,2820,397,2821,152,0
20150105.230258,2821,2,262354,2,2820,397,2821,151,0
20150105.230258,2821,2,262356,2,2820,397,2821,150,0
20150105.230259,2821,8,262364,0,2820,427,2821,146,0
20150105.2303,2820,10,262374,4,2820,425,2821,146,0
20150105.2303,2820,8,262382,4,2820,424,2821,143,0
20150105.230301,2821,2,262384,2,2820,425,2821,142,1
20150105.230303,2821,2,262386,2,2820,424,2821,350,1
20150105.230304,2821,4,262390,2,2820,414,2821,530,1
20150105.230305,2820,2,262392,0,2820,413,2821,530,0
20150105.230306,2820,2,262394,0,2820,428,2821,530,0
20150105.230307,2820,2,262396,2,2820,425,2821,530,0
20150105.230309,2821,4,262400,4,2820,434,2821,528,1
20150105.23031,2821,4,262404,4,2820,434,2821,526,1
20150105.230311,2820,12,262416,10,2820,433,2821,506,0
20150105.230314,2821,2,262418,0,2820,440,2821,520,1
20150105.230318,2821,20,262438,20,2820,438,2821,530,1
20150105.23032,2821,2,262440,2,2820,439,2821,529,1
20150105.230321,2821,2,262442,0,2820,439,2821,528,1
20150105.230324,2821,1000,263442,-18,2820,450,2821,20,1
20150105.230326,2821,2,263444,0,2820,443,2821,19,1
20150105.230327,2821,4,263448,2,2820,443,2821,17,1
20150105.230327,2821,20,263468,4,2820,444,2821,7,1
20150105.230328,2821,14,263482,-4,2821,25,2822,391,1
20150105.230328,2821,2,263484,0,2821,36,2822,391,1
20150105.230332,2821,4,263488,0,2821,36,2822,391,1
20150105.230334,2822,62,263550,62,2821,35,2822,369,1
20150105.230336,2821,10,263560,8,2821,30,2822,362,0
20150105.230338,2822,2,263562,2,2821,34,2822,369,1
20150105.230338,2821,4,263566,0,2821,35,2822,369,0
20150105.230339,2821,2,263568,2,2821,34,2822,366,0
20150105.23034,2821,2,263570,2,2821,69,2822,366,0
20150105.230341,2821,2,263572,0,2821,88,2822,366,0
20150105.230343,2821,6,263578,0,2821,96,2822,366,0
20150105.230345,2821,2,263580,2,2821,95,2822,367,0
20150105.230349,2822,8,263588,0,2821,283,2822,326,1
20150105.23035,2821,80,263668,-28,2821,244,2822,344,0
20150105.230354,2821,2,263670,0,2821,210,2822,354,0
20150105.230355,2822,4,263674,4,2821,211,2822,352,1
20150105.230358,2822,2,263676,0,2821,216,2822,351,1
20150105.230359,2821,390,264066,-310,2820,551,2821,6,0
20150105.230401,2821,2,264068,0,2820,551,2821,5,0
20150105.230401,2821,12,264080,0,2821,1,2822,351,0
20150105.230403,2820,114,264194,100,2821,2,2822,339,0
20150105.230405,2821,2,264196,-2,2821,92,2822,340,1
20150105.230409,2821,8,264204,6,2821,104,2822,340,1
20150105.230415,2821,4,264208,0,2821,114,2822,349,1
20150105.230415,2821,2,264210,2,2821,114,2822,349,1
20150105.230419,2821,4,264214,2,2821,166,2822,340,1
20150105.230421,2821,60,264274,0,2821,101,2822,343,1
20150105.230424,2821,2,264276,0,2821,83,2822,335,1
20150105.230425,2822,4,264280,4,2821,84,2822,333,1
20150105.230429,2821,4,264284,4,2821,196,2822,333,0
20150105.230432,2822,22,264306,0,2821,197,2822,334,1
20150105.230437,2822,2,264308,2,2821,227,2822,334,1
20150105.230439,2821,10,264318,10,2821,221,2822,328,0
20150105.23044,2821,14,264332,14,2821,229,2822,313,0
20150105.230441,2822,2,264334,0,2821,259,2822,312,1
20150105.230444,2822,10,264344,10,2821,282,2822,316,1
20150105.230447,2822,24,264368,2,2821,278,2822,318,1
20150105.230448,2822,2,264370,0,2821,276,2822,317,1
20150105.230452,2821,2,264372,0,2821,365,2822,316,0
20150105.230453,2822,4,264376,0,2821,378,2822,314,1
20150105.230454,2821,2,264378,2,2821,377,2822,314,0
20150105.230456,2822,2,264380,2,2821,478,2822,313,1
20150105.230456,2821,2,264382,0,2821,478,2822,313,0
20150105.230457,2821,2,264384,2,2821,477,2822,313,0
20150105.230502,2822,12,264396,0,2821,476,2822,320,1
20150105.230506,2822,16,264412,16,2821,473,2822,313,1
20150105.230511,2822,4,264416,4,2821,473,2822,310,1
20150105.230512,2822,2,264418,2,2821,488,2822,163,1
20150105.230515,2822,2,264420,0,2821,496,2822,165,1
20150105.230516,2822,200,264620,-86,2821,497,2822,65,1
20150105.230516,2821,2,264622,0,2821,496,2822,65,0
20150105.230517,2821,2,264624,2,2821,496,2822,65,0
20150105.23052,2821,64,264688,62,2821,453,2822,112,0
20150105.23053,2821,20,264708,18,2821,463,2822,144,0
20150105.230532,2822,2,264710,0,2821,446,2822,144,1
20150105.230533,2822,16,264726,2,2821,446,2822,136,1
20150105.230544,2822,2,264728,0,2821,436,2822,131,1
20150105.230549,2821,2,264730,2,2821,452,2822,131,0
20150105.230552,2822,4,264734,-4,2821,452,2822,152,1
20150105.230553,2822,2,264736,0,2821,452,2822,151,1
20150105.230557,2821,2,264738,0,2821,438,2822,158,0
20150105.230606,2822,272,265010,-208,2821,438,2822,25,1
20150105.230608,2822,2,265012,0,2821,439,2822,69,1
20150105.230616,2821,2,265014,0,2821,400,2822,346,0
20150105.230619,2821,2,265016,2,2821,399,2822,352,0
20150105.230622,2821,4,265020,0,2821,400,2822,345,0
20150105.230623,2821,4,265024,4,2821,413,2822,345,0
20150105.230624,2822,2,265026,0,2821,412,2822,344,1
20150105.230626,2822,4,265030,-4,2821,412,2822,344,1
20150105.230627,2821,2,265032,0,2821,411,2822,344,0
20150105.230632,2821,6,265038,0,2821,404,2822,350,0
20150105.230635,2821,2,265040,0,2821,403,2822,352,0
20150105.23064,2821,12,265052,0,2821,398,2822,355,0
20150105.230642,2821,16,265068,8,2821,390,2822,366,0
20150105.230645,2821,2,265070,0,2821,376,2822,375,0
20150105.230646,2822,10,265080,-10,2821,376,2822,370,1
20150105.230647,2821,400,265480,156,2821,176,2822,370,0
20150105.230648,2821,352,265832,206,2820,740,2821,3,0
20150105.230649,2821,2,265834,-2,2820,740,2821,19,0
20150105.230651,2821,10,265844,-6,2820,737,2821,13,0
20150105.230652,2821,6,265850,0,2820,737,2821,11,0
20150105.230655,2820,10,265860,8,2820,742,2821,27,0
20150105.230659,2820,2,265862,2,2820,733,2821,295,0
20150105.230659,2820,4,265866,0,2820,731,2821,295,0
20150105.2307,2820,2,265868,0,2820,727,2821,295,0
20150105.230706,2820,8,265876,2,2820,727,2821,280,0
20150105.230711,2820,2,265878,2,2820,749,2821,40,0
20150105.230713,2821,2,265880,0,2820,749,2821,59,1
20150105.230714,2820,4,265884,0,2820,747,2821,60,0
20150105.230715,2821,10,265894,-8,2820,543,2821,56,1
20150105.230716,2821,104,265998,-72,2820,543,2821,4,1
20150105.230717,2821,2,266000,0,2820,546,2821,4,1
20150105.23072,2821,10,266010,2,2821,6,2822,250,1
20150105.230721,2821,14,266024,-2,2820,537,2822,251,1
20150105.230725,2821,12,266036,0,2820,535,2821,27,1
20150105.230726,2821,2,266038,2,2820,535,2821,51,1
20150105.230727,2821,2,266040,2,2820,536,2821,51,1
20150105.230728,2821,4,266044,4,2820,536,2821,57,1
20150105.230734,2820,14,266058,6,2820,2539,2821,334,0
20150105.230736,2821,2,266060,2,2820,2539,2821,363,1
20150105.230737,2821,2,266062,-2,2820,2539,2821,362,1
20150105.230739,2821,2,266064,0,2820,539,2821,84,1
20150105.230741,2820,1082,267146,860,2819,530,2820,475,0
20150105.230741,2820,32,267178,12,2819,530,2820,459,0
20150105.230742,2820,10,267188,0,2819,529,2820,454,0
20150105.230746,2820,10,267198,10,2819,638,2820,449,0
20150105.23075,2820,2,267200,2,2819,842,2820,449,0
20150105.230752,2820,24,267224,0,2819,843,2820,426,0
20150105.230752,2820,6,267230,6,2819,858,2820,423,0
20150105.230756,2820,4,267234,0,2819,759,2820,424,0
20150105.230758,2820,2,267236,2,2819,763,2820,454,0
20150105.230758,2820,2,267238,2,2819,764,2820,455,0
20150105.230759,2819,4,267242,0,2819,762,2820,455,0
20150105.2308,2820,2,267244,2,2819,764,2820,455,1
20150105.230801,2820,100,267344,0,2819,764,2820,375,1
20150105.230801,2819,20,267364,-18,2819,757,2820,375,0
20150105.230801,2820,28,267392,28,2819,762,2820,361,1
20150105.230803,2820,2,267394,2,2819,773,2820,375,1
20150105.230804,2820,2,267396,2,2819,773,2820,374,1
20150105.230804,2820,2,267398,2,2819,773,2820,373,1
20150105.230805,2820,6,267404,6,2819,773,2820,410,1
20150105.230805,2819,8,267412,-8,2819,771,2820,411,0
20150105.230807,2820,2,267414,0,2819,773,2820,410,1
20150105.230807,2819,2,267416,-2,2819,772,2820,410,0
20150105.230814,2819,6,267422,2,2819,782,2820,429,0
20150105.230815,2819,4,267426,-4,2819,781,2820,429,0
20150105.230816,2820,2,267428,0,2819,775,2820,444,1
20150105.230817,2819,2,267430,-2,2819,776,2820,454,0
20150105.23082,2820,2,267432,2,2819,788,2820,457,1
20150105.230821,2820,10,267442,10,2819,788,2820,446,1
20150105.230824,2820,4,267446,4,2819,789,2820,446,1
20150105.230824,2820,2,267448,2,2819,788,2820,445,1
20150105.230825,2820,2,267450,2,2819,788,2820,444,1
20150105.230826,2819,6,267456,-6,2819,785,2820,445,0
20150105.230827,2820,2,267458,2,2819,787,2820,444,1
20150105.230831,2819,4,267462,-4,2819,805,2820,443,0
20150105.230835,2820,2,267464,0,2819,801,2820,452,1
20150105.230837,2820,8,267472,6,2819,803,2820,451,1
20150105.230838,2820,12,267484,0,2819,800,2820,448,1
20150105.230842,2819,20,267504,0,2819,805,2820,438,0
20150105.230844,2820,4,267508,4,2819,806,2820,441,1
20150105.230845,2819,1614,269122,952,2818,601,2819,195,0
20150105.230846,2819,100,269222,100,2818,601,2819,145,0
20150105.230847,2819,10,269232,0,2818,605,2819,158,0
20150105.230848,2819,4,269236,2,2818,605,2819,156,0
20150105.230849,2818,4,269240,0,2818,603,2819,161,0
20150105.23085,2818,10,269250,6,2818,601,2819,161,0
20150105.23085,2818,40,269290,-4,2818,581,2819,160,0
20150105.230851,2818,12,269302,-12,2818,559,2819,160,0
20150105.230852,2818,4,269306,2,2818,560,2819,159,0
20150105.230852,2818,2,269308,0,2818,559,2819,159,0
20150105.230853,2818,4,269312,0,2818,558,2819,160,0
20150105.230854,2818,4,269316,-4,2818,561,2819,178,0
20150105.230855,2819,6,269322,4,2818,565,2819,177,1
20150105.230856,2818,2,269324,2,2818,563,2819,177,0
20150105.230857,2819,2,269326,2,2818,653,2819,177,1
20150105.230858,2819,378,269704,-106,2819,11,2820,476,1
20150105.230859,2819,52,269756,-20,2818,681,2820,469,1
20150105.230859,2818,8,269764,0,2818,649,2819,280,0
20150105.2309,2818,14,269778,-2,2818,643,2819,275,0
20150105.230901,2818,6,269784,0,2818,640,2819,280,0
20150105.230902,2818,6,269790,2,2818,656,2819,278,0
20150105.230903,2818,2,269792,0,2818,656,2819,278,0
20150105.230903,2819,2,269794,0,2818,656,2819,277,1
20150105.230904,2818,28,269822,2,2818,678,2819,264,0
20150105.230907,2818,2,269824,0,2818,704,2819,274,0
20150105.230907,2818,2,269826,0,2818,703,2819,274,0
20150105.230908,2819,2,269828,0,2818,701,2819,273,1
20150105.230909,2819,18,269846,0,2818,697,2819,264,1
20150105.230909,2819,2,269848,0,2818,697,2819,263,1
20150105.23091,2819,4,269852,0,2818,697,2819,262,1
20150105.23091,2819,2,269854,0,2818,698,2819,281,1
20150105.230911,2819,4,269858,0,2818,709,2819,279,1
20150105.230912,2819,8,269866,-2,2818,708,2819,275,1
20150105.230912,2819,2,269868,0,2818,708,2819,274,1
20150105.230913,2819,2,269870,-2,2818,724,2819,263,1
20150105.230914,2819,50,269920,-48,2818,717,2819,245,1
20150105.230915,2818,2,269922,-2,2818,718,2819,256,0
20150105.230917,2818,2,269924,-2,2818,717,2819,256,0
20150105.230917,2819,2,269926,0,2818,717,2819,265,1
20150105.230918,2819,2,269928,-2,2818,718,2819,264,1
20150105.230921,2819,4,269932,-4,2818,699,2819,296,1
20150105.230922,2819,2,269934,0,2818,679,2819,295,1
20150105.230923,2819,22,269956,-20,2818,680,2819,285,1
20150105.230925,2819,2,269958,-2,2818,693,2819,274,1
20150105.230925,2819,300,270258,-300,2818,708,2819,124,1
20150105.230926,2819,10,270268,0,2818,757,2819,119,1
20150105.230927,2819,8,270276,2,2818,756,2819,118,1
20150105.230928,2819,2,270278,0,2818,757,2819,118,1
20150105.230928,2819,2,270280,0,2818,757,2819,117,1
20150105.230928,2819,234,270514,-138,2818,772,2820,487,1
20150105.23093,2819,2,270516,2,2818,588,2819,12,1
20150105.23093,2820,144,270660,24,2819,2,2820,436,1
20150105.23093,2819,26,270686,16,2819,9,2820,436,0
20150105.230931,2820,2,270688,2,2819,10,2820,435,1
20150105.230931,2819,8,270696,8,2819,13,2820,435,0
20150105.230932,2819,10,270706,-4,2819,8,2820,435,0
20150105.230933,2819,32,270738,26,2818,581,2820,437,0
20150105.230935,2819,2,270740,2,2819,12,2820,444,0
20150105.230936,2819,2,270742,2,2819,11,2820,444,0
20150105.230936,2820,42,270784,38,2818,584,2819,1,1
20150105.230937,2819,4,270788,-2,2819,101,2820,434,0
20150105.230937,2819,22,270810,-2,2819,111,2820,434,0
20150105.230938,2819,16,270826,-16,2819,110,2820,445,0
20150105.230938,2819,4,270830,0,2819,91,2820,445,0
20150105.230939,2820,40,270870,40,2819,91,2820,425,1
20150105.230939,2820,14,270884,4,2819,90,2820,409,1
20150105.230944,2819,20,270904,-20,2819,98,2820,393,0
20150105.230945,2819,4,270908,0,2819,97,2820,392,0
20150105.230946,2820,60,270968,0,2819,99,2820,367,1
20150105.230947,2819,2,270970,0,2819,98,2820,376,0
20150105.230948,2820,2,270972,2,2819,99,2820,385,1
20150105.230954,2819,2,270974,-2,2819,160,2820,390,0
20150105.230957,2819,30,271004,-30,2819,157,2820,400,0
20150105.230959,2819,20,271024,-20,2819,152,2820,401,0
20150105.231,2820,2,271026,2,2819,152,2820,400,1
20150105.231003,2819,12,271038,0,2819,158,2820,406,0
20150105.231004,2820,20,271058,20,2819,158,2820,396,1
20150105.231005,2820,40,271098,0,2819,168,2820,377,1
20150105.231006,2819,2,271100,-2,2819,167,2820,377,0
20150105.231006,2819,10,271110,-10,2819,162,2820,377,0
20150105.23101,2820,2,271112,2,2819,192,2820,372,1
20150105.231018,2819,10,271122,-10,2819,217,2820,387,0
20150105.231021,2820,10,271132,10,2819,227,2820,374,1
20150105.231022,2820,20,271152,20,2819,237,2820,364,1
20150105.231022,2820,2,271154,2,2819,282,2820,363,1
20150105.231023,2819,2,271156,-2,2819,281,2820,363,0
20150105.231024,2819,2,271158,0,2819,280,2820,363,0
20150105.231027,2820,2,271160,2,2819,306,2820,362,1
20150105.231028,2820,4,271164,2,2819,292,2820,361,1
20150105.231033,2819,2,271166,-2,2819,351,2820,347,0
20150105.231035,2820,2,271168,2,2819,361,2820,357,1
20150105.231037,2820,100,271268,100,2819,369,2820,307,1
20150105.231038,2820,348,271616,40,2819,369,2820,133,1
20150105.231038,2820,152,271768,42,2819,369,2820,63,1
20150105.23104,2820,10,271778,10,2819,370,2820,60,1
20150105.23104,2820,2,271780,2,2819,370,2820,60,1
20150105.231045,2820,280,272060,-52,2819,361,2820,431,1
20150105.231046,2820,18,272078,18,2819,355,2820,938,1
20150105.231047,2820,2,272080,2,2819,355,2820,937,1
20150105.231049,2820,2,272082,2,2819,359,2820,937,1
20150105.23105,2819,20,272102,-20,2819,349,2820,937,0
20150105.231051,2820,22,272124,22,2819,349,2820,928,1
20150105.231054,2820,2,272126,2,2819,367,2820,928,1
20150105.231055,2819,2,272128,-2,2819,366,2820,928,0
20150105.231058,2820,2,272130,0,2819,389,2820,932,1
20150105.231059,2820,2,272132,2,2819,379,2820,931,1
20150105.231101,2820,120,272252,120,2819,391,2820,871,1
20150105.231102,2820,2,272254,0,2819,391,2820,870,1
20150105.231103,2819,22,272276,0,2819,382,2820,870,0
20150105.231108,2819,2,272278,2,2819,434,2820,884,0
20150105.231108,2820,6,272284,2,2819,425,2820,883,1
20150105.231116,2819,2,272286,0,2819,422,2820,884,0
20150105.231117,2820,4,272290,4,2819,418,2820,882,1
20150105.231122,2820,8,272298,8,2819,423,2820,881,1
20150105.231122,2819,846,273144,652,2818,878,2819,77,0
20150105.231126,2819,2,273146,2,2818,855,2819,107,0
20150105.231127,2819,20,273166,20,2818,855,2819,97,0
20150105.231127,2819,88,273254,6,2818,867,2819,53,0
20150105.23113,2819,2,273256,2,2818,867,2819,94,0
20150105.231132,2819,10,273266,10,2818,869,2819,89,0
20150105.231132,2819,2,273268,2,2818,869,2819,88,0
20150105.231133,2819,6,273274,6,2818,869,2819,85,0
20150105.231133,2819,32,273306,-8,2818,870,2819,69,0
20150105.231135,2819,20,273326,2,2818,872,2819,65,0
20150105.231135,2819,24,273350,0,2818,872,2819,53,0
20150105.231136,2819,104,273454,16,2819,10,2820,910,0
20150105.231136,2819,20,273474,-2,2819,1,2820,902,0
20150105.231137,2819,34,273508,0,2818,892,2820,887,0
20150105.231138,2819,2,273510,2,2818,997,2820,887,0
20150105.231139,2820,20,273530,20,2818,997,2820,878,1
20150105.231141,2819,2,273532,-2,2818,997,2819,2,0
20150105.231141,2819,4,273536,-2,2818,698,2820,878,0
20150105.231144,2819,64,273600,-64,2818,699,2820,882,0
20150105.231144,2819,6,273606,-2,2818,994,2820,882,0
20150105.231144,2819,4,273610,0,2818,994,2820,882,0
20150105.231146,2819,64,273674,2,2819,30,2820,882,0
20150105.231146,2819,60,273734,58,2818,994,2820,882,0
20150105.231147,2818,344,274078,-144,2818,826,2820,883,0
20150105.231147,2820,2,274080,0,2818,834,2820,882,1
20150105.231149,2819,32,274112,-30,2818,833,2820,882,0
20150105.231154,2819,2,274114,0,2819,2,2820,884,0
20150105.231155,2819,4,274118,0,2818,854,2820,884,0
20150105.231156,2819,4,274122,0,2818,854,2820,885,0
20150105.231157,2819,2,274124,0,2818,854,2820,914,0
20150105.231158,2818,60,274184,-48,2819,1,2820,914,0
20150105.231158,2819,2,274186,0,2818,528,2820,915,1
20150105.2312,2819,2,274188,0,2818,818,2820,925,1
20150105.231201,2820,10,274198,0,2818,823,2820,920,1
20150105.231201,2820,10,274208,10,2819,2,2820,915,1
20150105.231202,2819,8,274216,0,2818,824,2819,128,0
20150105.231203,2819,22,274238,-20,2818,824,2819,117,0
20150105.231204,2819,4,274242,-2,2818,818,2819,117,0
20150105.231204,2819,10,274252,-8,2818,820,2819,114,0
20150105.231205,2819,10,274262,-2,2818,820,2819,109,0
20150105.231206,2819,2,274264,0,2818,820,2819,118,0
20150105.231207,2819,2,274266,0,2818,820,2819,117,0
20150105.231208,2819,44,274310,-34,2818,822,2819,97,0
20150105.231208,2819,40,274350,0,2818,822,2819,77,0
20150105.231209,2819,2,274352,0,2818,823,2819,81,0
20150105.231211,2819,6,274358,0,2818,827,2819,92,0
20150105.231213,2819,14,274372,-4,2818,827,2819,86,0
20150105.231213,2819,10,274382,-8,2818,826,2819,81,0
20150105.231214,2818,104,274486,24,2818,826,2819,31,0
20150105.231215,2819,2,274488,-2,2818,828,2819,29,1
20150105.231216,2819,58,274546,10,2819,103,2820,916,1
20150105.231216,2819,164,274710,164,2819,22,2820,916,1
20150105.231217,2820,8,274718,0,2819,22,2820,913,1
20150105.23122,2819,8,274726,0,2819,25,2820,912,0
20150105.23122,2820,10,274736,10,2819,24,2820,909,1
20150105.231222,2819,20,274756,-12,2819,27,2820,911,0
20150105.231224,2819,2,274758,-2,2819,35,2820,911,0
20150105.231226,2819,22,274780,-8,2819,26,2820,911,0
20150105.231227,2819,4,274784,4,2819,25,2820,913,0
20150105.231232,2820,36,274820,0,2819,53,2820,900,1
20150105.231235,2819,2,274822,0,2819,62,2820,901,0
20150105.231238,2819,8,274830,2,2819,67,2820,892,0
20150105.231241,2820,2,274832,2,2819,76,2820,892,1
20150105.231245,2820,10,274842,10,2819,82,2820,907,1
20150105.231248,2819,2,274844,0,2819,121,2820,928,0
20150105.231251,2820,2,274846,2,2819,143,2820,929,1
20150105.231254,2819,4,274850,0,2819,194,2820,929,0
20150105.231257,2820,18,274868,0,2819,228,2820,920,1
20150105.231258,2820,2,274870,2,2819,250,2820,920,1
20150105.2313,2820,2,274872,0,2819,260,2820,919,1
20150105.231302,2820,2,274874,2,2819,265,2820,918,1
20150105.231303,2820,6,274880,6,2819,270,2820,915,1
20150105.231308,2819,40,274920,-6,2819,258,2820,916,0
20150105.23131,2820,2,274922,0,2819,358,2820,919,1
20150105.231311,2820,248,275170,12,2819,361,2820,795,1
20150105.231312,2820,2,275172,2,2819,365,2820,794,1
20150105.231314,2820,202,275374,-2,2819,259,2820,808,1
20150105.231316,2820,4,275378,4,2819,261,2820,787,1
20150105.231318,2820,6,275384,0,2819,255,2820,824,1
20150105.231322,2820,16,275400,0,2819,258,2820,806,1
20150105.231325,2819,2,275402,0,2819,269,2820,806,0
20150105.231327,2820,4,275406,4,2819,285,2820,814,1
20150105.231335,2819,2,275408,2,2819,389,2820,1315,0
20150105.231337,2820,20,275428,20,2819,390,2820,1305,1
20150105.231337,2819,110,275538,70,2819,335,2820,1305,0
20150105.231339,2820,2,275540,2,2819,337,2820,1304,1
20150105.23134,2820,8,275548,0,2819,336,2820,1300,1
20150105.231347,2820,166,275714,166,2819,359,2820,1205,1
20150105.231352,2820,2,275716,2,2819,357,2820,1217,1
20150105.231354,2820,4,275720,4,2819,357,2820,1215,1
20150105.231354,2820,20,275740,20,2819,363,2820,1206,1
20150105.231404,2820,76,275816,76,2819,524,2820,1151,1
20150105.231404,2820,116,275932,116,2819,526,2820,1093,1
20150105.231405,2820,2,275934,2,2819,526,2820,1092,1
20150105.231406,2820,2,275936,2,2819,511,2820,1091,1
20150105.231407,2820,196,276132,196,2819,517,2820,993,1
20150105.231408,2820,202,276334,202,2819,526,2820,906,1
20150105.231409,2820,308,276642,0,2819,542,2820,737,1
20150105.23141,2820,22,276664,22,2819,553,2820,726,1
20150105.231411,2820,2,276666,0,2819,553,2820,725,1
20150105.231411,2820,10,276676,10,2819,553,2820,720,1
20150105.231412,2820,4,276680,2,2819,554,2820,718,1
20150105.231412,2820,10,276690,10,2819,556,2820,715,1
20150105.231414,2820,10,276700,10,2819,560,2820,710,1
20150105.231414,2820,30,276730,0,2819,559,2820,695,1
20150105.231416,2820,10,276740,10,2819,566,2820,690,1
20150105.231416,2820,140,276880,-116,2819,576,2820,620,1
20150105.231419,2820,22,276902,10,2819,579,2820,620,1
20150105.231421,2820,110,277012,16,2819,580,2820,565,1
20150105.231422,2820,4,277016,2,2819,580,2820,563,1
20150105.231423,2820,80,277096,0,2819,581,2820,523,1
20150105.231423,2820,22,277118,2,2819,584,2820,512,1
20150105.231426,2820,34,277152,34,2819,585,2820,495,1
20150105.231428,2820,110,277262,110,2819,591,2820,440,1
20150105.231428,2820,8,277270,8,2819,591,2820,435,1
20150105.231429,2820,42,277312,42,2819,592,2820,414,1
20150105.231429,2820,26,277338,20,2819,593,2820,401,1
20150105.23143,2820,802,278140,774,2820,9,2821,573,1
20150105.231431,2821,2,278142,0,2820,13,2821,587,1
20150105.231434,2821,6,278148,-6,2820,105,2821,588,1
20150105.231437,2820,2,278150,-2,2820,107,2821,587,0
20150105.23144,2821,2,278152,-2,2820,135,2821,596,1
20150105.231441,2821,4,278156,0,2820,138,2821,599,1
20150105.231443,2820,14,278170,0,2820,136,2821,600,0
20150105.231449,2821,2,278172,0,2820,250,2821,491,1
20150105.231454,2821,200,278372,34,2820,348,2821,337,1
20150105.231454,2821,2,278374,0,2820,348,2821,336,1
20150105.231458,2821,2,278376,0,2820,377,2821,351,1
20150105.231458,2820,16,278392,16,2820,369,2821,351,0
20150105.231459,2821,22,278414,6,2820,369,2821,340,1
20150105.231501,2820,6,278420,-2,2820,367,2821,320,0
20150105.231501,2820,10,278430,0,2820,363,2821,322,0
20150105.231503,2821,92,278522,-10,2820,377,2821,263,1
20150105.231505,2821,4,278526,-2,2820,362,2821,282,1
20150105.231506,2821,4,278530,0,2820,363,2821,286,1
20150105.231507,2821,240,278770,-240,2820,464,2821,152,1
20150105.231508,2821,20,278790,-20,2820,466,2821,143,1
20150105.231508,2820,326,279116,-86,2820,288,2821,158,0
20150105.231509,2821,18,279134,-18,2820,303,2821,134,1
20150105.231511,2821,2,279136,-2,2820,411,2821,134,1
20150105.231513,2821,2,279138,-2,2820,387,2821,560,1
20150105.231514,2821,2,279140,0,2820,389,2821,560,1
20150105.231517,2820,2,279142,-2,2820,389,2821,560,0
20150105.231517,2821,2,279144,0,2820,390,2821,559,1
20150105.231519,2821,4,279148,0,2820,400,2821,557,1
20150105.231522,2821,16,279164,-16,2820,399,2821,550,1
20150105.231523,2820,2,279166,-2,2820,400,2821,550,0
20150105.231524,2821,8,279174,-4,2820,397,2821,554,1
20150105.231527,2820,4,279178,-4,2820,424,2821,163,0
20150105.231527,2821,22,279200,-2,2820,424,2821,152,1
20150105.231528,2821,4,279204,0,2820,428,2821,150,1
20150105.23153,2821,2,279206,-2,2820,442,2821,129,1
20150105.231532,2821,12,279218,0,2820,453,2821,133,1
20150105.231533,2820,20,279238,10,2820,421,2821,133,0
20150105.231536,2821,20,279258,-20,2820,448,2821,182,1
20150105.23154,2820,2,279260,0,2820,423,2821,570,0
20150105.231541,2821,2,279262,0,2820,423,2821,569,1
20150105.231542,2821,4,279266,0,2820,438,2821,567,1
20150105.231544,2821,2,279268,-2,2820,439,2821,587,1
20150105.231545,2820,6,279274,0,2820,436,2821,587,0
20150105.231545,2821,2,279276,0,2820,437,2821,586,1
20150105.231546,2821,4,279280,0,2820,437,2821,584,1
20150105.231547,2821,2,279282,0,2820,437,2821,584,1
20150105.231553,2821,2,279284,0,2820,456,2821,640,1
20150105.231554,2821,4,279288,0,2820,441,2821,638,1
20150105.231556,2821,4,279292,0,2820,431,2821,652,1
20150105.231603,2821,24,279316,16,2820,391,2821,684,1
20150105.231608,2821,2,279318,0,2820,385,2821,698,1
20150105.23161,2821,6,279324,0,2820,385,2821,695,1
20150105.231611,2821,2,279326,0,2820,381,2821,694,1
20150105.231616,2821,2,279328,0,2820,483,2821,693,1
20150105.231618,2821,4,279332,0,2820,492,2821,691,1
20150105.231628,2821,10,279342,-10,2820,492,2821,702,1
20150105.231628,2821,2,279344,-2,2820,492,2821,701,1
20150105.231629,2821,20,279364,0,2820,502,2821,689,1
20150105.231634,2821,2,279366,-2,2820,527,2821,687,1
20150105.231641,2821,200,279566,0,2820,625,2821,688,1
20150105.231644,2820,2,279568,0,2820,627,2821,688,0
20150105.231648,2820,2,279570,2,2820,627,2821,688,0
20150105.231654,2820,2,279572,2,2820,740,2821,709,0
20150105.231659,2820,4,279576,0,2820,739,2821,710,0
20150105.2317,2820,2,279578,2,2820,738,2821,711,0
20150105.231701,2821,4,279582,0,2820,738,2821,709,1
20150105.231701,2820,8,279590,8,2820,729,2821,709,0
20150105.231713,2820,2,279592,2,2820,729,2821,693,0
20150105.231716,2820,258,279850,248,2820,592,2821,708,0
20150105.231718,2820,2,279852,0,2820,606,2821,690,0
20150105.231721,2821,2,279854,-2,2820,607,2821,689,1
20150105.231722,2820,4,279858,-2,2820,606,2821,699,0
20150105.231723,2820,2,279860,0,2820,605,2821,699,0
20150105.231726,2820,2,279862,-2,2820,607,2821,699,0
20150105.231729,2820,2,279864,-2,2820,591,2821,715,0
20150105.231736,2821,2,279866,0,2820,598,2821,723,1
20150105.231744,2821,2,279868,-2,2820,595,2821,732,1
20150105.231745,2821,2,279870,0,2820,595,2821,731,1
20150105.231746,2820,2,279872,-2,2820,595,2821,731,0
20150105.231748,2820,10,279882,8,2820,590,2821,731,0
20150105.231755,2821,8,279890,-4,2820,592,2821,733,1
20150105.231756,2820,80,279970,-14,2820,559,2821,733,0
20150105.231758,2820,2,279972,0,2820,572,2821,718,0
20150105.231801,2821,2,279974,0,2820,572,2821,717,1
20150105.231802,2820,240,280214,-40,2820,437,2821,732,0
20150105.231803,2820,90,280304,-90,2820,392,2821,677,0
20150105.231804,2820,6,280310,-6,2820,410,2821,677,0
20150105.231804,2820,12,280322,-2,2820,404,2821,678,0
20150105.231806,2820,2,280324,0,2820,383,2821,676,0
20150105.231808,2820,400,280724,122,2819,447,2821,692,0
20150105.231808,2820,60,280784,30,2820,57,2821,997,0
20150105.231809,2820,4,280788,-2,2820,57,2821,997,0
20150105.231809,2820,2,280790,0,2820,57,2821,996,0
20150105.23181,2820,10,280800,10,2819,440,2821,996,0
20150105.23181,2820,52,280852,50,2819,455,2821,996,0
20150105.231811,2820,6,280858,0,2819,584,2821,997,0
20150105.231816,2820,8,280866,6,2819,571,2820,29,0
20150105.231817,2820,4,280870,4,2819,573,2820,28,0
20150105.231821,2820,4,280874,0,2819,575,2820,36,0
20150105.231823,2819,2,280876,0,2819,577,2820,37,0
20150105.231823,2820,2,280878,2,2819,577,2820,37,1
20150105.231824,2820,6,280884,6,2819,577,2820,40,1
20150105.231825,2820,2,280886,-2,2819,563,2820,89,1
20150105.231832,2819,6,280892,-6,2819,559,2820,219,0
20150105.231833,2819,2,280894,-2,2819,544,2820,322,0
20150105.231835,2820,2,280896,0,2819,547,2820,321,1
20150105.231837,2820,2,280898,0,2819,556,2820,306,1
20150105.23184,2819,2,280900,0,2819,510,2820,334,0
20150105.23184,2819,44,280944,2,2819,508,2820,320,0
20150105.231841,2820,4,280948,0,2819,507,2820,319,1
20150105.231846,2819,10,280958,-10,2819,525,2820,321,0
20150105.23185,2820,12,280970,2,2819,525,2820,331,1
20150105.231854,2819,2,280972,0,2819,518,2820,292,0
20150105.231855,2820,162,281134,-46,2819,533,2820,211,1
20150105.231855,2820,2,281136,2,2819,533,2820,215,1
20150105.231856,2820,2,281138,2,2819,534,2820,215,1
20150105.231857,2820,2,281140,2,2819,534,2820,214,1
20150105.231858,2820,2,281142,2,2819,534,2820,218,1
20150105.231858,2820,2,281144,2,2819,534,2820,217,1
20150105.231901,2819,2,281146,-2,2819,1033,2820,217,0
20150105.231902,2820,2,281148,2,2819,1033,2820,216,1
20150105.231902,2820,12,281160,12,2819,1033,2820,210,1
20150105.231903,2820,2,281162,2,2819,1031,2820,209,1
20150105.231904,2819,4,281166,0,2819,1033,2820,209,0
20150105.231905,2819,2,281168,-2,2819,1032,2820,218,0
20150105.231908,2820,2,281170,2,2819,1032,2820,221,1
20150105.231916,2819,6,281176,-6,2819,1051,2820,241,0
20150105.231917,2819,20,281196,-20,2819,1041,2820,242,0
20150105.231918,2820,2,281198,2,2819,1041,2820,280,1
20150105.231921,2819,32,281230,-2,2819,1026,2820,291,0
20150105.231922,2820,100,281330,-10,2819,1030,2820,241,1
20150105.231923,2820,20,281350,14,2819,1030,2820,231,1
20150105.231929,2820,6,281356,0,2819,2015,2820,190,1
20150105.23193,2819,2,281358,0,2819,2014,2820,190,0
20150105.231931,2820,4,281362,-2,2819,2114,2820,191,1
20150105.231932,2819,4,281366,0,2819,2112,2820,191,0
20150105.231933,2819,4,281370,-4,2819,2110,2820,191,0
20150105.231937,2820,2,281372,0,2819,2126,2820,190,1
20150105.231938,2820,4,281376,-4,2819,2146,2820,203,1
20150105.231939,2820,248,281624,-4,2819,2146,2820,79,1
20150105.23194,2820,158,281782,-108,2820,11,2821,511,1
20150105.231941,2820,8,281790,8,2820,18,2821,508,1
20150105.231942,2820,2,281792,0,2820,18,2821,507,1
20150105.231943,2820,36,281828,-24,2819,2163,2820,385,1
20150105.231943,2819,2,281830,-2,2819,2161,2820,385,0
20150105.231944,2820,4,281834,0,2819,2160,2820,383,1
20150105.231946,2820,20,281854,0,2819,2161,2820,375,1
20150105.231947,2820,2,281856,0,2819,2161,2820,374,1
20150105.231948,2820,2,281858,0,2819,2161,2820,373,1
20150105.231949,2820,30,281888,0,2819,2166,2820,359,1
20150105.231951,2820,2,281890,0,2819,2166,2820,358,1
20150105.231952,2819,2,281892,-2,2819,2170,2820,358,0
20150105.231954,2819,4,281896,-4,2819,2170,2820,358,0
20150105.231958,2820,2,281898,-2,2819,2170,2820,362,1
20150105.232002,2820,2,281900,0,2819,2169,2820,366,1
20150105.232003,2819,2,281902,0,2819,2168,2820,366,0
20150105.232004,2820,4,281906,-4,2819,2168,2820,364,1
20150105.232005,2820,42,281948,0,2819,2168,2820,343,1
20150105.232009,2820,100,282048,0,2819,2168,2820,298,1
20150105.232011,2819,2,282050,-2,2819,2167,2820,300,0
20150105.232012,2820,2,282052,0,2819,2169,2820,299,1
20150105.232017,2820,2,282054,0,2819,2216,2820,299,1
20150105.232018,2820,4,282058,-4,2819,2217,2820,297,1
20150105.232018,2820,2,282060,0,2819,2227,2820,296,1
20150105.232022,2820,2,282062,0,2819,2227,2820,328,1
20150105.232023,2820,2,282064,0,2819,2227,2820,329,1
20150105.23203,2819,4,282068,-4,2819,2248,2820,330,0
20150105.23203,2820,660,282728,72,2819,2189,2821,547,1
20150105.232031,2820,4,282732,-2,2820,28,2821,532,1
20150105.232032,2820,8,282740,0,2820,15,2821,547,1
20150105.232033,2820,60,282800,-10,2819,2261,2821,547,1
20150105.232034,2820,8,282808,-6,2820,15,2821,532,1
20150105.232035,2820,2,282810,0,2819,2263,2820,11,1
20150105.232035,2820,34,282844,10,2820,1,2821,547,1
20150105.232036,2820,2,282846,-2,2820,15,2821,532,1
20150105.232037,2821,4,282850,0,2819,2253,2821,546,1
20150105.232037,2820,4,282854,-4,2820,3,2821,532,0
20150105.232038,2820,6,282860,0,2819,2248,2820,57,0
20150105.232039,2820,118,282978,116,2820,5,2821,548,0
20150105.23204,2820,4,282982,0,2820,4,2821,548,0
20150105.232042,2821,4,282986,-2,2820,7,2821,547,1
20150105.232043,2820,22,283008,-8,2819,2248,2821,549,0
20150105.232047,2820,20,283028,16,2820,3,2821,549,0
20150105.232049,2820,2,283030,2,2820,14,2821,546,0
20150105.232049,2820,2,283032,2,2820,13,2821,546,0
20150105.23205,2820,2,283034,0,2820,12,2821,546,0
20150105.232051,2820,104,283138,-96,2819,2242,2821,547,0
20150105.232052,2820,20,283158,0,2820,1,2821,546,0
20150105.232056,2820,20,283178,18,2820,6,2821,549,0
20150105.232058,2820,2,283180,2,2820,43,2821,549,0
20150105.232103,2821,2,283182,0,2820,51,2821,549,1
20150105.232108,2821,4,283186,-2,2820,328,2821,218,1
20150105.232109,2821,296,283482,32,2820,324,2821,69,1
20150105.232109,2821,2,283484,0,2820,324,2821,68,1
20150105.23211,2821,4,283488,4,2820,324,2821,66,1
20150105.232117,2821,8,283496,8,2820,344,2821,74,1
20150105.232117,2821,2,283498,2,2820,344,2821,73,1
20150105.23212,2820,2,283500,0,2820,359,2821,93,0
20150105.232121,2821,2,283502,2,2820,359,2821,100,1
20150105.232123,2820,20,283522,20,2820,345,2821,101,0
20150105.232127,2820,48,283570,48,2820,365,2821,99,0
20150105.232131,2821,16,283586,-8,2820,364,2821,92,1
20150105.232132,2821,12,283598,0,2820,364,2821,87,1
20150105.232135,2820,2,283600,2,2820,364,2821,90,0
20150105.232138,2820,20,283620,20,2820,354,2821,90,0
20150105.23214,2821,16,283636,-16,2820,400,2821,101,1
20150105.232141,2820,2,283638,0,2820,401,2821,102,0
20150105.232155,2821,4,283642,0,2820,477,2821,627,1
20150105.232155,2821,2,283644,0,2820,478,2821,626,1
20150105.232156,2821,2,283646,0,2820,478,2821,625,1
20150105.232157,2821,2,283648,0,2820,478,2821,624,1
20150105.232157,2821,2,283650,0,2820,478,2821,623,1
20150105.2322,2821,2,283652,-2,2820,480,2821,623,1
20150105.232211,2820,2,283654,0,2820,528,2821,1034,0
20150105.232215,2820,4,283658,0,2820,1312,2821,1034,0
20150105.232216,2820,10,283668,10,2820,1307,2821,1034,0
20150105.232216,2820,40,283708,40,2820,1272,2821,1049,0
20150105.232219,2820,2,283710,2,2820,1271,2821,1049,0
20150105.232223,2820,1000,284710,142,2820,778,2821,1049,0
20150105.232224,2820,40,284750,-40,2820,758,2821,1049,0
20150105.232225,2820,242,284992,-242,2820,637,2821,1049,0
20150105.232226,2820,4,284996,-4,2820,635,2821,954,0
20150105.232232,2820,20,285016,0,2820,663,2821,938,0
20150105.232243,2821,2,285018,-2,2820,651,2821,956,1
20150105.232244,2821,2,285020,0,2820,662,2821,955,1
20150105.232252,2820,10,285030,-10,2820,676,2821,936,0
20150105.232256,2821,10,285040,0,2820,776,2821,931,1
20150105.232303,2821,26,285066,-22,2820,760,2821,939,1
20150105.232305,2820,12,285078,-12,2820,754,2821,962,0
20150105.232309,2820,2,285080,-2,2820,753,2821,974,0
20150105.23231,2820,1222,286302,-708,2820,132,2821,974,0
20150105.232313,2820,162,286464,2,2819,2139,2821,977,0
20150105.232314,2820,2,286466,2,2819,2139,2821,980,0
20150105.232315,2820,16,286482,-6,2819,2139,2821,980,0
20150105.232316,2821,12,286494,-8,2819,2139,2821,974,1
20150105.232316,2820,14,286508,-14,2819,2139,2821,974,0
20150105.232319,2820,2,286510,0,2819,2139,2821,973,0
20150105.23232,2820,2,286512,2,2819,2139,2821,958,0
20150105.232323,2820,150,286662,12,2819,2165,2820,2,0
20150105.232324,2820,8,286670,-6,2820,3,2821,664,0
20150105.232325,2821,2,286672,0,2820,4,2821,664,1
20150105.232328,2820,86,286758,22,2820,13,2821,657,0
20150105.23233,2820,2,286760,-2,2819,2169,2821,667,0
20150105.232331,2821,4,286764,-4,2820,1,2821,662,1
20150105.232332,2820,50,286814,4,2820,15,2821,660,0
20150105.232335,2820,2,286816,0,2820,30,2821,661,0
20150105.232336,2820,2,286818,2,2819,2145,2821,662,0
20150105.232339,2820,2,286820,0,2820,11,2821,663,0
20150105.23234,2820,2,286822,0,2820,13,2821,654,0
20150105.232341,2820,26,286848,18,2819,2167,2820,491,0
20150105.232342,2820,4,286852,0,2819,2167,2820,489,0
20150105.232343,2820,4,286856,0,2819,2167,2820,487,0
20150105.232345,2820,6,286862,0,2819,2164,2820,495,0
20150105.232345,2820,2,286864,2,2819,2164,2820,494,0
20150105.232347,2820,2,286866,2,2819,2164,2820,493,0
20150105.232349,2820,10,286876,10,2819,2164,2820,489,0
20150105.232351,2819,154,287030,96,2819,2143,2820,488,0
20150105.232352,2820,2,287032,0,2819,2143,2820,487,1
20150105.232353,2820,4,287036,0,2819,2141,2820,485,1
20150105.232355,2820,4,287040,0,2819,2143,2820,484,1
20150105.232356,2819,76,287116,76,2819,2090,2820,499,0
20150105.232401,2819,2,287118,0,2819,2111,2820,486,0
20150105.232404,2820,2,287120,0,2819,2111,2820,485,1
20150105.232405,2819,2,287122,2,2819,2112,2820,487,0
20150105.232408,2820,6,287128,6,2819,2112,2820,485,1
20150105.232413,2819,12,287140,0,2819,2107,2820,497,0
20150105.232415,2819,2,287142,0,2819,2107,2820,497,0
20150105.232415,2819,2,287144,2,2819,2106,2820,497,0
20150105.232418,2820,2,287146,2,2819,2106,2820,497,1
20150105.23242,2820,6,287152,4,2819,2106,2820,495,1
20150105.232422,2819,4,287156,2,2819,2105,2820,796,0
20150105.232422,2820,206,287362,206,2819,2105,2820,693,1
20150105.232428,2819,4,287366,0,2819,2103,2820,694,0
20150105.232431,2820,4,287370,2,2819,2085,2820,708,1
20150105.232437,2820,18,287388,18,2819,2094,2820,684,1
20150105.232441,2819,2,287390,0,2819,2093,2820,685,0
20150105.232444,2820,4,287394,4,2819,2091,2820,683,1
20150105.232445,2820,8,287402,4,2819,2091,2820,680,1
20150105.232449,2820,2,287404,2,2819,2109,2820,779,1
20150105.232452,2820,4,287408,4,2819,2109,2820,787,1
20150105.232456,2819,6,287414,0,2819,2109,2820,788,0
20150105.232501,2820,320,287734,0,2819,2107,2820,629,1
20150105.232502,2820,10,287744,10,2819,2107,2820,624,1
20150105.232505,2820,4,287748,0,2819,2107,2820,621,1
20150105.23251,2820,6,287754,6,2819,2104,2820,619,1
20150105.232516,2820,4,287758,0,2819,2104,2820,616,1
20150105.232517,2820,196,287954,196,2819,2104,2820,518,1
20150105.232518,2820,16,287970,16,2819,2096,2820,510,1
20150105.232522,2820,420,288390,138,2819,2097,2821,207,1
20150105.232523,2819,118,288508,116,2820,2,2821,207,0
20150105.232525,2820,2,288510,2,2820,16,2821,207,1
20150105.232526,2820,32,288542,-10,2820,2,2821,207,1
20150105.232526,2820,4,288546,0,2820,20,2821,205,1
20150105.232528,2820,2,288548,2,2820,6,2821,207,1
20150105.232529,2820,10,288558,-2,2820,2,2821,205,1
20150105.232529,2820,2,288560,0,2820,1,2821,205,1
20150105.232531,2820,2,288562,0,2820,7,2821,221,1
20150105.232532,2820,24,288586,24,2820,31,2821,220,1
20150105.232533,2820,2,288588,0,2820,246,2821,228,1
20150105.232534,2820,2,288590,2,2820,250,2821,228,1
20150105.232542,2820,8,288598,0,2820,246,2821,205,1
20150105.232543,2821,2,288600,-2,2820,246,2821,204,1
20150105.232547,2820,20,288620,0,2820,238,2821,205,0
20150105.232548,2821,2,288622,0,2820,239,2821,206,1
20150105.232549,2821,10,288632,0,2820,249,2821,221,1
20150105.232557,2820,80,288712,-2,2820,198,2821,240,0
20150105.232558,2820,4,288716,0,2820,196,2821,240,0
20150105.232558,2821,2,288718,0,2820,196,2821,219,1
20150105.232607,2820,2,288720,0,2820,206,2821,197,0
20150105.232614,2820,2,288722,0,2820,213,2821,238,0
20150105.232616,2820,2,288724,0,2820,212,2821,243,0
20150105.232618,2821,2,288726,0,2820,212,2821,242,1
20150105.23262,2820,2,288728,0,2820,212,2821,242,0
20150105.232623,2820,2,288730,2,2820,212,2821,257,0
20150105.232627,2821,2,288732,0,2820,228,2821,255,1
20150105.232636,2820,44,288776,0,2820,211,2821,254,0
20150105.232646,2820,2,288778,2,2820,228,2821,254,0
20150105.232656,2821,2,288780,0,2820,233,2821,253,1
20150105.232657,2820,2,288782,2,2820,232,2821,253,0
20150105.232706,2821,10,288792,-10,2820,236,2821,259,1
20150105.232708,2821,2,288794,0,2820,237,2821,258,1
20150105.23271,2820,4,288798,0,2820,242,2821,258,0
20150105.232712,2821,4,288802,-4,2820,243,2821,258,1
20150105.232713,2821,34,288836,-18,2820,243,2821,241,1
20150105.232713,2821,4,288840,0,2820,244,2821,239,1
20150105.232714,2821,2,288842,0,2820,297,2821,241,1
20150105.232718,2821,2,288844,0,2820,308,2821,242,1
20150105.232719,2821,10,288854,4,2820,309,2821,250,1
20150105.23272,2821,2,288856,0,2820,309,2821,249,1
20150105.232721,2820,2,288858,0,2820,307,2821,249,0
20150105.232722,2820,4,288862,0,2820,305,2821,253,0
20150105.232736,2820,2,288864,2,2820,334,2821,305,0
20150105.232737,2820,4,288868,0,2820,332,2821,305,0
20150105.232748,2820,4,288872,0,2820,317,2821,316,0
20150105.232749,2821,2,288874,2,2820,317,2821,315,1
20150105.232754,2820,10,288884,0,2820,312,2821,317,0
20150105.232756,2820,6,288890,0,2820,310,2821,317,0
20150105.2328,2820,2,288892,2,2820,308,2821,317,0
20150105.232805,2820,646,289538,-60,2819,2133,2820,190,0
20150105.23281,2820,2,289540,0,2819,2138,2820,226,0
20150105.232811,2819,2,289542,0,2819,2137,2820,226,0
20150105.232813,2819,2,289544,0,2819,2136,2820,230,0
20150105.232816,2820,20,289564,-20,2819,2137,2820,233,1
20150105.232817,2820,2,289566,0,2819,2142,2820,232,1
20150105.232818,2820,2,289568,0,2819,2142,2820,261,1
20150105.232819,2819,6,289574,0,2819,2139,2820,269,0
20150105.232821,2819,4,289578,4,2819,2137,2820,269,0
20150105.232822,2820,20,289598,0,2819,2137,2820,259,1
20150105.232822,2820,60,289658,0,2819,2137,2820,229,1
20150105.232823,2820,26,289684,-20,2819,2138,2820,216,1
20150105.232824,2820,22,289706,2,2819,2137,2820,206,1
20150105.232827,2819,40,289746,0,2819,2104,2820,206,0
20150105.232831,2820,2,289748,0,2819,2114,2820,218,1
20150105.232831,2820,2,289750,0,2819,2114,2820,217,1
20150105.232832,2820,2,289752,0,2819,2129,2820,216,1
20150105.232832,2820,18,289770,-18,2819,2120,2820,207,1
20150105.232833,2819,20,289790,0,2819,2095,2820,208,0
20150105.232835,2820,10,289800,-2,2819,2095,2820,204,1
20150105.232837,2820,12,289812,0,2819,2095,2820,198,1
20150105.232837,2819,12,289824,0,2819,2089,2820,258,0
20150105.23284,2819,2,289826,2,2819,2103,2820,264,0
20150105.232847,2819,12,289838,12,2819,2136,2820,294,0
20150105.232849,2819,2,289840,0,2819,2135,2820,390,0
20150105.23285,2819,100,289940,-44,2819,2085,2820,390,0
20150105.23285,2819,400,290340,-116,2819,1870,2820,405,0
20150105.232851,2819,4,290344,-4,2819,1882,2820,390,0
20150105.232854,2820,2,290346,0,2819,1886,2820,390,1
20150105.232855,2819,2,290348,0,2819,1885,2820,401,0
20150105.232857,2819,2,290350,-2,2819,1884,2820,401,0
20150105.232859,2819,10,290360,-10,2819,1854,2820,476,0
20150105.232901,2819,6,290366,-6,2819,1851,2820,476,0
20150105.232905,2819,2,290368,-2,2819,1861,2820,480,0
20150105.232906,2819,8,290376,-8,2819,1873,2820,780,0
20150105.232907,2820,2,290378,0,2819,1873,2820,779,1
20150105.232908,2820,4,290382,0,2819,1888,2820,763,1
20150105.232913,2819,80,290462,0,2819,1786,2820,789,0
20150105.232914,2820,6,290468,0,2819,1786,2820,786,1
20150105.232915,2819,20,290488,-20,2819,1775,2820,785,0
20150105.232919,2819,12,290500,-12,2819,1770,2820,788,0
20150105.23292,2819,2,290502,0,2819,1769,2820,788,0
20150105.232921,2820,2,290504,-2,2819,1769,2820,787,1
20150105.232922,2820,8,290512,0,2819,1769,2820,783,1
20150105.232923,2819,2,290514,-2,2819,1768,2820,789,0
20150105.232925,2820,2,290516,0,2819,1767,2820,798,1
20150105.232925,2819,42,290558,-2,2819,1746,2820,798,0
20150105.232926,2819,40,290598,0,2819,1726,2820,798,0
20150105.232927,2820,2,290600,-2,2819,1726,2820,800,1
20150105.232928,2819,2,290602,0,2819,1725,2820,800,0
20150105.232929,2820,2,290604,0,2819,1727,2820,799,1
20150105.23293,2820,12,290616,-12,2819,1727,2820,796,1
20150105.232931,2820,2,290618,0,2819,1727,2820,795,1
20150105.232933,2820,2,290620,0,2819,1728,2820,794,1
20150105.232936,2820,2,290622,-2,2819,1778,2820,794,1
20150105.232939,2819,2,290624,-2,2819,1776,2820,793,0
20150105.232941,2820,2,290626,-2,2819,1776,2820,792,1
20150105.232943,2820,4,290630,-4,2819,1795,2820,794,1
20150105.232944,2819,8,290638,0,2819,1773,2820,794,0
20150105.232944,2819,4,290642,-4,2819,1771,2820,794,0
20150105.232946,2820,8,290650,0,2819,1771,2820,790,1
20150105.232946,2820,2,290652,-2,2819,1771,2820,789,1
20150105.232948,2820,2,290654,0,2819,1774,2820,789,1
20150105.232948,2819,4,290658,-4,2819,1769,2820,789,0
20150105.232949,2820,24,290682,-20,2819,1767,2820,779,1
20150105.23295,2819,6,290688,-6,2819,1764,2820,779,0
20150105.232953,2820,12,290700,-8,2819,1764,2820,801,1
20150105.232954,2820,4,290704,-4,2819,1767,2820,796,1
20150105.232954,2820,20,290724,-20,2819,1764,2820,786,1
20150105.232955,2819,50,290774,-30,2819,1749,2820,970,0
20150105.232956,2820,2,290776,0,2819,1749,2820,969,1
20150105.232957,2819,2,290778,-2,2819,1749,2820,968,0
20150105.232958,2820,2,290780,-2,2819,1749,2820,967,1
20150105.232958,2819,6,290786,-6,2819,1746,2820,967,0
20150105.232959,2819,2,290788,-2,2819,1745,2820,972,0
20150105.233,2820,4,290792,0,2819,1745,2820,970,1
20150105.233001,2819,4,290796,-2,2819,1758,2820,949,0
20150105.233001,2820,2,290798,-2,2819,1758,2820,948,1
20150105.233002,2819,2,290800,0,2819,1757,2820,948,0
20150105.233003,2820,2,290802,0,2819,1758,2820,920,1
20150105.233006,2819,4,290806,-4,2819,1755,2820,912,0
20150105.233007,2820,4,290810,0,2819,1755,2820,910,1
20150105.233007,2820,114,290924,18,2819,1754,2820,855,1
20150105.233009,2820,480,291404,102,2819,1753,2820,615,1
20150105.233009,2820,2,291406,2,2819,1753,2820,614,1
20150105.23301,2820,20,291426,0,2819,1753,2820,604,1
20150105.233011,2820,2,291428,2,2819,1754,2820,605,1
20150105.233011,2820,6,291434,6,2819,1753,2820,602,1
20150105.233012,2820,80,291514,74,2819,1753,2820,562,1
20150105.233013,2819,6,291520,0,2819,1752,2820,262,0
20150105.233014,2820,18,291538,-10,2819,1755,2820,304,1
20150105.233015,2820,2,291540,0,2819,1754,2820,303,1
20150105.233017,2820,2,291542,2,2819,1753,2820,306,1
20150105.233018,2820,20,291562,16,2819,1754,2820,296,1
20150105.23302,2820,222,291784,52,2819,1789,2820,150,1
20150105.233021,2820,54,291838,0,2819,1824,2820,116,1
20150105.233021,2820,2,291840,0,2819,1824,2820,115,1
20150105.233022,2820,6,291846,0,2819,1824,2820,112,1
20150105.233022,2820,60,291906,0,2819,1829,2820,83,1
20150105.233023,2820,4,291910,0,2819,1832,2820,81,1
20150105.233023,2820,162,292072,16,2820,24,2821,315,1
20150105.233024,2820,2,292074,2,2820,24,2821,315,1
20150105.233024,2821,2,292076,2,2820,25,2821,314,1
20150105.233027,2821,12,292088,2,2820,33,2821,306,1
20150105.233028,2821,12,292100,2,2820,33,2821,300,1
20150105.233028,2820,14,292114,2,2820,209,2821,408,0
20150105.233029,2821,6,292120,0,2820,210,2821,404,1
20150105.233032,2821,2,292122,0,2820,241,2821,410,1
20150105.233033,2821,2,292124,0,2820,243,2821,409,1
20150105.233035,2820,16,292140,16,2820,235,2821,460,0
20150105.233037,2821,2,292142,0,2820,240,2821,466,1
20150105.233039,2821,8,292150,0,2820,243,2821,460,1
20150105.23304,2820,4,292154,4,2820,69,2821,460,0
20150105.233043,2820,40,292194,36,2820,92,2821,499,0
20150105.233044,2821,2,292196,0,2820,253,2821,498,1
20150105.233045,2820,20,292216,0,2820,253,2821,498,0
20150105.233047,2820,44,292260,0,2820,232,2821,500,0
20150105.233048,2820,6,292266,0,2820,229,2821,529,0
20150105.233049,2821,6,292272,0,2820,229,2821,526,1
20150105.23305,2820,6,292278,2,2820,229,2821,524,0
20150105.233051,2820,20,292298,20,2820,69,2821,524,0
20150105.233053,2820,2,292300,0,2820,93,2821,527,0
20150105.233053,2820,14,292314,2,2820,86,2821,527,0
20150105.233054,2820,2,292316,0,2820,585,2821,517,0
20150105.233054,2820,2,292318,0,2820,599,2821,502,0
20150105.233055,2820,10,292328,0,2820,594,2821,502,0
20150105.233057,2820,62,292390,-14,2820,576,2821,501,0
20150105.233059,2820,86,292476,-6,2820,540,2821,482,0
20150105.2331,2820,20,292496,20,2820,529,2821,482,0
20150105.233101,2821,2,292498,0,2820,532,2821,481,1
20150105.233102,2820,42,292540,0,2820,513,2821,481,0
20150105.233104,2821,4,292544,0,2820,516,2821,481,1
20150105.233105,2821,2,292546,0,2820,516,2821,473,1
20150105.233109,2821,6,292552,0,2820,517,2821,477,1
20150105.233109,2820,40,292592,40,2820,490,2821,477,0
20150105.23311,2821,954,293546,-806,2821,24,2822,1018,1
20150105.233111,2821,48,293594,-28,2820,501,2821,1,1
20150105.233112,2821,2,293596,0,2820,531,2821,21,1
20150105.233113,2821,16,293612,0,2820,531,2821,13,1
20150105.233114,2821,2,293614,0,2820,531,2821,42,1
20150105.233115,2821,4,293618,0,2820,531,2821,40,1
20150105.233115,2821,32,293650,2,2820,531,2821,24,1
20150105.233117,2820,46,293696,0,2820,540,2821,33,0
20150105.233118,2821,2,293698,-2,2820,541,2821,32,1
20150105.233122,2820,18,293716,0,2820,539,2821,42,0
20150105.233124,2820,22,293738,-20,2820,541,2821,33,0
20150105.233125,2820,40,293778,40,2820,521,2821,48,0
20150105.233127,2821,8,293786,0,2820,546,2821,46,1
20150105.233128,2821,2,293788,0,2820,546,2821,45,1
20150105.233131,2821,2,293790,0,2820,537,2821,72,1
20150105.233131,2821,2,293792,0,2820,537,2821,71,1
20150105.233132,2821,2,293794,-2,2820,538,2821,70,1
20150105.233133,2821,40,293834,12,2820,545,2821,50,1
20150105.233134,2821,48,293882,42,2820,515,2821,64,1
20150105.233134,2821,12,293894,6,2820,522,2821,43,1
20150105.233135,2821,4,293898,0,2820,528,2821,44,1
20150105.233138,2821,6,293904,0,2820,526,2821,46,1
20150105.233139,2821,6,293910,0,2820,527,2821,43,1
20150105.23314,2821,2,293912,0,2820,527,2821,52,1
20150105.233141,2821,90,294002,-64,2820,527,2821,7,1
20150105.233142,2821,2,294004,2,2820,528,2821,26,1
20150105.233143,2821,4,294008,4,2820,548,2821,24,1
20150105.233145,2820,30,294038,30,2820,531,2821,47,0
20150105.233145,2821,2,294040,2,2820,547,2821,31,1
20150105.233147,2821,10,294050,6,2820,539,2821,27,1
20150105.233148,2820,2,294052,0,2820,538,2821,25,0
20150105.233149,2821,2,294054,0,2820,543,2821,34,1
20150105.23315,2821,2,294056,0,2820,543,2821,34,1
20150105.233153,2821,20,294076,-20,2820,553,2821,28,1
20150105.233154,2821,2,294078,-2,2820,553,2821,27,1
20150105.233155,2821,2,294080,0,2820,553,2821,26,1
20150105.233156,2820,32,294112,30,2820,538,2821,25,0
20150105.233156,2821,2,294114,0,2820,538,2821,24,1
20150105.233157,2821,2,294116,0,2820,537,2821,23,1
20150105.233157,2820,6,294122,0,2820,514,2821,23,0
20150105.233158,2821,4,294126,0,2820,514,2821,31,1
20150105.233158,2821,40,294166,20,2820,514,2821,11,1
20150105.233159,2821,12,294178,10,2820,515,2821,5,1
20150105.2332,2821,2,294180,2,2820,511,2821,24,1
20150105.233201,2821,4,294184,4,2820,511,2821,22,1
20150105.233202,2821,6,294190,2,2820,511,2821,19,1
20150105.233204,2821,2,294192,0,2820,522,2821,18,1
20150105.233205,2821,2,294194,-2,2820,522,2821,17,1
20150105.233206,2821,2,294196,0,2820,522,2821,20,1
20150105.233207,2820,2,294198,0,2820,521,2821,20,0
20150105.233212,2820,2,294200,0,2820,620,2821,69,0
20150105.233213,2820,4,294204,0,2820,618,2821,69,0
20150105.233213,2820,82,294286,0,2820,576,2821,89,0
20150105.233218,2820,2,294288,0,2820,582,2821,100,0
20150105.233221,2820,22,294310,0,2820,582,2821,100,0
20150105.233222,2821,4,294314,-2,2820,575,2821,113,1
20150105.233224,2821,2,294316,0,2820,575,2821,112,1
20150105.233225,2821,10,294326,-10,2820,575,2821,107,1
20150105.233229,2820,16,294342,0,2820,575,2821,93,0
20150105.233229,2821,186,294528,14,2821,7,2822,1006,1
20150105.23323,2821,16,294544,-2,2820,575,2822,1006,1
20150105.233236,2821,2,294546,0,2820,546,2822,996,1
20150105.233237,2821,4,294550,0,2820,545,2821,36,1
20150105.233239,2821,16,294566,0,2820,545,2821,33,1
20150105.233239,2821,2,294568,-2,2820,557,2821,32,1
20150105.23324,2821,2,294570,-2,2820,551,2821,31,1
20150105.233242,2821,2,294572,2,2820,551,2821,37,1
20150105.233243,2821,2,294574,2,2820,552,2821,59,1
20150105.233244,2820,22,294596,0,2820,543,2821,58,0
20150105.233244,2820,2,294598,0,2820,542,2821,58,0
20150105.233245,2820,50,294648,0,2820,518,2821,33,0
20150105.233246,2821,6,294654,6,2820,518,2821,30,1
20150105.233249,2820,4,294658,0,2820,517,2821,28,0
20150105.233249,2820,22,294680,20,2820,516,2821,17,0
20150105.23325,2820,2,294682,0,2820,516,2821,16,0
20150105.233252,2821,20,294702,18,2820,515,2822,997,1
20150105.233253,2821,10,294712,0,2820,530,2822,997,1
20150105.233257,2821,12,294724,0,2820,527,2822,997,1
20150105.233258,2821,8,294732,0,2820,526,2821,967,1
20150105.2333,2821,6,294738,0,2820,511,2821,983,1
20150105.233303,2821,2,294740,0,2820,500,2821,985,1
20150105.233309,2820,2,294742,0,2820,490,2821,985,0
20150105.233312,2820,36,294778,0,2820,472,2821,986,0
20150105.233312,2820,2,294780,0,2820,471,2821,986,0
20150105.233313,2820,2,294782,2,2820,468,2821,986,0
20150105.233319,2821,4,294786,-4,2820,472,2821,984,1
20150105.233321,2820,12,294798,0,2820,467,2821,984,0
20150105.233325,2821,18,294816,0,2820,491,2821,976,1
20150105.233328,2820,4,294820,0,2820,490,2821,975,0
20150105.233328,2821,2,294822,0,2820,491,2821,974,1
20150105.23333,2820,2,294824,0,2820,490,2821,974,0
20150105.233337,2821,42,294866,-40,2820,463,2821,955,1
20150105.233339,2820,4,294870,4,2820,465,2821,955,0
20150105.233341,2821,2,294872,-2,2820,470,2821,955,1
20150105.233342,2820,20,294892,20,2820,455,2821,955,0
20150105.23335,2820,4,294896,0,2820,953,2821,955,0
20150105.23335,2821,10,294906,0,2820,953,2821,950,1
20150105.233411,2821,2,294908,0,2820,960,2821,1075,1
20150105.233411,2820,2,294910,2,2820,959,2821,1076,0
20150105.233421,2821,2,294912,-2,2820,971,2821,1063,1
20150105.233423,2820,2,294914,0,2820,970,2821,1063,0
20150105.233424,2820,4,294918,4,2820,968,2821,1063,0
20150105.233424,2820,100,295018,0,2820,918,2821,1063,0
20150105.233436,2821,2,295020,0,2820,917,2821,1073,1
20150105.233436,2821,2,295022,0,2820,917,2821,1072,1
20150105.233437,2820,2,295024,0,2820,916,2821,1072,0
20150105.233438,2821,4,295028,-4,2820,916,2821,1070,1
20150105.233443,2820,248,295276,104,2820,761,2821,1087,0
20150105.233443,2820,96,295372,84,2820,713,2821,1087,0
20150105.233446,2820,4,295376,2,2820,711,2821,1088,0
20150105.233447,2820,2,295378,-2,2820,710,2821,1090,0
20150105.233451,2821,2,295380,-2,2820,710,2821,1099,1
20150105.233452,2820,80,295460,-42,2820,670,2821,1099,0
20150105.233453,2820,300,295760,224,2820,520,2821,1100,0
20150105.233453,2820,8,295768,2,2820,518,2821,1098,0
20150105.233454,2820,54,295822,-40,2820,489,2821,1098,0
20150105.233454,2820,14,295836,-14,2820,482,2821,1099,0
20150105.233455,2820,14,295850,-4,2820,475,2821,1099,0
20150105.233455,2820,6,295856,-2,2820,472,2821,1099,0
20150105.233501,2820,6,295862,-6,2820,469,2821,1100,0
20150105.233501,2821,12,295874,-12,2820,468,2821,1095,1
20150105.233503,2820,4,295878,-4,2820,467,2821,1105,0
20150105.233504,2821,6,295884,-6,2820,468,2821,1102,1
20150105.233505,2820,8,295892,-8,2820,466,2821,1102,0
20150105.233507,2820,2,295894,-2,2820,465,2821,1102,0
20150105.233508,2820,2,295896,0,2820,464,2821,1102,0
20150105.233508,2820,2,295898,0,2820,463,2821,1102,0
20150105.233509,2820,2,295900,0,2820,462,2821,1115,0
20150105.233509,2820,2,295902,-2,2820,461,2821,1115,0
20150105.23351,2820,40,295942,-40,2820,441,2821,1115,0
20150105.233511,2820,20,295962,-20,2820,431,2821,1115,0
20150105.233513,2820,16,295978,-16,2820,434,2821,1118,0
20150105.233518,2820,16,295994,-16,2820,486,2821,1122,0
20150105.233519,2820,4,295998,-4,2820,484,2821,1126,0
20150105.23352,2821,2,296000,0,2820,484,2821,1126,1
20150105.233521,2820,4,296004,-4,2820,497,2821,1162,0
20150105.233526,2821,8,296012,-8,2820,489,2821,1173,1
20150105.233527,2821,2,296014,0,2820,490,2821,1173,1
20150105.233529,2820,20,296034,-20,2820,480,2821,1174,0
20150105.233536,2820,996,297030,-832,2819,1956,2820,3,0
20150105.233536,2820,6,297036,-6,2819,1956,2821,1198,0
20150105.233537,2821,300,297336,-300,2819,1956,2821,1048,1
20150105.233538,2820,24,297360,-20,2819,1956,2821,1048,0
20150105.233539,2820,12,297372,-10,2819,1956,2820,6,0
20150105.233539,2820,14,297386,-2,2819,1956,2821,1049,0
20150105.23354,2820,4,297390,0,2820,10,2821,1048,0
20150105.233541,2820,240,297630,-222,2820,390,2821,1048,0
20150105.233544,2820,2,297632,-2,2820,569,2821,1056,0
20150105.233546,2820,30,297662,-30,2820,554,2821,1056,0
20150105.233546,2820,10,297672,-10,2820,549,2821,1156,0
20150105.233549,2820,2,297674,0,2820,369,2821,1153,0
20150105.23355,2820,2,297676,-2,2820,376,2821,1153,0
20150105.233552,2820,238,297914,0,2820,257,2821,1154,0
20150105.233554,2820,6,297920,0,2820,255,2821,1156,0
20150105.233555,2820,2,297922,0,2820,254,2821,1156,0
20150105.233556,2820,80,298002,0,2820,218,2821,1156,0
20150105.233601,2820,2,298004,-2,2820,718,2821,1155,0
20150105.233608,2821,2,298006,0,2820,728,2821,1157,1
20150105.233615,2821,2,298008,0,2820,734,2821,1440,1
20150105.23362,2821,2,298010,-2,2820,746,2821,1441,1
20150105.23362,2821,2,298012,-2,2820,747,2821,1440,1
20150105.233623,2820,2,298014,0,2820,746,2821,1440,0
20150105.233647,2820,80,298094,-80,2820,692,2821,704,0
20150105.233649,2820,1514,299608,-1358,2819,1984,2820,216,0
20150105.233657,2819,6,299614,-6,2819,1960,2820,324,0
20150105.233657,2820,200,299814,0,2819,1960,2820,224,1
20150105.233658,2820,100,299914,0,2819,1960,2820,224,1
20150105.233704,2820,448,300362,-346,2820,777,2821,741,1
20150105.233705,2820,2,300364,-2,2820,776,2821,740,1
20150105.23371,2820,2,300366,-2,2820,776,2821,742,1
20150105.233715,2820,2,300368,-2,2820,775,2821,746,1
20150105.233718,2820,2,300370,-2,2820,775,2821,751,1
20150105.233719,2820,16,300386,0,2820,767,2821,751,1
20150105.23372,2820,2,300388,0,2820,766,2821,751,1
20150105.233722,2820,4,300392,0,2820,765,2821,1149,1
20150105.233724,2820,8,300400,0,2820,761,2821,1149,1
20150105.233725,2820,12,300412,-12,2820,755,2821,1151,1
20150105.233726,2820,4,300416,0,2820,753,2821,1151,1
20150105.233734,2820,2,300418,-2,2820,756,2821,1149,1
20150105.233736,2820,2,300420,0,2820,755,2821,1164,1
20150105.233737,2820,2,300422,-2,2820,754,2821,1164,1
20150105.233739,2820,600,301022,-600,2820,465,2821,1199,1
20150105.233741,2820,2,301024,0,2820,464,2821,1206,1
20150105.233745,2821,2,301026,2,2820,526,2821,1219,1
20150105.233745,2820,40,301066,-40,2820,506,2821,1219,0
20150105.233746,2820,4,301070,-4,2820,504,2821,1220,0
20150105.233748,2820,400,301470,-400,2820,305,2821,1220,0
20150105.233748,2820,590,302060,-44,2820,10,2821,1123,0
20150105.233749,2820,18,302078,2,2820,1,2821,1124,0
20150105.233749,2820,4,302082,2,2819,1959,2820,2,0
20150105.233754,2820,4,302086,-2,2819,1959,2820,10,0
20150105.233755,2820,2,302088,0,2819,1959,2820,9,0
20150105.233757,2820,8,302096,-4,2819,1956,2820,13,0
20150105.233757,2819,20,302116,-10,2819,1946,2820,22,0
20150105.233758,2820,2,302118,2,2819,1960,2820,21,1
20150105.233759,2820,4,302122,4,2819,1966,2820,69,1
20150105.233802,2820,6,302128,-2,2819,1964,2820,89,1
20150105.23381,2819,10,302138,-10,2819,1960,2820,174,0
20150105.233812,2820,200,302338,24,2819,1960,2820,98,1
20150105.233817,2820,2,302340,0,2819,1920,2820,125,1
20150105.233818,2820,2,302342,0,2819,1920,2820,125,1
20150105.23382,2820,48,302390,32,2819,1920,2820,101,1
20150105.233821,2820,20,302410,-2,2819,1920,2820,91,1
20150105.233823,2820,10,302420,0,2819,1920,2820,107,1
20150105.233825,2819,2,302422,0,2819,1919,2820,108,0
20150105.233826,2820,2,302424,0,2819,1904,2820,507,1
20150105.233826,2820,18,302442,0,2819,1904,2820,498,1
20150105.233827,2819,2,302444,-2,2819,1918,2820,499,0
20150105.233827,2819,6,302450,-6,2819,1995,2820,499,0
20150105.233829,2820,18,302468,0,2819,1995,2820,494,1
20150105.233831,2820,18,302486,0,2819,2002,2820,786,1
20150105.233833,2820,20,302506,10,2819,2003,2820,778,1
20150105.233836,2820,220,302726,-180,2819,1905,2820,780,1
20150105.233838,2820,20,302746,18,2819,1905,2820,785,1
20150105.233839,2819,6,302752,-6,2819,1829,2820,785,0
20150105.233841,2820,38,302790,2,2819,1829,2820,769,1
20150105.233842,2819,14,302804,0,2819,1822,2820,769,0
20150105.233844,2820,18,302822,2,2819,1822,2820,760,1
20150105.233844,2819,10,302832,-10,2819,1817,2820,773,0
20150105.233845,2819,2,302834,0,2819,1817,2820,773,0
20150105.233845,2819,266,303100,-256,2819,1683,2820,773,0
20150105.233847,2819,2004,305104,138,2819,681,2820,777,0
20150105.233848,2819,442,305546,356,2819,460,2820,787,0
20150105.233849,2819,22,305568,20,2819,449,2820,788,0
20150105.233849,2819,14,305582,0,2819,424,2820,788,0
20150105.23385,2819,6,305588,0,2819,421,2820,788,0
20150105.233851,2819,2,305590,2,2819,430,2820,788,0
20150105.233851,2819,4,305594,0,2819,428,2820,788,0
20150105.233852,2819,32,305626,32,2819,413,2820,788,0
20150105.233853,2819,10,305636,0,2819,409,2820,784,0
20150105.233854,2819,2,305638,0,2819,408,2820,784,0
20150105.233854,2819,2,305640,0,2819,407,2820,795,0
20150105.233855,2819,10,305650,0,2819,402,2820,795,0
20150105.233855,2819,2,305652,2,2819,401,2820,795,0
20150105.233857,2819,2,305654,2,2819,400,2820,795,0
20150105.233859,2819,2,305656,2,2819,413,2820,796,0
20150105.233901,2819,14,305670,-2,2819,407,2820,797,0
20150105.233902,2819,4,305674,0,2819,405,2820,797,0
20150105.233905,2820,2,305676,0,2819,406,2820,796,1
20150105.233906,2819,4,305680,0,2819,403,2820,796,0
20150105.233907,2819,2,305682,-2,2819,401,2820,796,0
20150105.233908,2819,2,305684,0,2819,400,2820,796,0
20150105.233908,2819,4,305688,0,2819,398,2820,796,0
20150105.233909,2819,14,305702,0,2819,391,2820,796,0
20150105.233911,2819,792,306494,648,2818,356,2819,15,0
20150105.233912,2819,6,306500,6,2818,367,2819,12,0
20150105.233916,2819,2,306502,2,2818,378,2819,23,0
20150105.233916,2819,22,306524,20,2818,390,2819,37,0
20150105.23392,2819,6,306530,2,2818,392,2819,53,0
20150105.233921,2819,20,306550,14,2818,382,2819,43,0
20150105.233921,2819,4,306554,4,2818,380,2819,162,0
20150105.233922,2819,6,306560,6,2818,481,2819,159,0
20150105.233924,2819,6,306566,2,2818,489,2819,158,0
20150105.233924,2819,2,306568,2,2818,490,2819,157,0
20150105.233926,2819,2,306570,2,2818,491,2819,156,0
20150105.233927,2818,4,306574,2,2818,490,2819,155,0
20150105.233927,2818,24,306598,0,2818,480,2819,156,0
20150105.233928,2818,114,306712,-24,2818,408,2819,171,0
20150105.233928,2818,10,306722,0,2818,404,2819,156,0
20150105.233929,2818,4,306726,0,2818,402,2819,156,0
20150105.23393,2818,8,306734,-4,2818,398,2819,156,0
20150105.233931,2819,6,306740,6,2818,396,2819,153,1
20150105.233931,2818,4,306744,-4,2818,409,2819,153,0
20150105.233933,2818,2,306746,0,2818,408,2819,158,0
20150105.233936,2818,2,306748,-2,2818,409,2819,674,0
20150105.233937,2818,2,306750,-2,2818,408,2819,674,0
20150105.233941,2818,10,306760,-8,2818,410,2819,675,0
20150105.233942,2818,2,306762,0,2818,409,2819,685,0
20150105.233942,2818,8,306770,0,2818,406,2819,683,0
20150105.233943,2818,2,306772,0,2818,405,2819,683,0
20150105.233944,2818,6,306778,4,2818,402,2819,690,0
20150105.233947,2818,2,306780,2,2818,435,2819,1091,0
20150105.233949,2818,10,306790,10,2818,441,2819,1091,0
20150105.233951,2818,2,306792,2,2818,442,2819,1091,0
20150105.233951,2819,24,306816,-6,2818,433,2819,1090,1
20150105.233953,2818,10,306826,10,2818,429,2819,1083,0
20150105.233953,2818,10,306836,0,2818,424,2819,1119,0
20150105.233954,2818,848,307684,580,2817,652,2818,76,0
20150105.233954,2817,12,307696,-2,2817,641,2818,77,0
20150105.233955,2817,68,307764,0,2817,608,2818,78,0
20150105.233955,2817,122,307886,16,2817,557,2818,130,0
20150105.233956,2818,226,308112,-40,2817,554,2818,31,1
20150105.233957,2818,68,308180,-36,2817,554,2819,1115,1
20150105.233958,2818,2,308182,0,2818,11,2819,1115,1
20150105.233959,2818,10,308192,0,2818,6,2819,1115,1
20150105.233959,2818,20,308212,-8,2817,557,2819,1115,1
20150105.234,2818,10,308222,-8,2817,558,2818,11,1
20150105.234,2819,54,308276,28,2817,545,2819,1115,1
20150105.234002,2818,6,308282,0,2818,3,2819,1115,0
20150105.234003,2818,20,308302,-14,2818,4,2819,1115,0
20150105.234003,2818,8,308310,0,2817,637,2818,497,0
20150105.234005,2818,16,308326,16,2817,688,2818,492,0
20150105.234006,2818,4,308330,4,2817,691,2818,490,0
20150105.234008,2817,2,308332,0,2817,723,2818,491,0
20150105.234009,2818,32,308364,28,2817,734,2818,476,1
20150105.234014,2817,20,308384,-4,2817,753,2818,578,0
20150105.234016,2817,4,308388,4,2817,737,2818,579,0
20150105.234017,2818,102,308490,102,2817,740,2818,530,1
20150105.234018,2817,2,308492,-2,2817,753,2818,530,0
20150105.234021,2817,2,308494,2,2817,760,2818,535,0
20150105.234021,2817,2,308496,2,2817,758,2818,550,0
20150105.234022,2817,4,308500,2,2817,756,2818,550,0
20150105.234022,2817,2,308502,2,2817,756,2818,550,0
20150105.234023,2817,4,308506,2,2817,754,2818,550,0
20150105.234023,2817,2,308508,0,2817,753,2818,550,0
20150105.234024,2818,4,308512,4,2817,752,2818,549,1
20150105.234024,2817,2,308514,-2,2817,751,2818,549,0
20150105.234025,2817,34,308548,-6,2817,735,2818,599,0
20150105.234025,2817,2,308550,2,2817,735,2818,600,0
20150105.234026,2818,22,308572,22,2817,735,2818,590,1
20150105.234026,2817,2,308574,2,2817,733,2818,590,0
20150105.234027,2817,2,308576,2,2817,736,2818,590,0
20150105.234027,2818,12,308588,12,2817,737,2818,570,1
20150105.23403,2817,2,308590,2,2817,757,2818,571,0
20150105.234032,2817,86,308676,2,2817,721,2818,572,0
20150105.234033,2818,2,308678,2,2817,722,2818,579,1
20150105.234034,2817,4,308682,4,2817,721,2818,579,0
20150105.234034,2818,204,308886,2,2817,720,2818,477,1
20150105.234036,2818,524,309410,0,2817,723,2818,219,1
20150105.234036,2817,242,309652,236,2817,727,2818,99,0
20150105.234037,2817,2,309654,2,2817,728,2818,102,0
20150105.234038,2818,16,309670,0,2817,729,2818,95,1
20150105.234038,2818,4,309674,0,2817,729,2818,95,1
20150105.234039,2818,20,309694,20,2817,724,2818,91,1
20150105.23404,2818,8,309702,0,2817,724,2818,87,1
20150105.234041,2818,2,309704,2,2817,724,2818,96,1
20150105.234042,2818,194,309898,-56,2818,3,2819,1123,1
20150105.234042,2818,2,309900,0,2818,3,2819,1123,1
20150105.234043,2818,8,309908,2,2817,723,2818,36,1
20150105.234043,2818,74,309982,-38,2818,374,2819,1125,1
20150105.234045,2818,8,309990,-8,2818,380,2819,1125,1
20150105.234046,2818,8,309998,-8,2818,377,2819,1126,1
20150105.234046,2818,2,310000,0,2818,377,2819,1127,1
20150105.234047,2818,2,310002,-2,2818,376,2819,1127,1
20150105.234052,2818,2,310004,-2,2818,623,2819,1136,1
20150105.234055,2818,416,310420,0,2818,517,2819,1136,1
20150105.234057,2818,2,310422,-2,2818,516,2819,1137,1
20150105.234059,2818,2,310424,-2,2818,526,2819,1137,1
20150105.2341,2818,2,310426,-2,2818,535,2819,1138,1
20150105.234101,2818,42,310468,-40,2818,514,2819,1134,1
20150105.234104,2818,2,310470,-2,2818,513,2819,1133,1
20150105.234105,2819,2,310472,2,2818,513,2819,1132,1
20150105.234107,2819,2,310474,2,2818,516,2819,1131,1
20150105.234107,2819,10,310484,-8,2818,517,2819,1126,1
20150105.234107,2818,4,310488,0,2818,515,2819,1126,0
20150105.234109,2818,4,310492,-4,2818,513,2819,1126,0
20150105.234109,2818,10,310502,0,2818,508,2819,1272,0
20150105.234111,2818,28,310530,-28,2818,494,2819,1272,0
20150105.234113,2818,2,310532,0,2818,493,2819,1272,0
20150105.234115,2818,420,310952,-398,2818,283,2819,1274,0
20150105.234119,2818,2,310954,-2,2818,303,2819,1273,0
20150105.234119,2818,2,310956,0,2818,302,2819,1273,0
20150105.23412,2819,2,310958,0,2818,302,2819,1272,1
20150105.23412,2818,2,310960,0,2818,301,2819,1272,0
20150105.234121,2818,20,310980,0,2818,294,2819,1272,0
20150105.234122,2818,22,311002,0,2818,283,2819,1272,0
20150105.234123,2818,100,311102,0,2818,233,2819,1262,0
20150105.234125,2818,6,311108,4,2818,185,2819,1462,0
20150105.234125,2818,2,311110,2,2818,184,2819,1452,0
20150105.234126,2818,2,311112,2,2818,243,2819,1452,0
20150105.234127,2818,476,311588,474,2817,438,2818,162,0
20150105.234128,2818,2,311590,0,2817,436,2818,172,0
20150105.23413,2818,6,311596,0,2817,435,2818,210,0
20150105.234131,2818,2,311598,0,2817,434,2818,209,0
20150105.234132,2818,20,311618,20,2817,434,2818,199,0
20150105.234133,2818,2,311620,2,2817,434,2818,198,0
20150105.234137,2817,4,311624,0,2817,449,2818,205,0
20150105.234138,2818,2,311626,2,2817,449,2818,204,1
20150105.234139,2817,22,311648,2,2817,424,2818,223,0
20150105.234141,2817,2,311650,0,2817,423,2818,223,0
20150105.234144,2817,6,311656,6,2817,422,2818,211,0
20150105.234145,2818,2,311658,2,2817,425,2818,210,1
20150105.234145,2818,2,311660,0,2817,425,2818,235,1
20150105.234146,2817,2,311662,0,2817,438,2818,235,0
20150105.234149,2817,2,311664,2,2817,444,2818,236,0
20150105.234154,2817,8,311672,4,2817,441,2818,251,0
20150105.234155,2817,2,311674,2,2817,481,2818,251,0
20150105.234159,2818,2,311676,0,2817,484,2818,135,1
20150105.2342,2818,2,311678,2,2817,485,2818,136,1
20150105.234202,2817,4,311682,2,2817,469,2818,152,0
20150105.234203,2818,2,311684,0,2817,470,2818,137,1
20150105.234207,2818,12,311696,12,2817,472,2818,132,1
20150105.234211,2818,40,311736,-38,2817,478,2818,88,1
20150105.234213,2818,2,311738,-2,2817,478,2818,88,1
20150105.234217,2818,2,311740,0,2817,480,2818,87,1
20150105.234218,2818,8,311748,2,2817,488,2818,100,1
20150105.234219,2818,24,311772,-20,2817,497,2818,88,1
20150105.234221,2818,2,311774,0,2817,497,2818,160,1
20150105.234223,2818,202,311976,-68,2817,396,2818,164,1
20150105.234225,2818,40,312016,30,2817,396,2818,152,1
20150105.234229,2818,2,312018,2,2817,396,2818,217,1
20150105.234232,2818,2,312020,2,2817,396,2818,216,1
20150105.234235,2818,2,312022,2,2817,396,2818,216,1
20150105.234239,2818,4,312026,0,2817,398,2818,214,1
20150105.23424,2818,4,312030,4,2817,398,2818,220,1
20150105.234242,2818,2,312032,2,2817,398,2818,219,1
20150105.234244,2817,4,312036,0,2817,397,2818,229,0
20150105.234245,2817,2,312038,0,2817,396,2818,259,0
20150105.234246,2818,2,312040,2,2817,404,2818,259,1
20150105.234247,2818,2,312042,0,2817,404,2818,258,1
20150105.234248,2817,32,312074,32,2817,386,2818,258,0
20150105.2343,2817,2,312076,2,2817,452,2818,263,0
20150105.234302,2817,14,312090,10,2817,447,2818,261,0
20150105.234304,2818,32,312122,26,2817,455,2818,269,1
20150105.234304,2817,2,312124,0,2817,454,2818,269,0
20150105.234306,2817,2,312126,0,2817,453,2818,299,0
20150105.23431,2817,2,312128,0,2817,494,2818,299,0
20150105.234313,2818,14,312142,-2,2817,495,2818,277,1
20150105.234321,2818,40,312182,-22,2817,509,2818,259,1
20150105.234324,2818,2,312184,2,2817,509,2818,243,1
20150105.234324,2817,6,312190,0,2817,506,2818,244,0
20150105.234325,2817,44,312234,-2,2817,484,2818,259,0
20150105.234327,2817,4,312238,4,2817,483,2818,292,0
20150105.234329,2818,40,312278,32,2817,483,2818,274,1
20150105.234329,2818,4,312282,0,2817,483,2818,272,1
20150105.234331,2817,6,312288,6,2817,480,2818,273,0
20150105.234333,2818,2,312290,2,2817,486,2818,293,1
20150105.234334,2818,40,312330,0,2817,486,2818,273,1
20150105.234336,2818,20,312350,20,2817,483,2818,263,1
20150105.234339,2817,1002,313352,-408,2817,19,2818,268,0
20150105.234339,2817,38,313390,-22,2816,1500,2817,16,0
20150105.23434,2817,34,313424,-34,2817,12,2818,293,0
20150105.23434,2817,2,313426,0,2817,11,2818,293,0
20150105.234347,2817,6,313432,0,2817,214,2818,299,0
20150105.234348,2817,2,313434,0,2817,213,2818,304,0
20150105.234349,2817,18,313452,2,2817,202,2818,304,0
20150105.234349,2817,2,313454,-2,2817,201,2818,306,0
20150105.234351,2817,6,313460,0,2817,200,2818,323,0
20150105.234352,2818,660,314120,-248,2817,242,2818,28,1
20150105.234352,2818,58,314178,-22,2817,266,2819,1430,1
20150105.234353,2818,6,314184,-4,2818,1,2819,1430,1
20150105.234353,2818,2,314186,0,2817,264,2819,1430,1
20150105.234354,2818,24,314210,-2,2817,264,2819,1430,1
20150105.234355,2818,32,314242,0,2817,271,2819,1431,1
20150105.234355,2818,30,314272,0,2817,263,2819,1431,1
20150105.234357,2818,20,314292,-20,2817,276,2819,1631,1
20150105.234358,2818,2,314294,-2,2817,276,2819,1630,1
20150105.234359,2818,2,314296,0,2818,3,2819,1630,1
20150105.2344,2818,6,314302,-2,2817,276,2819,1630,1
20150105.234401,2818,2,314304,-2,2817,293,2819,1630,1
20150105.234402,2818,2,314306,0,2817,295,2818,1,1
20150105.234402,2818,2,314308,2,2817,297,2818,15,1
20150105.234403,2818,30,314338,30,2817,296,2818,2,1
20150105.234403,2818,4,314342,0,2817,297,2818,15,1
20150105.234404,2818,26,314368,26,2817,312,2819,1619,1
20150105.234404,2818,10,314378,4,2818,1,2819,1616,1
20150105.234405,2818,6,314384,2,2817,312,2819,1631,1
20150105.234406,2818,2,314386,0,2817,322,2818,6,1
20150105.234406,2819,50,314436,10,2817,323,2819,1612,1
20150105.234408,2818,4,314440,0,2817,336,2818,3,0
20150105.234409,2818,4,314444,2,2817,336,2818,1,0
20150105.23441,2818,4,314448,0,2817,337,2818,24,0
20150105.234412,2818,2,314450,0,2817,353,2818,37,0
20150105.234415,2818,2,314452,0,2817,366,2818,53,0
20150105.234419,2817,50,314502,0,2817,473,2818,57,0
20150105.23442,2818,12,314514,12,2817,473,2818,51,1
20150105.23442,2818,2,314516,2,2817,473,2818,50,1
20150105.234421,2818,2,314518,0,2817,485,2818,49,1
20150105.234421,2818,2,314520,0,2817,486,2818,49,1
20150105.234423,2818,60,314580,54,2817,486,2818,19,1
20150105.234424,2818,2,314582,-2,2817,487,2818,19,1
20150105.234425,2817,802,315384,302,2817,88,2818,57,0
20150105.234426,2818,2,315386,0,2817,101,2818,53,1
20150105.234428,2818,6,315392,-2,2817,101,2818,63,1
20150105.234429,2818,2,315394,0,2817,111,2818,63,1
20150105.234429,2818,8,315402,8,2817,111,2818,59,1
20150105.234432,2818,2,315404,2,2817,111,2818,69,1
20150105.234433,2818,10,315414,2,2817,110,2818,84,1
20150105.234439,2817,2,315416,0,2817,112,2818,193,0
20150105.234442,2818,2,315418,2,2817,114,2818,194,1
20150105.234446,2818,2,315420,0,2817,114,2818,193,1
20150105.234456,2817,2,315422,2,2817,316,2818,169,0
20150105.234459,2818,350,315772,-292,2818,164,2819,1213,1
20150105.234501,2818,2,315774,0,2818,178,2819,1190,1
20150105.234503,2818,516,316290,160,2817,353,2818,153,1
20150105.234504,2817,90,316380,50,2817,297,2818,168,0
20150105.234508,2818,2,316382,2,2817,352,2818,170,1
20150105.23451,2817,40,316422,20,2817,349,2818,170,0
20150105.234511,2817,4,316426,4,2817,317,2818,217,0
20150105.234512,2818,10,316436,0,2817,318,2818,224,1
20150105.234514,2818,2,316438,2,2817,321,2818,223,1
20150105.234515,2817,2,316440,-2,2817,305,2818,209,0
20150105.234517,2818,2,316442,2,2817,305,2818,219,1
20150105.234518,2818,18,316460,18,2817,310,2818,210,1
20150105.234519,2818,4,316464,0,2817,310,2818,208,1
20150105.234521,2817,2,316466,-2,2817,310,2818,214,0
20150105.234522,2817,4,316470,-4,2817,309,2818,215,0
20150105.234525,2818,200,316670,200,2817,314,2818,116,1
20150105.234526,2817,4,316674,-4,2817,312,2818,137,0
20150105.234526,2818,4,316678,2,2817,312,2818,135,1
20150105.234527,2818,400,317078,-176,2818,11,2819,780,1
20150105.234528,2818,22,317100,-22,2817,113,2819,795,1
20150105.234528,2818,12,317112,12,2817,111,2818,6,1
20150105.234529,2818,2,317114,0,2817,111,2818,5,1
20150105.23453,2818,4,317118,4,2817,111,2818,3,1
20150105.234531,2818,2,317120,2,2817,111,2818,2,1
20150105.234533,2818,2,317122,2,2817,137,2818,2,1
20150105.234533,2818,2,317124,2,2817,137,2818,4,1
20150105.234534,2817,312,317436,-132,2816,1480,2817,50,0
20150105.234535,2817,102,317538,-50,2817,7,2818,47,0
20150105.234536,2818,32,317570,32,2817,246,2818,32,1
20150105.234538,2817,10,317580,-4,2817,246,2818,5,0
20150105.234539,2817,4,317584,0,2817,254,2818,5,0
20150105.234551,2818,2,317586,0,2817,401,2818,42,1
20150105.234555,2818,16,317602,6,2817,402,2818,46,1
20150105.234555,2817,2,317604,0,2817,401,2818,46,0
20150105.234556,2818,2,317606,2,2817,401,2818,45,1
20150105.234601,2818,40,317646,40,2817,409,2818,28,1
20150105.234601,2818,10,317656,-2,2817,409,2818,23,1
20150105.234602,2818,10,317666,8,2817,409,2818,18,1
20150105.234605,2818,2,317668,2,2817,414,2818,22,1
20150105.234606,2817,4,317672,2,2817,413,2818,20,0
20150105.234607,2818,4,317676,2,2817,415,2818,28,1
20150105.234608,2818,20,317696,-14,2817,415,2818,19,1
20150105.234609,2818,2,317698,0,2817,415,2818,18,1
20150105.234612,2818,46,317744,0,2817,431,2818,35,1
20150105.234613,2817,10,317754,-2,2817,426,2818,37,0
20150105.234614,2817,10,317764,10,2817,421,2818,37,0
20150105.234615,2818,4,317768,-4,2817,421,2818,35,1
20150105.234615,2818,10,317778,-10,2817,421,2818,30,1
20150105.234616,2818,20,317798,0,2817,421,2818,21,1
20150105.234617,2818,40,317838,4,2817,424,2818,1,1
20150105.234624,2817,4,317842,-2,2817,425,2818,40,0
20150105.234625,2817,4,317846,4,2817,423,2818,40,0
20150105.234629,2818,8,317854,-4,2817,423,2818,38,1
20150105.234629,2817,2,317856,0,2817,422,2818,38,0
20150105.234631,2818,10,317866,-10,2817,424,2818,34,1
20150105.234632,2818,40,317906,0,2817,425,2818,17,1
20150105.234633,2818,2,317908,0,2817,425,2818,16,1
20150105.234634,2818,4,317912,0,2817,425,2818,14,1
20150105.234639,2818,2,317914,-2,2817,426,2818,21,1
20150105.234641,2818,20,317934,-20,2817,426,2818,16,1
20150105.234643,2818,20,317954,-6,2817,427,2818,7,1
20150105.234644,2818,4,317958,4,2817,427,2818,5,1
20150105.234649,2818,2,317960,0,2817,428,2818,4,1
20150105.234649,2818,6,317966,6,2817,428,2818,1,1
20150105.23465,2818,4,317970,-2,2817,427,2819,832,1
20150105.23465,2819,6,317976,0,2817,427,2818,2,1
20150105.234656,2818,4,317980,-4,2817,434,2818,12,0
20150105.234657,2817,20,318000,8,2817,424,2818,12,0
20150105.234658,2818,2,318002,0,2817,429,2818,21,1
20150105.2347,2818,4,318006,-4,2817,429,2818,28,1
20150105.234702,2818,12,318018,0,2817,429,2818,26,1
20150105.234702,2818,2,318020,-2,2817,429,2818,25,1
20150105.234704,2818,2,318022,0,2817,429,2818,25,1
20150105.234707,2818,4,318026,0,2817,428,2818,23,1
20150105.234708,2818,2,318028,0,2817,428,2818,22,1
20150105.234716,2818,4,318032,0,2817,429,2818,22,1
20150105.234718,2818,4,318036,0,2817,430,2818,22,1
20150105.234719,2818,2,318038,-2,2817,430,2818,21,1
20150105.234722,2818,2,318040,0,2817,430,2818,20,1
20150105.234722,2818,2,318042,0,2817,430,2818,19,1
20150105.234732,2818,12,318054,-12,2817,467,2818,14,1
20150105.234735,2818,4,318058,-4,2817,457,2818,12,1
20150105.234741,2818,2,318060,0,2817,457,2818,12,1
20150105.234742,2818,2,318062,0,2817,457,2818,22,1
20150105.234743,2818,2,318064,2,2817,457,2818,21,1
20150105.234746,2818,10,318074,6,2817,487,2818,16,1
20150105.234749,2818,6,318080,2,2817,487,2818,13,1
20150105.234754,2818,2,318082,2,2817,460,2818,1,1
20150105.234755,2818,2,318084,2,2817,460,2819,800,1
20150105.234814,2818,6,318090,6,2817,428,2818,47,1
20150105.234821,2818,20,318110,0,2817,428,2818,54,1
20150105.234823,2818,4,318114,4,2817,428,2818,52,1
20150105.234827,2818,2,318116,0,2817,418,2818,57,1
20150105.234829,2817,48,318164,-48,2817,394,2818,51,0
20150105.234831,2818,2,318166,2,2817,394,2818,51,1
20150105.234836,2818,2,318168,2,2817,395,2818,51,1
20150105.234838,2817,2,318170,0,2817,395,2818,51,0
20150105.234841,2817,40,318210,-40,2817,360,2818,67,0
20150105.234845,2817,780,318990,362,2816,1373,2817,110,0
20150105.234846,2817,2,318992,0,2816,1375,2817,111,0
20150105.234847,2817,2,318994,2,2816,1375,2817,110,0
20150105.234848,2816,196,319190,194,2816,1372,2817,13,0
20150105.234849,2817,28,319218,22,2817,1,2818,94,1
20150105.234849,2816,30,319248,-28,2816,1371,2818,94,0
20150105.234851,2816,4,319252,0,2817,499,2818,73,0
20150105.234851,2817,48,319300,0,2817,490,2818,103,1
20150105.234852,2817,14,319314,0,2817,468,2818,103,1
20150105.234853,2817,12,319326,10,2817,462,2818,120,1
20150105.234858,2817,20,319346,0,2817,454,2818,241,1
20150105.234901,2818,16,319362,0,2817,458,2818,233,1
20150105.234901,2817,14,319376,0,2817,458,2818,233,0
20150105.234902,2817,2,319378,0,2817,457,2818,233,0
20150105.234905,2817,2,319380,2,2817,459,2818,236,0
20150105.234906,2817,12,319392,6,2817,453,2818,238,0
20150105.234908,2818,44,319436,12,2817,516,2818,273,1
20150105.23491,2817,4,319440,4,2817,514,2818,274,0
20150105.234911,2817,400,319840,200,2817,314,2818,574,0
20150105.234911,2817,2,319842,0,2817,313,2818,574,0
20150105.234912,2818,6,319848,0,2817,313,2818,571,1
20150105.234919,2817,2,319850,0,2817,315,2818,676,0
20150105.234923,2818,4,319854,0,2817,453,2818,674,1
20150105.234929,2817,2,319856,0,2817,455,2818,713,0
20150105.23493,2818,2,319858,0,2817,455,2818,712,1
20150105.23493,2817,2,319860,0,2817,454,2818,712,0
20150105.234932,2817,32,319892,32,2817,438,2818,712,0
20150105.234935,2817,20,319912,0,2817,428,2818,712,0
20150105.234937,2817,16,319928,16,2817,420,2818,712,0
20150105.234941,2817,206,320134,206,2817,317,2818,715,0
20150105.234947,2818,8,320142,-8,2817,319,2818,715,1
20150105.234947,2817,6,320148,0,2817,316,2818,715,0
20150105.23495,2817,6,320154,6,2817,313,2818,714,0
20150105.234951,2817,2,320156,0,2817,312,2818,713,0
20150105.234953,2818,40,320196,30,2817,312,2818,693,1
20150105.234959,2817,2,320198,2,2817,313,2818,696,0
20150105.234959,2818,2,320200,-2,2817,313,2818,695,1
20150105.235001,2818,10,320210,0,2817,313,2818,691,1
20150105.235007,2817,2,320212,2,2817,312,2818,690,0
20150105.235008,2818,2,320214,0,2817,312,2818,694,1
20150105.23501,2817,10,320224,0,2817,313,2818,737,0
20150105.235011,2818,2,320226,0,2817,313,2818,736,1
20150105.235012,2817,4,320230,0,2817,311,2818,736,0
20150105.235013,2817,2,320232,2,2817,310,2818,736,0
20150105.235014,2818,2,320234,-2,2817,310,2818,735,1
20150105.235015,2817,2,320236,0,2817,309,2818,985,0
20150105.235017,2817,2,320238,2,2817,308,2818,885,0
20150105.23502,2817,12,320250,12,2817,303,2818,881,0
20150105.23502,2817,4,320254,4,2817,301,2818,881,0
20150105.235021,2817,240,320494,-20,2817,183,2818,881,0
20150105.235022,2817,4,320498,0,2817,182,2818,881,0
20150105.235023,2817,50,320548,34,2817,157,2818,881,0
20150105.235024,2817,8,320556,0,2817,153,2818,881,0
20150105.235025,2817,8,320564,0,2817,149,2818,881,0
20150105.235025,2817,10,320574,10,2817,144,2818,881,0
20150105.235026,2817,2,320576,0,2817,143,2818,881,0
20150105.235026,2817,2,320578,0,2817,142,2818,881,0
20150105.235027,2818,42,320620,32,2817,142,2818,859,1
20150105.235028,2817,2,320622,0,2817,141,2818,859,0
20150105.235028,2817,4,320626,4,2817,140,2818,868,0
20150105.235031,2817,10,320636,0,2817,135,2818,872,0
20150105.235032,2818,4,320640,4,2817,135,2818,870,1
20150105.235034,2817,66,320706,0,2817,102,2818,872,0
20150105.235035,2817,4,320710,0,2817,100,2818,871,0
20150105.235036,2817,14,320724,0,2817,93,2818,871,0
20150105.235038,2817,4,320728,0,2817,91,2818,871,0
20150105.235044,2817,2,320730,2,2817,102,2818,571,0
20150105.235044,2817,2,320732,0,2817,102,2818,571,0
20150105.235046,2817,10,320742,0,2817,97,2818,572,0
20150105.235049,2817,4,320746,0,2817,96,2818,572,0
20150105.23505,2817,2,320748,2,2817,96,2818,572,0
20150105.235053,2817,194,320942,122,2816,1352,2817,403,0
20150105.235055,2816,4,320946,-4,2816,1350,2817,404,0
20150105.235055,2816,6,320952,-6,2816,1347,2817,405,0
20150105.235058,2816,2,320954,0,2816,1346,2817,456,0
20150105.2351,2816,2,320956,0,2816,1332,2817,473,0
20150105.235105,2817,2,320958,2,2816,1332,2817,505,1
20150105.235106,2817,102,321060,102,2816,1332,2817,455,1
20150105.235106,2817,100,321160,100,2816,1332,2817,390,1
20150105.235108,2817,8,321168,8,2816,1353,2817,386,1
20150105.235109,2817,2,321170,2,2816,1353,2817,385,1
20150105.235111,2816,6,321176,4,2816,1352,2817,455,0
20150105.235113,2817,4,321180,4,2816,1362,2817,453,1
20150105.235113,2816,6,321186,0,2816,1359,2817,467,0
20150105.235115,2816,2,321188,0,2816,1358,2817,467,0
20150105.235117,2817,6,321194,0,2816,1358,2817,464,1
20150105.235117,2817,4,321198,4,2816,1360,2817,462,1
20150105.235118,2817,10,321208,10,2816,1365,2817,457,1
20150105.23512,2817,2,321210,2,2816,1366,2817,456,1
20150105.235122,2817,40,321250,40,2816,1407,2817,421,1
20150105.235124,2816,2,321252,0,2816,1408,2817,422,0
20150105.235126,2817,2,321254,2,2816,1408,2817,421,1
20150105.235126,2817,2,321256,2,2816,1393,2817,457,1
20150105.235127,2817,4,321260,4,2816,1393,2817,455,1
20150105.235127,2817,6,321266,4,2816,1392,2817,453,1
20150105.235128,2817,10,321276,4,2816,1389,2817,451,1
20150105.235129,2817,4,321280,4,2816,1389,2817,551,1
20150105.235129,2817,6,321286,6,2816,1389,2817,547,1
20150105.23513,2817,4,321290,4,2816,1389,2817,545,1
20150105.23513,2817,8,321298,8,2816,1389,2817,542,1
20150105.235131,2817,4,321302,4,2816,1389,2817,540,1
20150105.235135,2817,6,321308,6,2816,1390,2817,541,1
20150105.235136,2817,2,321310,2,2816,1390,2817,540,1
20150105.235137,2817,2,321312,2,2816,1390,2817,554,1
20150105.235139,2816,12,321324,0,2816,1395,2817,525,0
20150105.23514,2816,4,321328,-4,2816,1393,2817,526,0
20150105.23514,2817,26,321354,26,2816,1394,2817,513,1
20150105.235141,2816,4,321358,0,2816,1392,2817,513,0
20150105.235147,2817,4,321362,0,2816,1405,2817,498,1
20150105.235147,2817,2,321364,2,2816,1405,2817,497,1
20150105.235148,2816,62,321426,2,2816,1375,2817,495,0
20150105.23515,2816,2,321428,0,2816,1373,2817,496,0
20150105.235153,2817,2,321430,2,2816,1375,2817,496,1
20150105.235154,2817,40,321470,0,2816,1375,2817,476,1
20150105.235155,2816,20,321490,-20,2816,1365,2817,477,0
20150105.235155,2816,26,321516,0,2816,1352,2817,478,0
20150105.235156,2817,2,321518,2,2816,1352,2817,477,1
20150105.235204,2817,2,321520,2,2816,1342,2817,491,1
20150105.235205,2817,2,321522,2,2816,1347,2817,489,1
20150105.23521,2817,4,321526,2,2816,1356,2817,493,1
20150105.235212,2817,100,321626,100,2816,1356,2817,443,1
20150105.235215,2816,4,321630,-2,2816,1357,2817,442,0
20150105.235216,2817,2,321632,2,2816,1357,2817,441,1
20150105.235217,2817,4,321636,0,2816,1357,2817,439,1
20150105.235218,2817,100,321736,100,2816,1357,2817,388,1
20150105.235219,2817,14,321750,4,2816,1357,2817,381,1
20150105.235219,2817,10,321760,0,2816,1357,2817,376,1
20150105.235219,2817,104,321864,0,2816,1357,2817,324,1
20150105.23522,2817,2,321866,2,2816,1358,2817,323,1
20150105.235221,2817,2,321868,2,2816,1358,2817,322,1
20150105.235222,2817,20,321888,20,2816,1358,2817,312,1
20150105.235223,2817,2,321890,2,2816,1378,2817,311,1
20150105.235223,2816,4,321894,0,2816,1376,2817,311,0
20150105.235228,2817,610,322504,168,2816,1394,2817,17,1
20150105.235229,2817,2,322506,0,2816,1394,2817,16,1
20150105.235229,2817,32,322538,-18,2817,3,2818,531,1
20150105.235233,2817,2,322540,0,2817,34,2818,531,1
20150105.235234,2817,2,322542,0,2817,34,2818,531,1
20150105.235242,2818,2,322544,0,2817,80,2818,536,1
20150105.235246,2817,20,322564,18,2817,105,2818,531,0
20150105.235246,2817,16,322580,6,2817,97,2818,531,0
20150105.235247,2818,2,322582,-2,2817,98,2818,530,1
20150105.235248,2818,4,322586,0,2817,104,2818,528,1
20150105.23525,2818,2,322588,0,2817,116,2818,527,1
20150105.23525,2818,2,322590,0,2817,116,2818,526,1
20150105.235251,2818,2,322592,0,2817,116,2818,525,1
20150105.235252,2818,4,322596,0,2817,139,2818,523,1
20150105.235303,2817,16,322612,-16,2817,195,2818,530,0
20150105.235303,2818,4,322616,-4,2817,195,2818,528,1
20150105.235311,2817,10,322626,0,2817,276,2818,555,0
20150105.235312,2818,2,322628,0,2817,286,2818,554,1
20150105.235313,2818,2,322630,-2,2817,286,2818,554,1
20150105.235339,2817,2,322632,0,2817,336,2818,537,0
20150105.235343,2817,4,322636,4,2817,334,2818,507,0
20150105.235357,2817,2,322638,0,2817,350,2818,492,0
20150105.235359,2818,60,322698,0,2817,365,2818,462,1
20150105.235401,2818,2,322700,0,2817,367,2818,457,1
20150105.235423,2818,2,322702,0,2817,383,2818,426,1
20150105.235427,2818,2,322704,0,2817,383,2818,425,1
20150105.235449,2818,8,322712,-8,2817,392,2818,423,1
20150105.235451,2817,8,322720,0,2817,388,2818,423,0
20150105.235503,2818,400,323120,-24,2817,507,2818,223,1
20150105.235503,2818,20,323140,0,2817,507,2818,213,1
20150105.235504,2818,20,323160,20,2817,507,2818,203,1
20150105.235504,2818,10,323170,0,2817,507,2818,198,1
20150105.235508,2818,2,323172,2,2817,507,2818,197,1
20150105.235508,2818,4,323176,0,2817,507,2818,195,1
20150105.235511,2818,10,323186,0,2817,507,2818,190,1
20150105.235515,2818,6,323192,0,2817,498,2818,187,1
20150105.235526,2818,2,323194,2,2817,493,2818,196,1
20150105.235528,2818,2,323196,0,2817,493,2818,195,1
20150105.235529,2818,2,323198,2,2817,493,2818,194,1
20150105.235529,2818,2,323200,2,2817,493,2818,193,1
20150105.235531,2818,2,323202,2,2817,493,2818,192,1
20150105.235534,2818,2,323204,2,2817,493,2818,191,1
20150105.235535,2818,2,323206,2,2817,493,2818,190,1
20150105.235548,2818,6,323212,0,2817,491,2818,192,1
20150105.235555,2817,4,323216,0,2817,500,2818,193,0
20150105.235557,2818,2,323218,2,2817,500,2818,193,1
20150105.235558,2818,2,323220,0,2817,500,2818,192,1
20150105.235601,2818,2,323222,2,2817,550,2818,192,1
20150105.235602,2818,2,323224,2,2817,549,2818,191,1
20150105.235605,2818,2,323226,2,2817,549,2818,190,1
20150105.235608,2817,4,323230,0,2817,548,2818,200,0
20150105.235609,2818,42,323272,42,2817,548,2818,179,1
20150105.235612,2818,4,323276,0,2817,547,2818,177,1
20150105.235617,2817,164,323440,92,2817,465,2818,186,0
20150105.235617,2817,8,323448,8,2817,446,2818,181,0
20150105.235617,2818,2,323450,2,2817,461,2818,180,1
20150105.235619,2818,2,323452,0,2817,461,2818,179,1
20150105.235623,2818,2,323454,2,2817,461,2818,210,1
20150105.235627,2818,2,323456,2,2817,460,2818,216,1
20150105.235632,2817,20,323476,20,2817,450,2818,217,0
20150105.235633,2817,2,323478,0,2817,449,2818,217,0
20150105.235634,2817,26,323504,20,2817,436,2818,216,0
20150105.235637,2817,20,323524,4,2817,436,2818,176,0
20150105.235641,2817,20,323544,4,2817,411,2818,194,0
20150105.235642,2818,2,323546,0,2817,411,2818,193,1
20150105.235643,2817,20,323566,20,2817,402,2818,192,0
20150105.235647,2817,20,323586,20,2817,393,2818,192,0
20150105.235648,2818,2,323588,2,2817,395,2818,191,1
20150105.23565,2817,20,323608,16,2817,385,2818,206,0
20150105.235656,2817,4,323612,0,2817,400,2818,193,0
20150105.235659,2817,2,323614,0,2817,399,2818,192,0
20150105.235659,2818,2,323616,0,2817,399,2818,191,1
20150105.235701,2817,2,323618,2,2817,398,2818,193,0
20150105.235703,2817,2,323620,2,2817,397,2818,193,0
20150105.235706,2817,2,323622,2,2817,398,2818,193,0
20150105.235709,2817,4,323626,0,2817,396,2818,203,0
20150105.235709,2818,102,323728,2,2817,394,2818,153,1
20150105.235712,2818,134,323862,-36,2817,404,2818,86,1
20150105.235713,2818,22,323884,-14,2817,404,2818,75,1
20150105.235715,2818,2,323886,0,2817,404,2818,74,1
20150105.235716,2818,4,323890,4,2817,404,2818,72,1
20150105.235717,2818,100,323990,-38,2817,404,2818,22,1
20150105.235719,2818,2,323992,2,2817,404,2818,29,1
20150105.23572,2818,2,323994,0,2817,404,2818,28,1
20150105.235721,2818,2,323996,0,2817,407,2818,28,1
20150105.235724,2818,82,324078,-58,2817,410,2819,821,1
20150105.23573,2819,2,324080,-2,2817,418,2819,820,1
20150105.235731,2818,8,324088,0,2817,428,2819,821,0
20150105.235732,2819,2,324090,-2,2817,428,2819,820,1
20150105.235736,2818,12,324102,0,2818,1,2819,821,0
20150105.235736,2818,2,324104,0,2817,431,2819,821,0
20150105.235737,2819,10,324114,-10,2817,431,2819,817,1
20150105.235744,2819,4,324118,0,2817,437,2819,916,1
20150105.235746,2819,62,324180,-62,2817,437,2819,885,1
20150105.235749,2819,14,324194,-10,2817,437,2819,881,1
20150105.235752,2818,2,324196,0,2818,49,2819,885,0
20150105.235755,2819,10,324206,-10,2818,52,2819,884,1
20150105.235756,2818,106,324312,2,2817,436,2818,447,0
20150105.2358,2818,2,324314,2,2817,426,2818,448,0
20150105.235801,2818,2,324316,2,2817,426,2818,448,0
20150105.235802,2818,2,324318,2,2817,426,2818,447,0
20150105.235802,2818,2,324320,2,2817,426,2818,446,0
20150105.235803,2818,2,324322,2,2817,426,2818,445,0
20150105.235803,2818,2,324324,2,2817,426,2818,444,0
20150105.235805,2818,2,324326,2,2817,426,2818,443,0
20150105.235805,2818,2,324328,2,2817,426,2818,442,0
20150105.235805,2818,2,324330,2,2817,426,2818,441,0
20150105.235806,2818,4,324334,2,2817,426,2818,439,0
20150105.235807,2818,2,324336,2,2817,411,2818,438,0
20150105.235807,2818,4,324340,2,2817,411,2818,436,0
20150105.235808,2818,2,324342,2,2817,411,2818,435,0
20150105.235808,2818,2,324344,2,2817,411,2818,434,0
20150105.235809,2818,2,324346,2,2817,411,2818,433,0
20150105.235809,2818,2,324348,2,2817,411,2818,433,0
20150105.235809,2818,2,324350,2,2817,411,2818,432,0
20150105.23581,2818,2,324352,2,2817,421,2818,431,0
20150105.235811,2818,4,324356,4,2817,421,2818,429,0
20150105.235811,2818,26,324382,0,2817,409,2818,428,0
20150105.235812,2818,2,324384,2,2817,409,2818,427,0
20150105.235812,2818,2,324386,2,2817,409,2818,426,0
20150105.235813,2818,6,324392,4,2817,409,2818,423,0
20150105.235813,2818,4,324396,4,2817,409,2818,421,0
20150105.235814,2818,4,324400,4,2817,409,2818,420,0
20150105.235814,2818,6,324406,6,2817,406,2818,417,0
20150105.235815,2818,4,324410,4,2817,406,2818,415,0
20150105.235815,2818,2,324412,2,2817,406,2818,414,0
20150105.235815,2818,2,324414,0,2817,403,2818,416,0
20150105.235817,2818,2,324416,2,2817,403,2818,415,0
20150105.235821,2818,2,324418,0,2817,403,2818,429,0
20150105.235834,2818,34,324452,24,2817,422,2818,425,0
20150105.235838,2818,4,324456,4,2817,423,2818,420,0
20150105.235842,2818,6,324462,6,2817,428,2818,417,0
20150105.235843,2818,6,324468,6,2817,428,2818,414,0
20150105.235844,2818,2,324470,2,2817,429,2818,413,0
20150105.235845,2818,6,324476,6,2817,429,2818,410,0
20150105.23585,2818,2,324478,2,2817,427,2818,409,0
20150105.235851,2818,2,324480,0,2817,427,2818,409,0
20150105.235852,2818,2,324482,2,2817,427,2818,408,0
20150105.235854,2818,20,324502,0,2817,426,2818,398,0
20150105.235857,2817,32,324534,0,2817,411,2818,398,0
20150105.235857,2818,6,324540,0,2817,411,2818,395,1
20150105.235858,2818,60,324600,60,2817,411,2818,365,1
20150105.235903,2817,4,324604,0,2817,406,2818,365,0
20150105.235909,2818,20,324624,20,2817,407,2818,355,1
20150105.235911,2818,2,324626,2,2817,488,2818,354,1
20150105.235918,2818,10,324636,0,2817,529,2818,360,1
20150105.235919,2818,720,325356,-50,2818,641,2819,727,1
20150105.235923,2819,4,325360,-4,2818,670,2819,710,1
20150105.235929,2819,4,325364,0,2818,712,2819,708,1
20150105.235946,2818,2,325366,0,2818,715,2819,786,0
20150105.235956,2818,100,325466,0,2818,651,2819,760,0
20150105.235957,2819,1520,326986,-1230,2819,240,2820,574,1
20150106,2819,60,327046,0,2819,211,2820,553,1
20150106.000001,2820,194,327240,-16,2819,123,2820,544,1
20150106.000002,2819,248,327488,-248,2818,77,2819,808,0
20150106.000002,2819,8,327496,-4,2818,62,2819,834,0
20150106.000003,2818,4,327500,-2,2818,60,2819,834,0
20150106.000004,2819,6,327506,-2,2818,61,2819,831,1
20150106.000005,2818,44,327550,-42,2818,39,2819,816,0
20150106.000005,2819,52,327602,12,2818,14,2819,815,1
20150106.000006,2819,1178,328780,-1178,2818,29,2819,211,1
20150106.000007,2819,2,328782,0,2818,14,2819,226,1
20150106.000008,2819,2,328784,0,2818,14,2819,225,1
20150106.000009,2818,32,328816,16,2818,1,2819,205,0
20150106.00001,2819,2,328818,-2,2818,12,2819,204,1
20150106.000015,2818,2,328820,2,2818,31,2819,215,0
20150106.000016,2819,10,328830,-10,2818,32,2819,210,1
20150106.000016,2819,10,328840,0,2818,32,2819,205,1
20150106.000017,2819,2,328842,0,2818,35,2819,204,1
20150106.000018,2818,2,328844,0,2818,37,2819,201,0
20150106.000019,2819,60,328904,-38,2819,376,2820,552,1
20150106.00002,2819,2,328906,-2,2819,375,2820,531,1
20150106.000021,2819,20,328926,-20,2819,365,2820,531,1
20150106.000026,2820,2,328928,2,2819,365,2820,237,1
20150106.000026,2819,2,328930,-2,2819,364,2820,237,0
20150106.000027,2819,380,329310,-96,2819,204,2820,207,0
20150106.000033,2819,2,329312,-2,2819,203,2820,228,0
20150106.000033,2820,240,329552,-184,2819,203,2820,108,1
20150106.000034,2820,38,329590,0,2819,204,2820,76,1
20150106.000035,2819,272,329862,-272,2819,69,2820,115,0
20150106.000036,2819,12,329874,-2,2819,67,2820,135,0
20150106.000036,2820,100,329974,-64,2819,68,2820,85,1
20150106.000036,2820,2,329976,2,2819,69,2820,85,1
20150106.000041,2820,2,329978,2,2819,72,2820,46,1
20150106.000042,2820,4,329982,0,2819,96,2820,25,1
20150106.000043,2819,6,329988,-4,2819,94,2820,24,0
20150106.000044,2820,10,329998,-4,2819,95,2820,19,1
20150106.000045,2820,2,330000,0,2819,95,2820,18,1
20150106.000045,2820,6,330006,-4,2819,96,2820,15,1
20150106.000046,2820,6,330012,0,2819,97,2820,12,1
20150106.000046,2820,10,330022,0,2819,97,2820,73,1
20150106.000047,2820,46,330068,32,2819,97,2821,731,1
20150106.000047,2820,6,330074,0,2819,97,2821,731,1
20150106.000048,2820,4,330078,0,2819,110,2820,47,1
20150106.000049,2820,4,330082,-2,2819,114,2820,46,1
20150106.000052,2820,2,330084,-2,2819,120,2820,37,1
20150106.000054,2820,4,330088,-4,2819,122,2820,35,1
20150106.000057,2820,4,330092,0,2819,121,2820,34,1
20150106.000058,2820,2,330094,0,2819,121,2820,23,1
20150106.0001,2820,2,330096,0,2819,123,2820,23,1
20150106.000101,2820,20,330116,4,2819,123,2820,14,1
20150106.000103,2820,80,330196,74,2820,2,2821,801,1
20150106.000103,2820,4,330200,2,2819,123,2821,801,1
20150106.000104,2821,80,330280,2,2819,143,2821,761,1
20150106.000104,2821,16,330296,-12,2819,147,2820,1,1
20150106.000105,2820,2,330298,0,2819,147,2820,11,0
20150106.000106,2820,2,330300,-2,2819,148,2820,82,0
20150106.000107,2820,20,330320,-18,2819,148,2821,686,0
20150106.000108,2820,4,330324,2,2819,149,2821,686,0
20150106.00011,2820,6,330330,-2,2819,149,2821,718,0
20150106.00011,2820,52,330382,0,2819,148,2820,85,0
20150106.000111,2820,2,330384,2,2819,148,2820,117,0
20150106.000113,2820,236,330620,-100,2820,882,2821,811,0
20150106.000115,2820,4,330624,0,2820,898,2821,793,0
20150106.000115,2820,6,330630,-6,2820,895,2821,792,0
20150106.000116,2820,4,330634,-2,2820,893,2821,792,0
20150106.000117,2820,46,330680,-36,2820,890,2821,772,0
20150106.000117,2821,2,330682,-2,2820,890,2821,773,1
20150106.000119,2820,14,330696,-14,2820,884,2821,794,0
20150106.00012,2820,2,330698,-2,2820,883,2821,788,0
20150106.000124,2821,1620,332318,-566,2821,207,2822,357,1
20150106.000124,2821,6,332324,-6,2821,204,2822,357,1
20150106.000125,2822,714,333038,106,2822,645,2823,815,1
20150106.000128,2823,4,333042,-2,2822,697,2823,813,1
20150106.000128,2823,422,333464,-16,2822,496,2823,805,1
20150106.000129,2822,412,333876,194,2822,280,2823,798,0
20150106.000129,2822,54,333930,12,2822,260,2823,794,0
20150106.00013,2823,4,333934,-4,2822,260,2823,792,1
20150106.00013,2823,4,333938,0,2822,269,2823,792,1
20150106.000131,2822,120,334058,0,2822,209,2823,792,0
20150106.000131,2823,10,334068,-2,2822,220,2823,787,1
20150106.000132,2822,418,334486,-48,2822,43,2823,785,0
20150106.000132,2822,252,334738,-230,2822,19,2823,785,0
20150106.000133,2822,22,334760,-22,2822,8,2823,789,0
20150106.000134,2822,4,334764,-2,2822,21,2823,792,0
20150106.000135,2822,8,334772,-2,2822,17,2823,787,0
20150106.000135,2822,2,334774,0,2822,16,2823,794,0
20150106.000136,2821,26,334800,-16,2821,46,2823,797,0
20150106.000137,2822,134,334934,-52,2821,56,2822,24,1
20150106.000137,2822,64,334998,48,2821,72,2823,702,1
20150106.000138,2821,2,335000,-2,2821,76,2822,4,0
20150106.000139,2821,4,335004,-4,2821,80,2822,54,0
20150106.000141,2822,108,335112,-18,2822,955,2823,831,1
20150106.000142,2822,10,335122,0,2822,968,2823,795,1
20150106.000143,2822,10,335132,8,2822,963,2823,797,1
20150106.000144,2822,10,335142,0,2822,958,2823,800,1
20150106.000145,2822,380,335522,0,2822,868,2823,867,1
20150106.000145,2822,2,335524,0,2822,868,2823,852,1
20150106.000146,2823,2,335526,0,2822,868,2823,851,1
20150106.000146,2822,2102,337628,114,2822,102,2823,550,0
20150106.000147,2823,22,337650,0,2822,92,2823,529,1
20150106.000147,2822,6,337656,0,2822,89,2823,517,0
20150106.000148,2822,2,337658,2,2822,93,2823,207,0
20150106.00015,2823,12,337670,10,2822,303,2823,201,1
20150106.000152,2823,2,337672,0,2822,331,2823,206,1
20150106.000153,2822,2,337674,0,2822,392,2823,311,0
20150106.000153,2823,2,337676,2,2822,397,2823,310,1
20150106.000154,2822,4,337680,2,2822,389,2823,309,0
20150106.000154,2823,204,337884,-142,2822,391,2823,208,1
20150106.000155,2823,10,337894,0,2822,391,2823,213,1
20150106.000155,2823,4,337898,0,2822,361,2823,211,1
20150106.000156,2823,30,337928,-30,2822,346,2823,511,1
20150106.000157,2822,2,337930,2,2822,360,2823,512,0
20150106.000157,2822,10,337940,10,2822,325,2823,503,0
20150106.000158,2822,2,337942,0,2822,324,2823,502,0
20150106.0002,2822,2,337944,2,2822,325,2823,514,0
20150106.0002,2822,100,338044,0,2822,260,2823,515,0
20150106.000202,2823,2,338046,0,2822,270,2823,518,1
20150106.000202,2822,4,338050,0,2822,283,2823,518,0
20150106.000203,2822,6,338056,0,2822,281,2823,522,0
20150106.000203,2823,2,338058,-2,2822,281,2823,524,1
20150106.000205,2822,4,338062,2,2822,280,2823,497,0
20150106.000205,2823,2,338064,0,2822,280,2823,496,1
20150106.000206,2822,2,338066,0,2822,280,2823,536,0
20150106.000208,2823,6,338072,0,2822,282,2823,538,1
20150106.00021,2822,28,338100,0,2822,253,2823,640,0
20150106.00021,2823,22,338122,-20,2822,266,2823,630,1
20150106.00021,2823,10,338132,8,2822,265,2823,626,1
20150106.000211,2823,2,338134,2,2822,265,2823,625,1
20150106.000212,2823,2,338136,2,2822,265,2823,623,1
20150106.000212,2822,4,338140,2,2822,264,2823,622,0
20150106.000215,2822,500,338640,-234,2821,248,2822,50,0
20150106.000216,2822,42,338682,-10,2821,248,2822,30,0
20150106.000218,2822,2,338684,0,2821,242,2822,36,0
20150106.00022,2822,46,338730,-44,2821,243,2822,19,0
20150106.000221,2822,24,338754,10,2821,245,2822,13,0
20150106.000223,2821,22,338776,-22,2821,240,2822,21,0
20150106.000224,2822,42,338818,6,2822,43,2823,767,1
20150106.000225,2822,2,338820,0,2822,44,2823,769,1
20150106.000227,2822,2,338822,2,2822,161,2823,733,1
20150106.000228,2822,4,338826,2,2822,159,2823,734,1
20150106.000228,2822,4,338830,0,2822,157,2823,733,1
20150106.00023,2822,4,338834,0,2822,177,2823,732,1
20150106.000231,2823,8,338842,0,2822,177,2823,730,1
20150106.000231,2822,12,338854,0,2822,171,2823,731,0
20150106.000232,2823,88,338942,-10,2822,131,2823,727,1
20150106.000233,2822,2,338944,0,2822,130,2823,727,0
20150106.000233,2822,2,338946,2,2822,130,2823,727,0
20150106.000234,2823,6,338952,0,2822,128,2823,726,1
20150106.000234,2822,196,339148,2,2822,142,2823,629,0
20150106.000236,2822,2,339150,0,2822,160,2823,681,0
20150106.000237,2823,2,339152,0,2822,160,2823,683,1
20150106.000238,2822,4,339156,2,2822,158,2823,683,0
20150106.000239,2823,1386,340542,-1064,2823,313,2824,873,1
20150106.00024,2823,18,340560,-14,2823,305,2824,873,1
20150106.00024,2823,4,340564,-4,2823,305,2824,873,1
20150106.000241,2824,22,340586,-2,2823,295,2824,872,1
20150106.000243,2823,8,340594,-8,2823,391,2824,882,0
20150106.000244,2823,2,340596,-2,2823,390,2824,883,0
20150106.000245,2823,2,340598,-2,2823,389,2824,883,0
20150106.000245,2823,888,341486,-686,2822,196,2823,178,0
20150106.000248,2823,6,341492,6,2822,141,2823,189,0
20150106.000248,2823,2,341494,0,2822,147,2823,194,0
20150106.00025,2823,4,341498,4,2822,152,2823,196,0
20150106.000251,2823,106,341604,4,2822,153,2823,143,0
20150106.000251,2823,20,341624,20,2822,195,2823,133,0
20150106.000252,2823,18,341642,0,2822,195,2823,125,0
20150106.000252,2823,2,341644,2,2822,195,2823,124,0
20150106.000253,2823,20,341664,20,2822,205,2823,124,0
20150106.000254,2823,282,341946,-82,2823,7,2824,895,0
20150106.000256,2823,4,341950,-2,2823,5,2824,900,0
20150106.000257,2823,14,341964,-14,2823,3,2824,897,0
20150106.000259,2823,2,341966,0,2823,15,2824,901,0
20150106.000259,2823,2,341968,-2,2823,14,2824,901,0
20150106.000259,2823,2,341970,0,2823,13,2824,901,0
20150106.0003,2824,2,341972,-2,2823,13,2824,900,1
20150106.0003,2823,8,341980,8,2823,9,2824,900,0
20150106.000301,2823,2,341982,2,2823,8,2824,903,0
20150106.000302,2823,68,342050,0,2822,200,2823,17,0
20150106.000302,2823,20,342070,0,2822,200,2823,8,0
20150106.000303,2823,6,342076,0,2822,201,2823,9,0
20150106.000304,2822,4,342080,4,2822,199,2823,40,0
20150106.000305,2823,28,342108,-22,2822,198,2823,44,1
20150106.000306,2823,14,342122,-2,2822,197,2823,38,1
20150106.000307,2823,20,342142,0,2822,208,2823,29,1
20150106.000309,2823,6,342148,-4,2822,150,2823,68,1
20150106.000313,2822,2,342150,2,2822,158,2823,133,0
20150106.000315,2823,4,342154,2,2822,159,2823,148,1
20150106.000319,2822,2,342156,0,2822,120,2823,260,0
20150106.00032,2822,2,342158,2,2822,119,2823,261,0
20150106.000321,2823,16,342174,0,2822,134,2823,257,1
20150106.000321,2822,76,342250,-2,2822,96,2823,257,0
20150106.000322,2822,2,342252,0,2822,80,2823,268,0
20150106.000323,2822,2,342254,2,2822,100,2823,270,0
20150106.000324,2822,2,342256,0,2822,99,2823,270,0
20150106.000326,2823,50,342306,-10,2822,85,2823,269,1
20150106.000326,2823,4,342310,4,2822,100,2823,269,1
20150106.000327,2823,4,342314,4,2822,98,2823,269,1
20150106.000327,2822,2,342316,0,2822,97,2823,272,0
20150106.000328,2822,16,342332,16,2822,75,2823,274,0
20150106.000328,2823,8,342340,-2,2822,75,2823,272,1
20150106.000329,2822,4,342344,4,2822,78,2823,278,0
20150106.00033,2822,4,342348,4,2822,84,2823,279,0
20150106.000331,2822,2,342350,0,2822,83,2823,280,0
20150106.000333,2822,34,342384,0,2822,69,2823,280,0
20150106.000334,2822,2,342386,0,2822,68,2823,281,0
20150106.000339,2822,90,342476,-28,2822,29,2823,282,0
20150106.000342,2823,200,342676,76,2822,29,2823,183,1
20150106.000342,2822,20,342696,-10,2822,19,2823,183,0
20150106.000344,2823,2,342698,0,2822,20,2823,182,1
20150106.000345,2822,6,342704,6,2822,17,2823,183,0
20150106.000345,2822,34,342738,-30,2821,236,2822,83,0
20150106.000346,2822,168,342906,-166,2822,3,2823,223,0
20150106.000347,2822,2,342908,2,2822,6,2823,230,0
20150106.000349,2823,4,342912,-4,2822,6,2823,249,1
20150106.00035,2822,12,342924,-6,2821,236,2823,249,0
20150106.000357,2822,2,342926,-2,2822,18,2823,250,0
20150106.000358,2823,6,342932,0,2822,3,2823,248,1
20150106.000359,2822,16,342948,-2,2821,244,2823,263,0
20150106.0004,2822,4,342952,-2,2821,244,2823,265,0
20150106.000401,2822,2,342954,0,2822,1,2823,266,0
20150106.000402,2822,2,342956,0,2821,239,2823,266,0
20150106.000403,2822,6,342962,-6,2821,239,2822,1,0
20150106.000403,2822,2,342964,-2,2821,240,2822,1,0
20150106.000404,2822,4,342968,-4,2822,166,2823,270,0
20150106.000405,2822,2,342970,0,2822,167,2823,246,0
20150106.000406,2822,4,342974,0,2822,165,2823,326,0
20150106.000407,2822,2,342976,0,2822,164,2823,326,0
20150106.000408,2823,44,343020,42,2822,129,2823,332,1
20150106.000409,2823,168,343188,-2,2822,62,2823,306,1
20150106.000409,2822,2,343190,0,2822,47,2823,304,0
20150106.000411,2823,74,343264,56,2822,69,2823,278,1
20150106.000411,2822,2,343266,0,2822,79,2823,278,0
20150106.000412,2822,2,343268,0,2822,93,2823,288,0
20150106.000412,2823,574,343842,200,2822,94,2824,769,1
20150106.000414,2823,2,343844,0,2822,128,2824,870,1
20150106.000417,2823,54,343898,0,2823,18,2824,835,1
20150106.000417,2822,288,344186,-124,2821,227,2823,24,0
20150106.000418,2822,60,344246,-30,2822,3,2823,81,0
20150106.00042,2823,2,344248,-2,2822,23,2823,90,1
20150106.00042,2823,20,344268,-20,2822,23,2823,80,1
20150106.000421,2823,8,344276,0,2822,46,2823,61,1
20150106.000422,2822,498,344774,22,2821,241,2824,755,0
20150106.000423,2822,4,344778,0,2822,1,2823,97,0
20150106.000424,2823,2,344780,0,2822,8,2823,242,1
20150106.000425,2823,2,344782,0,2822,9,2823,243,1
20150106.000426,2822,50,344832,-24,2821,237,2823,192,0
20150106.000428,2822,2,344834,0,2821,237,2823,193,0
20150106.000428,2822,2,344836,0,2821,237,2823,193,0
20150106.000429,2822,54,344890,2,2821,237,2822,161,0
20150106.00043,2822,124,345014,0,2821,239,2823,254,0
20150106.000432,2823,8,345022,-6,2822,22,2823,231,1
20150106.000432,2822,46,345068,-14,2821,222,2823,50,0
20150106.000433,2822,62,345130,-32,2821,207,2823,77,0
20150106.000434,2821,4,345134,0,2821,206,2823,78,0
20150106.000435,2822,40,345174,0,2821,206,2823,78,1
20150106.000436,2823,100,345274,-92,2822,150,2823,152,1
20150106.000437,2823,80,345354,46,2822,193,2823,87,1
20150106.000437,2823,84,345438,6,2822,58,2823,80,1
20150106.000438,2822,2,345440,0,2822,78,2823,68,0
20150106.000439,2823,2,345442,0,2822,102,2823,58,1
20150106.000439,2822,208,345650,-44,2821,225,2823,57,0
20150106.00044,2822,92,345742,-88,2821,220,2823,83,0
20150106.000441,2823,288,346030,116,2822,39,2824,467,1
20150106.000442,2823,80,346110,24,2822,84,2824,467,1
20150106.000443,2822,8,346118,0,2822,123,2823,8,0
20150106.000444,2822,292,346410,-192,2821,120,2823,63,0
20150106.000444,2823,26,346436,-24,2822,1,2823,119,1
20150106.000446,2823,2,346438,0,2822,3,2823,130,1
20150106.000446,2823,22,346460,0,2822,3,2823,123,1
20150106.000447,2824,822,347282,378,2822,26,2824,296,1
20150106.000447,2823,2,347284,0,2822,177,2824,297,0
20150106.000448,2822,188,347472,-48,2822,87,2823,44,0
20150106.000449,2823,20,347492,-20,2822,92,2823,70,1
20150106.00045,2822,2,347494,2,2822,92,2823,68,0
20150106.00045,2823,10,347504,0,2822,97,2823,68,1
20150106.000451,2823,56,347560,2,2822,113,2824,222,1
20150106.000451,2824,18,347578,0,2822,133,2824,274,1
20150106.000452,2824,60,347638,-60,2822,133,2824,243,1
20150106.000452,2824,12,347650,-8,2822,133,2824,224,1
20150106.000454,2824,8,347658,0,2823,4,2824,220,1
20150106.000454,2823,12,347670,-8,2822,140,2823,166,0
20150106.000455,2823,12,347682,10,2822,117,2823,121,0
20150106.000455,2823,4,347686,4,2822,123,2823,111,0
20150106.000457,2823,236,347922,16,2823,42,2824,236,0
20150106.000458,2824,14,347936,0,2823,39,2824,234,1
20150106.000458,2824,2,347938,0,2823,2,2824,233,1
20150106.000458,2824,2,347940,0,2823,4,2824,232,1
20150106.000459,2824,4,347944,0,2823,4,2824,233,1
20150106.000501,2824,10,347954,0,2823,43,2824,229,1
20150106.000502,2823,78,348032,8,2823,10,2824,176,0
20150106.000502,2823,64,348096,-50,2823,3,2824,190,0
20150106.000503,2823,6,348102,-6,2822,168,2824,133,0
20150106.000503,2823,2,348104,0,2822,155,2823,209,0
20150106.000504,2823,12,348116,4,2822,212,2823,219,0
20150106.000505,2823,2,348118,0,2822,228,2823,217,0
20150106.000506,2823,20,348138,-20,2822,228,2823,207,0
20150106.000506,2823,4,348142,0,2822,243,2824,161,0
20150106.000507,2823,14,348156,-12,2822,243,2824,161,0
20150106.000508,2823,18,348174,-2,2822,259,2824,182,0
20150106.00051,2823,50,348224,2,2822,267,2824,184,0
20150106.00051,2823,2,348226,0,2822,272,2824,184,0
20150106.000511,2823,42,348268,0,2822,274,2824,185,0
20150106.000512,2823,4,348272,-4,2822,274,2823,90,0
20150106.000512,2823,6,348278,-6,2822,276,2824,183,0
20150106.000514,2822,4,348282,0,2822,273,2824,183,0
20150106.000516,2822,44,348326,44,2822,275,2824,184,0
20150106.000517,2823,2,348328,0,2822,315,2824,184,1
20150106.000519,2823,6,348334,-6,2822,313,2823,99,1
20150106.00052,2823,410,348744,172,2822,99,2823,372,1
20150106.000523,2823,34,348778,24,2822,131,2823,364,1
20150106.000524,2823,16,348794,-16,2822,143,2823,371,1
20150106.000525,2823,2,348796,-2,2822,158,2823,385,1
20150106.000526,2823,400,349196,-400,2822,163,2823,185,1
20150106.000528,2823,8,349204,0,2822,169,2823,181,1
20150106.000536,2823,6,349210,-6,2822,158,2823,220,1
20150106.000536,2823,2,349212,-2,2822,158,2823,219,1
20150106.000538,2822,2,349214,0,2822,155,2823,220,0
20150106.000538,2822,2,349216,2,2822,145,2823,220,0
20150106.000539,2823,2,349218,-2,2822,245,2823,218,1
20150106.00054,2823,20,349238,0,2822,246,2823,208,1
20150106.000541,2823,8,349246,0,2822,247,2823,198,1
20150106.000541,2823,4,349250,0,2822,247,2823,217,1
20150106.000544,2823,2,349252,-2,2822,240,2823,199,1
20150106.000546,2823,2,349254,0,2822,240,2823,201,1
20150106.000549,2823,2,349256,0,2822,241,2823,200,1
20150106.000549,2822,2,349258,2,2822,240,2823,200,0
20150106.00055,2822,4,349262,4,2822,241,2823,202,0
20150106.000552,2822,2,349264,0,2822,240,2823,204,0
20150106.000558,2823,12,349276,-12,2822,295,2823,250,1
20150106.000559,2823,6,349282,0,2822,292,2823,247,1
20150106.0006,2822,6,349288,0,2822,290,2823,245,0
20150106.000601,2822,16,349304,16,2822,285,2823,314,0
20150106.000601,2822,12,349316,0,2822,279,2823,314,0
20150106.000603,2822,2,349318,0,2822,283,2823,236,0
20150106.000605,2822,2,349320,0,2822,283,2823,237,0
20150106.000606,2822,2,349322,2,2822,282,2823,238,0
20150106.000608,2823,2,349324,0,2822,267,2823,237,1
20150106.000611,2823,10,349334,8,2822,269,2823,257,1
20150106.000612,2823,2,349336,0,2822,271,2823,257,1
20150106.000614,2823,2,349338,0,2822,271,2823,258,1
20150106.000615,2823,2,349340,0,2822,281,2823,257,1
20150106.000619,2823,210,349550,-136,2822,283,2823,189,1
20150106.000619,2823,190,349740,184,2822,283,2823,93,1
20150106.00062,2823,130,349870,-38,2822,289,2824,195,1
20150106.000623,2823,4,349874,-2,2822,288,2823,30,1
20150106.000624,2823,260,350134,256,2823,1,2824,330,1
20150106.000624,2824,2,350136,2,2823,3,2824,329,1
20150106.000625,2824,4,350140,0,2823,3,2824,327,1
20150106.000626,2823,8,350148,4,2822,290,2824,327,0
20150106.000631,2823,8,350156,8,2822,290,2823,97,0
20150106.000631,2823,102,350258,100,2822,290,2823,46,0
20150106.000632,2823,16,350274,16,2822,290,2823,38,0
20150106.000633,2823,2,350276,0,2822,291,2823,37,0
20150106.000633,2823,8,350284,8,2822,291,2823,34,0
20150106.000634,2822,2,350286,0,2822,290,2823,35,0
20150106.000635,2823,6,350292,6,2822,292,2823,31,1
20150106.000635,2823,10,350302,0,2822,290,2823,41,1
20150106.000636,2823,28,350330,28,2822,290,2823,29,1
20150106.000637,2824,480,350810,304,2823,24,2824,128,1
20150106.000638,2823,2,350812,0,2823,50,2824,129,0
20150106.000639,2824,2,350814,0,2823,56,2824,130,1
20150106.000642,2824,2,350816,0,2823,59,2824,110,1
20150106.000642,2824,2,350818,0,2823,122,2824,109,1
20150106.000643,2824,250,351068,0,2824,375,2825,929,1
20150106.000643,2824,30,351098,-20,2824,363,2825,929,1
20150106.000644,2824,2,351100,0,2824,377,2825,913,1
20150106.000645,2824,2,351102,0,2824,377,2825,912,1
20150106.000645,2825,2,351104,0,2824,378,2825,913,1
20150106.000646,2825,4,351108,-2,2824,377,2825,914,1
20150106.000647,2825,42,351150,-32,2824,371,2825,906,1
20150106.000647,2825,2,351152,0,2824,373,2825,905,1
20150106.000648,2825,10,351162,0,2824,372,2825,895,1
20150106.000649,2825,2,351164,0,2824,372,2825,894,1
20150106.00065,2824,66,351230,0,2824,325,2825,875,0
20150106.000652,2825,16,351246,-2,2824,325,2825,869,1
20150106.000652,2825,1006,352252,-754,2824,338,2825,366,1
20150106.000653,2824,22,352274,-4,2824,337,2825,361,0
20150106.000653,2824,42,352316,2,2824,330,2825,343,0
20150106.000654,2825,4,352320,2,2824,330,2825,339,1
20150106.000654,2825,34,352354,10,2824,330,2825,322,1
20150106.000655,2824,18,352372,2,2824,348,2825,315,0
20150106.000655,2825,2,352374,2,2824,349,2825,314,1
20150106.000656,2825,2,352376,0,2824,373,2825,313,1
20150106.000657,2825,20,352396,18,2824,373,2825,303,1
20150106.000658,2825,480,352876,110,2824,375,2825,66,1
20150106.000658,2824,4,352880,0,2824,376,2825,65,0
20150106.000659,2825,130,353010,-54,2825,1,2826,1333,1
20150106.000659,2825,10,353020,-2,2825,1,2826,1333,1
20150106.0007,2826,10,353030,-8,2825,2,2826,1344,1
20150106.0007,2826,80,353110,-72,2825,8,2826,1311,1
20150106.000701,2826,478,353588,-424,2825,52,2826,1058,1
20150106.000701,2826,92,353680,0,2825,60,2826,1000,1
20150106.000702,2826,4,353684,0,2825,63,2826,1009,1
20150106.000702,2826,46,353730,-10,2825,64,2826,986,1
20150106.000703,2825,36,353766,0,2825,62,2826,985,0
20150106.000703,2826,8,353774,2,2825,67,2826,982,1
20150106.000704,2826,6,353780,6,2825,573,2826,980,1
20150106.000705,2825,10,353790,0,2825,570,2826,997,0
20150106.000705,2826,24,353814,0,2825,559,2826,980,1
20150106.000706,2825,216,354030,106,2825,566,2826,873,0
20150106.000706,2826,8,354038,-2,2825,566,2826,870,1
20150106.000708,2826,2,354040,-2,2825,571,2826,869,1
20150106.000708,2826,2,354042,0,2825,871,2826,868,1
20150106.000709,2826,32,354074,-30,2825,891,2826,852,1
20150106.000709,2826,920,354994,116,2825,896,2826,392,1
20150106.00071,2826,360,355354,294,2825,899,2826,191,1
20150106.000711,2826,202,355556,22,2825,900,2826,90,1
20150106.000711,2826,6,355562,0,2825,901,2826,88,1
20150106.000712,2826,8,355570,8,2825,926,2826,83,1
20150106.000712,2826,58,355628,20,2825,926,2826,56,1
20150106.000713,2826,90,355718,-46,2825,947,2827,835,1
20150106.000713,2826,28,355746,-26,2826,13,2827,986,1
20150106.000713,2826,30,355776,-20,2826,4,2827,985,1
20150106.000714,2827,30,355806,2,2825,927,2827,976,1
20150106.000715,2827,84,355890,8,2825,899,2827,945,1
20150106.000715,2827,36,355926,-30,2825,899,2827,931,1
20150106.000716,2827,106,356032,-58,2825,899,2826,1,1
20150106.000716,2826,4,356036,0,2825,899,2827,798,0
20150106.000717,2826,4,356040,0,2826,1,2827,598,0
20150106.000717,2827,104,356144,-44,2825,899,2827,532,1
20150106.000718,2827,120,356264,-120,2826,21,2827,478,1
20150106.000718,2826,2,356266,2,2826,33,2827,478,0
20150106.000719,2827,24,356290,20,2826,22,2827,478,1
20150106.000719,2826,4,356294,0,2826,26,2827,492,0
20150106.00072,2826,4,356298,0,2826,25,2827,492,0
20150106.00072,2826,52,356350,-22,2825,913,2826,2,0
20150106.000721,2826,546,356896,-242,2826,12,2827,253,0
20150106.000722,2826,102,356998,-84,2826,12,2827,282,0
20150106.000722,2827,32,357030,-26,2826,10,2827,307,1
20150106.000723,2827,30,357060,28,2826,10,2827,293,1
20150106.000723,2826,6,357066,0,2826,8,2827,292,0
20150106.000724,2827,728,357794,-470,2827,641,2828,1522,1
20150106.000724,2827,14,357808,-6,2827,651,2828,1525,1
20150106.000725,2828,86,357894,66,2827,646,2828,1487,1
20150106.000725,2828,874,358768,-772,2827,333,2828,1351,1
20150106.000726,2828,176,358944,-164,2827,301,2828,1308,1
20150106.000726,2828,104,359048,-10,2827,301,2828,1256,1
20150106.000727,2827,62,359110,-40,2827,259,2828,1270,0
20150106.000727,2827,522,359632,-430,2826,113,2828,1271,0
20150106.000728,2828,100,359732,0,2826,118,2828,1266,1
20150106.000728,2828,2,359734,2,2826,118,2828,1267,1
20150106.000729,2828,2,359736,0,2826,118,2828,1268,1
20150106.000729,2827,4,359740,0,2826,118,2828,1272,0
20150106.00073,2827,2,359742,-2,2826,118,2828,1272,0
20150106.000731,2828,10,359752,-8,2826,117,2828,1268,1
20150106.000731,2828,2,359754,0,2826,101,2827,15,1
20150106.000732,2826,16,359770,0,2826,96,2827,60,0
20150106.000734,2827,16,359786,-4,2826,87,2827,289,1
20150106.000735,2826,4,359790,2,2826,86,2827,289,0
20150106.000736,2827,10,359800,-6,2826,87,2827,299,1
20150106.000736,2827,2,359802,0,2826,104,2827,300,1
20150106.000736,2827,14,359816,-14,2826,104,2827,294,1
20150106.000737,2826,4,359820,2,2826,103,2827,301,0
20150106.000738,2827,14,359834,-12,2826,105,2827,295,1
20150106.000738,2827,90,359924,8,2826,257,2827,267,1
20150106.000739,2826,40,359964,0,2826,237,2827,269,0
20150106.00074,2826,6,359970,2,2826,220,2827,284,0
20150106.000741,2827,38,360008,-4,2826,530,2827,280,1
20150106.000742,2827,464,360472,292,2826,538,2827,66,1
20150106.000743,2827,16,360488,-16,2826,540,2827,179,1
20150106.000743,2827,8,360496,-4,2826,540,2827,178,1
20150106.000744,2827,12,360508,0,2826,541,2827,172,1
20150106.000745,2827,52,360560,10,2826,543,2827,205,1
20150106.000746,2827,2,360562,2,2826,543,2827,220,1
20150106.000747,2826,18,360580,10,2826,541,2827,210,0
20150106.000747,2827,2,360582,0,2826,541,2827,207,1
20150106.000748,2826,2,360584,0,2826,539,2827,208,0
20150106.000748,2827,10,360594,10,2826,539,2827,208,1
20150106.000749,2827,8,360602,0,2826,542,2827,208,1
20150106.00075,2827,24,360626,24,2826,542,2827,203,1
20150106.000751,2827,14,360640,0,2826,542,2827,213,1
20150106.000751,2827,2,360642,2,2826,542,2827,207,1
20150106.000753,2827,2,360644,2,2826,546,2827,254,1
20150106.000753,2827,2,360646,2,2826,546,2827,253,1
20150106.000754,2826,6,360652,-6,2826,541,2827,254,0
20150106.000755,2826,12,360664,0,2826,535,2827,246,0
20150106.000755,2827,20,360684,0,2826,535,2827,237,1
20150106.000756,2827,818,361502,-314,2826,113,2827,250,1
20150106.000757,2827,18,361520,10,2826,123,2827,229,1
20150106.000758,2826,158,361678,130,2826,44,2827,253,0
20150106.000758,2827,62,361740,60,2825,852,2827,262,1
20150106.000759,2826,10,361750,10,2826,12,2827,268,0
20150106.000759,2826,2,361752,2,2825,852,2827,286,0
20150106.0008,2826,50,361802,30,2825,852,2826,42,0
20150106.000801,2826,100,361902,96,2826,1,2827,410,0
20150106.000801,2826,2,361904,2,2825,852,2827,411,0
20150106.000801,2826,4,361908,-2,2825,852,2827,409,0
20150106.000802,2826,6,361914,0,2826,2,2827,443,0
20150106.000802,2826,4,361918,4,2825,852,2827,443,0
20150106.000803,2825,2,361920,-2,2825,851,2827,429,0
20150106.000803,2826,10,361930,2,2825,849,2827,442,1
20150106.000804,2825,8,361938,4,2826,18,2827,421,0
20150106.000804,2826,36,361974,-24,2825,850,2827,438,1
20150106.000805,2825,2,361976,-2,2825,849,2826,53,0
20150106.000806,2826,2,361978,0,2825,907,2826,56,1
20150106.000807,2826,142,362120,-28,2825,957,2827,392,1
20150106.000808,2825,200,362320,-198,2825,859,2827,398,0
20150106.000808,2825,40,362360,0,2825,840,2827,398,0
20150106.000809,2825,6,362366,0,2825,837,2827,412,0
20150106.000811,2826,10,362376,0,2825,837,2826,12,1
20150106.000813,2825,58,362434,-58,2825,809,2826,14,0
20150106.000813,2825,2,362436,-2,2825,808,2826,14,0
20150106.000814,2825,2,362438,-2,2825,807,2826,15,0
20150106.000815,2826,2,362440,-2,2825,806,2826,15,1
20150106.000816,2826,16,362456,-10,2825,806,2826,7,1
20150106.000816,2825,2,362458,0,2825,807,2826,8,0
20150106.000817,2826,6,362464,-4,2825,1108,2826,6,1
20150106.000818,2825,102,362566,2,2825,1058,2826,8,0
20150106.000819,2826,18,362584,12,2826,2,2827,480,1
20150106.000819,2826,6,362590,2,2825,1026,2827,480,1
20150106.00082,2826,2,362592,0,2825,1026,2826,6,1
20150106.000822,2826,102,362694,70,2825,1026,2827,490,1
20150106.000822,2826,6,362700,2,2826,1,2827,490,1
20150106.000823,2826,4,362704,2,2825,1026,2827,490,1
20150106.000823,2826,10,362714,0,2825,1026,2827,689,1
20150106.000824,2826,2,362716,0,2825,1027,2826,17,1
20150106.000824,2826,6,362722,0,2825,1028,2826,19,1
20150106.000825,2826,8,362730,-8,2825,1029,2826,91,1
20150106.000826,2826,14,362744,-8,2825,1025,2826,89,1
20150106.000826,2826,28,362772,-4,2825,1026,2826,84,1
20150106.000827,2826,4,362776,0,2825,1026,2826,81,1
20150106.000827,2826,2,362778,0,2825,1026,2826,80,1
20150106.000828,2826,166,362944,42,2825,1026,2827,676,1
20150106.000829,2826,2,362946,2,2826,50,2827,677,1
20150106.000829,2826,10,362956,0,2826,57,2827,677,1
20150106.000829,2826,2,362958,0,2826,56,2827,677,1
20150106.00083,2827,110,363068,0,2826,59,2827,623,1
20150106.00083,2826,14,363082,14,2826,62,2827,620,0
20150106.000832,2826,12,363094,0,2826,61,2827,625,0
20150106.000832,2826,80,363174,-18,2826,22,2827,623,0
20150106.000833,2826,44,363218,-40,2825,1026,2827,661,0
20150106.000835,2826,2,363220,2,2826,2,2827,603,0
20150106.000835,2826,4,363224,-2,2825,1122,2826,5,0
20150106.000836,2826,16,363240,-14,2825,1122,2827,604,0
20150106.000838,2826,10,363250,10,2825,1124,2826,95,0
20150106.000838,2827,1490,364740,-902,2827,291,2828,1501,1
20150106.000839,2827,10,364750,0,2827,299,2828,1489,1
20150106.00084,2827,2,364752,-2,2827,296,2828,1514,1
20150106.000841,2827,396,365148,-156,2827,107,2828,1503,1
20150106.000842,2827,214,365362,40,2826,122,2827,1,1
20150106.000842,2827,2,365364,0,2827,2,2828,1503,1
20150106.000843,2827,14,365378,6,2827,1,2828,1504,1
20150106.000844,2827,4,365382,4,2826,121,2827,3,1
20150106.000844,2826,82,365464,-26,2826,94,2827,11,0
20150106.000845,2827,2,365466,2,2826,96,2827,12,1
20150106.000847,2827,26,365492,22,2826,73,2827,53,1
20150106.000847,2827,2,365494,0,2826,88,2827,37,1
20150106.000848,2827,74,365568,70,2827,65,2828,1513,1
20150106.000848,2827,32,365600,32,2827,60,2828,1513,1
20150106.000849,2827,28,365628,0,2827,48,2828,1513,1
20150106.000849,2827,10,365638,2,2827,45,2828,1494,1
20150106.00085,2827,12,365650,10,2827,39,2828,1494,1
20150106.00085,2827,6,365656,-2,2827,36,2828,1495,1
20150106.000851,2827,2,365658,2,2827,35,2828,1496,1
20150106.000851,2827,4,365662,0,2827,33,2828,1496,1
20150106.000852,2827,6,365668,4,2827,19,2828,1508,1
20150106.000853,2827,18,365686,-14,2827,19,2828,1511,1
20150106.000855,2827,14,365700,12,2827,12,2828,1512,1
20150106.000855,2827,24,365724,-2,2826,150,2827,116,1
20150106.000856,2826,22,365746,-2,2826,140,2827,116,0
20150106.000857,2827,90,365836,0,2826,142,2827,111,1
20150106.000859,2827,32,365868,0,2826,642,2827,98,1
20150106.000901,2827,20,365888,0,2826,691,2827,138,1
20150106.000904,2826,2,365890,2,2826,680,2827,148,0
20150106.000905,2827,20,365910,0,2826,685,2827,140,1
20150106.000905,2826,6,365916,0,2826,683,2827,139,0
20150106.000906,2826,4,365920,-2,2826,682,2827,138,0
20150106.000907,2827,4,365924,0,2826,681,2827,148,1
20150106.000907,2827,4,365928,0,2826,683,2827,147,1
20150106.000908,2827,10,365938,0,2826,683,2827,144,1
20150106.000909,2827,20,365958,0,2826,684,2827,140,1
20150106.00091,2827,280,366238,-78,2826,685,2828,1517,1
20150106.00091,2827,10,366248,8,2826,685,2828,1497,1
20150106.000911,2827,6,366254,4,2826,684,2827,1,1
20150106.000911,2827,2,366256,-2,2827,11,2828,1497,1
20150106.000912,2827,10,366266,10,2827,22,2828,1493,1
20150106.000912,2828,32,366298,-20,2827,7,2828,1492,1
20150106.000913,2827,22,366320,0,2826,684,2828,1492,0
20150106.000913,2827,20,366340,-2,2826,684,2828,1502,0
20150106.000916,2828,2,366342,-2,2826,694,2827,2,1
20150106.000916,2826,10,366352,0,2826,689,2827,3,0
20150106.000917,2826,34,366386,10,2827,1,2828,1509,0
20150106.000918,2827,24,366410,4,2826,691,2828,1509,1
20150106.000919,2827,2,366412,0,2827,1,2828,1508,1
20150106.00092,2827,2,366414,0,2826,692,2828,1508,1
20150106.000921,2827,114,366528,54,2826,694,2828,1496,1
20150106.000923,2827,2,366530,0,2826,695,2827,2,1
20150106.000923,2827,2,366532,0,2826,695,2827,6,1
20150106.000924,2827,18,366550,0,2827,1,2828,1494,1
20150106.000924,2827,4,366554,4,2826,695,2827,7,1
20150106.000925,2827,2,366556,2,2826,695,2827,6,1
20150106.000926,2827,4,366560,4,2826,705,2827,5,1
20150106.000926,2827,2,366562,2,2826,705,2827,31,1
20150106.000927,2827,8,366570,4,2826,705,2827,28,1
20150106.000928,2827,62,366632,-56,2827,1,2828,1486,1
20150106.000928,2827,2,366634,2,2826,705,2828,1487,1
20150106.000929,2828,204,366838,6,2826,714,2828,1387,1
20150106.000929,2827,4,366842,-4,2826,714,2827,1,0
20150106.00093,2827,6,366848,0,2826,715,2828,1387,0
20150106.00093,2827,2,366850,0,2827,1,2828,1386,0
20150106.000931,2827,18,366868,12,2827,1,2828,1393,0
20150106.000931,2827,2,366870,2,2826,714,2828,1394,0
20150106.000932,2826,30,366900,18,2826,710,2828,1394,0
20150106.000933,2828,10,366910,0,2826,710,2828,1391,1
20150106.000934,2827,2,366912,0,2826,710,2827,3,0
20150106.000934,2827,6,366918,-2,2826,709,2827,1,0
20150106.000935,2828,16,366934,4,2826,709,2828,1391,1
20150106.000935,2828,2,366936,0,2826,709,2827,10,1
20150106.000937,2828,4,366940,0,2826,709,2827,13,1
20150106.000937,2827,36,366976,0,2827,502,2828,1791,0
20150106.000938,2827,10,366986,0,2827,509,2828,1780,0
20150106.000939,2827,2,366988,0,2827,1052,2828,1674,0
20150106.000941,2828,2,366990,0,2827,1039,2828,1659,1
20150106.000942,2828,1200,368190,-478,2827,1053,2828,1041,1
20150106.000942,2828,296,368486,110,2827,1065,2828,883,1
20150106.000943,2828,28,368514,-26,2827,1065,2828,869,1
20150106.000944,2828,532,369046,-426,2827,1071,2828,609,1
20150106.000944,2828,10,369056,0,2827,1072,2828,604,1
20150106.000945,2828,6,369062,6,2827,1146,2828,602,1
20150106.000945,2828,10,369072,10,2827,1146,2828,605,1
20150106.000946,2828,2,369074,2,2827,1119,2828,705,1
20150106.000946,2828,2,369076,0,2827,1121,2828,704,1
20150106.000947,2828,42,369118,42,2827,1121,2828,684,1
20150106.000947,2828,10,369128,0,2827,1121,2828,680,1
20150106.000948,2828,16,369144,6,2827,1119,2828,679,1
20150106.000949,2828,14,369158,14,2827,1115,2828,674,1
20150106.00095,2828,6,369164,6,2827,1114,2828,672,1
20150106.00095,2828,2,369166,2,2827,1129,2828,675,1
20150106.000951,2828,72,369238,48,2827,1129,2828,639,1
20150106.000951,2828,6,369244,0,2827,1128,2828,636,1
20150106.000952,2827,20,369264,20,2827,1118,2828,637,0
20150106.000952,2828,36,369300,-2,2827,1118,2828,618,1
20150106.000953,2828,32,369332,6,2827,1123,2828,602,1
20150106.000953,2828,4,369336,2,2827,1123,2828,604,1
20150106.000954,2828,58,369394,56,2827,1124,2828,575,1
20150106.000954,2828,4,369398,4,2827,1124,2828,573,1
20150106.000955,2828,22,369420,2,2827,1124,2828,572,1
20150106.000956,2828,402,369822,34,2827,1129,2828,372,1
20150106.000957,2828,6,369828,0,2827,1129,2828,372,1
20150106.000957,2828,32,369860,-30,2827,1114,2828,365,1
20150106.000958,2828,6,369866,0,2827,1117,2828,362,1
20150106.000959,2828,32,369898,0,2827,1117,2828,365,1
20150106.000959,2828,34,369932,0,2827,1116,2828,349,1
20150106.001,2828,2,369934,0,2827,1116,2828,349,1
20150106.001001,2828,8,369942,-6,2827,1116,2828,345,1
20150106.001001,2828,134,370076,-134,2827,1116,2828,279,1
20150106.001002,2828,20,370096,0,2827,1118,2828,272,1
20150106.001002,2828,6,370102,-2,2827,1119,2828,302,1
20150106.001003,2828,102,370204,2,2827,1118,2828,253,1
20150106.001003,2827,24,370228,0,2827,1115,2828,244,0
20150106.001004,2828,4,370232,-2,2827,1116,2828,242,1
20150106.001005,2828,486,370718,-446,2828,64,2829,1021,1
20150106.001005,2829,20,370738,-20,2828,180,2829,1011,1
20150106.001006,2829,164,370902,-128,2828,217,2829,911,1
20150106.001006,2829,70,370972,-66,2828,240,2829,878,1
20150106.001007,2829,6,370978,0,2828,236,2829,890,1
20150106.001007,2829,2,370980,0,2828,269,2829,889,1
20150106.001007,2829,26,371006,-20,2828,317,2829,863,1
20150106.001008,2829,6,371012,-4,2828,314,2829,861,1
20150106.001009,2828,6,371018,-4,2828,314,2829,860,0
20150106.001009,2829,12,371030,-10,2828,414,2829,856,1
20150106.00101,2828,92,371122,-80,2828,390,2829,850,0
20150106.00101,2828,10,371132,-2,2828,392,2829,861,0
20150106.001011,2829,106,371238,-36,2828,349,2829,851,1
20150106.001012,2829,12,371250,-4,2828,401,2829,865,1
20150106.001013,2829,64,371314,-60,2828,428,2829,819,1
20150106.001014,2829,4,371318,0,2828,415,2829,834,1
20150106.001014,2829,12,371330,-2,2828,414,2829,829,1
20150106.001015,2828,2,371332,2,2828,413,2829,829,0
20150106.001015,2829,1688,373020,-1284,2829,157,2830,1783,1
20150106.001016,2829,6,373026,-6,2829,155,2830,1783,1
20150106.001016,2829,8,373034,-4,2829,160,2830,1780,1
20150106.001017,2830,2,373036,2,2829,187,2830,1779,1
20150106.001017,2830,530,373566,-422,2829,195,2830,1506,1
20150106.001018,2829,74,373640,-70,2829,186,2830,1506,0
20150106.001018,2830,2,373642,0,2829,186,2830,1501,1
20150106.001019,2830,2,373644,-2,2829,186,2830,1494,1
20150106.001019,2829,10,373654,-10,2829,183,2830,1487,0
20150106.00102,2829,42,373696,-20,2829,190,2830,1477,0
20150106.00102,2830,32,373728,0,2829,186,2830,1186,1
20150106.001021,2829,32,373760,-32,2829,180,2830,1176,0
20150106.001021,2830,4,373764,0,2829,181,2830,1174,1
20150106.001022,2829,46,373810,0,2829,181,2830,1152,0
20150106.001022,2830,2,373812,0,2829,182,2830,1151,1
20150106.001023,2830,4,373816,0,2829,183,2830,1152,1
20150106.001023,2829,50,373866,-10,2829,165,2830,1147,0
20150106.001024,2830,4,373870,0,2829,166,2830,1145,1
20150106.001024,2830,12,373882,-10,2829,176,2830,1125,1
20150106.001025,2830,42,373924,8,2829,175,2830,1104,1
20150106.001025,2829,4,373928,-2,2829,199,2830,1106,0
20150106.001026,2830,4,373932,0,2829,200,2830,1104,1
20150106.001027,2830,4,373936,0,2829,210,2830,1103,1
20150106.001027,2830,30,373966,26,2829,209,2830,1095,1
20150106.001028,2830,18,373984,2,2829,211,2830,1087,1
20150106.001029,2830,142,374126,30,2829,191,2830,1036,1
20150106.001029,2830,36,374162,34,2829,193,2830,1025,1
20150106.00103,2830,2,374164,0,2829,193,2830,1025,1
20150106.00103,2829,4,374168,-2,2829,197,2830,1026,0
20150106.001031,2830,14,374182,12,2829,202,2830,1019,1
20150106.001031,2830,2,374184,2,2829,205,2830,1018,1
20150106.001032,2829,6,374190,-6,2829,204,2830,1021,0
20150106.001032,2830,2,374192,2,2829,228,2830,1015,1
20150106.001033,2830,20,374212,-16,2829,230,2830,1010,1
20150106.001033,2829,6,374218,0,2829,206,2830,988,0
20150106.001034,2829,2,374220,-2,2829,206,2830,967,0
20150106.001034,2830,606,374826,98,2829,206,2830,664,1
20150106.001035,2830,20,374846,0,2829,219,2830,653,1
20150106.001035,2830,78,374924,26,2829,219,2830,616,1
20150106.001036,2830,6,374930,-2,2829,230,2830,613,1
20150106.001036,2829,2,374932,0,2829,229,2830,615,0
20150106.001037,2829,2,374934,0,2829,230,2830,658,0
20150106.001037,2830,8,374942,-6,2829,230,2830,653,1
20150106.001038,2829,4,374946,0,2829,257,2830,655,0
20150106.001038,2830,4,374950,0,2829,257,2830,652,1
20150106.001039,2830,1304,376254,-720,2830,151,2831,365,1
20150106.001039,2830,4,376258,-2,2830,164,2831,351,1
20150106.00104,2830,12,376270,-2,2830,162,2831,344,1
20150106.00104,2831,6,376276,-6,2830,161,2831,342,1
20150106.001041,2831,190,376466,-92,2830,155,2831,255,1
20150106.001041,2831,86,376552,-82,2830,163,2831,252,1
20150106.001042,2830,4,376556,0,2830,171,2831,252,0
20150106.001042,2830,16,376572,-2,2830,164,2831,250,0
20150106.001043,2830,8,376580,0,2830,161,2831,249,0
20150106.001043,2831,20,376600,0,2830,179,2831,242,1
20150106.001044,2831,14,376614,-12,2830,175,2831,240,1
20150106.001044,2830,70,376684,-54,2830,158,2831,221,0
20150106.001045,2831,34,376718,-6,2830,176,2831,202,1
20150106.001045,2830,10,376728,0,2830,171,2831,202,0
20150106.001046,2830,306,377034,78,2830,26,2831,203,0
20150106.001046,2831,64,377098,-10,2830,1,2831,220,1
20150106.001047,2830,10,377108,2,2829,252,2830,8,0
20150106.001047,2831,20,377128,-6,2829,252,2831,263,1
20150106.001048,2830,24,377152,4,2829,242,2830,153,0
20150106.001048,2830,34,377186,-14,2829,203,2830,204,0
20150106.001049,2830,44,377230,0,2829,203,2830,182,0
20150106.001049,2830,4,377234,4,2829,203,2830,196,0
20150106.00105,2830,20,377254,20,2829,203,2830,189,0
20150106.001051,2830,40,377294,-22,2829,203,2830,170,0
20150106.001051,2829,8,377302,0,2829,199,2830,171,0
20150106.001052,2830,18,377320,0,2829,199,2830,162,1
20150106.001052,2830,22,377342,-18,2829,198,2830,155,1
20150106.001053,2830,14,377356,-12,2829,197,2830,154,1
20150106.001053,2830,2,377358,0,2829,197,2830,153,1
20150106.001054,2830,58,377416,-2,2829,171,2830,299,1
20150106.001054,2830,6,377422,-2,2829,179,2830,301,1
20150106.001056,2830,42,377464,-2,2829,182,2830,333,1
20150106.001056,2830,20,377484,0,2829,185,2830,326,1
20150106.001057,2830,108,377592,-26,2829,182,2830,283,1
20150106.001058,2830,4,377596,4,2829,182,2830,284,1
20150106.0011,2830,22,377618,2,2829,182,2830,286,1
20150106.0011,2829,2,377620,0,2829,192,2830,267,0
20150106.0011,2829,4,377624,4,2829,182,2830,272,0
20150106.001101,2830,30,377654,24,2829,181,2830,262,1
20150106.001101,2830,8,377662,4,2829,184,2830,262,1
20150106.001102,2829,2,377664,0,2829,185,2830,263,0
20150106.001102,2829,12,377676,0,2829,179,2830,263,0
20150106.001103,2829,390,378066,-126,2828,482,2829,16,0
20150106.001104,2829,2,378068,0,2828,482,2829,23,0
20150106.001104,2828,2,378070,0,2828,481,2829,23,0
20150106.001104,2829,20,378090,-20,2828,481,2829,27,1
20150106.001105,2829,8,378098,0,2828,480,2829,35,1
20150106.001105,2828,2,378100,0,2828,489,2829,36,0
20150106.001106,2829,2,378102,0,2828,489,2829,35,1
20150106.001107,2829,6,378108,-2,2828,487,2829,33,1
20150106.001108,2828,6,378114,0,2828,485,2829,43,0
20150106.001109,2829,2,378116,-2,2828,485,2829,93,1
20150106.00111,2828,42,378158,0,2828,464,2829,93,0
20150106.00111,2829,32,378190,-12,2828,466,2829,79,1
20150106.001111,2829,60,378250,14,2828,466,2829,50,1
20150106.001111,2828,2,378252,0,2828,465,2829,50,0
20150106.001112,2829,2,378254,0,2828,465,2829,100,1
20150106.001112,2829,200,378454,-94,2828,465,2830,318,1
20150106.001113,2828,28,378482,0,2828,451,2830,318,0
20150106.001113,2828,6,378488,0,2828,448,2829,2,0
20150106.001114,2829,4,378492,2,2828,448,2830,322,1
20150106.001114,2829,2,378494,0,2828,448,2829,4,1
20150106.001115,2829,10,378504,0,2829,30,2830,326,1
20150106.001116,2829,2,378506,2,2829,29,2830,330,1
20150106.001116,2829,2,378508,0,2829,31,2830,392,1
20150106.001117,2829,4,378512,2,2829,29,2830,398,1
20150106.001118,2829,58,378570,-12,2829,1,2830,397,1
20150106.001119,2830,2,378572,2,2829,3,2830,391,1
20150106.00112,2829,6,378578,4,2829,2,2830,401,0
20150106.001121,2829,2,378580,0,2829,2,2830,401,0
20150106.001122,2830,2,378582,0,2829,3,2830,400,1
20150106.001123,2829,2,378584,2,2829,2,2830,404,0
20150106.001124,2830,6,378590,6,2829,2,2830,399,1
20150106.001124,2829,8,378598,-2,2828,472,2830,399,0
20150106.001125,2829,2,378600,0,2829,11,2830,395,0
20150106.001126,2829,12,378612,-12,2829,6,2830,396,0
20150106.001126,2829,4,378616,0,2829,4,2830,397,0
20150106.001126,2830,10,378626,10,2829,4,2830,392,1
20150106.001127,2828,20,378646,16,2828,467,2829,6,0
20150106.001127,2829,18,378664,2,2829,42,2830,393,1
20150106.001128,2829,84,378748,0,2828,467,2829,9,1
20150106.001129,2829,2,378750,0,2828,467,2829,33,1
20150106.00113,2829,6,378756,4,2828,465,2829,33,1
20150106.001131,2829,42,378798,-36,2828,465,2829,13,1
20150106.001132,2828,2,378800,0,2828,464,2829,15,0
20150106.001133,2829,4,378804,0,2828,464,2829,13,1
20150106.001133,2829,2,378806,0,2828,464,2829,14,1
20150106.001134,2829,4,378810,0,2828,464,2829,16,1
20150106.001136,2829,2,378812,-2,2828,464,2829,53,1
20150106.001137,2829,118,378930,24,2829,70,2830,359,1
20150106.001138,2829,2,378932,2,2829,130,2830,359,1
20150106.001139,2829,4,378936,4,2829,128,2830,359,1
20150106.001139,2829,4,378940,0,2829,140,2830,359,1
20150106.00114,2829,12,378952,6,2829,134,2830,367,1
20150106.00114,2829,4,378956,4,2829,132,2830,358,1
20150106.001141,2829,2,378958,2,2829,132,2830,317,1
20150106.001142,2830,2,378960,0,2829,132,2830,367,1
20150106.001143,2829,2,378962,0,2829,138,2830,367,0
20150106.001144,2829,40,379002,40,2829,104,2830,367,0
20150106.001144,2829,4,379006,4,2829,103,2830,576,0
20150106.001145,2830,2,379008,0,2829,103,2830,579,1
20150106.001145,2830,12,379020,-4,2829,103,2830,572,1
20150106.001146,2829,4,379024,2,2829,101,2830,573,0
20150106.001147,2829,202,379226,-26,2828,451,2829,200,0
20150106.001148,2828,2,379228,0,2828,435,2829,220,0
20150106.001149,2829,200,379428,0,2828,435,2829,255,1
20150106.001151,2829,2,379430,0,2828,464,2829,404,1
20150106.001155,2828,22,379452,-18,2828,467,2829,411,0
20150106.001155,2828,2,379454,0,2828,576,2829,412,0
20150106.001156,2828,2,379456,0,2828,580,2829,414,0
20150106.001158,2828,2,379458,2,2828,579,2829,414,0
20150106.001159,2828,6,379464,6,2828,576,2829,465,0
20150106.001159,2828,398,379862,-248,2828,377,2829,466,0
20150106.001159,2828,2,379864,0,2828,376,2829,467,0
20150106.0012,2828,2,379866,2,2828,375,2829,469,0
20150106.001201,2829,2,379868,-2,2828,376,2829,469,1
20150106.001201,2829,20,379888,-10,2828,376,2829,459,1
20150106.001201,2828,202,380090,4,2828,355,2829,382,0
20150106.001203,2829,2,380092,0,2828,356,2829,385,1
20150106.001206,2828,14,380106,0,2828,355,2829,504,0
20150106.001207,2828,4,380110,4,2828,353,2829,504,0
20150106.001207,2828,62,380172,2,2828,307,2829,519,0
20150106.001208,2829,1048,381220,-152,2829,492,2830,624,1
20150106.001209,2829,6,381226,-4,2829,489,2830,624,1
20150106.001211,2829,2,381228,0,2829,490,2830,623,1
20150106.001211,2829,2,381230,-2,2829,489,2830,623,1
20150106.001212,2829,18,381248,-18,2829,480,2830,623,1
20150106.001213,2829,2,381250,0,2829,479,2830,623,1
20150106.001213,2830,2,381252,2,2829,479,2830,623,1
20150106.001215,2829,2,381254,0,2829,478,2830,629,0
20150106.001216,2830,90,381344,0,2829,481,2830,589,1
20150106.001216,2829,10,381354,-10,2829,476,2830,590,0
20150106.001217,2829,4,381358,-4,2829,475,2830,590,0
20150106.001218,2829,300,381658,-300,2829,310,2830,605,0
20150106.001219,2829,72,381730,-2,2829,278,2830,605,0
20150106.00122,2830,2,381732,0,2829,278,2830,604,1
20150106.001221,2829,32,381764,-32,2829,270,2830,596,0
20150106.001221,2829,4,381768,-4,2829,268,2830,596,0
20150106.001221,2829,6,381774,-4,2829,265,2830,596,0
20150106.001222,2829,2,381776,-2,2829,265,2830,597,0
20150106.001222,2830,2,381778,0,2829,265,2830,596,1
20150106.001223,2830,4,381782,0,2829,280,2830,679,1
20150106.001223,2830,2,381784,0,2829,280,2830,678,1
20150106.001224,2830,8,381792,0,2829,400,2830,679,1
20150106.001225,2830,2,381794,0,2829,400,2830,678,1
20150106.001226,2830,40,381834,0,2829,1400,2830,858,1
20150106.001226,2830,12,381846,-10,2829,1410,2830,852,1
20150106.001227,2830,110,381956,-110,2829,1434,2830,787,1
20150106.001227,2830,10,381966,0,2829,1431,2830,782,1
20150106.001228,2829,40,382006,0,2829,1393,2830,782,0
20150106.001228,2829,12,382018,-12,2829,1385,2830,792,0
20150106.001229,2830,20,382038,-16,2829,1387,2830,794,1
20150106.001231,2830,10,382048,-6,2829,1386,2830,791,1
20150106.001232,2830,40,382088,-32,2829,1386,2830,771,1
20150106.001234,2830,2,382090,0,2829,1386,2830,772,1
20150106.001235,2829,4,382094,-2,2829,1384,2830,772,0
20150106.001237,2829,8,382102,-6,2829,1390,2830,779,0
20150106.001238,2830,2,382104,-2,2829,1390,2830,778,1
20150106.001239,2830,68,382172,62,2829,1391,2830,749,1
20150106.001239,2830,20,382192,20,2829,1384,2830,739,1
20150106.00124,2829,602,382794,-448,2829,1083,2830,754,0
20150106.00124,2829,2,382796,2,2829,1097,2830,739,0
20150106.001242,2830,24,382820,-16,2829,1097,2830,730,1
20150106.001242,2830,604,383424,-60,2829,1082,2830,443,1
20150106.001242,2830,2,383426,0,2829,1097,2830,427,1
20150106.001243,2830,22,383448,4,2829,1097,2830,416,1
20150106.001244,2830,804,384252,296,2829,1095,2830,14,1
20150106.001245,2829,48,384300,-24,2830,17,2831,212,0
20150106.001246,2830,16,384316,0,2830,17,2831,210,1
20150106.001246,2830,4,384320,0,2830,32,2831,221,1
20150106.001248,2830,18,384338,18,2830,63,2831,222,1
20150106.001249,2830,2,384340,0,2830,113,2831,222,1
20150106.001249,2830,2,384342,0,2830,112,2831,222,1
20150106.00125,2830,2,384344,0,2830,119,2831,207,1
20150106.001251,2831,12,384356,0,2830,134,2831,201,1
20150106.001252,2830,2,384358,2,2830,133,2831,202,0
20150106.001252,2831,4,384362,-2,2830,132,2831,202,1
20150106.001253,2831,12,384374,4,2830,116,2831,226,1
20150106.001253,2831,482,384856,-316,2831,759,2832,792,1
20150106.001254,2831,2,384858,-2,2831,782,2832,736,1
20150106.001255,2832,52,384910,-24,2831,771,2832,734,1
20150106.001256,2832,2,384912,-2,2831,772,2832,542,1
20150106.001256,2831,58,384970,-16,2831,757,2832,531,0
20150106.001257,2832,150,385120,-102,2831,773,2832,442,1
20150106.001257,2832,16,385136,-4,2831,775,2832,435,1
20150106.001258,2831,40,385176,-40,2831,740,2832,452,0
20150106.001259,2832,6,385182,-4,2831,731,2832,450,1
20150106.001259,2832,16,385198,-8,2831,731,2832,442,1
20150106.0013,2832,10,385208,0,2831,731,2832,441,1
20150106.0013,2832,8,385216,4,2831,730,2832,438,1
20150106.001301,2832,102,385318,56,2831,731,2832,387,1
20150106.001301,2832,2,385320,2,2831,731,2832,386,1
20150106.001302,2832,12,385332,12,2831,732,2832,381,1
20150106.001302,2832,2,385334,2,2831,732,2832,380,1
20150106.001303,2832,46,385380,4,2831,732,2832,358,1
20150106.001303,2831,18,385398,0,2831,746,2832,335,0
20150106.001304,2832,4,385402,0,2831,746,2832,335,1
20150106.001305,2832,12,385414,6,2831,743,2832,343,1
20150106.001305,2832,84,385498,68,2831,742,2832,306,1
20150106.001306,2832,8,385506,4,2831,743,2832,302,1
20150106.001306,2832,6,385512,0,2831,740,2832,300,1
20150106.001307,2832,6,385518,2,2831,739,2832,298,1
20150106.001307,2832,62,385580,32,2831,728,2832,284,1
20150106.001308,2832,10,385590,8,2831,727,2832,291,1
20150106.001308,2832,20,385610,6,2831,725,2832,243,1
20150106.001309,2832,488,386098,-208,2832,272,2833,424,1
20150106.00131,2832,8,386106,0,2832,291,2833,407,1
20150106.001311,2833,32,386138,0,2832,301,2833,396,1
20150106.001311,2833,92,386230,-18,2832,302,2833,351,1
20150106.001312,2832,82,386312,0,2832,302,2833,312,0
20150106.001312,2833,10,386322,8,2832,303,2833,307,1
20150106.001313,2833,4,386326,0,2832,315,2833,305,1
20150106.001313,2832,332,386658,-318,2832,143,2833,314,0
20150106.001314,2833,22,386680,14,2832,168,2833,304,1
20150106.001314,2833,10,386690,8,2832,168,2833,284,1
20150106.001315,2833,70,386760,32,2832,172,2833,256,1
20150106.001316,2832,14,386774,-6,2832,153,2833,286,0
20150106.001317,2833,52,386826,-46,2832,143,2833,293,1
20150106.001317,2832,4,386830,0,2832,146,2833,292,0
20150106.001318,2832,20,386850,-2,2832,143,2833,288,0
20150106.001318,2832,8,386858,0,2832,142,2833,285,0
20150106.001318,2832,42,386900,-2,2832,122,2833,285,0
20150106.001319,2832,26,386926,-2,2832,120,2833,274,0
20150106.001319,2832,4,386930,-2,2832,200,2833,274,0
20150106.00132,2833,14,386944,0,2832,199,2833,271,1
20150106.00132,2833,24,386968,-24,2832,214,2833,244,1
20150106.001321,2833,502,387470,-372,2833,352,2834,774,1
20150106.001321,2833,204,387674,-204,2833,274,2834,773,1
20150106.001322,2833,12,387686,-10,2833,268,2834,768,1
20150106.001322,2834,2,387688,0,2833,269,2834,768,1
20150106.001323,2834,404,388092,-402,2833,69,2834,573,1
20150106.001324,2834,164,388256,-124,2832,264,2834,563,1
20150106.001324,2833,14,388270,6,2832,264,2833,6,0
20150106.001324,2833,38,388308,18,2833,25,2834,556,0
20150106.001325,2833,654,388962,140,2833,18,2834,256,0
20150106.001326,2833,64,389026,-50,2832,259,2834,270,0
20150106.001326,2834,10,389036,10,2832,259,2834,266,1
20150106.001327,2833,16,389052,10,2832,258,2833,26,0
20150106.001327,2834,142,389194,-56,2833,4,2834,238,1
20150106.001328,2834,2,389196,2,2833,4,2834,238,1
20150106.001328,2833,46,389242,20,2832,259,2833,4,0
20150106.001329,2833,146,389388,-58,2832,188,2833,5,0
20150106.00133,2833,32,389420,10,2832,189,2833,98,0
20150106.00133,2833,4,389424,4,2832,189,2833,98,0
20150106.001331,2833,22,389446,20,2832,189,2833,92,0
20150106.001331,2833,30,389476,30,2832,189,2833,88,0
20150106.001332,2833,10,389486,10,2832,191,2833,84,0
20150106.001333,2832,310,389796,-98,2832,25,2833,135,0
20150106.001333,2832,12,389808,12,2832,26,2833,157,0
20150106.001334,2832,24,389832,16,2832,32,2833,152,0
20150106.001335,2833,2,389834,0,2832,29,2833,152,1
20150106.001335,2833,10,389844,2,2832,26,2833,137,1
20150106.001336,2833,8,389852,0,2832,27,2833,140,1
20150106.001337,2833,22,389874,-2,2832,30,2833,129,1
20150106.001337,2832,10,389884,0,2832,25,2833,130,0
20150106.001338,2833,2,389886,-2,2832,25,2833,142,1
20150106.001339,2832,2,389888,2,2832,26,2833,224,0
20150106.00134,2833,2,389890,0,2832,49,2833,218,1
20150106.001341,2833,60,389950,-20,2832,54,2833,183,1
20150106.001341,2833,2,389952,0,2832,40,2833,197,1
20150106.001342,2833,16,389968,0,2832,40,2833,193,1
20150106.001342,2832,12,389980,4,2832,38,2833,188,0
20150106.001343,2832,2,389982,2,2832,38,2833,271,0
20150106.001343,2833,20,390002,0,2832,46,2833,260,1
20150106.001344,2833,2,390004,0,2832,47,2833,261,1
20150106.001344,2833,4,390008,0,2832,47,2833,259,1
20150106.001345,2832,2,390010,2,2832,52,2833,260,0
20150106.001345,2832,4,390014,0,2832,50,2833,264,0
20150106.001346,2832,2,390016,2,2832,51,2833,265,0
20150106.001347,2833,4,390020,-2,2832,51,2833,263,1
20150106.001348,2832,12,390032,-8,2832,68,2833,244,0
20150106.001349,2832,22,390054,4,2832,102,2833,234,0
20150106.001349,2832,10,390064,10,2832,97,2833,234,0
20150106.00135,2832,4,390068,2,2832,93,2833,212,0
20150106.001351,2832,116,390184,86,2832,108,2833,161,0
20150106.001351,2832,58,390242,-6,2832,119,2833,161,0
20150106.001352,2832,36,390278,-8,2832,118,2833,361,0
20150106.001352,2832,40,390318,-20,2832,98,2833,412,0
20150106.001353,2832,4,390322,0,2832,96,2833,413,0
20150106.001353,2832,28,390350,8,2832,69,2833,427,0
20150106.001354,2832,130,390480,38,2831,851,2833,430,0
20150106.001354,2832,6,390486,2,2831,851,2832,4,0
20150106.001355,2832,2,390488,0,2831,850,2832,7,0
20150106.001356,2831,34,390522,-2,2831,840,2833,432,0
20150106.001356,2832,6,390528,-6,2831,837,2832,32,1
20150106.001357,2831,18,390546,-2,2831,828,2832,43,0
20150106.001357,2832,8,390554,-6,2831,832,2832,40,1
20150106.001357,2831,20,390574,0,2831,822,2832,40,0
20150106.001359,2831,22,390596,0,2831,811,2832,40,0
20150106.001359,2832,82,390678,12,2831,811,2832,2,1
20150106.0014,2831,14,390692,6,2831,809,2833,440,0
20150106.0014,2831,2,390694,0,2831,808,2833,440,0
20150106.001401,2832,12,390706,0,2832,1,2833,437,1
20150106.001401,2832,4,390710,2,2831,807,2832,2,1
20150106.001402,2831,6,390716,-2,2831,804,2832,3,0
20150106.001402,2831,8,390724,-2,2831,801,2832,524,0
20150106.001403,2832,4,390728,2,2831,800,2832,563,1
20150106.001404,2832,42,390770,40,2831,800,2832,543,1
20150106.001404,2831,2,390772,-2,2831,799,2832,548,0
20150106.001405,2831,26,390798,-26,2831,786,2832,548,0
20150106.001406,2832,6,390804,6,2831,799,2832,557,1
20150106.001407,2832,2,390806,2,2831,799,2832,556,1
20150106.001408,2831,2,390808,-2,2831,778,2832,561,0
20150106.001408,2831,154,390962,-154,2831,701,2832,561,0
20150106.001409,2831,2,390964,0,2831,700,2832,563,0
20150106.001409,2831,6,390970,-6,2831,697,2832,563,0
20150106.00141,2831,40,391010,-40,2831,677,2832,563,0
20150106.001412,2831,20,391030,-10,2831,675,2832,567,0
20150106.001413,2832,2,391032,0,2831,675,2832,568,1
20150106.001413,2832,24,391056,20,2831,674,2832,558,1
20150106.001414,2832,12,391068,-8,2831,669,2832,557,1
20150106.001415,2831,78,391146,-78,2831,667,2832,560,0
20150106.001416,2831,14,391160,-14,2831,660,2832,561,0
20150106.001418,2831,4,391164,-4,2831,664,2832,600,0
20150106.00142,2832,2,391166,0,2831,667,2832,599,1
20150106.001422,2831,38,391204,-38,2831,656,2832,81,0
20150106.001424,2831,24,391228,-12,2831,649,2832,97,0
20150106.001424,2832,2,391230,0,2831,650,2832,100,1
20150106.001425,2831,2,391232,-2,2831,659,2832,100,0
20150106.001426,2831,2,391234,-2,2831,660,2832,100,0
20150106.001426,2831,2,391236,-2,2831,660,2832,100,0
20150106.001427,2832,66,391302,-12,2831,651,2832,76,1
20150106.001428,2832,2,391304,0,2831,650,2832,81,1
20150106.001429,2831,2,391306,0,2831,646,2832,86,0
20150106.00143,2832,14,391320,4,2831,645,2832,80,1
20150106.00143,2831,42,391362,-38,2831,625,2832,80,0
20150106.001431,2831,10,391372,-10,2831,625,2832,85,0
20150106.001432,2832,14,391386,-6,2831,623,2832,79,1
20150106.001433,2831,80,391466,-80,2831,583,2832,79,0
20150106.001434,2832,20,391486,0,2831,583,2832,69,1
20150106.001435,2831,2,391488,-2,2831,582,2832,87,0
20150106.001436,2831,4,391492,-2,2831,581,2832,106,0
20150106.001437,2832,40,391532,-36,2831,578,2832,101,1
20150106.001437,2832,2,391534,0,2831,578,2832,100,1
20150106.001438,2831,120,391654,-100,2831,529,2832,97,0
20150106.001439,2832,34,391688,30,2831,530,2832,81,1
20150106.00144,2832,12,391700,12,2831,529,2832,79,1
20150106.001442,2832,2,391702,2,2831,549,2832,83,1
20150106.001442,2832,4,391706,2,2831,549,2832,81,1
20150106.001443,2832,100,391806,86,2831,549,2832,32,1
20150106.001444,2832,26,391832,8,2831,545,2832,31,1
20150106.001447,2832,2,391834,0,2831,549,2832,34,1
20150106.001447,2832,4,391838,-2,2831,548,2832,33,1
20150106.001449,2832,4,391842,0,2831,547,2832,31,1
20150106.00145,2832,6,391848,4,2831,552,2832,28,1
20150106.001451,2832,22,391870,8,2831,553,2832,17,1
20150106.001451,2831,200,392070,0,2831,453,2832,19,0
20150106.001452,2832,8,392078,4,2831,453,2832,18,1
20150106.001452,2832,6,392084,6,2831,453,2832,84,1
20150106.001453,2832,4,392088,0,2831,452,2832,83,1
20150106.001453,2831,602,392690,-508,2831,171,2832,83,0
20150106.001454,2832,2,392692,2,2831,171,2832,84,1
20150106.001457,2831,2,392694,0,2831,171,2832,88,0
20150106.001458,2833,586,393280,60,2831,156,2833,368,1
20150106.001459,2831,2,393282,-2,2831,195,2832,2,0
20150106.001459,2831,4,393286,0,2831,193,2832,3,0
20150106.001501,2832,118,393404,-6,2831,195,2833,357,1
20150106.001502,2831,18,393422,18,2831,186,2833,357,0
20150106.001502,2832,20,393442,8,2832,2,2833,354,1
20150106.001503,2832,2,393444,2,2832,1,2833,404,1
20150106.001504,2832,2,393446,0,2831,186,2833,405,1
20150106.001504,2832,2,393448,0,2832,1,2833,405,1
20150106.001505,2831,52,393500,2,2831,162,2832,61,0
20150106.001506,2831,6,393506,0,2831,152,2832,76,0
20150106.001508,2832,2,393508,0,2831,182,2832,176,1
20150106.00151,2831,2,393510,2,2831,187,2832,184,0
20150106.001511,2832,56,393566,52,2831,194,2832,160,1
20150106.001512,2831,4,393570,0,2831,197,2832,160,0
20150106.001512,2831,8,393578,0,2831,193,2832,165,0
20150106.001514,2832,10,393588,0,2831,172,2832,168,1
20150106.001515,2832,4,393592,0,2831,173,2832,166,1
20150106.001516,2832,4,393596,4,2831,172,2832,166,1
20150106.001517,2831,2,393598,2,2831,196,2832,177,0
20150106.001518,2831,62,393660,16,2831,308,2832,123,0
20150106.001519,2831,2,393662,0,2831,307,2832,123,0
20150106.001519,2831,2,393664,0,2831,306,2832,123,0
20150106.00152,2831,10,393674,10,2831,301,2832,123,0
20150106.001521,2832,2,393676,2,2831,301,2832,126,1
20150106.001522,2831,2,393678,2,2831,332,2832,140,0
20150106.001523,2832,2,393680,0,2831,338,2832,140,1
20150106.001524,2832,6,393686,-2,2831,336,2832,140,1
20150106.001524,2832,2,393688,0,2831,336,2832,139,1
20150106.001525,2831,12,393700,-4,2831,330,2832,141,0
20150106.001526,2831,14,393714,0,2831,324,2832,151,0
20150106.001527,2832,10,393724,-2,2831,324,2832,146,1
20150106.001529,2831,4,393728,0,2831,323,2832,149,0
20150106.00153,2832,8,393736,8,2831,323,2832,146,1
20150106.001531,2832,6,393742,6,2831,322,2832,145,1
20150106.001534,2831,4,393746,0,2831,332,2832,154,0
20150106.001536,2831,2,393748,0,2831,331,2832,157,0
20150106.001538,2831,4,393752,4,2831,321,2832,157,0
20150106.001539,2831,4,393756,4,2831,319,2832,159,0
20150106.001539,2831,4,393760,0,2831,317,2832,159,0
20150106.001542,2831,4,393764,0,2831,317,2832,190,0
20150106.001543,2832,30,393794,30,2831,317,2832,175,1
20150106.001543,2832,4,393798,4,2831,317,2832,173,1
20150106.001544,2831,20,393818,-6,2831,307,2832,173,0
20150106.001547,2831,4,393822,-4,2831,288,2832,201,0
20150106.001548,2831,4,393826,-2,2831,287,2832,203,0
20150106.00155,2832,4,393830,4,2831,287,2832,248,1
20150106.001551,2832,2,393832,0,2831,317,2832,233,1
20150106.001552,2831,684,394516,252,2830,415,2831,158,0
20150106.001552,2831,398,394914,196,2830,371,2832,257,0
20150106.001553,2832,6,394920,2,2830,368,2832,255,1
20150106.001553,2831,6,394926,2,2830,368,2832,263,0
20150106.001554,2831,8,394934,0,2830,368,2832,264,0
20150106.001555,2832,2,394936,0,2830,368,2832,285,1
20150106.001555,2831,2,394938,0,2831,131,2832,285,0
20150106.001557,2831,2,394940,2,2831,130,2832,287,0
20150106.001558,2831,2,394942,2,2831,131,2832,287,0
20150106.0016,2831,22,394964,-14,2831,138,2832,293,0
20150106.0016,2831,2,394966,-2,2831,157,2832,314,0
20150106.001601,2831,44,395010,44,2831,155,2832,297,0
20150106.001601,2831,6,395016,0,2831,152,2832,298,0
20150106.001602,2832,54,395070,36,2831,150,2832,280,1
20150106.001605,2831,24,395094,2,2831,196,2832,280,0
20150106.001606,2832,42,395136,2,2831,197,2832,259,1
20150106.001607,2832,6,395142,6,2831,214,2832,242,1
20150106.001607,2832,28,395170,16,2831,199,2832,243,1
20150106.001615,2831,12,395182,0,2831,292,2832,282,0
20150106.001616,2831,2,395184,0,2831,291,2832,282,0
20150106.001617,2832,220,395404,-152,2831,303,2832,157,1
20150106.001618,2832,348,395752,88,2832,59,2833,244,1
20150106.001619,2832,2,395754,0,2832,59,2833,244,1
20150106.001621,2832,2,395756,2,2832,66,2833,244,1
20150106.001622,2832,132,395888,2,2831,309,2833,244,1
20150106.001623,2833,4,395892,0,2832,1,2833,242,1
20150106.001623,2832,8,395900,2,2831,321,2832,12,0
20150106.001624,2833,62,395962,2,2831,321,2833,226,1
20150106.001627,2832,4,395966,0,2832,2,2833,231,0
20150106.001628,2832,6,395972,4,2831,320,2832,1,0
20150106.001628,2832,4,395976,-2,2831,320,2832,1,0
20150106.001629,2833,6,395982,-4,2831,321,2833,230,1
20150106.00163,2832,4,395986,-2,2831,321,2833,234,0
20150106.00163,2832,40,396026,40,2831,320,2833,239,0
20150106.001631,2832,4,396030,-2,2831,322,2833,329,0
20150106.001633,2832,6,396036,-6,2831,344,2833,241,0
20150106.001634,2832,6,396042,2,2831,345,2833,251,0
20150106.001635,2832,4,396046,0,2831,335,2833,253,0
20150106.001637,2832,2,396048,0,2831,335,2832,110,0
20150106.001639,2832,2,396050,0,2831,336,2832,109,0
20150106.00164,2832,18,396068,-14,2831,321,2832,115,0
20150106.001641,2832,44,396112,-42,2831,321,2832,100,0
20150106.001644,2832,10,396122,-10,2831,321,2832,251,0
20150106.001645,2831,2,396124,0,2831,330,2832,262,0
20150106.001648,2831,2,396126,0,2831,339,2832,265,0
20150106.00165,2832,10,396136,0,2831,339,2832,267,1
20150106.00165,2832,6,396142,0,2831,339,2832,262,1
20150106.001652,2831,2,396144,0,2831,338,2832,278,0
20150106.001652,2831,2,396146,2,2831,338,2832,279,0
20150106.001657,2831,16,396162,0,2831,331,2832,284,0
20150106.001658,2831,60,396222,60,2831,300,2832,299,0
20150106.001658,2832,32,396254,-18,2831,299,2832,284,1
20150106.001659,2831,40,396294,40,2831,329,2832,284,0
20150106.0017,2831,2,396296,0,2831,343,2832,273,0
20150106.001701,2832,2,396298,0,2831,328,2832,272,1
20150106.001702,2831,8,396306,0,2831,327,2832,300,0
20150106.001704,2831,4,396310,0,2831,325,2832,300,0
20150106.001705,2831,400,396710,60,2830,430,2832,306,0
20150106.001707,2831,4,396714,0,2830,430,2832,310,0
20150106.001707,2830,300,397014,250,2830,764,2832,310,0
20150106.001708,2831,4,397018,0,2830,404,2832,311,1
20150106.001709,2831,2,397020,2,2830,404,2832,351,1
20150106.001709,2830,4,397024,0,2830,727,2831,2,0
20150106.001711,2830,48,397072,0,2830,704,2831,290,0
20150106.001712,2830,18,397090,-14,2830,701,2831,287,0
20150106.001713,2830,2,397092,0,2830,700,2831,287,0
20150106.001713,2830,2,397094,0,2830,704,2831,287,0
20150106.001714,2830,2,397096,2,2830,703,2831,287,0
20150106.001715,2830,6,397102,4,2830,700,2831,338,0
20150106.001716,2830,2,397104,2,2830,699,2831,370,0
20150106.001717,2830,6,397110,0,2830,695,2831,370,0
20150106.001717,2830,6,397116,2,2830,695,2831,370,0
20150106.001718,2830,2,397118,0,2830,694,2831,378,0
20150106.001718,2830,2,397120,2,2830,693,2831,379,0
20150106.001719,2830,2,397122,2,2830,689,2831,385,0
20150106.001719,2830,10,397132,0,2830,669,2831,404,0
20150106.00172,2830,6,397138,0,2830,548,2831,402,0
20150106.00172,2830,10,397148,0,2830,543,2831,403,0
20150106.001721,2830,30,397178,20,2830,328,2831,404,0
20150106.001721,2830,38,397216,0,2830,298,2831,406,0
20150106.001722,2830,38,397254,-8,2830,278,2831,406,0
20150106.001723,2830,44,397298,-26,2830,242,2831,406,0
20150106.001723,2830,54,397352,8,2830,216,2831,407,0
20150106.001723,2830,6,397358,4,2830,213,2831,407,0
20150106.001724,2830,12,397370,6,2830,207,2831,412,0
20150106.001725,2831,24,397394,10,2830,194,2831,410,1
20150106.001726,2830,104,397498,-14,2830,125,2831,410,0
20150106.001726,2830,26,397524,4,2830,111,2831,409,0
20150106.001727,2830,44,397568,-4,2830,88,2831,406,0
20150106.001727,2830,90,397658,-62,2829,1154,2831,406,0
20150106.001728,2830,20,397678,-20,2829,1154,2831,407,0
20150106.001728,2830,8,397686,-6,2829,1154,2831,406,0
20150106.001729,2830,18,397704,2,2829,1188,2831,416,0
20150106.00173,2830,10,397714,6,2830,10,2831,416,0
20150106.001731,2830,4,397718,2,2830,21,2831,416,0
20150106.001731,2830,32,397750,6,2830,7,2831,417,0
20150106.001732,2830,2,397752,0,2830,6,2831,418,0
20150106.001732,2830,20,397772,10,2829,1159,2830,17,0
20150106.001733,2829,2,397774,0,2829,1158,2830,17,0
20150106.001733,2829,4,397778,0,2829,1157,2830,17,0
20150106.001734,2829,4,397782,0,2829,1154,2830,19,0
20150106.001734,2829,2,397784,2,2829,1153,2830,19,0
20150106.001735,2830,44,397828,-36,2830,478,2831,415,1
20150106.001735,2831,26,397854,-24,2830,528,2831,403,1
20150106.001736,2830,150,398004,-110,2830,453,2831,403,0
20150106.001737,2830,10,398014,0,2830,448,2831,403,0
20150106.001737,2830,14,398028,0,2830,441,2831,403,0
20150106.001738,2830,6,398034,0,2830,440,2831,396,0
20150106.001738,2830,2,398036,0,2830,440,2831,396,0
20150106.00174,2830,10,398046,-10,2830,445,2831,397,0
20150106.00174,2830,32,398078,-10,2830,449,2831,412,0
20150106.001741,2830,138,398216,-138,2830,380,2831,411,0
20150106.001742,2830,40,398256,0,2830,372,2831,416,0
20150106.001742,2830,2,398258,0,2830,371,2831,423,0
20150106.001744,2830,12,398270,-12,2830,365,2831,725,0
20150106.001745,2830,2,398272,0,2830,364,2831,729,0
20150106.001746,2830,22,398294,-22,2830,353,2831,732,0
20150106.001746,2830,2,398296,-2,2830,353,2831,732,0
20150106.001746,2831,6,398302,0,2830,353,2831,730,1
20150106.001748,2830,20,398322,-20,2830,356,2831,730,0
20150106.00175,2830,2,398324,0,2830,355,2831,715,0
20150106.001751,2830,18,398342,-16,2830,511,2831,715,0
20150106.001751,2830,4,398346,0,2830,494,2831,731,0
20150106.001752,2830,100,398446,-100,2830,445,2831,749,0
20150106.001754,2830,12,398458,-10,2830,446,2831,759,0
20150106.001755,2830,20,398478,-20,2830,436,2831,807,0
20150106.001756,2831,2,398480,0,2830,436,2831,807,1
20150106.001757,2830,2,398482,-2,2830,447,2831,824,0
20150106.001758,2830,20,398502,0,2830,431,2831,844,0
20150106.001759,2831,24,398526,-4,2830,421,2831,843,1
20150106.001759,2830,8,398534,-6,2830,417,2831,843,0
20150106.0018,2830,2,398536,-2,2830,417,2831,843,0
20150106.0018,2830,8,398544,-4,2830,413,2831,843,0
20150106.001802,2830,20,398564,-20,2830,405,2831,846,0
20150106.001802,2830,20,398584,0,2830,395,2831,846,0
20150106.001803,2830,4,398588,-4,2830,243,2831,847,0
20150106.001804,2830,316,398904,-76,2830,85,2831,848,0
20150106.001804,2830,170,399074,-64,2829,1153,2830,64,0
20150106.001807,2830,10,399084,0,2829,1151,2830,86,0
20150106.001808,2829,4,399088,0,2829,1150,2830,87,0
20150106.001809,2829,2,399090,2,2829,1149,2830,94,0
20150106.00181,2829,2,399092,0,2829,1148,2830,113,0
20150106.001811,2830,2,399094,0,2829,1148,2830,131,1
20150106.001813,2829,10,399104,6,2829,1144,2830,130,0
20150106.001814,2829,204,399308,2,2829,1043,2830,131,0
20150106.001815,2829,100,399408,0,2829,993,2830,132,0
20150106.001816,2829,10,399418,10,2829,988,2830,139,0
20150106.001816,2830,10,399428,0,2829,986,2830,136,1
20150106.001817,2829,20,399448,20,2829,976,2830,360,0
20150106.001818,2829,6,399454,2,2829,973,2830,361,0
20150106.001819,2830,12,399466,-12,2829,973,2830,357,1
20150106.00182,2829,1010,400476,1000,2829,469,2830,358,0
20150106.001821,2829,6,400482,2,2829,466,2830,360,0
20150106.001822,2829,12,400494,2,2829,460,2830,360,0
20150106.001822,2829,106,400600,2,2829,407,2830,360,0
20150106.001823,2829,2,400602,0,2829,406,2830,360,0
20150106.001824,2829,8,400610,8,2829,383,2830,379,0
20150106.001826,2829,44,400654,4,2829,416,2830,403,0
20150106.001826,2829,2,400656,0,2829,417,2830,406,0
20150106.001827,2829,4,400660,4,2829,416,2830,408,0
20150106.001828,2829,34,400694,34,2829,399,2830,407,0
20150106.001828,2829,40,400734,40,2829,379,2830,408,0
20150106.00183,2829,600,401334,-20,2829,79,2830,409,0
20150106.00183,2829,2,401336,0,2829,78,2830,409,0
20150106.00183,2829,40,401376,-6,2829,59,2830,415,0
20150106.001831,2829,8,401384,0,2829,55,2830,414,0
20150106.001832,2830,10,401394,6,2829,221,2830,413,1
20150106.001832,2829,10,401404,0,2829,216,2830,428,0
20150106.001833,2829,164,401568,84,2829,135,2830,431,0
20150106.001833,2830,6,401574,-4,2829,136,2830,431,1
20150106.001834,2829,8,401582,-6,2829,133,2830,446,0
20150106.001835,2829,4,401586,0,2829,144,2830,449,0
20150106.001835,2829,4,401590,0,2829,142,2830,449,0
20150106.001835,2829,8,401598,-4,2829,138,2830,449,0
20150106.001836,2830,4,401602,0,2829,139,2830,447,1
20150106.001837,2829,60,401662,-60,2829,111,2830,446,0
20150106.001838,2829,4,401666,-4,2829,109,2830,447,0
20150106.001839,2829,24,401690,-24,2829,99,2830,447,0
20150106.00184,2830,966,402656,-368,2830,537,2831,786,1
20150106.001841,2830,6,402662,0,2830,535,2831,801,1
20150106.001841,2830,8,402670,-8,2830,531,2831,799,1
20150106.001842,2830,2,402672,0,2830,545,2831,784,1
20150106.001843,2830,22,402694,-22,2830,534,2831,783,1
20150106.001844,2830,12,402706,-12,2830,528,2831,784,1
20150106.001844,2830,12,402718,-12,2830,522,2831,784,1
20150106.001846,2830,2,402720,0,2830,571,2831,785,1
20150106.001847,2830,12,402732,0,2830,565,2831,785,1
20150106.001848,2830,36,402768,0,2830,547,2831,801,1
20150106.00185,2830,2,402770,-2,2830,546,2831,500,1
20150106.001851,2831,1000,403770,124,2831,41,2832,157,1
20150106.001851,2832,8,403778,-4,2831,56,2832,153,1
20150106.001852,2831,2,403780,0,2831,55,2832,153,0
20150106.001852,2831,14,403794,0,2831,34,2832,169,0
20150106.001853,2831,30,403824,8,2831,23,2832,169,0
20150106.001856,2831,2,403826,0,2831,22,2832,189,0
20150106.001857,2832,46,403872,4,2831,4,2832,187,1
20150106.001859,2833,450,404322,262,2831,19,2833,252,1
20150106.0019,2833,4,404326,-4,2831,43,2833,250,1
20150106.0019,2833,12,404338,-8,2831,38,2833,249,1
20150106.001902,2833,86,404424,2,2832,15,2833,209,1
20150106.001903,2832,62,404486,-60,2831,1048,2833,209,0
20150106.001904,2832,2,404488,0,2832,1,2833,208,0
20150106.001905,2832,128,404616,-126,2831,1049,2832,1,0
20150106.001905,2831,12,404628,-12,2831,1044,2832,1,0
20150106.001906,2832,2,404630,0,2831,1044,2833,232,1
20150106.001906,2832,10,404640,-10,2832,33,2833,241,1
20150106.001907,2832,8,404648,-2,2832,30,2833,241,1
20150106.001908,2832,2,404650,0,2832,34,2833,242,1
20150106.001908,2833,32,404682,-12,2832,27,2833,236,1
20150106.001909,2832,12,404694,-12,2832,21,2833,236,0
20150106.001909,2833,2,404696,0,2832,71,2833,225,1
20150106.00191,2832,2,404698,-2,2832,70,2833,230,0
20150106.001911,2832,2,404700,-2,2832,69,2833,231,0
20150106.001911,2833,2,404702,0,2832,71,2833,250,1
20150106.001912,2832,2,404704,-2,2832,70,2833,252,0
20150106.001912,2833,2,404706,0,2832,70,2833,252,1
20150106.001913,2832,10,404716,-10,2832,65,2833,252,0
20150106.001914,2832,2,404718,-2,2832,81,2833,263,0
20150106.001915,2833,72,404790,20,2832,83,2833,227,1
20150106.001915,2832,2,404792,-2,2832,82,2833,227,0
20150106.001916,2833,2,404794,0,2832,92,2833,191,1
20150106.001916,2832,2,404796,0,2832,81,2833,204,0
20150106.001918,2833,2,404798,0,2832,84,2833,205,1
20150106.001919,2832,2,404800,-2,2832,85,2833,208,0
20150106.001921,2833,2,404802,0,2832,85,2833,217,1
20150106.001921,2833,140,404942,-72,2832,82,2833,150,1
20150106.001921,2832,2,404944,0,2832,91,2833,139,0
20150106.001922,2833,2,404946,0,2832,81,2833,160,1
20150106.001923,2833,104,405050,-100,2832,91,2833,98,1
20150106.001923,2833,24,405074,-24,2832,91,2833,86,1
20150106.001924,2833,12,405086,-2,2832,115,2833,56,1
20150106.001925,2833,2,405088,2,2832,145,2833,56,1
20150106.001925,2833,24,405112,10,2832,145,2833,93,1
20150106.001928,2833,6,405118,-2,2832,148,2833,98,1
20150106.001928,2832,20,405138,20,2832,140,2833,97,0
20150106.001929,2833,2,405140,2,2832,141,2833,97,1
20150106.001931,2832,4,405144,4,2832,141,2833,132,0
20150106.001932,2832,302,405446,-74,2831,1114,2832,400,0
20150106.001932,2832,2,405448,0,2831,1101,2832,399,0
20150106.001934,2832,2,405450,0,2831,1101,2832,401,0
20150106.001938,2831,6,405456,-6,2831,1113,2832,401,0
20150106.00194,2831,4,405460,-4,2831,1111,2832,402,0
20150106.001941,2832,6,405466,0,2831,1111,2832,402,1
20150106.001945,2831,2,405468,-2,2831,1110,2832,405,0
20150106.001945,2831,20,405488,-12,2831,1110,2832,407,0
20150106.001946,2831,160,405648,6,2831,1030,2832,407,0
20150106.00195,2831,2,405650,-2,2831,1054,2832,410,0
20150106.001951,2831,2,405652,0,2831,1060,2832,412,0
20150106.001952,2831,2,405654,0,2831,1059,2832,413,0
20150106.001952,2831,6,405660,-2,2831,1056,2832,413,0
20150106.001956,2831,160,405820,-160,2831,976,2832,75,0
20150106.001956,2831,2,405822,0,2831,975,2832,109,0
20150106.001957,2832,60,405882,-12,2831,968,2832,79,1
20150106.001958,2831,8,405890,-8,2831,964,2832,84,0
20150106.001959,2832,10,405900,10,2831,964,2832,81,1
20150106.002,2831,10,405910,-10,2831,959,2832,81,0
20150106.002,2832,42,405952,26,2831,959,2832,101,1
20150106.002001,2832,204,406156,-190,2832,84,2833,534,1
20150106.002001,2833,28,406184,-2,2832,84,2833,509,1
20150106.002002,2833,22,406206,-4,2832,97,2833,500,1
20150106.002003,2832,162,406368,-60,2832,26,2833,423,0
20150106.002004,2832,12,406380,-10,2832,7,2833,438,0
20150106.002004,2832,4,406384,0,2832,5,2833,438,0
20150106.002005,2832,16,406400,8,2831,960,2832,3,0
20150106.002006,2832,8,406408,-2,2831,960,2833,424,0
20150106.002006,2831,6,406414,-6,2831,957,2833,424,0
20150106.002007,2832,2,406416,-2,2831,957,2833,466,1
20150106.002007,2831,12,406428,-10,2831,951,2833,468,0
20150106.002008,2832,4,406432,0,2832,2,2833,532,1
20150106.002009,2832,4,406436,-2,2831,951,2833,532,1
20150106.002011,2832,6,406442,-6,2831,958,2833,536,1
20150106.002014,2832,4,406446,-2,2831,970,2833,561,1
20150106.002015,2832,24,406470,12,2832,12,2833,562,1
20150106.002015,2832,162,406632,-158,2831,989,2832,1,1
20150106.002016,2832,2,406634,0,2832,196,2833,547,1
20150106.002017,2832,4,406638,0,2832,199,2833,548,1
20150106.002018,2832,4,406642,4,2832,281,2833,563,1
20150106.002018,2832,2,406644,0,2832,280,2833,563,1
20150106.002019,2832,8,406652,4,2832,276,2833,563,1
20150106.00202,2832,2,406654,0,2832,276,2833,563,1
20150106.002021,2832,12,406666,12,2832,270,2833,608,1
20150106.002021,2832,572,407238,-30,2831,991,2832,14,1
20150106.002021,2832,30,407268,-30,2831,984,2833,626,1
20150106.002023,2833,14,407282,14,2831,983,2833,619,1
20150106.002024,2832,4,407286,0,2832,1,2833,737,0
20150106.002025,2833,18,407304,8,2831,979,2833,731,1
20150106.002028,2832,10,407314,-4,2832,18,2833,435,0
20150106.002028,2832,2,407316,2,2832,17,2833,435,0
20150106.002029,2832,46,407362,42,2831,981,2832,7,0
20150106.00203,2832,32,407394,10,2832,173,2833,435,0
20150106.00203,2832,6,407400,0,2832,170,2833,433,0
20150106.002032,2833,2,407402,0,2832,170,2833,432,1
20150106.002034,2832,2,407404,0,2832,184,2833,429,0
20150106.002035,2832,14,407418,4,2832,179,2833,431,0
20150106.002035,2832,2,407420,2,2832,178,2833,431,0
20150106.002036,2832,2,407422,2,2832,177,2833,432,0
20150106.002037,2832,20,407442,0,2832,167,2833,433,0
20150106.002038,2833,10,407452,6,2832,172,2833,433,1
20150106.002039,2833,2,407454,2,2832,24,2833,433,1
20150106.002039,2832,2,407456,2,2832,24,2833,433,0
20150106.00204,2833,6,407462,4,2832,25,2833,430,1
20150106.002041,2833,30,407492,4,2832,12,2833,428,1
20150106.002042,2832,2,407494,-2,2832,11,2833,428,0
20150106.002043,2832,14,407508,2,2832,4,2833,429,0
20150106.002043,2832,8,407516,2,2831,963,2832,1,0
20150106.002044,2832,4,407520,-2,2831,963,2833,431,0
20150106.002045,2832,32,407552,12,2832,1,2833,421,0
20150106.002046,2832,2,407554,2,2831,963,2833,421,0
20150106.002047,2832,4,407558,4,2832,5,2833,424,0
20150106.002049,2833,4,407562,4,2832,15,2833,422,1
20150106.002049,2833,18,407580,2,2832,17,2833,413,1
20150106.00205,2832,14,407594,0,2832,10,2833,416,0
20150106.002051,2832,2,407596,2,2832,509,2833,416,0
20150106.002051,2832,2,407598,0,2832,524,2833,401,0
20150106.002055,2833,20,407618,20,2832,527,2833,393,1
20150106.002055,2832,2,407620,2,2832,593,2833,413,0
20150106.002056,2832,2,407622,2,2832,592,2833,415,0
20150106.002056,2833,2,407624,2,2832,593,2833,414,1
20150106.002057,2832,2,407626,2,2832,592,2833,414,0
20150106.002101,2833,6,407632,6,2832,597,2833,423,1
20150106.002104,2832,2,407634,0,2832,602,2833,428,0
20150106.002105,2833,36,407670,0,2832,602,2833,410,1
20150106.002107,2832,22,407692,-2,2832,652,2833,421,0
20150106.002109,2833,2,407694,2,2832,652,2833,420,1
20150106.00211,2832,2,407696,0,2832,651,2833,423,0
20150106.002111,2833,2,407698,2,2832,651,2833,420,1
20150106.002112,2832,848,408546,848,2832,212,2833,433,0
20150106.002112,2832,50,408596,50,2832,188,2833,434,0
20150106.002113,2832,376,408972,-262,2831,1962,2832,386,0
20150106.002117,2832,2,408974,0,2831,1962,2832,448,0
20150106.002117,2832,10,408984,-10,2831,1962,2832,443,0
20150106.002119,2832,24,409008,0,2831,1962,2832,431,0
20150106.00212,2832,14,409022,-10,2831,1962,2832,424,0
20150106.002121,2832,2,409024,0,2831,1962,2832,423,0
20150106.002123,2831,4,409028,-4,2831,1960,2832,423,0
20150106.002124,2831,4,409032,-4,2831,1959,2832,424,0
20150106.002125,2832,6,409038,-6,2831,1959,2832,431,1
20150106.00213,2831,4,409042,-4,2831,1957,2832,436,0
20150106.002132,2832,2,409044,0,2831,1957,2832,435,1
20150106.002134,2832,18,409062,-4,2831,1957,2832,83,1
20150106.002135,2832,14,409076,0,2831,1957,2832,77,1
20150106.002137,2831,2,409078,-2,2831,1956,2832,79,0
20150106.002138,2832,2,409080,2,2831,1956,2832,78,1
20150106.002139,2832,2,409082,2,2831,1966,2832,77,1
20150106.002139,2832,2,409084,2,2831,1966,2832,80,1
20150106.00214,2832,160,409244,-42,2831,1966,2833,436,1
20150106.002141,2831,2,409246,-2,2831,1965,2833,466,0
20150106.002141,2832,2,409248,2,2831,1965,2833,466,1
20150106.002142,2832,2,409250,2,2831,1965,2832,1,1
20150106.002143,2832,2,409252,0,2832,132,2833,466,1
20150106.002143,2832,2,409254,0,2832,131,2833,466,1
20150106.002144,2832,4,409258,0,2832,129,2833,466,1
20150106.002145,2832,258,409516,0,2831,1980,2832,228,1
20150106.002145,2831,2,409518,0,2831,1979,2832,229,0
20150106.002146,2832,2,409520,0,2831,1984,2832,232,1
20150106.002147,2832,10,409530,0,2831,1984,2832,232,1
20150106.002148,2832,2,409532,0,2831,1986,2832,233,1
20150106.002151,2831,6,409538,-6,2831,1983,2832,238,0
20150106.002153,2832,20,409558,0,2831,1985,2832,231,1
20150106.002154,2832,2,409560,0,2831,1985,2832,233,1
20150106.002155,2832,470,410030,-448,2832,781,2833,458,1
20150106.002156,2832,4,410034,-4,2832,782,2833,458,1
20150106.002157,2832,2,410036,-2,2832,781,2833,458,1
20150106.002157,2833,2,410038,0,2832,781,2833,459,1
20150106.002158,2832,2,410040,-2,2832,780,2833,459,0
20150106.002158,2832,4,410044,0,2832,778,2833,459,0
20150106.0022,2833,40,410084,-2,2832,778,2833,441,1
20150106.002201,2832,2,410086,-2,2832,778,2833,441,0
20150106.002203,2832,2,410088,-2,2832,777,2833,441,0
20150106.002205,2833,44,410132,12,2832,762,2833,434,1
20150106.002206,2832,2,410134,-2,2832,760,2833,434,0
20150106.002206,2832,6,410140,-6,2832,757,2833,433,0
20150106.002207,2832,12,410152,0,2832,752,2833,432,0
20150106.002209,2832,2,410154,-2,2832,752,2833,342,0
20150106.002209,2832,308,410462,-84,2832,618,2833,854,0
20150106.00221,2832,174,410636,0,2832,531,2833,852,0
20150106.00221,2832,20,410656,0,2832,523,2833,852,0
20150106.002213,2832,60,410716,0,2832,493,2833,852,0
20150106.002216,2832,4,410720,-4,2832,491,2833,903,0
20150106.002217,2832,2,410722,-2,2832,490,2833,903,0
20150106.002217,2833,4,410726,0,2832,490,2833,901,1
20150106.002219,2832,6,410732,-6,2832,987,2833,900,0
20150106.002221,2832,10,410742,0,2832,1007,2833,900,0
20150106.002224,2832,2,410744,-2,2832,1026,2833,895,0
20150106.002225,2833,6,410750,-6,2832,1026,2833,892,1
20150106.002227,2832,2,410752,-2,2832,1025,2833,888,0
20150106.002229,2833,2,410754,-2,2832,1025,2833,899,1
20150106.002233,2833,10,410764,0,2832,1025,2833,894,1
20150106.002236,2832,2,410766,-2,2832,1024,2833,930,0
20150106.002239,2833,8,410774,-6,2832,1004,2833,924,1
20150106.002239,2832,2,410776,0,2832,1003,2833,924,0
20150106.002241,2833,2,410778,-2,2832,1021,2833,882,1
20150106.002243,2832,30,410808,-30,2832,1006,2833,889,0
20150106.002245,2832,2,410810,-2,2832,1005,2833,891,0
20150106.002247,2833,4,410814,0,2832,1005,2833,889,1
20150106.002248,2833,6,410820,-6,2832,1020,2833,886,1
20150106.002249,2833,8,410828,-8,2832,1035,2833,883,1
20150106.002252,2833,4,410832,0,2832,1050,2833,738,1
20150106.002255,2833,10,410842,0,2832,1050,2833,767,1
20150106.002255,2832,4,410846,-4,2832,1048,2833,767,0
20150106.002257,2832,6,410852,-6,2832,1045,2833,767,0
20150106.0023,2832,240,411092,-240,2832,926,2833,784,0
20150106.0023,2832,2,411094,0,2832,910,2833,784,0
20150106.002301,2833,2,411096,0,2832,926,2833,783,1
20150106.002302,2832,2,411098,0,2832,925,2833,803,0
20150106.002302,2832,2,411100,-2,2832,924,2833,803,0
20150106.002303,2832,398,411498,-258,2832,725,2833,803,0
20150106.002305,2832,4,411502,-4,2832,726,2833,802,0
20150106.002306,2832,378,411880,122,2832,522,2833,812,0
20150106.002307,2832,2,411882,0,2832,522,2833,812,0
20150106.002307,2832,64,411946,0,2832,490,2833,812,0
20150106.002308,2832,18,411964,0,2832,482,2833,811,0
20150106.002309,2832,404,412368,292,2832,295,2833,607,0
20150106.002309,2832,6,412374,4,2832,278,2833,622,0
20150106.002309,2832,494,412868,492,2832,31,2833,622,0
20150106.00231,2832,92,412960,-30,2831,2028,2832,1,0
20150106.002311,2832,18,412978,-4,2832,18,2833,617,0
20150106.002311,2832,10,412988,-4,2832,16,2833,613,0
20150106.002312,2832,8,412996,0,2832,12,2833,613,0
20150106.002312,2832,380,413376,142,2831,2027,2833,395,0
20150106.002313,2832,20,413396,0,2831,2027,2832,1,0
20150106.002313,2832,6,413402,-2,2832,14,2833,370,0
20150106.002314,2832,4,413406,0,2831,2032,2832,2,0
20150106.002314,2832,4,413410,0,2831,2432,2833,381,0
20150106.002315,2832,18,413428,0,2831,2252,2832,5,0
20150106.002316,2832,50,413478,-38,2832,10,2833,542,0
20150106.002317,2832,6,413484,-4,2832,11,2833,543,0
20150106.002317,2832,22,413506,-18,2831,2065,2833,542,0
20150106.002318,2833,20,413526,0,2831,2065,2833,535,1
20150106.002318,2833,124,413650,-102,2832,30,2833,474,1
20150106.002319,2833,124,413774,20,2832,30,2833,412,1
20150106.002319,2832,10,413784,0,2832,40,2833,428,0
20150106.00232,2832,2,413786,0,2832,39,2833,427,0
20150106.00232,2832,2,413788,0,2832,38,2833,426,0
20150106.002321,2832,10,413798,0,2832,33,2833,426,0
20150106.002321,2832,2,413800,0,2832,32,2833,426,0
20150106.002322,2833,6,413806,-2,2832,143,2833,424,1
20150106.002323,2833,6,413812,-4,2832,158,2833,422,1
20150106.002326,2832,2,413814,2,2832,218,2833,430,0
20150106.00233,2833,2,413816,2,2832,299,2833,432,1
20150106.002331,2832,10,413826,0,2832,294,2833,431,0
20150106.002334,2832,2,413828,2,2832,295,2833,430,0
20150106.002335,2832,2,413830,0,2832,299,2833,432,0
20150106.002335,2832,20,413850,10,2832,294,2833,427,0
20150106.002336,2832,402,414252,278,2832,104,2833,538,0
20150106.002336,2832,2,414254,0,2832,104,2833,538,0
20150106.002338,2832,2,414256,0,2832,113,2833,540,0
20150106.002339,2832,60,414316,54,2832,83,2833,540,0
20150106.002339,2832,352,414668,316,2831,2063,2833,240,0
20150106.002343,2832,6,414674,0,2831,2063,2833,674,0
20150106.002344,2832,2,414676,2,2831,2064,2833,673,0
20150106.002345,2832,4,414680,2,2831,2063,2832,205,0
20150106.002348,2832,22,414702,14,2831,2063,2832,198,0
20150106.002351,2832,2,414704,0,2831,2063,2832,8,0
20150106.002353,2832,2,414706,-2,2831,2063,2832,210,0
20150106.002354,2832,2,414708,-2,2831,2093,2832,241,0
20150106.002357,2831,2,414710,0,2831,2092,2832,245,0
20150106.002358,2832,2,414712,-2,2831,2092,2832,243,1
20150106.0024,2832,30,414742,12,2831,2093,2832,229,1
20150106.002401,2831,2,414744,-2,2831,2092,2832,232,0
20150106.002403,2832,40,414784,0,2831,2092,2832,219,1
20150106.002404,2831,4,414788,0,2831,2090,2832,219,0
20150106.002406,2832,40,414828,22,2831,2089,2832,200,1
20150106.002408,2831,16,414844,-16,2831,2090,2832,198,0
20150106.002408,2831,2,414846,0,2831,2089,2832,198,0
20150106.002409,2831,40,414886,-40,2831,2069,2832,197,0
20150106.00241,2831,2,414888,-2,2831,2068,2832,208,0
20150106.002411,2832,430,415318,-174,2832,785,2833,587,1
20150106.002411,2832,2,415320,0,2832,797,2833,552,1
20150106.002413,2832,20,415340,-20,2832,787,2833,552,1
20150106.002414,2832,60,415400,-50,2832,758,2833,566,1
20150106.002414,2832,396,415796,-396,2832,552,2833,330,1
20150106.002417,2832,70,415866,-70,2832,525,2833,448,1
20150106.002418,2832,8,415874,-8,2832,523,2833,452,1
20150106.002419,2832,2,415876,0,2832,549,2833,452,1
20150106.00242,2832,4,415880,-4,2832,552,2833,455,1
20150106.002421,2832,4,415884,-4,2832,550,2833,455,1
20150106.002422,2832,10,415894,-10,2832,545,2833,455,1
20150106.002423,2832,2,415896,0,2832,544,2833,456,1
20150106.002423,2832,4,415900,-4,2832,542,2833,456,1
20150106.002427,2832,4,415904,-4,2832,540,2833,457,1
20150106.002428,2832,16,415920,0,2832,534,2833,459,1
20150106.002432,2832,10,415930,-10,2832,572,2833,450,1
20150106.002437,2833,28,415958,-20,2832,574,2833,426,1
20150106.002438,2832,44,416002,-44,2832,550,2833,448,0
20150106.002439,2832,404,416406,0,2832,350,2833,449,0
20150106.002442,2832,2,416408,-2,2832,353,2833,449,0
20150106.002443,2832,2,416410,-2,2832,357,2833,456,0
20150106.002444,2832,20,416430,-20,2832,347,2833,448,0
20150106.002449,2833,4,416434,0,2832,347,2833,457,1
20150106.002451,2832,14,416448,-14,2832,332,2833,457,0
20150106.002452,2833,4,416452,0,2832,332,2833,460,1
20150106.002453,2832,4,416456,-4,2832,325,2833,430,0
20150106.002456,2833,6,416462,-6,2832,333,2833,406,1
20150106.002456,2832,26,416488,0,2832,312,2833,406,0
20150106.002458,2832,10,416498,-10,2832,307,2833,405,0
20150106.002501,2832,40,416538,-40,2832,295,2833,393,0
20150106.002501,2833,348,416886,-230,2832,287,2833,230,1
20150106.002502,2832,4,416890,0,2832,293,2833,218,0
20150106.002504,2832,4,416894,-4,2832,292,2833,190,0
20150106.002504,2833,4,416898,0,2832,290,2833,210,1
20150106.002505,2832,4,416902,-4,2832,288,2833,208,0
20150106.002509,2832,2,416904,0,2832,287,2833,205,0
20150106.002514,2832,10,416914,-10,2832,290,2833,200,0
20150106.002514,2833,4,416918,2,2832,290,2833,200,1
20150106.002515,2832,2,416920,-2,2832,289,2833,199,0
20150106.002516,2833,222,417142,-186,2832,274,2833,92,1
20150106.002517,2833,10,417152,4,2832,282,2833,88,1
20150106.002517,2832,10,417162,-10,2832,277,2833,98,0
20150106.002518,2833,2,417164,0,2832,270,2833,108,1
20150106.002518,2833,10,417174,2,2832,270,2833,93,1
20150106.00252,2833,16,417190,-4,2832,267,2833,260,1
20150106.002529,2833,50,417240,-10,2832,1056,2833,261,1
20150106.00253,2833,16,417256,0,2832,1059,2833,253,1
20150106.002531,2832,2,417258,-2,2832,1058,2833,253,0
20150106.002533,2832,2,417260,0,2832,1057,2833,253,0
20150106.002534,2833,2,417262,-2,2832,1057,2833,252,1
20150106.002536,2833,4,417266,0,2832,1056,2833,289,1
20150106.002538,2833,2,417268,0,2832,1057,2833,298,1
20150106.002539,2833,8,417276,-8,2832,1054,2833,297,1
20150106.00254,2833,40,417316,12,2832,1058,2833,279,1
20150106.002542,2833,8,417324,0,2832,1060,2833,275,1
20150106.002542,2833,2,417326,2,2832,1061,2833,274,1
20150106.002543,2833,2,417328,0,2832,1062,2833,273,1
20150106.002544,2833,2,417330,2,2832,1061,2833,272,1
20150106.002547,2833,556,417886,-90,2832,1062,2834,225,1
20150106.002547,2833,16,417902,0,2832,1062,2834,638,1
20150106.002549,2833,2,417904,0,2832,1062,2833,2,1
20150106.00255,2833,4,417908,-4,2832,1112,2833,187,1
20150106.002552,2833,10,417918,-10,2832,1114,2833,182,1
20150106.002553,2833,2,417920,0,2832,1124,2833,181,1
20150106.002554,2833,12,417932,10,2832,1123,2833,175,1
20150106.002558,2833,10,417942,10,2832,1121,2833,173,1
20150106.002559,2833,358,418300,-4,2833,821,2834,604,1
20150106.0026,2834,1002,419302,-402,2833,822,2834,88,1
20150106.002601,2834,82,419384,0,2833,1030,2835,555,1
20150106.002601,2834,18,419402,-4,2833,1030,2835,555,1
20150106.002602,2834,4,419406,4,2833,1036,2835,555,1
20150106.002603,2834,2,419408,2,2833,1048,2835,555,1
20150106.002604,2834,2,419410,2,2833,1048,2835,554,1
20150106.002604,2834,604,420014,-2,2833,741,2834,40,1
20150106.002605,2833,2,420016,0,2833,742,2835,554,0
20150106.002606,2833,6,420022,0,2833,739,2834,25,0
20150106.002607,2834,2,420024,0,2833,739,2835,554,1
20150106.002609,2834,2,420026,0,2833,760,2835,556,1
20150106.00261,2835,1328,421354,-812,2835,115,2836,640,1
20150106.002611,2835,636,421990,-46,2834,1,2835,36,1
20150106.002611,2835,62,422052,-6,2834,18,2836,585,1
20150106.002612,2834,8,422060,-2,2834,8,2835,19,0
20150106.002612,2835,2,422062,0,2834,11,2835,39,1
20150106.002613,2835,2,422064,-2,2834,11,2836,573,1
20150106.002613,2834,316,422380,0,2833,553,2835,319,0
20150106.002614,2834,4,422384,-2,2833,553,2835,319,0
20150106.002614,2834,12,422396,0,2833,553,2835,321,0
20150106.002615,2835,14,422410,0,2834,1,2835,356,1
20150106.002615,2834,4,422414,-2,2833,554,2835,343,0
20150106.002616,2835,42,422456,0,2834,1,2835,343,1
20150106.002616,2835,4,422460,-2,2834,1,2835,343,1
20150106.002617,2834,16,422476,-2,2833,554,2835,346,0
20150106.002617,2835,2,422478,0,2833,554,2835,345,1
20150106.002618,2835,6,422484,-6,2833,554,2834,198,1
20150106.002618,2835,2,422486,0,2833,555,2835,319,1
20150106.002619,2835,140,422626,-70,2833,543,2835,319,1
20150106.002619,2834,20,422646,0,2833,544,2835,319,0
20150106.00262,2834,36,422682,-14,2833,637,2835,335,0
20150106.00262,2834,40,422722,0,2833,653,2835,336,0
20150106.002621,2834,38,422760,-30,2833,653,2835,336,0
20150106.002621,2834,4,422764,-4,2833,654,2834,63,0
20150106.002622,2834,4,422768,-2,2833,653,2834,64,0
20150106.002623,2834,24,422792,0,2833,653,2835,357,0
20150106.002623,2834,124,422916,-58,2833,625,2835,357,0
20150106.002625,2834,14,422930,0,2833,623,2835,359,0
20150106.002625,2834,2,422932,0,2834,19,2835,413,0
20150106.002626,2834,60,422992,0,2833,643,2835,393,0
20150106.002626,2835,34,423026,-16,2833,643,2835,377,1
20150106.002628,2834,6,423032,-4,2833,652,2835,349,0
20150106.002629,2834,8,423040,0,2833,652,2835,360,0
20150106.00263,2834,8,423048,0,2833,452,2835,362,0
20150106.002631,2834,2,423050,-2,2833,452,2835,366,0
20150106.002631,2834,2,423052,0,2833,452,2835,366,0
20150106.002632,2834,2,423054,0,2833,452,2835,433,0
20150106.002633,2834,2,423056,2,2833,454,2834,1,0
20150106.002634,2834,2,423058,0,2833,454,2834,94,0
20150106.002636,2834,6,423064,0,2833,459,2834,93,0
20150106.002637,2834,10,423074,0,2833,458,2834,95,0
20150106.002638,2833,8,423082,0,2833,439,2834,105,0
20150106.002639,2834,60,423142,-60,2833,457,2834,66,1
20150106.002639,2833,304,423446,-104,2833,290,2834,531,0
20150106.00264,2833,44,423490,0,2833,289,2834,510,0
20150106.002641,2833,594,424084,326,2832,382,2833,243,0
20150106.002642,2833,4,424088,4,2832,367,2833,241,0
20150106.002643,2833,12,424100,0,2832,367,2833,245,0
20150106.002645,2833,2,424102,2,2832,369,2833,245,0
20150106.002646,2833,4,424106,2,2832,369,2833,261,0
20150106.002648,2832,70,424176,-70,2832,334,2833,261,0
20150106.002651,2832,4,424180,0,2832,301,2833,364,0
20150106.002656,2832,4,424184,-4,2832,334,2833,366,0
20150106.002657,2832,2,424186,-2,2832,333,2833,366,0
20150106.002659,2832,8,424194,-8,2832,327,2833,368,0
20150106.002701,2833,2,424196,2,2832,327,2833,367,1
20150106.002709,2832,4,424200,0,2832,299,2833,477,0
20150106.00271,2832,12,424212,-10,2832,293,2833,484,0
20150106.00271,2832,10,424222,-10,2832,288,2833,484,0
20150106.002711,2832,34,424256,-26,2832,273,2833,482,0
20150106.002712,2832,82,424338,-80,2832,232,2833,482,0
20150106.002712,2832,30,424368,-10,2832,218,2833,482,0
20150106.002714,2832,6,424374,-6,2832,215,2833,482,0
20150106.002715,2832,10,424384,-6,2832,212,2833,503,0
20150106.002716,2832,4,424388,-4,2832,216,2833,453,0
20150106.002716,2832,100,424488,32,2832,166,2833,454,0
20150106.002717,2832,4,424492,4,2832,165,2833,454,0
20150106.002718,2833,4,424496,2,2832,164,2833,453,1
20150106.002718,2832,8,424504,2,2832,160,2833,450,0
20150106.00272,2832,108,424612,-8,2832,106,2833,451,0
20150106.002721,2832,2,424614,2,2832,105,2833,451,0
20150106.002721,2832,6,424620,0,2832,102,2833,451,0
20150106.002722,2832,16,424636,2,2832,97,2833,451,0
20150106.002722,2832,10,424646,-6,2832,92,2833,447,0
20150106.002723,2832,2,424648,0,2832,91,2833,447,0
20150106.002723,2832,10,424658,-10,2832,87,2833,447,0
20150106.002724,2832,22,424680,-22,2832,76,2833,447,0
20150106.002725,2832,2,424682,2,2832,75,2833,449,0
20150106.002726,2832,18,424700,-4,2832,67,2833,449,0
20150106.002726,2832,20,424720,10,2832,57,2833,449,0
20150106.002727,2832,2,424722,0,2832,56,2833,450,0
20150106.002728,2832,14,424736,2,2832,57,2833,444,0
20150106.002728,2833,12,424748,12,2832,57,2833,438,1
20150106.002729,2832,10,424758,0,2832,53,2833,439,0
20150106.002729,2832,4,424762,0,2832,51,2833,439,0
20150106.00273,2832,2,424764,2,2832,51,2833,439,0
20150106.00273,2832,2,424766,0,2832,50,2833,439,0
20150106.002731,2832,2,424768,2,2832,49,2833,442,0
20150106.002732,2832,2,424770,0,2832,55,2833,443,0
20150106.002733,2833,6,424776,0,2832,66,2833,440,1
20150106.002734,2832,2,424778,2,2832,78,2833,440,0
20150106.002737,2833,2,424780,2,2832,78,2833,438,1
20150106.002741,2832,2,424782,2,2832,78,2833,417,0
20150106.002742,2832,2,424784,0,2832,77,2833,417,0
20150106.002743,2832,2,424786,2,2832,76,2833,417,0
20150106.002744,2832,40,424826,-4,2832,56,2833,430,0
20150106.002745,2833,890,425716,-158,2833,55,2834,136,1
20150106.002746,2833,10,425726,-10,2833,50,2834,175,1
20150106.002746,2833,2,425728,0,2833,49,2834,175,1
20150106.002747,2833,10,425738,0,2833,44,2834,175,1
20150106.002748,2833,4,425742,0,2833,42,2834,175,1
20150106.002748,2833,10,425752,-10,2833,37,2834,175,1
20150106.002749,2833,2,425754,0,2833,36,2834,175,1
20150106.002751,2833,20,425774,-20,2833,26,2834,176,1
20150106.002753,2833,54,425828,2,2832,75,2833,123,1
20150106.002756,2833,12,425840,12,2832,91,2833,141,1
20150106.002758,2833,2,425842,2,2832,81,2833,155,1
20150106.002802,2832,6,425848,-2,2832,85,2833,157,0
20150106.002804,2833,4,425852,4,2832,85,2833,155,1
20150106.002807,2833,4,425856,4,2832,85,2833,175,1
20150106.002808,2832,6,425862,0,2832,82,2833,178,0
20150106.002808,2832,6,425868,4,2832,79,2833,66,0
20150106.002811,2833,254,426122,-156,2833,388,2834,162,1
20150106.002812,2833,2,426124,-2,2833,839,2834,162,1
20150106.002814,2833,2,426126,0,2833,838,2834,162,1
20150106.002816,2833,2,426128,-2,2833,837,2834,162,1
20150106.002816,2833,6,426134,-6,2833,834,2834,164,1
20150106.002816,2833,2,426136,-2,2833,833,2834,166,1
20150106.002817,2833,10,426146,0,2833,828,2834,166,1
20150106.002818,2833,2,426148,0,2833,827,2834,165,1
20150106.002821,2833,20,426168,-16,2833,821,2834,185,1
20150106.002822,2834,2,426170,0,2833,821,2834,194,1
20150106.002824,2833,10,426180,-10,2833,816,2834,184,0
20150106.002826,2834,10,426190,0,2833,816,2834,182,1
20150106.00283,2833,276,426466,-262,2833,798,2834,54,0
20150106.002831,2834,108,426574,-38,2833,798,2835,372,1
20150106.002832,2835,6,426580,-2,2833,801,2835,371,1
20150106.002835,2833,4,426584,0,2833,799,2835,372,0
20150106.002836,2835,18,426602,0,2834,15,2835,364,1
20150106.002838,2835,200,426802,0,2834,40,2835,265,1
20150106.002838,2834,2,426804,-2,2834,24,2835,265,0
20150106.002839,2834,2,426806,-2,2834,24,2835,265,0
20150106.00284,2834,2,426808,-2,2834,24,2835,264,0
20150106.00284,2834,10,426818,0,2834,57,2835,264,0
20150106.002841,2834,4,426822,-4,2834,92,2835,264,0
20150106.002842,2835,20,426842,0,2834,95,2835,255,1
20150106.002845,2834,4,426846,0,2834,121,2835,255,0
20150106.002845,2834,2,426848,-2,2834,135,2835,243,0
20150106.002846,2834,10,426858,0,2834,118,2835,252,0
20150106.002846,2835,30,426888,0,2834,118,2835,237,1
20150106.002847,2835,14,426902,0,2834,118,2835,230,1
20150106.00285,2835,48,426950,-22,2834,113,2835,316,1
20150106.00285,2835,10,426960,-6,2834,115,2835,311,1
20150106.002851,2835,6,426966,-2,2834,116,2835,309,1
20150106.002851,2834,4,426970,-2,2834,116,2835,309,0
20150106.002852,2835,2,426972,0,2834,116,2835,308,1
20150106.002854,2834,10,426982,0,2834,112,2835,308,0
20150106.002857,2834,2,426984,0,2834,114,2835,322,0
20150106.002858,2834,146,427130,-146,2834,34,2835,249,0
20150106.002859,2834,2,427132,-2,2834,48,2835,394,0
20150106.002859,2834,4,427136,-4,2834,47,2835,394,0
20150106.0029,2834,120,427256,78,2833,791,2834,3,0
20150106.0029,2834,6,427262,-6,2833,791,2835,409,0
20150106.002901,2834,10,427272,10,2833,791,2835,399,0
20150106.002901,2835,64,427336,-22,2834,30,2835,375,1
20150106.002903,2834,2,427338,-2,2834,29,2835,477,0
20150106.002905,2834,2,427340,-2,2834,33,2835,477,0
20150106.002905,2834,20,427360,0,2834,24,2835,477,0
20150106.002907,2835,20,427380,0,2834,28,2835,467,1
20150106.002907,2835,4,427384,0,2834,28,2835,465,1
20150106.002908,2834,2,427386,-2,2834,27,2835,464,0
20150106.00291,2834,2,427388,0,2834,27,2835,465,0
20150106.002911,2835,24,427412,0,2834,25,2835,455,1
20150106.002911,2834,4,427416,-2,2834,23,2835,455,0
20150106.002913,2834,46,427462,-30,2833,826,2835,441,0
20150106.002914,2834,6,427468,-2,2833,827,2835,442,0
20150106.002915,2834,6,427474,0,2833,827,2835,452,0
20150106.002917,2834,2,427476,-2,2833,827,2835,386,0
20150106.002918,2834,2,427478,0,2833,827,2835,460,0
20150106.002919,2835,10,427488,0,2833,867,2835,448,1
20150106.00292,2835,70,427558,-68,2833,867,2835,456,1
20150106.002921,2835,6,427564,-2,2833,867,2835,454,1
20150106.002922,2835,300,427864,98,2834,1,2835,398,1
20150106.002924,2834,44,427908,0,2833,867,2835,433,0
20150106.002924,2834,6,427914,-6,2834,1,2835,433,0
20150106.002925,2834,8,427922,0,2833,865,2835,433,0
20150106.002926,2834,2,427924,0,2833,865,2835,433,0
20150106.002927,2834,100,428024,-92,2833,865,2835,443,0
20150106.002928,2835,2,428026,0,2833,865,2835,441,1
20150106.002929,2835,2,428028,0,2833,865,2835,455,1
20150106.00293,2834,242,428270,-82,2834,10,2835,456,0
20150106.002931,2834,22,428292,2,2833,808,2834,6,0
20150106.002931,2834,12,428304,10,2833,809,2835,456,0
20150106.002934,2834,368,428672,88,2833,676,2834,25,0
20150106.002935,2834,20,428692,0,2833,691,2835,333,0
20150106.002937,2834,12,428704,-4,2833,692,2835,296,0
20150106.002939,2834,40,428744,20,2833,694,2835,306,0
20150106.00294,2834,4,428748,0,2833,694,2835,307,0
20150106.00294,2834,4,428752,0,2833,694,2835,307,0
20150106.002941,2834,2,428754,-2,2833,694,2835,308,0
20150106.002947,2834,18,428772,-8,2834,33,2835,359,0
20150106.002949,2834,2,428774,-2,2834,33,2835,333,0
20150106.00295,2835,2,428776,2,2834,36,2835,333,1
20150106.002952,2834,90,428866,-68,2833,705,2834,55,0
20150106.003003,2835,372,429238,-106,2834,49,2835,408,1
20150106.003004,2835,24,429262,16,2834,63,2835,397,1
20150106.003004,2834,30,429292,-2,2834,49,2835,455,0
20150106.003005,2835,238,429530,18,2834,49,2835,329,1
20150106.003005,2835,70,429600,-70,2834,14,2835,295,1
20150106.003006,2834,2,429602,0,2834,15,2835,295,0
20150106.003007,2834,8,429610,-4,2834,73,2835,295,0
20150106.003008,2835,4,429614,0,2834,74,2835,292,1
20150106.00301,2835,10,429624,0,2834,79,2835,265,1
20150106.003011,2835,2,429626,0,2834,99,2835,262,1
20150106.003012,2834,184,429810,66,2834,7,2835,327,0
20150106.003013,2834,20,429830,2,2833,331,2835,342,0
20150106.003014,2834,42,429872,-40,2833,331,2834,91,0
20150106.00302,2834,8,429880,-8,2833,350,2834,149,0
20150106.003021,2834,10,429890,-10,2833,351,2834,144,0
20150106.003023,2833,10,429900,-10,2833,347,2834,146,0
20150106.003024,2834,2,429902,0,2833,347,2834,147,1
20150106.003026,2834,2,429904,-2,2833,347,2834,158,1
20150106.003029,2833,4,429908,-4,2833,344,2834,163,0
20150106.003032,2834,16,429924,-4,2833,342,2834,159,1
20150106.003032,2833,6,429930,-6,2833,339,2834,159,0
20150106.003034,2833,2,429932,0,2833,338,2834,160,0
20150106.003036,2833,2,429934,0,2833,338,2834,163,0
20150106.003037,2833,10,429944,-10,2833,334,2834,163,0
20150106.003037,2834,326,430270,56,2834,22,2835,472,1
20150106.003037,2834,2,430272,0,2834,21,2835,471,1
20150106.003038,2834,4,430276,0,2834,19,2835,471,1
20150106.003039,2834,38,430314,0,2833,334,2835,471,1
20150106.00304,2833,2,430316,-2,2833,333,2834,21,0
20150106.003041,2834,80,430396,-80,2833,293,2835,475,1
20150106.003042,2834,8,430404,-8,2834,6,2835,475,1
20150106.003042,2834,2,430406,-2,2834,55,2835,476,1
20150106.003043,2834,8,430414,0,2834,54,2835,473,1
20150106.003044,2834,2,430416,-2,2834,53,2835,482,1
20150106.003045,2834,2,430418,-2,2834,52,2835,483,1
20150106.003047,2835,24,430442,6,2834,50,2835,462,1
20150106.003051,2835,8,430450,0,2834,329,2835,449,1
20150106.003053,2835,18,430468,8,2834,345,2835,444,1
20150106.003055,2835,888,431356,-788,2835,56,2836,750,1
20150106.003056,2835,12,431368,0,2835,50,2836,748,1
20150106.003058,2835,2,431370,0,2835,60,2836,726,1
20150106.003059,2835,2,431372,-2,2835,99,2836,726,1
20150106.0031,2835,6,431378,0,2835,96,2836,726,1
20150106.0031,2835,2,431380,0,2835,95,2836,726,1
20150106.003101,2835,2,431382,-2,2835,94,2836,726,1
20150106.003101,2836,4,431386,0,2835,95,2836,724,1
20150106.003102,2836,132,431518,-88,2835,95,2836,658,1
20150106.003102,2836,104,431622,24,2835,95,2836,607,1
20150106.003103,2835,10,431632,-2,2835,92,2836,604,0
20150106.003103,2835,2,431634,0,2835,91,2836,604,0
20150106.003104,2836,38,431672,10,2835,91,2836,586,1
20150106.003104,2836,2,431674,2,2835,106,2836,585,1
20150106.003105,2836,1080,432754,-680,2835,156,2836,27,1
20150106.003106,2836,56,432810,4,2835,181,2837,315,1
20150106.003107,2836,28,432838,-4,2835,181,2837,312,1
20150106.003107,2837,2,432840,0,2835,221,2837,311,1
20150106.003108,2837,148,432988,-96,2836,9,2837,234,1
20150106.003108,2837,52,433040,-48,2836,60,2837,234,1
20150106.003109,2836,38,433078,2,2836,73,2837,205,0
20150106.003109,2836,12,433090,4,2836,71,2837,203,0
20150106.003109,2837,2,433092,0,2836,71,2837,202,1
20150106.00311,2837,2,433094,2,2836,72,2837,204,1
20150106.00311,2836,8,433102,-2,2836,71,2837,201,0
20150106.003111,2836,4,433106,-4,2836,69,2837,202,0
20150106.003112,2836,98,433204,20,2836,30,2837,180,0
20150106.003112,2836,54,433258,-20,2835,225,2837,210,0
20150106.003113,2836,2,433260,0,2835,225,2837,208,0
20150106.003113,2835,2,433262,-2,2835,224,2836,2,0
20150106.003114,2836,4,433266,0,2836,1,2837,207,1
20150106.003114,2835,8,433274,0,2835,236,2837,206,0
20150106.003115,2837,4,433278,4,2836,30,2837,204,1
20150106.003115,2836,388,433666,-122,2835,80,2836,45,0
20150106.003117,2836,4,433670,-2,2835,125,2836,26,0
20150106.003117,2836,2,433672,0,2835,125,2836,25,0
20150106.003118,2836,10,433682,0,2835,125,2836,20,0
20150106.003118,2835,324,434006,64,2834,138,2836,29,0
20150106.003119,2835,18,434024,0,2834,133,2836,53,0
20150106.003119,2836,496,434520,416,2836,4,2837,218,1
20150106.00312,2836,18,434538,-2,2835,39,2836,1,1
20150106.003121,2836,2,434540,0,2835,39,2837,90,1
20150106.003121,2836,4,434544,2,2835,39,2837,218,1
20150106.003122,2836,4,434548,2,2835,40,2837,91,1
20150106.003123,2835,106,434654,54,2834,179,2836,55,0
20150106.003123,2835,26,434680,26,2834,179,2836,94,0
20150106.003126,2835,24,434704,24,2834,184,2836,96,0
20150106.003126,2835,2,434706,2,2834,184,2836,96,0
20150106.003128,2835,50,434756,0,2834,464,2836,116,0
20150106.003129,2835,2,434758,2,2834,464,2836,166,0
20150106.00313,2835,146,434904,76,2834,464,2836,214,0
20150106.003132,2836,2,434906,0,2835,1,2836,234,1
20150106.003133,2834,12,434918,-10,2834,514,2835,6,0
20150106.003134,2835,12,434930,0,2834,514,2836,244,1
20150106.003135,2835,2,434932,2,2835,6,2836,246,1
20150106.003136,2835,12,434944,12,2834,514,2835,188,1
20150106.003136,2835,2,434946,2,2834,486,2835,198,1
20150106.003137,2835,2,434948,0,2834,488,2835,252,1
20150106.003138,2835,6,434954,-6,2834,514,2835,290,1
20150106.003139,2835,68,435022,52,2834,514,2835,271,1
20150106.00314,2834,600,435622,504,2834,215,2835,271,0
20150106.00314,2835,4,435626,4,2834,215,2835,274,1
20150106.003142,2835,10,435636,0,2834,233,2835,269,1
20150106.003143,2834,40,435676,0,2834,213,2835,269,0
20150106.003143,2834,14,435690,14,2834,207,2835,267,0
20150106.003146,2834,14,435704,4,2834,202,2835,267,0
20150106.003149,2835,14,435718,14,2834,222,2835,273,1
20150106.003154,2834,4,435722,4,2834,223,2835,331,0
20150106.003156,2834,80,435802,74,2834,228,2835,349,0
20150106.003156,2834,10,435812,0,2834,223,2835,349,0
20150106.003157,2834,6,435818,0,2834,221,2835,351,0
20150106.003158,2834,200,436018,200,2834,121,2835,251,0
20150106.003159,2834,48,436066,-36,2834,97,2835,251,0
20150106.0032,2834,34,436100,-12,2834,80,2835,253,0
20150106.003201,2834,32,436132,22,2834,64,2835,294,0
20150106.003201,2834,42,436174,36,2834,43,2835,350,0
20150106.003202,2834,86,436260,18,2833,242,2835,350,0
20150106.003202,2833,64,436324,58,2833,240,2835,321,0
20150106.003203,2834,16,436340,-10,2833,235,2834,12,1
20150106.003203,2834,2,436342,0,2833,239,2834,14,1
20150106.003204,2833,2,436344,0,2833,237,2834,23,0
20150106.003205,2834,2,436346,0,2833,237,2834,25,1
20150106.003206,2834,2,436348,0,2833,236,2834,43,1
20150106.003207,2834,4,436352,-4,2833,237,2834,44,1
20150106.003208,2834,4,436356,-2,2833,236,2834,44,1
20150106.003209,2833,2,436358,-2,2833,236,2834,47,0
20150106.00321,2833,4,436362,-4,2833,235,2834,58,0
20150106.003211,2834,2,436364,0,2833,235,2834,60,1
20150106.003212,2834,2,436366,0,2833,219,2834,60,1
20150106.003215,2833,2,436368,-2,2833,219,2834,134,0
20150106.003216,2833,10,436378,10,2833,214,2834,317,0
20150106.003218,2834,4,436382,0,2833,246,2834,323,1
20150106.003218,2833,2,436384,-2,2833,245,2834,323,0
20150106.003219,2834,2,436386,0,2833,244,2834,323,1
20150106.00322,2833,2,436388,-2,2833,243,2834,323,0
20150106.003221,2833,10,436398,0,2833,248,2834,339,0
20150106.003221,2833,2,436400,0,2833,247,2834,324,0
20150106.003222,2834,8,436408,4,2833,247,2834,321,1
20150106.003224,2833,520,436928,230,2832,143,2833,240,0
20150106.003228,2832,2,436930,2,2832,118,2833,372,0
20150106.003229,2832,38,436968,-4,2832,102,2833,368,0
20150106.003229,2832,10,436978,0,2832,97,2833,368,0
20150106.00323,2832,200,437178,146,2832,17,2833,368,0
20150106.00323,2832,4,437182,-2,2832,13,2833,367,0
20150106.003231,2832,4,437186,-4,2832,11,2833,367,0
20150106.003231,2832,4,437190,0,2832,9,2833,367,0
20150106.003232,2832,12,437202,-12,2832,3,2833,369,0
20150106.003232,2832,6,437208,-4,2831,1222,2832,2,0
20150106.003233,2832,6,437214,2,2832,32,2833,368,0
20150106.003234,2832,14,437228,0,2832,26,2833,368,0
20150106.003234,2832,2,437230,0,2832,46,2833,368,0
20150106.003235,2832,24,437254,-22,2832,35,2833,369,0
20150106.003236,2832,4,437258,0,2832,45,2833,368,0
20150106.003237,2833,2,437260,2,2832,45,2833,367,1
20150106.003237,2832,10,437270,-2,2832,43,2833,370,0
20150106.003239,2832,2,437272,-2,2832,46,2833,370,0
20150106.003239,2832,6,437278,2,2832,62,2833,380,0
20150106.003241,2832,100,437378,-24,2832,19,2833,370,0
20150106.003242,2832,2,437380,2,2832,22,2833,370,0
20150106.003243,2833,206,437586,180,2832,132,2833,371,1
20150106.003244,2832,2,437588,2,2832,133,2833,386,0
20150106.003244,2832,4,437592,4,2832,131,2833,386,0
20150106.003246,2832,20,437612,4,2832,124,2833,384,0
20150106.003249,2832,4,437616,4,2832,129,2833,387,0
20150106.00325,2833,4,437620,4,2832,130,2833,385,1
20150106.00325,2832,2,437622,0,2832,129,2833,389,0
20150106.003252,2832,2,437624,0,2832,131,2833,389,0
20150106.003252,2832,4,437628,2,2832,129,2833,389,0
20150106.003254,2832,4,437632,4,2832,129,2833,385,0
20150106.003255,2832,4,437636,2,2832,127,2833,384,0
20150106.003257,2833,8,437644,8,2832,126,2833,380,1
20150106.003258,2832,2,437646,0,2832,125,2833,381,0
20150106.003302,2833,2,437648,2,2832,129,2833,380,1
20150106.003303,2832,4,437652,0,2832,128,2833,383,0
20150106.003304,2832,80,437732,80,2832,93,2833,384,0
20150106.003305,2832,4,437736,4,2832,93,2833,384,0
20150106.003305,2832,2,437738,0,2832,92,2833,385,0
20150106.003306,2832,6,437744,4,2832,89,2833,385,0
20150106.003306,2833,4,437748,2,2832,89,2833,383,1
20150106.003307,2832,2,437750,2,2832,87,2833,382,0
20150106.003307,2832,4,437754,4,2832,85,2833,382,0
20150106.003308,2832,6,437760,4,2832,84,2833,383,0
20150106.003309,2832,2,437762,2,2832,83,2833,383,0
20150106.003309,2832,26,437788,24,2832,70,2833,383,0
20150106.00331,2832,16,437804,6,2832,67,2833,378,0
20150106.003312,2832,20,437824,-4,2832,60,2833,379,0
20150106.003312,2832,2,437826,2,2832,62,2833,379,0
20150106.003314,2833,2,437828,0,2832,67,2833,387,1
20150106.003317,2832,4,437832,2,2832,71,2833,388,0
20150106.003318,2832,2,437834,-2,2832,96,2833,388,0
20150106.003319,2832,10,437844,-8,2832,82,2833,388,0
20150106.00332,2832,4,437848,0,2832,80,2833,388,0
20150106.003321,2832,2,437850,-2,2832,80,2833,387,0
20150106.003322,2832,300,438150,-176,2832,3,2833,392,0
20150106.003323,2833,2,438152,2,2832,3,2833,391,1
20150106.003324,2832,4,438156,-2,2832,16,2833,376,0
20150106.003325,2832,2,438158,0,2832,15,2833,376,0
20150106.003325,2832,2,438160,-2,2831,1278,2832,3,0
20150106.003326,2832,6,438166,-6,2831,1280,2833,379,0
20150106.003327,2832,102,438268,80,2831,1280,2833,382,0
20150106.003328,2832,10,438278,-10,2831,1282,2833,387,0
20150106.003329,2832,2,438280,-2,2831,1282,2833,387,0
20150106.00333,2832,12,438292,-8,2831,1282,2833,385,0
20150106.003334,2832,12,438304,-8,2832,13,2833,384,0
20150106.003336,2832,10,438314,-8,2831,1279,2833,386,0
20150106.003337,2832,8,438322,0,2831,1279,2833,386,0
20150106.003338,2832,8,438330,-8,2831,1285,2833,386,0
20150106.00334,2832,30,438360,4,2831,1335,2833,386,0
20150106.00334,2831,8,438368,0,2831,1331,2833,386,0
20150106.003341,2831,2,438370,-2,2831,1331,2833,386,0
20150106.003341,2831,10,438380,8,2831,1326,2833,387,0
20150106.003342,2832,4,438384,0,2832,98,2833,387,1
20150106.003342,2832,2,438386,0,2832,98,2833,387,1
20150106.003344,2832,2,438388,0,2832,110,2833,391,1
20150106.003345,2832,4,438392,0,2832,108,2833,391,1
20150106.003349,2832,2,438394,2,2832,208,2833,410,1
20150106.003353,2833,904,439298,-136,2833,48,2834,330,1
20150106.003353,2833,6,439304,-6,2833,45,2834,330,1
20150106.003355,2833,20,439324,-20,2833,35,2834,329,1
20150106.003357,2833,10,439334,0,2833,30,2834,331,1
20150106.003359,2833,2,439336,0,2833,31,2834,331,1
20150106.0034,2833,6,439342,-6,2833,28,2834,331,1
20150106.003401,2833,24,439366,0,2833,16,2834,331,1
20150106.003402,2833,2,439368,-2,2833,18,2834,347,1
20150106.003403,2833,2,439370,0,2833,17,2834,348,1
20150106.003404,2833,38,439408,-26,2833,18,2834,358,1
20150106.003406,2833,2,439410,2,2833,17,2834,359,1
20150106.003407,2834,20,439430,0,2833,17,2834,353,1
20150106.003408,2833,2,439432,0,2833,18,2834,354,0
20150106.00341,2833,36,439468,2,2832,267,2834,356,0
20150106.00341,2833,8,439476,0,2832,267,2834,356,0
20150106.003411,2833,8,439484,-8,2832,267,2834,356,0
20150106.003418,2833,4,439488,0,2832,268,2833,105,0
20150106.003421,2833,2,439490,0,2832,254,2833,121,0
20150106.003431,2833,2,439492,-2,2832,275,2833,168,0
20150106.003432,2832,2,439494,2,2832,274,2833,168,0
20150106.003438,2832,2,439496,0,2832,279,2833,168,0
20150106.003438,2833,2,439498,0,2832,279,2833,166,1
20150106.00344,2832,2,439500,0,2832,273,2833,166,0
20150106.003443,2832,2,439502,2,2832,271,2833,175,0
20150106.003446,2833,2,439504,-2,2832,285,2833,174,1
20150106.003449,2832,10,439514,10,2832,279,2833,174,0
20150106.003449,2832,2,439516,0,2832,299,2833,174,0
20150106.003453,2832,16,439532,-2,2832,291,2833,218,0
20150106.003455,2832,4,439536,0,2832,318,2833,228,0
20150106.003456,2832,2,439538,0,2832,297,2833,228,0
20150106.003504,2832,20,439558,20,2832,288,2833,235,0
20150106.003505,2833,6,439564,-6,2832,288,2833,233,1
20150106.003512,2833,6,439570,0,2832,308,2833,233,1
20150106.003515,2832,2,439572,2,2832,308,2833,218,0
20150106.003517,2832,4,439576,0,2832,306,2833,214,0
20150106.00352,2832,2,439578,2,2832,310,2833,229,0
20150106.003521,2833,300,439878,40,2832,310,2833,79,1
20150106.003522,2832,160,440038,46,2832,324,2834,318,0
20150106.003522,2833,20,440058,20,2832,325,2834,318,1
20150106.00353,2833,14,440072,-2,2833,109,2834,302,1
20150106.00355,2833,2,440074,-2,2833,642,2834,189,1
20150106.003552,2833,2,440076,-2,2833,641,2834,189,1
20150106.003554,2834,2,440078,0,2833,641,2834,189,1
20150106.003554,2833,2,440080,-2,2833,640,2834,189,0
20150106.003556,2834,42,440122,32,2833,640,2834,168,1
20150106.003556,2834,24,440146,-24,2833,640,2834,158,1
20150106.0036,2834,2,440148,-2,2833,640,2834,165,1
20150106.003601,2834,2,440150,0,2833,640,2834,164,1
20150106.003601,2833,2,440152,0,2833,639,2834,178,0
20150106.003602,2834,2,440154,-2,2833,639,2834,178,1
20150106.003603,2834,4,440158,0,2833,639,2834,189,1
20150106.003609,2833,18,440176,8,2833,630,2834,192,0
20150106.003611,2834,2,440178,0,2833,630,2834,191,1
20150106.003614,2833,2,440180,0,2833,629,2834,193,0
20150106.003622,2833,2,440182,2,2833,632,2834,215,0
20150106.003622,2833,6,440188,0,2833,630,2834,215,0
20150106.003623,2834,4,440192,-4,2833,628,2834,214,1
20150106.00363,2834,18,440210,-10,2833,624,2834,217,1
20150106.003632,2834,80,440290,28,2833,624,2834,178,1
20150106.003633,2834,80,440370,26,2833,624,2834,138,1
20150106.003634,2834,80,440450,64,2833,624,2834,99,1
20150106.003637,2834,72,440522,70,2833,594,2834,78,1
20150106.003638,2834,4,440526,4,2833,694,2834,76,1
20150106.003639,2834,2,440528,2,2833,694,2834,77,1
20150106.00364,2833,2,440530,0,2833,693,2834,77,0
20150106.003644,2833,16,440546,16,2833,686,2834,171,0
20150106.003646,2834,20,440566,18,2833,686,2834,161,1
20150106.003647,2833,2,440568,0,2833,725,2834,161,0
20150106.003648,2834,2,440570,0,2833,725,2834,160,1
20150106.003649,2833,6,440576,6,2833,723,2834,169,0
20150106.00365,2834,8,440584,0,2833,723,2834,167,1
20150106.00365,2834,28,440612,-24,2833,723,2834,153,1
20150106.00365,2834,144,440756,-114,2833,723,2834,81,1
20150106.003651,2833,2,440758,2,2833,723,2834,101,0
20150106.003652,2834,42,440800,0,2833,743,2834,80,1
20150106.003652,2834,18,440818,0,2833,720,2834,79,1
20150106.003653,2834,110,440928,12,2833,720,2834,24,1
20150106.003654,2834,8,440936,0,2833,819,2834,12,1
20150106.003655,2834,24,440960,20,2834,30,2835,233,1
20150106.003656,2834,2,440962,0,2834,169,2835,197,1
20150106.003656,2834,2,440964,2,2834,169,2835,197,1
20150106.0037,2834,10,440974,0,2834,181,2835,181,1
20150106.003703,2834,2,440976,2,2834,185,2835,182,1
20150106.003703,2835,2,440978,0,2834,185,2835,181,1
20150106.003704,2835,4,440982,0,2834,195,2835,179,1
20150106.003708,2835,2,440984,0,2834,196,2835,263,1
20150106.003708,2835,2,440986,2,2834,196,2835,262,1
20150106.003709,2835,8,440994,8,2834,194,2835,261,1
20150106.00371,2835,200,441194,142,2834,180,2835,175,1
20150106.003711,2835,2,441196,0,2834,204,2835,175,1
20150106.003712,2835,2,441198,0,2834,203,2835,219,1
20150106.003713,2835,12,441210,2,2834,202,2835,282,1
20150106.003714,2835,2,441212,-2,2834,202,2835,296,1
20150106.003714,2835,2,441214,0,2834,202,2835,295,1
20150106.003715,2835,2,441216,0,2834,202,2835,295,1
20150106.003716,2835,12,441228,4,2834,231,2835,290,1
20150106.003717,2835,36,441264,-28,2834,231,2835,276,1
20150106.003718,2835,38,441302,2,2834,231,2835,257,1
20150106.003719,2834,2,441304,2,2834,218,2835,317,0
20150106.00372,2835,30,441334,0,2834,219,2835,302,1
20150106.00372,2835,2,441336,-2,2834,219,2835,301,1
20150106.003721,2835,2,441338,0,2834,220,2835,285,1
20150106.003721,2835,2,441340,0,2834,220,2835,299,1
20150106.003722,2835,40,441380,2,2834,222,2835,279,1
20150106.003723,2835,598,441978,-52,2835,201,2836,255,1
20150106.003724,2835,8,441986,-8,2835,297,2836,231,1
20150106.003724,2836,28,442014,6,2835,287,2836,227,1
20150106.003726,2836,4,442018,0,2835,302,2836,227,1
20150106.003727,2836,2,442020,2,2835,312,2836,226,1
20150106.003728,2836,2,442022,2,2835,313,2836,225,1
20150106.003729,2836,2,442024,2,2835,313,2836,225,1
20150106.00373,2836,4,442028,0,2835,313,2836,242,1
20150106.003731,2835,8,442036,0,2835,315,2836,244,0
20150106.003731,2836,2,442038,2,2835,315,2836,243,1
20150106.003735,2835,46,442084,0,2835,295,2836,254,0
20150106.003736,2836,6,442090,4,2835,297,2836,264,1
20150106.003738,2836,2,442092,-2,2835,297,2836,277,1
20150106.003739,2836,2,442094,0,2835,297,2836,276,1
20150106.00374,2836,18,442112,0,2835,296,2836,269,1
20150106.00374,2836,6,442118,0,2835,296,2836,266,1
20150106.003744,2835,2,442120,0,2835,296,2836,299,0
20150106.003745,2836,2,442122,0,2835,317,2836,306,1
20150106.003746,2836,2,442124,-2,2835,317,2836,304,1
20150106.003746,2836,2,442126,0,2835,317,2836,303,1
20150106.003748,2835,14,442140,-14,2835,310,2836,305,0
20150106.003749,2836,26,442166,-26,2835,310,2836,293,1
20150106.003749,2836,6,442172,0,2835,310,2836,292,1
20150106.00375,2835,12,442184,0,2835,309,2836,276,0
20150106.003751,2836,2,442186,0,2835,309,2836,278,1
20150106.003753,2835,2,442188,0,2835,308,2836,283,0
20150106.003753,2836,6,442194,-4,2835,308,2836,280,1
20150106.003754,2836,2,442196,-2,2835,310,2836,279,1
20150106.003755,2836,2,442198,0,2835,305,2836,323,1
20150106.003758,2835,2,442200,0,2835,305,2836,320,0
20150106.003759,2836,2,442202,0,2835,377,2836,319,1
20150106.003759,2836,2,442204,0,2835,378,2836,318,1
20150106.0038,2835,2,442206,0,2835,378,2836,319,0
20150106.003801,2835,100,442306,0,2835,328,2836,328,0
20150106.003802,2836,4,442310,0,2835,328,2836,461,1
20150106.003803,2835,2,442312,0,2835,327,2836,452,0
20150106.003804,2836,8,442320,2,2835,328,2836,451,1
20150106.003806,2835,14,442334,0,2835,319,2836,451,0
20150106.003807,2835,2,442336,0,2835,324,2836,462,0
20150106.003807,2836,4,442340,4,2835,324,2836,460,1
20150106.003808,2835,4,442344,0,2835,323,2836,459,0
20150106.003809,2836,906,443250,804,2835,323,2837,192,1
20150106.00381,2836,24,443274,-12,2835,321,2837,433,1
20150106.00381,2836,2,443276,0,2835,321,2837,433,1
20150106.003811,2836,42,443318,-40,2835,329,2837,433,1
20150106.003811,2836,2,443320,-2,2835,330,2837,433,1
20150106.003812,2835,108,443428,-24,2835,329,2837,396,0
20150106.003813,2835,16,443444,-4,2835,321,2837,396,0
20150106.003813,2835,2,443446,-2,2835,335,2837,487,0
20150106.003814,2836,30,443476,0,2836,19,2837,491,1
20150106.003814,2836,42,443518,0,2835,330,2837,478,1
20150106.003815,2836,2,443520,2,2836,7,2837,478,1
20150106.003815,2836,14,443534,0,2835,346,2837,478,1
20150106.003817,2835,8,443542,-2,2835,320,2836,1,0
20150106.003817,2836,20,443562,0,2835,320,2836,17,1
20150106.003818,2836,2,443564,0,2835,321,2836,22,1
20150106.003819,2836,368,443932,214,2835,125,2836,24,1
20150106.00382,2836,54,443986,48,2836,20,2837,372,1
20150106.00382,2836,42,444028,2,2835,165,2837,243,1
20150106.003821,2835,14,444042,14,2835,159,2837,372,0
20150106.003822,2836,10,444052,10,2835,172,2836,1,1
20150106.003823,2835,258,444310,40,2835,55,2836,42,0
20150106.003825,2836,46,444356,28,2835,33,2836,67,1
20150106.003825,2836,2,444358,2,2835,34,2836,66,1
20150106.003826,2836,22,444380,22,2835,46,2836,54,1
20150106.003827,2835,4,444384,0,2835,48,2836,56,0
20150106.003829,2836,2,444386,2,2835,55,2836,69,1
20150106.003835,2835,2,444388,0,2835,397,2836,70,0
20150106.003835,2835,2,444390,0,2835,396,2836,69,0
20150106.003836,2836,4,444394,0,2835,398,2836,61,1
20150106.003836,2836,4,444398,4,2835,398,2836,59,1
20150106.003837,2836,10,444408,6,2835,399,2836,54,1
20150106.003837,2836,6,444414,-2,2835,399,2836,50,1
20150106.003838,2836,102,444516,96,2836,50,2837,396,1
20150106.003838,2836,2,444518,0,2836,50,2837,396,1
20150106.003839,2836,100,444618,26,2835,399,2837,396,1
20150106.003839,2835,20,444638,-20,2835,390,2837,398,0
20150106.00384,2837,24,444662,12,2835,392,2837,387,1
20150106.00384,2836,6,444668,-4,2836,9,2837,387,0
20150106.003841,2836,18,444686,-18,2835,391,2837,263,0
20150106.003843,2836,4,444690,2,2835,392,2836,1,0
20150106.003843,2836,2,444692,0,2835,392,2837,265,0
20150106.003844,2836,4,444696,4,2835,392,2837,265,0
20150106.003845,2836,2,444698,2,2835,392,2836,287,0
20150106.003849,2836,2,444700,2,2835,388,2836,320,0
20150106.003849,2835,4,444704,-4,2835,386,2836,320,0
20150106.003851,2836,12,444716,12,2835,390,2836,291,1
20150106.003851,2835,2,444718,0,2835,389,2836,292,0
20150106.003852,2836,6,444724,2,2835,389,2836,290,1
20150106.003853,2835,12,444736,0,2835,383,2836,291,0
20150106.003857,2835,2,444738,-2,2835,382,2836,320,0
20150106.0039,2836,40,444778,0,2835,384,2836,308,1
20150106.003901,2835,138,444916,-62,2835,315,2836,322,0
20150106.003905,2835,10,444926,10,2835,315,2836,338,0
20150106.003905,2835,4,444930,4,2835,313,2836,336,0
20150106.003906,2835,2,444932,0,2835,308,2836,348,0
20150106.003906,2835,86,445018,6,2835,265,2836,346,0
20150106.003907,2835,82,445100,0,2835,224,2836,346,0
20150106.003907,2835,86,445186,6,2835,181,2836,345,0
20150106.003908,2835,20,445206,20,2835,171,2836,356,0
20150106.003909,2835,4,445210,2,2835,167,2836,356,0
20150106.003909,2835,2,445212,0,2835,166,2836,359,0
20150106.00391,2835,2,445214,2,2835,165,2836,359,0
20150106.00391,2835,46,445260,0,2835,162,2836,361,0
20150106.003911,2835,40,445300,0,2835,142,2836,361,0
20150106.003912,2835,16,445316,2,2835,134,2836,361,0
20150106.003912,2835,4,445320,0,2835,132,2836,361,0
20150106.003913,2835,4,445324,4,2835,131,2836,312,0
20150106.003914,2835,10,445334,10,2835,126,2836,212,0
20150106.003915,2835,22,445356,2,2835,115,2836,211,0
20150106.003916,2835,2,445358,2,2835,105,2836,210,0
20150106.003917,2835,2,445360,0,2835,104,2836,210,0
20150106.003919,2835,4,445364,0,2835,102,2836,221,0
20150106.00392,2835,2,445366,0,2835,101,2836,221,0
20150106.00392,2835,24,445390,24,2835,89,2836,201,0
20150106.00392,2835,20,445410,20,2835,79,2836,191,0
20150106.003921,2835,22,445432,22,2835,70,2836,191,0
20150106.003922,2835,2,445434,0,2835,69,2836,192,0
20150106.003922,2835,4,445438,4,2835,67,2836,192,0
20150106.003923,2835,2,445440,2,2835,66,2836,192,0
20150106.003924,2835,100,445540,80,2835,17,2836,192,0
20150106.003924,2835,34,445574,32,2834,106,2836,207,0
20150106.003932,2835,4,445578,0,2834,123,2835,8,0
20150106.003935,2835,2,445580,0,2834,145,2835,9,0
20150106.003938,2834,4,445584,4,2834,128,2835,171,0
20150106.003941,2835,2,445586,0,2834,129,2835,178,1
20150106.003943,2834,2,445588,2,2834,128,2835,179,0
20150106.003945,2834,2,445590,0,2834,127,2835,199,0
20150106.00395,2834,2,445592,2,2834,138,2835,195,0
20150106.003953,2834,2,445594,0,2834,137,2835,207,0
20150106.003956,2834,4,445598,0,2834,135,2835,209,0
20150106.003958,2835,40,445638,-4,2834,135,2835,241,1
20150106.003959,2834,2,445640,2,2834,135,2835,251,0
20150106.004,2834,2,445642,0,2834,134,2835,253,0
20150106.004001,2835,18,445660,18,2834,141,2835,244,1
20150106.004004,2834,2,445662,0,2834,150,2835,244,0
20150106.004006,2834,2,445664,0,2834,149,2835,244,0
20150106.004008,2835,2,445666,0,2834,151,2835,242,1
20150106.004011,2834,94,445760,-12,2834,115,2835,242,0
20150106.004012,2835,8,445768,8,2834,114,2835,240,1
20150106.004015,2835,20,445788,14,2834,138,2835,102,1
20150106.004015,2835,20,445808,8,2834,138,2835,92,1
20150106.004016,2835,92,445900,38,2834,138,2835,46,1
20150106.004017,2835,2,445902,0,2834,138,2835,48,1
20150106.004017,2835,2,445904,2,2834,138,2835,47,1
20150106.00402,2835,94,445998,-10,2834,150,2836,385,1
20150106.004023,2835,2,446000,2,2835,3,2836,385,1
20150106.004025,2835,2,446002,2,2835,2,2836,385,1
20150106.004029,2835,2,446004,2,2835,50,2836,382,1
20150106.004031,2836,230,446234,136,2835,56,2836,256,1
20150106.004034,2836,242,446476,-36,2835,98,2837,191,1
20150106.004035,2836,40,446516,20,2835,124,2837,191,1
20150106.004035,2836,8,446524,8,2835,124,2837,191,1
20150106.004036,2836,2,446526,2,2835,125,2837,191,1
20150106.004038,2836,4,446530,4,2835,149,2836,67,1
20150106.004039,2836,80,446610,80,2835,150,2837,194,1
20150106.00404,2835,4,446614,-2,2835,150,2836,38,0
20150106.004041,2836,2,446616,0,2835,151,2836,34,1
20150106.004043,2836,2,446618,2,2835,151,2836,32,1
20150106.004044,2836,64,446682,64,2836,8,2837,356,1
20150106.004044,2836,22,446704,0,2836,4,2837,357,1
20150106.004045,2836,12,446716,-2,2835,154,2837,357,1
20150106.004046,2837,2,446718,0,2835,160,2837,367,1
20150106.004047,2836,4,446722,-2,2835,187,2837,195,0
20150106.004048,2836,6,446728,0,2835,185,2837,195,0
20150106.004049,2836,20,446748,0,2835,202,2837,195,0
20150106.00405,2836,20,446768,20,2835,202,2837,196,0
20150106.004051,2836,348,447116,244,2836,328,2837,378,0
20150106.004053,2836,8,447124,8,2836,339,2837,349,0
20150106.004054,2836,384,447508,356,2836,148,2837,172,0
20150106.004055,2837,446,447954,-382,2836,156,2837,49,1
20150106.004056,2837,8,447962,4,2836,157,2837,45,1
20150106.004056,2837,112,448074,92,2836,157,2838,1164,1
20150106.004057,2836,4,448078,-2,2836,156,2838,1018,0
20150106.004057,2837,4,448082,0,2836,211,2838,1018,1
20150106.004058,2837,12,448094,0,2836,213,2838,1018,1
20150106.0041,2837,34,448128,12,2836,208,2837,104,1
20150106.004101,2837,2,448130,0,2836,208,2837,116,1
20150106.004101,2837,20,448150,20,2836,208,2837,107,1
20150106.004102,2837,4,448154,2,2836,209,2837,105,1
20150106.004103,2837,134,448288,6,2836,203,2838,1023,1
20150106.004103,2837,6,448294,-2,2836,203,2838,1023,1
20150106.004104,2837,20,448314,-18,2836,203,2838,1023,1
20150106.004105,2838,2,448316,0,2836,212,2837,2,1
20150106.004105,2838,38,448354,20,2837,175,2838,1143,1
20150106.004106,2838,70,448424,-6,2837,180,2838,1112,1
20150106.004106,2837,2022,450446,-656,2837,184,2839,628,0
20150106.004107,2837,210,450656,-196,2837,80,2838,8,0
20150106.004107,2838,124,450780,0,2838,1,2839,755,1
20150106.004108,2839,12,450792,-10,2837,53,2838,3,1
20150106.004108,2839,26,450818,-2,2837,42,2839,745,1
20150106.004109,2839,52,450870,-4,2838,11,2839,714,1
20150106.004109,2838,26,450896,2,2837,129,2839,586,0
20150106.00411,2838,20,450916,0,2837,129,2838,182,0
20150106.00411,2838,2,450918,2,2837,105,2838,183,0
20150106.004111,2838,4,450922,0,2837,93,2838,193,0
20150106.004112,2838,2,450924,0,2837,93,2838,191,0
20150106.004112,2838,14,450938,4,2837,93,2838,186,0
20150106.004113,2837,2,450940,0,2837,42,2838,189,0
20150106.004114,2838,24,450964,-10,2837,57,2838,183,1
20150106.004115,2838,4,450968,2,2837,42,2838,182,1
20150106.004115,2837,98,451066,-70,2836,291,2837,32,0
20150106.004116,2837,8,451074,0,2836,291,2837,28,0
20150106.004116,2837,2,451076,0,2836,291,2837,77,0
20150106.004117,2838,164,451240,-152,2836,291,2838,145,1
20150106.004118,2837,2,451242,2,2836,291,2837,4,0
20150106.004118,2837,10,451252,-2,2837,180,2838,131,0
20150106.004119,2838,2,451254,0,2837,197,2838,130,1
20150106.004119,2837,4,451258,4,2837,195,2838,130,0
20150106.004121,2838,10,451268,2,2837,245,2838,128,1
20150106.004121,2837,2,451270,0,2837,245,2838,129,0
20150106.004122,2838,4,451274,-4,2837,245,2838,146,1
20150106.004125,2837,190,451464,190,2837,70,2838,310,0
20150106.004125,2838,14,451478,-4,2837,55,2838,303,1
20150106.004126,2837,4,451482,0,2837,58,2838,302,0
20150106.004127,2838,638,452120,-112,2838,682,2839,867,1
20150106.004127,2838,400,452520,0,2838,484,2839,667,1
20150106.004128,2838,2,452522,-2,2838,498,2839,665,1
20150106.004128,2839,62,452584,-18,2838,498,2839,694,1
20150106.004129,2838,6,452590,-2,2838,497,2839,694,0
20150106.00413,2839,12,452602,-8,2838,497,2839,688,1
20150106.00413,2838,2,452604,-2,2838,496,2839,688,0
20150106.004131,2839,30,452634,0,2838,496,2839,673,1
20150106.004131,2838,10,452644,0,2838,492,2839,669,0
20150106.004132,2838,2,452646,0,2838,495,2839,669,0
20150106.004132,2839,4,452650,0,2838,495,2839,667,1
20150106.004133,2839,8,452658,8,2838,494,2839,665,1
20150106.004133,2839,2,452660,2,2838,494,2839,665,1
20150106.004134,2839,4,452664,4,2838,481,2839,667,1
20150106.004134,2839,18,452682,18,2838,481,2839,659,1
20150106.004135,2839,6,452688,4,2838,481,2839,656,1
20150106.004136,2839,4,452692,4,2838,481,2839,655,1
20150106.004136,2839,6,452698,4,2838,480,2839,654,1
20150106.004137,2838,14,452712,2,2838,477,2839,651,0
20150106.004138,2839,2,452714,0,2838,477,2839,652,1
20150106.004138,2838,6,452720,-4,2838,474,2839,652,0
20150106.00414,2839,184,452904,-176,2838,384,2839,652,1
20150106.00414,2839,2,452906,2,2838,385,2839,652,1
20150106.004141,2838,4,452910,0,2838,385,2839,603,0
20150106.004142,2839,2,452912,2,2838,385,2839,602,1
20150106.004142,2839,2,452914,0,2838,385,2839,603,1
20150106.004143,2838,20,452934,-10,2838,375,2839,603,0
20150106.004144,2838,10,452944,0,2838,374,2839,603,0
20150106.004144,2839,8,452952,0,2838,368,2839,600,1
20150106.004145,2838,22,452974,-2,2838,367,2839,590,0
20150106.004146,2838,200,453174,0,2838,298,2839,592,0
20150106.004146,2838,2,453176,0,2838,297,2839,592,0
20150106.004147,2839,2,453178,2,2838,297,2839,591,1
20150106.004148,2839,6,453184,2,2838,316,2839,609,1
20150106.004148,2838,2,453186,0,2838,319,2839,589,0
20150106.004149,2838,6,453192,-6,2838,316,2839,589,0
20150106.004149,2838,2,453194,0,2838,314,2839,576,0
20150106.00415,2839,10,453204,0,2838,314,2839,566,1
20150106.004151,2838,2,453206,0,2838,316,2839,567,0
20150106.004152,2838,2,453208,-2,2838,315,2839,563,0
20150106.004153,2838,10,453218,0,2838,310,2839,553,0
20150106.004154,2839,2,453220,0,2838,785,2839,543,1
20150106.004155,2839,30,453250,14,2838,792,2839,528,1
20150106.004157,2839,2,453252,2,2838,792,2839,533,1
20150106.004157,2839,4,453256,0,2838,792,2839,531,1
20150106.004159,2839,4,453260,0,2838,793,2839,529,1
20150106.004159,2839,2,453262,2,2838,795,2839,531,1
20150106.0042,2839,8,453270,4,2838,795,2839,527,1
20150106.0042,2839,4,453274,4,2838,795,2839,527,1
20150106.004201,2839,6,453280,2,2838,795,2839,525,1
20150106.004202,2838,400,453680,0,2838,589,2839,529,0
20150106.004203,2839,16,453696,6,2838,593,2839,521,1
20150106.004203,2839,2,453698,-2,2838,593,2839,521,1
20150106.004204,2839,152,453850,-36,2838,514,2839,533,1
20150106.004204,2839,6,453856,0,2838,1018,2839,532,1
20150106.004205,2839,2,453858,0,2838,1019,2839,531,1
20150106.004206,2839,60,453918,-40,2838,1019,2839,501,1
20150106.004206,2839,1004,454922,374,2838,1019,2840,1043,1
20150106.004207,2839,2,454924,2,2839,2,2840,1048,1
20150106.004207,2839,4,454928,-2,2839,3,2840,1053,1
20150106.004208,2839,96,455024,36,2839,19,2840,1016,1
20150106.004208,2839,38,455062,2,2838,1037,2839,4,1
20150106.004209,2839,12,455074,-10,2838,1038,2840,1019,1
20150106.004209,2839,80,455154,4,2839,478,2840,1019,1
20150106.00421,2839,38,455192,-2,2839,545,2840,1007,1
20150106.00421,2839,16,455208,0,2839,537,2840,1010,1
20150106.004211,2839,48,455256,-32,2839,524,2840,988,1
20150106.004211,2839,4,455260,0,2839,527,2840,986,1
20150106.004212,2840,1002,456262,944,2839,542,2840,489,1
20150106.004212,2841,1174,457436,402,2840,74,2842,640,1
20150106.004213,2842,426,457862,-334,2840,26,2842,579,1
20150106.004213,2841,114,457976,-46,2840,38,2841,6,0
20150106.004214,2840,252,458228,86,2839,570,2841,20,0
20150106.004214,2842,142,458370,-10,2840,78,2841,24,1
20150106.004215,2841,10,458380,2,2840,79,2841,11,0
20150106.004216,2841,10,458390,-4,2840,79,2841,6,0
20150106.004216,2841,14,458404,-4,2840,79,2842,573,0
20150106.004217,2841,8,458412,-4,2840,103,2842,561,0
20150106.004217,2840,12,458424,-6,2840,101,2842,564,0
20150106.004218,2842,78,458502,-34,2840,101,2842,633,1
20150106.004219,2841,184,458686,-24,2840,114,2842,624,0
20150106.004219,2840,26,458712,-22,2840,102,2841,1,0
20150106.00422,2842,612,459324,-400,2840,101,2842,324,1
20150106.00422,2841,640,459964,144,2840,101,2843,116,0
20150106.004221,2841,4,459968,-2,2841,71,2843,116,0
20150106.004222,2841,30,459998,28,2841,94,2842,43,0
20150106.004222,2842,118,460116,-10,2841,79,2843,222,1
20150106.004223,2842,6,460122,0,2841,103,2843,221,1
20150106.004223,2842,10,460132,0,2841,92,2842,11,1
20150106.004224,2843,28,460160,-2,2842,7,2843,217,1
20150106.004224,2842,18,460178,0,2841,93,2842,4,0
20150106.004225,2841,16,460194,0,2841,86,2842,7,0
20150106.004226,2842,42,460236,-6,2841,88,2842,3,1
20150106.004226,2842,26,460262,-10,2841,88,2842,1,1
20150106.004227,2842,24,460286,-10,2841,80,2842,7,1
20150106.004228,2842,10,460296,4,2841,93,2842,5,1
20150106.004229,2842,22,460318,2,2841,84,2842,8,1
20150106.004229,2842,2,460320,0,2841,95,2842,17,1
20150106.00423,2842,2,460322,0,2841,96,2842,24,1
20150106.004231,2841,22,460344,12,2841,91,2842,27,0
20150106.004231,2841,12,460356,0,2841,89,2842,32,0
20150106.004231,2842,16,460372,2,2841,89,2842,31,1
20150106.004232,2842,2,460374,0,2841,89,2842,35,1
20150106.004233,2841,2,460376,0,2841,89,2842,40,0
20150106.004233,2842,4,460380,0,2841,89,2842,42,1
20150106.004234,2841,2,460382,0,2841,92,2842,43,0
20150106.004234,2841,18,460400,0,2841,83,2842,43,0
20150106.004235,2841,2,460402,2,2841,83,2842,44,0
20150106.004235,2841,406,460808,66,2841,81,2842,45,0
20150106.004236,2841,10,460818,2,2841,76,2842,48,0
20150106.004237,2842,12,460830,-12,2841,88,2842,49,1
20150106.004238,2841,214,461044,146,2840,596,2841,617,0
20150106.004239,2841,2,461046,0,2840,596,2841,618,0
20150106.00424,2841,40,461086,-4,2840,584,2841,610,0
20150106.00424,2841,2,461088,2,2840,584,2841,609,0
20150106.004241,2841,2,461090,0,2840,585,2841,609,0
20150106.004241,2840,40,461130,-38,2840,565,2841,609,0
20150106.004242,2841,10,461140,10,2840,565,2841,604,1
20150106.004243,2840,8,461148,4,2840,564,2841,601,0
20150106.004243,2841,4,461152,2,2840,557,2841,601,1
20150106.004244,2841,30,461182,30,2840,557,2841,586,1
20150106.004244,2841,240,461422,200,2840,557,2841,466,1
20150106.004245,2840,4,461426,-4,2840,556,2841,471,0
20150106.004245,2840,62,461488,44,2840,540,2841,473,0
20150106.004246,2840,4,461492,0,2840,538,2841,479,0
20150106.004246,2840,6,461498,0,2840,548,2841,479,0
20150106.004247,2841,6,461504,2,2840,546,2841,478,1
20150106.004248,2841,10,461514,10,2840,546,2841,479,1
20150106.004249,2840,6,461520,4,2840,543,2841,479,0
20150106.004249,2841,2,461522,2,2840,544,2841,478,1
20150106.00425,2840,56,461578,0,2840,516,2841,30,0
20150106.004251,2840,22,461600,14,2840,515,2841,35,0
20150106.004252,2841,58,461658,38,2840,535,2841,7,1
20150106.004252,2841,44,461702,-24,2841,14,2842,118,1
20150106.004253,2841,6,461708,6,2841,14,2842,148,1
20150106.004253,2841,2,461710,2,2841,3,2842,179,1
20150106.004254,2841,10,461720,6,2840,536,2841,2,1
20150106.004254,2841,8,461728,-2,2841,2,2842,179,1
20150106.004255,2841,2,461730,2,2841,2,2842,190,1
20150106.004256,2841,2,461732,0,2841,2,2842,241,1
20150106.004257,2841,64,461796,0,2840,540,2841,9,1
20150106.004258,2841,38,461834,28,2840,527,2841,4,1
20150106.004258,2841,144,461978,-108,2841,26,2842,165,1
20150106.004259,2841,6,461984,-4,2841,9,2842,181,1
20150106.004259,2840,20,462004,-16,2840,526,2842,182,0
20150106.0043,2841,12,462016,2,2841,14,2842,171,1
20150106.004301,2840,6,462022,4,2840,521,2841,10,0
20150106.004301,2840,200,462222,0,2840,406,2841,13,0
20150106.004302,2841,36,462258,22,2840,421,2841,6,1
20150106.004303,2841,10,462268,10,2840,421,2841,1,1
20150106.004303,2841,2,462270,2,2840,421,2841,1,1
20150106.004304,2841,2,462272,2,2840,421,2841,1,1
20150106.004304,2840,30,462302,30,2840,406,2841,2,0
20150106.004305,2841,4,462306,2,2841,17,2842,188,1
20150106.004305,2841,6,462312,6,2841,21,2842,188,1
20150106.004306,2841,42,462354,42,2840,407,2841,91,1
20150106.004306,2840,30,462384,28,2840,394,2841,90,0
20150106.004307,2840,4,462388,0,2840,392,2841,93,0
20150106.004307,2840,204,462592,2,2840,291,2841,92,0
20150106.004308,2841,6,462598,2,2840,290,2841,91,1
20150106.004308,2840,4,462602,2,2840,289,2841,106,0
20150106.004309,2840,8,462610,8,2840,287,2841,122,0
20150106.00431,2841,30,462640,30,2840,288,2841,109,1
20150106.004312,2840,206,462846,4,2840,187,2841,125,0
20150106.004314,2840,16,462862,0,2840,195,2841,138,0
20150106.004314,2841,4,462866,4,2840,195,2841,137,1
20150106.004315,2841,4,462870,4,2840,195,2841,135,1
20150106.004315,2840,4,462874,4,2840,193,2841,136,0
20150106.004316,2840,8,462882,0,2840,190,2841,140,0
20150106.004317,2841,2,462884,2,2840,192,2841,139,1
20150106.004317,2841,26,462910,4,2840,192,2841,130,1
20150106.004318,2840,8,462918,8,2840,188,2841,130,0
20150106.004319,2841,2,462920,2,2840,188,2841,130,1
20150106.004321,2840,18,462938,0,2840,254,2841,142,0
20150106.004322,2840,10,462948,10,2840,237,2841,142,0
20150106.004323,2840,20,462968,16,2840,255,2841,137,0
20150106.004324,2841,2,462970,2,2840,254,2841,138,1
20150106.004325,2840,4,462974,2,2840,262,2841,138,0
20150106.004326,2840,2,462976,0,2840,261,2841,139,0
20150106.004326,2841,4,462980,4,2840,261,2841,138,1
20150106.004328,2841,2,462982,2,2840,281,2841,137,1
20150106.004328,2841,2,462984,0,2840,281,2841,138,1
20150106.004329,2840,200,463184,-8,2840,166,2841,163,0
20150106.004331,2841,20,463204,20,2840,182,2841,139,1
20150106.004331,2840,12,463216,2,2840,179,2841,138,0
20150106.004332,2841,140,463356,66,2840,179,2841,68,1
20150106.004334,2841,2,463358,0,2840,189,2841,68,1
20150106.004335,2840,4,463362,0,2840,195,2841,146,0
20150106.004336,2840,24,463386,-2,2840,185,2841,146,0
20150106.004337,2840,6,463392,0,2840,167,2841,162,0
20150106.004337,2841,2,463394,0,2840,182,2841,146,1
20150106.004338,2840,2,463396,2,2840,181,2841,146,0
20150106.004338,2840,4,463400,0,2840,179,2841,149,0
20150106.004339,2841,62,463462,14,2840,179,2841,118,1
20150106.004339,2840,2,463464,2,2840,178,2841,118,0
20150106.00434,2841,2,463466,0,2840,178,2841,117,1
20150106.004344,2841,10,463476,6,2840,180,2841,163,1
20150106.004345,2840,4,463480,4,2840,178,2841,163,0
20150106.004345,2841,4,463484,2,2840,175,2841,162,1
20150106.004346,2840,2,463486,2,2840,175,2841,163,0
20150106.004349,2840,4,463490,4,2840,155,2841,180,0
20150106.00435,2841,22,463512,4,2840,151,2841,189,1
20150106.004352,2840,28,463540,0,2840,151,2841,284,0
20150106.004353,2840,4,463544,0,2840,159,2841,286,0
20150106.004354,2840,2,463546,2,2840,158,2841,286,0
20150106.004355,2840,16,463562,12,2840,160,2841,279,0
20150106.004356,2840,6,463568,6,2840,161,2841,281,0
20150106.004357,2840,2,463570,0,2840,161,2841,281,0
20150106.004357,2841,10,463580,-6,2840,161,2841,276,1
20150106.004358,2840,4,463584,4,2840,159,2841,276,0
20150106.004359,2840,22,463606,22,2840,135,2841,391,0
20150106.0044,2841,2,463608,0,2840,135,2841,390,1
20150106.004401,2840,2,463610,0,2840,145,2841,392,0
20150106.004401,2840,100,463710,0,2840,95,2841,392,0
20150106.004402,2840,100,463810,80,2840,45,2841,392,0
20150106.004402,2840,2,463812,2,2840,44,2841,394,0
20150106.004403,2840,32,463844,-4,2840,39,2841,395,0
20150106.004403,2840,6,463850,-2,2840,36,2841,395,0
20150106.004404,2840,4,463854,-4,2840,36,2841,396,0
20150106.004405,2840,6,463860,-4,2840,34,2841,396,0
20150106.004405,2840,50,463910,2,2840,9,2841,396,0
20150106.004406,2840,4,463914,4,2839,973,2841,396,0
20150106.004406,2840,2,463916,0,2839,973,2841,399,0
20150106.004407,2840,6,463922,0,2840,358,2841,384,0
20150106.004408,2840,8,463930,-2,2840,449,2841,381,0
20150106.004409,2840,4,463934,-4,2840,448,2841,385,0
20150106.00441,2840,20,463954,0,2840,438,2841,385,0
20150106.004412,2840,10,463964,-10,2840,433,2841,386,0
20150106.004413,2840,6,463970,-6,2840,448,2841,393,0
20150106.004414,2840,10,463980,0,2840,448,2841,425,0
20150106.004415,2840,4,463984,-4,2840,446,2841,425,0
20150106.004416,2840,6,463990,-6,2840,449,2841,474,0
20150106.004417,2840,22,464012,-2,2840,440,2841,472,0
20150106.004419,2840,20,464032,-2,2840,336,2841,485,0
20150106.00442,2840,2,464034,0,2840,344,2841,487,0
20150106.004421,2841,8,464042,-6,2840,344,2841,483,1
20150106.004422,2840,2,464044,-2,2840,343,2841,483,0
20150106.004422,2841,2,464046,0,2840,343,2841,482,1
20150106.004422,2840,2,464048,-2,2840,342,2841,482,0
20150106.004423,2841,2,464050,0,2840,342,2841,481,1
20150106.004424,2841,2,464052,0,2840,342,2841,480,1
20150106.004424,2841,6,464058,-2,2840,341,2841,478,1
20150106.004425,2841,2,464060,0,2840,342,2841,477,1
20150106.004427,2841,12,464072,0,2840,341,2841,478,1
20150106.004427,2840,2,464074,-2,2840,340,2841,478,0
20150106.004428,2841,16,464090,0,2840,340,2841,470,1
20150106.004429,2840,20,464110,0,2840,330,2841,476,0
20150106.004432,2840,4,464114,0,2840,357,2841,477,0
20150106.004435,2841,2,464116,0,2840,364,2841,482,1
20150106.004436,2841,10,464126,0,2840,365,2841,481,1
20150106.004436,2841,4,464130,0,2840,365,2841,479,1
20150106.004437,2841,2,464132,-2,2840,365,2841,478,1
20150106.004438,2840,2,464134,0,2840,365,2841,478,0
20150106.00444,2841,4,464138,-4,2840,365,2841,477,1
20150106.004442,2841,4,464142,-4,2840,381,2841,474,1
20150106.004442,2840,4,464146,-4,2840,379,2841,474,0
20150106.004444,2841,2,464148,0,2840,380,2841,481,1
20150106.004452,2841,6,464154,0,2840,433,2841,520,1
20150106.004453,2841,2,464156,-2,2840,433,2841,521,1
20150106.004455,2840,16,464172,-8,2840,430,2841,516,0
20150106.004456,2841,6,464178,-2,2840,414,2841,527,1
20150106.004456,2841,200,464378,-86,2840,414,2841,413,1
20150106.004458,2840,4,464382,-4,2840,426,2841,417,0
20150106.004459,2841,2,464384,0,2840,432,2841,416,1
20150106.004501,2841,468,464852,-230,2840,446,2841,180,1
20150106.004502,2841,12,464864,10,2840,446,2841,174,1
20150106.004502,2841,230,465094,198,2840,446,2841,59,1
20150106.004503,2841,20,465114,0,2840,446,2841,49,1
20150106.004503,2841,44,465158,-6,2840,446,2841,28,1
20150106.004504,2841,4,465162,-2,2840,446,2841,27,1
20150106.004505,2841,2,465164,0,2840,447,2841,27,1
20150106.004506,2841,2,465166,0,2840,447,2841,26,1
20150106.004506,2840,6,465172,-2,2840,444,2841,26,0
20150106.004507,2841,4,465176,0,2840,444,2841,46,1
20150106.004508,2841,2,465178,0,2840,444,2841,46,1
20150106.004508,2841,120,465298,38,2840,444,2841,87,1
20150106.004511,2840,2,465300,-2,2840,497,2841,90,0
20150106.004514,2841,6,465306,2,2840,797,2841,194,1
20150106.00452,2840,4,465310,2,2840,755,2841,370,0
20150106.004522,2841,2,465312,0,2840,759,2841,374,1
20150106.004523,2840,10,465322,0,2840,754,2841,376,0
20150106.004524,2840,2,465324,-2,2840,738,2841,416,0
20150106.004525,2840,224,465548,-200,2840,638,2841,404,0
20150106.004526,2840,2,465550,-2,2840,637,2841,407,0
20150106.004527,2840,2,465552,-2,2840,639,2841,410,0
20150106.004527,2841,2,465554,2,2840,639,2841,409,1
20150106.004528,2840,2,465556,-2,2840,634,2841,408,0
20150106.004529,2841,2,465558,2,2840,634,2841,407,1
20150106.004531,2841,4,465562,4,2840,650,2841,393,1
20150106.004532,2841,4,465566,0,2840,660,2841,392,1
20150106.004533,2841,4,465570,4,2840,660,2841,390,1
20150106.004534,2840,4,465574,-4,2840,658,2841,390,0
20150106.004534,2841,2,465576,2,2840,658,2841,389,1
20150106.004535,2840,2,465578,0,2840,667,2841,404,0
20150106.004535,2840,2,465580,0,2840,676,2841,404,0
20150106.004536,2840,6,465586,-6,2840,673,2841,414,0
20150106.004536,2841,2,465588,2,2840,683,2841,413,1
20150106.004537,2840,2,465590,0,2840,682,2841,413,0
20150106.004539,2840,4,465594,0,2840,680,2841,413,0
20150106.004543,2840,6,465600,-4,2840,688,2841,435,0
20150106.004544,2840,4,465604,0,2840,686,2841,435,0
20150106.004544,2840,20,465624,0,2840,676,2841,435,0
20150106.004545,2841,90,465714,90,2840,676,2841,392,1
20150106.004547,2840,20,465734,0,2840,662,2841,404,0
20150106.004549,2840,28,465762,0,2840,648,2841,371,0
20150106.00455,2840,120,465882,-120,2840,588,2841,371,0
20150106.004551,2840,12,465894,-8,2840,582,2841,371,0
20150106.004551,2840,8,465902,0,2840,578,2841,372,0
20150106.004552,2840,54,465956,-52,2840,551,2841,372,0
20150106.004553,2841,20,465976,0,2840,551,2841,364,1
20150106.004554,2840,2,465978,2,2840,550,2841,370,0
20150106.004555,2840,2,465980,-2,2840,549,2841,403,0
20150106.004556,2840,2,465982,-2,2840,548,2841,403,0
20150106.004558,2840,10,465992,-2,2840,547,2841,407,0
20150106.004602,2840,10,466002,10,2840,527,2841,443,0
20150106.004604,2840,2,466004,0,2840,526,2841,443,0
20150106.004605,2840,4,466008,4,2840,524,2841,443,0
20150106.004605,2840,6,466014,0,2840,521,2841,443,0
20150106.004606,2840,20,466034,0,2840,511,2841,444,0
20150106.004607,2840,80,466114,-72,2840,471,2841,444,0
20150106.004607,2840,2,466116,-2,2840,470,2841,444,0
20150106.004608,2840,4,466120,0,2840,468,2841,454,0
20150106.004608,2840,2,466122,0,2840,467,2841,454,0
20150106.004609,2840,12,466134,-4,2840,465,2841,488,0
20150106.004609,2840,16,466150,-4,2840,457,2841,487,0
20150106.00461,2840,2,466152,0,2840,455,2841,488,0
20150106.004611,2840,14,466166,12,2840,448,2841,488,0
20150106.004613,2840,32,466198,2,2840,433,2841,488,0
20150106.004613,2840,2,466200,2,2840,432,2841,488,0
20150106.004617,2840,2,466202,0,2840,466,2841,494,0
20150106.004618,2840,22,466224,0,2840,455,2841,494,0
20150106.004619,2840,60,466284,-10,2840,425,2841,494,0
20150106.004621,2840,144,466428,-144,2840,374,2841,494,0
20150106.004622,2840,64,466492,-44,2840,327,2841,494,0
20150106.004622,2840,42,466534,0,2840,306,2841,494,0
20150106.004623,2840,2,466536,-2,2840,305,2841,536,0
20150106.004623,2840,10,466546,-8,2840,300,2841,536,0
20150106.004624,2840,46,466592,-46,2840,277,2841,538,0
20150106.004625,2840,40,466632,-40,2840,267,2841,518,0
20150106.004626,2840,22,466654,-22,2840,256,2841,518,0
20150106.004626,2840,512,467166,-276,2839,983,2840,198,0
20150106.004627,2840,4,467170,0,2839,983,2840,297,0
20150106.004628,2840,20,467190,0,2839,983,2840,328,0
20150106.00463,2839,6,467196,0,2839,980,2840,330,0
20150106.00463,2839,14,467210,10,2839,976,2840,329,0
20150106.004631,2840,2,467212,0,2839,985,2840,328,1
20150106.004634,2840,22,467234,0,2839,969,2840,429,1
20150106.004635,2840,2,467236,-2,2839,969,2840,428,1
20150106.004636,2839,90,467326,0,2839,924,2840,507,0
20150106.004637,2840,2,467328,0,2839,924,2840,559,1
20150106.004637,2840,20,467348,0,2839,939,2840,595,1
20150106.004639,2840,20,467368,0,2839,939,2840,585,1
20150106.004639,2840,2,467370,0,2839,939,2840,634,1
20150106.00464,2839,6,467376,2,2839,936,2840,634,0
20150106.00464,2839,4,467380,0,2839,919,2840,677,0
20150106.004641,2839,6,467386,0,2839,916,2840,704,0
20150106.004642,2839,44,467430,16,2839,896,2840,703,0
20150106.004643,2839,508,467938,0,2839,642,2840,703,0
20150106.004644,2839,4,467942,0,2839,640,2840,703,0
20150106.004644,2839,2,467944,0,2839,641,2840,704,0
20150106.004645,2839,72,468016,0,2839,605,2840,704,0
20150106.004645,2839,12,468028,0,2839,599,2840,704,0
20150106.004646,2839,2,468030,0,2839,598,2840,703,0
20150106.004646,2839,2,468032,0,2839,587,2840,703,0
20150106.004647,2839,6,468038,0,2839,584,2840,703,0
20150106.004647,2839,2,468040,0,2839,586,2840,733,0
20150106.004648,2839,2,468042,0,2839,585,2840,733,0
20150106.004648,2839,10,468052,0,2839,580,2840,738,0
20150106.004649,2839,6,468058,6,2839,577,2840,738,0
20150106.004649,2839,8,468066,0,2839,573,2840,740,0
20150106.00465,2839,20,468086,0,2839,563,2840,725,0
20150106.00465,2839,2,468088,2,2839,561,2840,740,0
20150106.004651,2839,4,468092,0,2839,559,2840,745,0
20150106.004651,2839,6,468098,0,2839,556,2840,745,0
20150106.004652,2839,2,468100,2,2839,555,2840,747,0
20150106.004653,2839,2,468102,0,2839,554,2840,747,0
20150106.004653,2839,6,468108,0,2839,554,2840,747,0
20150106.004654,2839,6,468114,6,2839,554,2840,749,0
20150106.004656,2839,20,468134,0,2839,544,2840,773,0
20150106.004657,2839,2,468136,0,2839,543,2840,773,0
20150106.004657,2839,6,468142,0,2839,540,2840,773,0
20150106.004658,2839,24,468166,0,2839,528,2840,773,0
20150106.004701,2839,14,468180,0,2839,562,2840,758,0
20150106.004702,2839,14,468194,10,2839,555,2840,759,0
20150106.004705,2839,4,468198,4,2839,537,2840,803,0
20150106.004705,2839,2,468200,0,2839,536,2840,802,0
20150106.004707,2839,4,468204,0,2839,534,2840,808,0
20150106.004707,2839,6,468210,0,2839,531,2840,808,0
20150106.004708,2839,20,468230,0,2839,521,2840,809,0
20150106.004708,2839,8,468238,0,2839,517,2840,709,0
20150106.004709,2839,952,469190,-284,2839,41,2840,709,0
20150106.00471,2839,82,469272,-16,2838,1205,2840,709,0
20150106.00471,2839,2,469274,0,2838,1204,2839,7,0
20150106.004711,2839,26,469300,16,2838,1200,2839,15,0
20150106.004711,2839,10,469310,10,2838,1200,2839,11,0
20150106.004712,2839,202,469512,2,2838,1093,2839,16,0
20150106.004713,2839,22,469534,20,2839,40,2840,716,0
20150106.004713,2839,2,469536,0,2839,39,2840,716,0
20150106.004714,2839,2,469538,2,2839,39,2840,725,0
20150106.004715,2839,2,469540,2,2839,38,2840,740,0
20150106.004716,2838,78,469618,-2,2838,1084,2839,91,0
20150106.004716,2838,16,469634,12,2838,1089,2839,242,0
20150106.004717,2838,40,469674,0,2838,1052,2839,245,0
20150106.004717,2838,10,469684,10,2838,1063,2839,245,0
20150106.004721,2839,4,469688,-4,2838,1057,2839,246,1
20150106.004722,2838,4,469692,0,2838,1055,2839,333,0
20150106.004723,2838,32,469724,0,2838,1024,2839,358,0
20150106.004724,2838,4,469728,0,2838,1021,2839,390,0
20150106.004725,2839,2,469730,0,2838,1021,2839,401,1
20150106.004727,2838,20,469750,20,2838,1004,2839,441,0
20150106.004728,2838,4,469754,0,2838,985,2839,440,0
20150106.004729,2839,4,469758,0,2838,985,2839,439,1
20150106.00473,2838,2,469760,0,2838,986,2839,439,0
20150106.004733,2838,16,469776,0,2838,1078,2839,440,0
20150106.004735,2838,2,469778,2,2838,1092,2839,426,0
20150106.004737,2838,6,469784,0,2838,1091,2839,432,0
20150106.004738,2838,184,469968,184,2838,1000,2839,432,0
20150106.004738,2838,2,469970,0,2838,999,2839,432,0
20150106.004739,2838,4,469974,4,2838,997,2839,434,0
20150106.00474,2838,6,469980,0,2838,994,2839,436,0
20150106.00474,2838,20,470000,0,2838,969,2839,421,0
20150106.004741,2838,306,470306,300,2838,832,2839,421,0
20150106.004742,2838,4,470310,2,2838,830,2839,426,0
20150106.004743,2839,450,470760,202,2838,592,2839,440,1
20150106.004743,2838,14,470774,0,2838,585,2839,440,0
20150106.004744,2838,66,470840,22,2838,552,2839,438,0
20150106.004746,2838,2,470842,0,2838,551,2839,438,0
20150106.004746,2838,8,470850,0,2838,527,2839,438,0
20150106.004747,2838,2,470852,0,2838,526,2839,439,0
20150106.004747,2838,1000,471852,822,2838,26,2839,440,0
20150106.004749,2838,52,471904,-6,2837,1355,2838,56,0
20150106.004749,2839,322,472226,78,2838,41,2839,439,1
20150106.00475,2838,2,472228,0,2838,40,2839,424,0
20150106.004751,2838,2,472230,2,2838,48,2839,440,0
20150106.004751,2838,10,472240,0,2838,43,2839,440,0
20150106.004752,2838,20,472260,20,2838,33,2839,439,0
20150106.004753,2838,6,472266,4,2838,30,2839,439,0
20150106.004753,2838,6,472272,2,2838,29,2839,437,0
20150106.004754,2838,46,472318,2,2838,7,2839,443,0
20150106.004754,2838,2,472320,-2,2838,6,2839,443,0
20150106.004755,2838,16,472336,-16,2837,1338,2838,376,0
20150106.004757,2838,4,472340,0,2837,1338,2838,396,0
20150106.004758,2838,40,472380,-40,2837,1338,2838,378,0
20150106.004759,2838,602,472982,-200,2837,1338,2838,77,0
20150106.004759,2838,194,473176,6,2837,1318,2838,2,0
20150106.0048,2838,6,473182,0,2838,15,2839,278,0
20150106.0048,2838,2,473184,-2,2837,1319,2838,3,0
20150106.004802,2837,6,473190,-4,2837,1318,2838,14,0
20150106.004803,2837,26,473216,0,2837,1306,2838,14,0
20150106.004803,2837,20,473236,0,2837,1296,2838,14,0
20150106.004804,2837,2,473238,2,2837,1295,2838,20,0
20150106.004804,2838,10,473248,2,2837,1290,2838,16,1
20150106.004805,2838,30,473278,2,2837,1290,2838,11,1
20150106.004805,2837,4,473282,2,2837,1288,2838,12,0
20150106.004806,2838,24,473306,4,2837,1288,2839,296,1
20150106.004806,2838,30,473336,0,2837,1288,2838,44,1
20150106.004807,2838,32,473368,32,2837,1288,2838,30,1
20150106.004807,2838,62,473430,60,2838,70,2839,291,1
20150106.004808,2838,2,473432,0,2838,72,2839,291,1
20150106.004809,2837,294,473726,-2,2837,1228,2839,291,0
20150106.00481,2837,10,473736,8,2837,1226,2839,291,0
20150106.004811,2837,50,473786,10,2837,1203,2838,3,0
20150106.004812,2837,2,473788,2,2837,1202,2838,3,0
20150106.004812,2838,10,473798,2,2837,1203,2839,296,1
20150106.004813,2838,42,473840,-2,2837,1203,2839,296,1
20150106.004813,2837,20,473860,20,2837,1193,2839,296,0
20150106.004815,2838,4,473864,-2,2837,1193,2839,301,1
20150106.004815,2837,2,473866,2,2837,1192,2839,301,0
20150106.00482,2838,2,473868,-2,2837,1308,2838,114,1
20150106.00482,2837,4,473872,0,2837,1306,2838,114,0
20150106.004821,2837,8,473880,0,2837,1302,2838,116,0
20150106.004822,2837,2,473882,0,2837,1300,2838,116,0
20150106.004822,2838,2,473884,0,2837,1300,2838,115,1
20150106.004824,2837,4,473888,-2,2837,1299,2838,123,0
20150106.004824,2837,2,473890,0,2837,1298,2838,124,0
20150106.004825,2837,2,473892,0,2837,1297,2838,138,0
20150106.004826,2837,4,473896,0,2837,1295,2838,138,0
20150106.004826,2837,2,473898,2,2837,1294,2838,138,0
20150106.004827,2838,2,473900,-2,2837,1295,2838,137,1
20150106.004828,2838,2,473902,-2,2837,1295,2838,137,1
20150106.004828,2837,26,473928,0,2837,1282,2838,137,0
20150106.00483,2837,198,474126,0,2837,1168,2838,145,0
20150106.004831,2838,8,474134,0,2837,1180,2838,139,1
20150106.004834,2837,2,474136,0,2837,1179,2838,142,0
20150106.004836,2837,14,474150,2,2837,1172,2838,150,0
20150106.004836,2838,4,474154,-4,2837,1172,2838,148,1
20150106.004837,2837,2,474156,0,2837,1142,2838,148,0
20150106.004838,2837,20,474176,0,2837,1132,2838,140,0
20150106.004839,2837,4,474180,4,2837,1130,2838,140,0
20150106.004841,2838,4,474184,0,2837,1133,2838,138,1
20150106.004841,2837,260,474444,0,2837,988,2838,140,0
20150106.004842,2837,4,474448,2,2837,1001,2838,140,0
20150106.004843,2838,2,474450,0,2837,1001,2838,146,1
20150106.004848,2838,2,474452,0,2837,1057,2838,153,1
20150106.004849,2838,2,474454,0,2837,1048,2838,152,1
20150106.00485,2837,40,474494,0,2837,1028,2838,168,0
20150106.004853,2837,2,474496,2,2837,1062,2838,275,0
20150106.004853,2837,4,474500,4,2837,1060,2838,270,0
20150106.004856,2837,2,474502,2,2837,1060,2838,272,0
20150106.004857,2837,32,474534,2,2837,1044,2838,272,0
20150106.004858,2837,4,474538,0,2837,1042,2838,274,0
20150106.0049,2837,2,474540,0,2837,1040,2838,269,0
20150106.004902,2837,10,474550,0,2837,1035,2838,267,0
20150106.004902,2838,2,474552,0,2837,1035,2838,266,1
20150106.004903,2837,2,474554,0,2837,1034,2838,266,0
20150106.004905,2837,2,474556,2,2837,1034,2838,266,0
20150106.004906,2837,12,474568,12,2837,1028,2838,267,0
20150106.004907,2838,2,474570,0,2837,1030,2838,296,1
20150106.004908,2837,2,474572,2,2837,1029,2838,296,0
20150106.004909,2838,2,474574,-2,2837,1029,2838,295,1
20150106.004913,2838,10,474584,0,2837,1049,2838,294,1
20150106.004913,2838,2,474586,-2,2837,1049,2838,293,1
20150106.004914,2838,2,474588,0,2837,1049,2838,292,1
20150106.004915,2838,192,474780,28,2837,1049,2838,207,1
20150106.004916,2838,48,474828,38,2837,1049,2838,183,1
20150106.004916,2838,366,475194,-306,2838,33,2839,257,1
20150106.004918,2838,6,475200,0,2838,31,2839,256,1
20150106.004922,2838,4,475204,-4,2838,49,2839,256,1
20150106.004926,2839,2,475206,-2,2838,60,2839,255,1
20150106.004927,2838,12,475218,0,2838,56,2839,255,0
20150106.004927,2839,2,475220,0,2838,57,2839,255,1
20150106.00493,2838,4,475224,-2,2838,62,2839,254,0
20150106.004934,2838,6,475230,-6,2838,71,2839,256,0
20150106.004937,2839,4,475234,-4,2838,77,2839,254,1
20150106.004939,2838,50,475284,14,2838,58,2839,255,0
20150106.004941,2839,26,475310,0,2838,58,2839,242,1
20150106.004942,2839,2,475312,-2,2838,58,2839,241,1
20150106.004943,2838,24,475336,0,2838,46,2839,241,0
20150106.004943,2838,6,475342,6,2838,43,2839,241,0
20150106.004944,2838,12,475354,6,2838,37,2839,241,0
20150106.004945,2839,2,475356,0,2838,37,2839,249,1
20150106.00495,2838,4,475360,-4,2838,43,2839,286,0
20150106.004951,2838,4,475364,0,2838,44,2839,286,0
20150106.004951,2838,4,475368,4,2838,43,2839,287,0
20150106.004952,2838,2,475370,0,2838,42,2839,287,0
20150106.004955,2839,2,475372,0,2838,44,2839,282,1
20150106.004956,2839,4,475376,-2,2838,44,2839,281,1
20150106.005,2839,22,475398,-2,2838,39,2839,279,1
20150106.005,2839,10,475408,-10,2838,39,2839,274,1
20150106.005001,2839,118,475526,-90,2838,39,2839,206,1
20150106.005003,2839,140,475666,86,2838,56,2839,136,1
20150106.005005,2839,12,475678,-6,2838,44,2839,141,1
20150106.005007,2838,2,475680,-2,2838,64,2839,165,0
20150106.005008,2839,2,475682,-2,2838,65,2839,164,1
20150106.00501,2838,2,475684,0,2838,64,2839,164,0
20150106.00501,2839,60,475744,2,2838,79,2839,119,1
20150106.005016,2838,10,475754,-6,2838,90,2839,134,0
20150106.005027,2839,2,475756,-2,2838,230,2839,124,1
20150106.005031,2838,26,475782,0,2838,216,2839,124,0
20150106.005033,2838,20,475802,-6,2838,206,2839,124,0
20150106.005034,2838,4,475806,-4,2838,208,2839,124,0
20150106.005037,2838,2,475808,0,2838,207,2839,124,0
20150106.005044,2839,4,475812,2,2838,227,2839,123,1
20150106.005045,2838,4,475816,-2,2838,225,2839,122,0
20150106.005051,2838,492,476308,-94,2837,1424,2838,55,0
20150106.005052,2838,2,476310,-2,2837,1424,2838,54,0
20150106.005053,2838,4,476314,0,2837,1424,2838,52,0
20150106.005056,2838,10,476324,0,2837,1425,2838,47,0
20150106.005058,2838,640,476964,-180,2837,1110,2838,52,0
20150106.005059,2838,2,476966,0,2837,1126,2838,36,0
20150106.005059,2838,2,476968,-2,2837,1126,2838,35,0
20150106.0051,2838,2,476970,0,2837,1126,2838,34,0
20150106.005102,2838,20,476990,-20,2837,1126,2838,24,0
20150106.005103,2837,600,477590,-166,2837,811,2838,33,0
20150106.005104,2838,8,477598,0,2837,827,2838,20,1
20150106.005104,2837,600,478198,-348,2837,527,2838,38,0
20150106.005107,2837,600,478798,-2,2837,217,2838,74,0
20150106.005108,2837,2,478800,0,2837,216,2838,74,0
20150106.005109,2838,12,478812,-12,2837,216,2838,68,1
20150106.00511,2838,16,478828,-8,2837,214,2838,62,1
20150106.00511,2837,10,478838,-2,2837,209,2838,62,0
20150106.005112,2837,420,479258,-268,2836,1543,2837,91,0
20150106.005113,2837,14,479272,-2,2836,1543,2837,84,0
20150106.005114,2837,2,479274,0,2836,1543,2837,86,0
20150106.005115,2836,2,479276,0,2836,1542,2837,90,0
20150106.005115,2836,4,479280,0,2836,1540,2837,95,0
20150106.005116,2836,30,479310,0,2836,1525,2837,95,0
20150106.005116,2836,2,479312,0,2836,1524,2837,95,0
20150106.005117,2837,4,479316,0,2836,1524,2837,93,1
20150106.005118,2836,10,479326,-8,2836,1523,2837,189,0
20150106.005119,2837,100,479426,0,2836,1473,2837,140,1
20150106.00512,2836,4,479430,0,2836,1471,2837,140,0
20150106.00512,2836,4,479434,4,2836,1470,2837,140,0
20150106.005121,2836,10,479444,8,2836,1471,2837,219,0
20150106.005121,2836,2,479446,2,2836,1470,2837,219,0
20150106.005123,2836,2,479448,0,2836,1454,2837,284,0
20150106.005124,2836,26,479474,0,2836,1416,2837,257,0
20150106.005124,2836,2,479476,0,2836,1415,2837,262,0
20150106.005126,2837,4,479480,0,2836,1415,2837,310,1
20150106.005127,2836,2,479482,0,2836,1415,2837,310,0
20150106.005131,2836,4,479486,0,2836,1415,2837,316,0
20150106.005131,2837,20,479506,0,2836,1416,2837,306,1
20150106.005133,2836,10,479516,0,2836,1411,2837,306,0
20150106.005134,2837,2,479518,0,2836,1411,2837,305,1
20150106.005135,2836,10,479528,4,2836,1406,2837,305,0
20150106.005135,2836,602,480130,0,2836,1105,2837,305,0
20150106.005137,2836,4,480134,0,2836,1104,2837,305,0
20150106.005138,2837,2,480136,0,2836,1104,2837,304,1
20150106.005139,2837,6,480142,2,2836,1105,2837,302,1
20150106.00514,2836,2,480144,0,2836,1106,2837,306,0
20150106.005141,2836,1200,481344,32,2835,766,2837,331,0
20150106.005142,2836,28,481372,-26,2835,766,2837,370,0
20150106.005143,2836,2,481374,-2,2836,479,2837,370,0
20150106.005143,2836,30,481404,-30,2835,766,2837,356,0
20150106.005144,2837,2,481406,0,2835,767,2837,360,1
20150106.005145,2836,4,481410,-2,2835,767,2837,360,0
20150106.005145,2836,2,481412,-2,2835,767,2837,360,0
20150106.005148,2837,2,481414,0,2836,471,2837,359,1
20150106.005148,2837,758,482172,-434,2837,623,2838,102,1
20150106.005152,2837,2,482174,-2,2837,637,2838,71,1
20150106.005154,2837,4,482178,-2,2837,636,2838,71,1
20150106.005156,2837,2,482180,0,2837,635,2838,71,1
20150106.005156,2838,2,482182,0,2837,635,2838,70,1
20150106.005156,2837,2,482184,-2,2837,634,2838,70,0
20150106.005157,2837,4,482188,-4,2837,632,2838,170,0
20150106.005159,2837,2,482190,-2,2837,632,2838,177,0
20150106.0052,2837,16,482206,0,2837,624,2838,178,0
20150106.005202,2838,2,482208,0,2837,624,2838,177,1
20150106.005203,2837,2,482210,0,2837,623,2838,177,0
20150106.005207,2837,8,482218,-8,2837,619,2838,176,0
20150106.005207,2838,2,482220,0,2837,619,2838,179,1
20150106.005209,2837,2,482222,-2,2837,619,2838,185,0
20150106.005211,2837,8,482230,-2,2837,615,2838,186,0
20150106.005211,2838,6,482236,-6,2837,615,2838,183,1
20150106.005217,2837,8,482244,0,2837,599,2838,598,0
20150106.00522,2838,2,482246,-2,2837,599,2838,608,1
20150106.005221,2837,20,482266,-20,2837,589,2838,608,0
20150106.005222,2837,600,482866,-600,2837,289,2838,608,0
20150106.005223,2837,42,482908,-42,2837,273,2838,608,0
20150106.005223,2837,2,482910,0,2837,272,2838,608,0
20150106.005224,2838,4,482914,-2,2837,272,2838,606,1
20150106.005226,2837,8,482922,-8,2837,268,2838,106,0
20150106.005226,2838,2,482924,-2,2837,283,2838,90,1
20150106.00523,2837,2,482926,-2,2837,330,2838,106,0
20150106.005231,2837,2,482928,0,2837,344,2838,91,0
20150106.005235,2838,12,482940,0,2837,346,2838,75,1
20150106.005241,2838,2,482942,0,2837,364,2838,76,1
20150106.005243,2838,6,482948,-2,2837,366,2838,73,1
20150106.005253,2838,2,482950,-2,2837,366,2838,174,1
20150106.005257,2838,160,483110,80,2837,373,2838,95,1
20150106.005257,2837,20,483130,-20,2837,363,2838,95,0
20150106.005259,2838,2,483132,0,2837,363,2838,94,1
20150106.0053,2838,10,483142,0,2837,348,2838,89,1
20150106.005303,2838,10,483152,0,2837,362,2838,88,1
20150106.005307,2838,10,483162,0,2837,347,2838,99,1
20150106.005309,2837,2,483164,-2,2837,346,2838,34,0
20150106.005309,2838,2,483166,-2,2837,346,2838,33,1
20150106.00531,2838,10,483176,8,2837,346,2838,28,1
20150106.00531,2838,10,483186,2,2837,346,2838,23,1
20150106.005311,2838,22,483208,22,2837,346,2838,12,1
20150106.005311,2838,20,483228,-20,2837,346,2839,451,1
20150106.005312,2838,4,483232,0,2837,361,2839,465,1
20150106.005312,2839,4,483236,0,2837,364,2839,473,1
20150106.005313,2838,32,483268,-32,2837,350,2839,477,0
20150106.005314,2837,2,483270,-2,2837,351,2839,477,0
20150106.005315,2838,4,483274,-2,2837,351,2839,477,1
20150106.005319,2838,2,483276,2,2837,347,2838,1,1
20150106.00532,2838,2,483278,-2,2837,347,2838,1,1
20150106.005321,2838,2,483280,2,2837,347,2839,478,1
20150106.005322,2838,2,483282,0,2838,1,2839,478,1
20150106.005322,2838,2,483284,0,2837,347,2839,478,1
20150106.005323,2838,122,483406,0,2837,347,2839,478,1
20150106.005325,2838,4,483410,2,2837,348,2838,3,1
20150106.005327,2838,2,483412,2,2837,358,2838,2,1
20150106.005327,2838,2,483414,-2,2837,358,2838,1,1
20150106.005328,2838,2,483416,0,2838,960,2839,480,1
20150106.005329,2838,40,483456,40,2838,940,2839,456,1
20150106.005331,2838,4,483460,0,2837,360,2839,456,1
20150106.005334,2838,2,483462,0,2837,351,2838,23,1
20150106.005335,2838,20,483482,0,2837,351,2838,13,1
20150106.005335,2838,2,483484,0,2837,351,2838,12,1
20150106.005337,2838,30,483514,20,2838,26,2839,456,1
20150106.005339,2838,4,483518,2,2838,35,2839,468,1
20150106.00534,2838,70,483588,0,2837,351,2839,468,1
20150106.005341,2838,82,483670,80,2837,352,2839,468,1
20150106.005344,2839,4,483674,0,2837,353,2838,1,1
20150106.005346,2838,6,483680,0,2838,4,2839,467,0
20150106.005347,2838,2,483682,2,2838,23,2839,467,0
20150106.005349,2838,10,483692,0,2838,25,2839,466,0
20150106.00535,2838,50,483742,-12,2837,356,2838,25,0
20150106.005351,2838,50,483792,0,2838,216,2839,456,0
20150106.005351,2839,2,483794,0,2838,216,2839,455,1
20150106.005356,2839,30,483824,-30,2838,261,2839,426,1
20150106.005357,2838,2,483826,0,2838,260,2839,441,0
20150106.005402,2838,94,483920,-18,2838,49,2839,431,0
20150106.005405,2839,2,483922,0,2838,220,2839,430,1
20150106.00541,2839,596,484518,-578,2838,236,2839,120,1
20150106.005412,2838,2,484520,-2,2838,238,2839,119,0
20150106.005414,2839,2,484522,0,2838,239,2839,119,1
20150106.005417,2838,8,484530,-2,2838,256,2839,125,0
20150106.005417,2839,12,484542,0,2838,261,2839,120,1
20150106.005419,2839,2,484544,0,2838,271,2839,118,1
20150106.005421,2839,242,484786,-214,2839,880,2840,678,1
20150106.005422,2839,22,484808,-2,2839,869,2840,678,1
20150106.005423,2839,2,484810,0,2839,868,2840,678,1
20150106.005424,2839,20,484830,0,2839,881,2840,652,1
20150106.005425,2839,40,484870,0,2839,861,2840,652,1
20150106.005431,2839,12,484882,-2,2839,845,2840,650,1
20150106.005443,2840,2,484884,0,2839,1363,2840,851,1
20150106.005444,2840,12,484896,-4,2839,1373,2840,845,1
20150106.005444,2840,8,484904,-8,2839,1375,2840,844,1
20150106.005447,2840,18,484922,-16,2839,1425,2840,827,1
20150106.005448,2840,8,484930,0,2839,1425,2840,823,1
20150106.005449,2840,8,484938,0,2839,1425,2840,819,1
20150106.005451,2839,8,484946,-8,2839,1421,2840,819,0
20150106.005452,2840,8,484954,-4,2839,1421,2840,815,1
20150106.005453,2840,2,484956,0,2839,1421,2840,836,1
20150106.005454,2840,2,484958,-2,2839,1421,2840,835,1
20150106.005454,2840,6,484964,0,2839,1471,2840,832,1
20150106.005455,2840,2,484966,-2,2839,1471,2840,831,1
20150106.005456,2840,2,484968,0,2839,1471,2840,831,1
20150106.005457,2840,6,484974,-6,2839,1475,2840,829,1
20150106.005458,2839,2,484976,-2,2839,1474,2840,857,0
20150106.0055,2840,200,485176,0,2839,1474,2840,832,1
20150106.0055,2840,12,485188,-6,2839,1474,2840,826,1
20150106.005501,2840,104,485292,-104,2839,1459,2840,775,1
20150106.005502,2840,2,485294,0,2839,1474,2840,774,1
20150106.005503,2840,2,485296,-2,2839,1459,2840,788,1
20150106.005504,2840,20,485316,0,2839,1459,2840,778,1
20150106.005504,2839,2,485318,-2,2839,1458,2840,778,0
20150106.005505,2840,2,485320,0,2839,1458,2840,782,1
20150106.005506,2840,2,485322,0,2839,1458,2840,782,1
20150106.005507,2840,2,485324,-2,2839,1458,2840,781,1
20150106.005507,2840,20,485344,-16,2839,1458,2840,771,1
20150106.005508,2840,4,485348,-2,2839,1457,2840,770,1
20150106.00551,2840,6,485354,-2,2839,1456,2840,767,1
20150106.005511,2840,2,485356,0,2839,1506,2840,768,1
20150106.005512,2839,8,485364,-8,2839,1507,2840,768,0
20150106.005513,2840,100,485464,52,2839,1507,2840,718,1
20150106.005516,2839,2,485466,-2,2839,1507,2840,722,0
20150106.005516,2840,40,485506,-40,2839,1507,2840,702,1
20150106.005517,2840,4,485510,0,2839,1507,2840,800,1
20150106.00552,2840,4,485514,-4,2839,1556,2840,799,1
20150106.005521,2840,502,486016,0,2839,1571,2840,533,1
20150106.005523,2840,2,486018,-2,2839,1556,2840,526,1
20150106.005523,2840,20,486038,-20,2839,1557,2840,537,1
20150106.005524,2839,2,486040,-2,2839,1556,2840,543,0
20150106.005525,2840,54,486094,-30,2839,1556,2840,516,1
20150106.005525,2840,4,486098,0,2839,1556,2840,514,1
20150106.005527,2839,100,486198,-100,2839,1506,2840,464,0
20150106.005528,2839,4,486202,2,2839,1520,2840,464,0
20150106.005529,2840,2,486204,2,2839,1520,2840,574,1
20150106.00553,2839,22,486226,2,2839,1511,2840,573,0
20150106.00553,2840,4,486230,4,2839,1511,2840,569,1
20150106.005531,2840,82,486312,24,2839,1511,2840,528,1
20150106.005533,2839,2,486314,-2,2839,1510,2840,531,0
20150106.005534,2840,18,486332,-18,2839,1510,2840,524,1
20150106.005537,2839,2,486334,-2,2839,1508,2840,525,0
20150106.005538,2840,2,486336,0,2839,1518,2840,606,1
20150106.00554,2840,100,486436,0,2839,1517,2840,561,1
20150106.005541,2839,2,486438,0,2839,1518,2840,740,0
20150106.005541,2840,2,486440,0,2839,1518,2840,740,1
20150106.005543,2840,2,486442,0,2839,1521,2840,740,1
20150106.005544,2840,28,486470,0,2839,1521,2840,726,1
20150106.005545,2840,40,486510,-40,2839,1521,2840,706,1
20150106.005547,2839,346,486856,-2,2839,1363,2840,726,0
20150106.005548,2840,2,486858,0,2839,1363,2840,726,1
20150106.005549,2840,6,486864,-6,2839,1363,2840,723,1
20150106.005549,2840,140,487004,-40,2839,1333,2840,683,1
20150106.00555,2839,2,487006,0,2839,1332,2840,683,0
20150106.005552,2840,80,487086,0,2839,1332,2840,644,1
20150106.005553,2840,38,487124,0,2839,1332,2840,626,1
20150106.005554,2840,12,487136,12,2839,1332,2840,620,1
20150106.005556,2840,20,487156,-12,2839,1331,2840,611,1
20150106.005557,2839,2,487158,0,2839,1330,2840,611,0
20150106.005606,2840,1004,488162,-152,2839,1330,2840,115,1
20150106.005607,2839,4,488166,-4,2839,1328,2840,117,0
20150106.005608,2839,12,488178,-12,2839,1307,2840,132,0
20150106.005609,2840,14,488192,12,2839,1307,2840,125,1
20150106.005609,2840,10,488202,10,2839,1307,2840,141,1
20150106.00561,2840,20,488222,16,2839,1307,2840,131,1
20150106.005611,2839,2,488224,-2,2839,1306,2840,131,0
20150106.005611,2840,44,488268,16,2839,1321,2840,109,1
20150106.005612,2840,2,488270,0,2839,1321,2840,108,1
20150106.005613,2840,2,488272,0,2839,1321,2840,117,1
20150106.005613,2840,26,488298,12,2839,1321,2840,104,1
20150106.005614,2840,2,488300,2,2839,1321,2840,104,1
20150106.005614,2840,208,488508,-200,2840,399,2841,311,1
20150106.005615,2840,20,488528,-20,2840,480,2841,311,1
20150106.005616,2840,4,488532,0,2840,484,2841,297,1
20150106.005618,2840,2,488534,0,2840,483,2841,297,1
20150106.005621,2840,100,488634,-100,2840,449,2841,298,1
20150106.005622,2840,12,488646,-2,2840,444,2841,304,1
20150106.005626,2840,160,488806,0,2840,350,2841,307,1
20150106.005627,2841,604,489410,-494,2841,200,2842,560,1
20150106.005628,2841,8,489418,-6,2841,196,2842,560,1
20150106.005629,2842,2,489420,0,2841,212,2842,559,1
20150106.005629,2842,14,489434,-10,2841,211,2842,553,1
20150106.00563,2841,60,489494,-2,2841,211,2842,524,0
20150106.00563,2842,2,489496,-2,2841,211,2842,522,1
20150106.00563,2841,436,489932,-8,2840,371,2841,313,0
20150106.005632,2841,4,489936,4,2840,358,2841,408,0
20150106.005633,2841,2,489938,2,2840,351,2841,418,0
20150106.005633,2840,2,489940,-2,2840,350,2841,418,0
20150106.005634,2841,10,489950,0,2840,365,2841,598,1
20150106.005637,2840,2,489952,-2,2840,374,2841,604,0
20150106.005638,2841,4,489956,2,2840,374,2841,604,1
20150106.005638,2841,2,489958,2,2840,374,2841,603,1
20150106.005639,2841,1002,490960,-376,2840,374,2841,125,1
20150106.00564,2841,10,490970,0,2840,546,2841,119,1
20150106.005642,2841,4,490974,0,2840,545,2841,117,1
20150106.005643,2841,238,491212,-180,2841,382,2842,541,1
20150106.005644,2841,2,491214,0,2841,390,2842,527,1
20150106.005645,2841,40,491254,-40,2841,372,2842,541,1
20150106.005646,2842,12,491266,-10,2841,373,2842,535,1
20150106.005646,2841,4,491270,0,2841,371,2842,537,0
20150106.005647,2841,10,491280,0,2841,367,2842,540,0
20150106.005648,2841,2,491282,0,2841,406,2842,541,0
20150106.005648,2841,26,491308,2,2841,407,2842,517,0
20150106.005649,2841,4,491312,0,2841,411,2842,515,0
20150106.005652,2841,4,491316,-4,2841,410,2842,521,0
20150106.005653,2842,32,491348,0,2841,455,2842,524,1
20150106.005653,2842,1004,492352,-898,2841,455,2842,24,1
20150106.005654,2842,2,492354,2,2841,469,2843,474,1
20150106.005655,2842,24,492378,10,2841,470,2843,474,1
20150106.005655,2841,38,492416,-2,2841,483,2843,542,0
20150106.005656,2843,44,492460,34,2841,483,2843,521,1
20150106.005657,2843,2,492462,2,2841,485,2843,522,1
20150106.005658,2843,4,492466,-4,2841,486,2843,520,1
20150106.005659,2843,16,492482,-8,2842,20,2843,513,1
20150106.0057,2842,1042,493524,-784,2842,27,2844,791,0
20150106.005701,2842,174,493698,104,2841,492,2842,227,0
20150106.005701,2842,408,494106,408,2841,492,2842,23,0
20150106.005702,2842,2,494108,2,2841,492,2842,22,0
20150106.005702,2842,48,494156,22,2842,138,2843,99,0
20150106.005703,2843,2,494158,0,2842,157,2843,122,1
20150106.005704,2842,4,494162,-4,2842,140,2843,127,0
20150106.005705,2843,32,494194,0,2842,158,2843,111,1
20150106.005706,2842,14,494208,-2,2842,158,2843,117,0
20150106.005706,2842,2,494210,-2,2842,157,2843,117,0
20150106.005707,2843,10,494220,6,2842,157,2843,113,1
20150106.005708,2843,6,494226,-2,2842,140,2843,434,1
20150106.005708,2842,280,494506,-190,2841,397,2843,435,0
20150106.005709,2842,102,494608,100,2841,397,2843,457,0
20150106.005709,2842,4,494612,4,2841,401,2842,201,0
20150106.00571,2842,4,494616,-2,2841,401,2842,199,0
20150106.005713,2841,32,494648,-32,2841,406,2842,187,0
20150106.005714,2842,16,494664,0,2841,408,2842,179,1
20150106.005714,2842,2,494666,0,2841,408,2842,178,1
20150106.005716,2842,6,494672,0,2841,408,2842,176,1
20150106.005717,2842,2,494674,-2,2841,409,2842,182,1
20150106.005718,2841,2,494676,-2,2841,408,2842,184,0
20150106.00572,2842,4,494680,0,2841,408,2842,239,1
20150106.005721,2842,100,494780,-100,2841,408,2842,189,1
20150106.005721,2842,2,494782,-2,2841,411,2842,188,1
20150106.005722,2841,2,494784,0,2841,410,2842,188,0
20150106.005723,2842,40,494824,0,2841,410,2842,176,1
20150106.005725,2841,4,494828,-4,2841,408,2842,184,0
20150106.005726,2841,2,494830,-2,2841,392,2842,187,0
20150106.005728,2841,2,494832,0,2841,410,2842,194,0
20150106.005728,2841,10,494842,0,2841,405,2842,204,0
20150106.00573,2842,2,494844,-2,2841,451,2842,213,1
20150106.005731,2842,4,494848,-4,2841,471,2842,211,1
20150106.005731,2842,22,494870,0,2841,471,2842,202,1
20150106.005732,2841,2,494872,-2,2841,470,2842,202,0
20150106.005732,2841,10,494882,0,2841,465,2842,202,0
20150106.005733,2842,378,495260,4,2841,475,2842,13,1
20150106.005733,2842,34,495294,0,2842,485,2843,381,1
20150106.005734,2842,60,495354,-4,2842,469,2843,355,1
20150106.005735,2843,2,495356,2,2842,476,2843,357,1
20150106.005736,2843,8,495364,0,2842,567,2843,352,1
20150106.005736,2843,16,495380,2,2842,567,2843,328,1
20150106.005737,2842,106,495486,0,2842,515,2843,342,0
20150106.005737,2842,4,495490,-2,2842,514,2843,341,0
20150106.005738,2843,2,495492,0,2842,514,2843,340,1
20150106.005739,2843,4,495496,0,2842,514,2843,339,1
20150106.00574,2842,110,495606,0,2842,465,2843,333,0
20150106.005741,2843,64,495670,-2,2842,464,2843,301,1
20150106.005742,2843,4,495674,0,2842,483,2843,285,1
20150106.005742,2842,10,495684,0,2842,463,2843,285,0
20150106.005743,2843,8,495692,-2,2842,462,2843,286,1
20150106.005744,2843,86,495778,-80,2842,478,2843,243,1
20150106.005745,2843,40,495818,-40,2842,479,2843,223,1
20150106.005745,2843,4,495822,0,2842,480,2843,221,1
20150106.005745,2843,4,495826,-2,2842,480,2843,219,1
20150106.005746,2843,6,495832,-4,2842,481,2843,223,1
20150106.005746,2842,4,495836,0,2842,479,2843,243,0
20150106.005747,2843,2,495838,0,2842,479,2843,242,1
20150106.005748,2842,2,495840,0,2842,478,2843,247,0
20150106.005749,2843,2,495842,0,2842,464,2843,297,1
20150106.005749,2842,2,495844,0,2842,464,2843,514,0
20150106.00575,2843,4,495848,-2,2842,464,2843,623,1
20150106.005751,2843,2,495850,0,2842,458,2843,625,1
20150106.005752,2842,2,495852,-2,2842,459,2843,626,0
20150106.005754,2842,40,495892,-38,2842,455,2843,606,0
20150106.005754,2842,6,495898,0,2842,452,2843,606,0
20150106.005757,2843,1000,496898,-592,2842,454,2843,119,1
20150106.005758,2843,2,496900,2,2842,469,2843,111,1
20150106.005759,2843,2,496902,2,2842,469,2843,117,1
20150106.005801,2843,60,496962,40,2842,469,2843,109,1
20150106.005801,2843,66,497028,66,2842,469,2843,76,1
20150106.005802,2843,2,497030,2,2842,469,2843,75,1
20150106.005802,2843,32,497062,32,2842,469,2843,59,1
20150106.005803,2843,2,497064,2,2842,469,2843,62,1
20150106.005803,2843,124,497188,-48,2843,447,2844,519,1
20150106.005807,2844,4,497192,0,2843,513,2844,529,1
20150106.005807,2844,82,497274,-76,2843,510,2844,492,1
20150106.005808,2843,10,497284,-6,2843,513,2844,491,0
20150106.005809,2843,212,497496,-10,2843,410,2844,484,0
20150106.005809,2844,2,497498,0,2843,419,2844,483,1
20150106.00581,2844,904,498402,-784,2843,119,2844,322,1
20150106.00581,2843,2,498404,-2,2843,119,2844,322,0
20150106.00581,2843,40,498444,-40,2843,99,2844,322,0
20150106.005812,2844,6,498450,-2,2843,103,2844,322,1
20150106.005812,2844,692,499142,-568,2844,162,2845,832,1
20150106.005813,2844,330,499472,-126,2843,138,2844,13,1
20150106.005813,2844,2,499474,2,2843,139,2844,13,1
20150106.005814,2844,2,499476,2,2843,139,2844,12,1
20150106.005814,2844,10,499486,8,2843,139,2844,9,1
20150106.005815,2844,104,499590,14,2843,140,2845,849,1
20150106.005815,2844,2,499592,-2,2843,125,2844,15,1
20150106.005816,2843,42,499634,-34,2843,108,2844,23,0
20150106.005817,2844,10,499644,0,2843,135,2844,3,1
20150106.005817,2843,2,499646,-2,2843,134,2844,17,0
20150106.005819,2843,216,499862,118,2843,132,2844,24,0
20150106.00582,2844,48,499910,-48,2844,477,2845,1192,1
20150106.005821,2845,10,499920,-8,2844,474,2845,1191,1
20150106.005821,2844,1640,501560,-192,2843,135,2844,358,0
20150106.005822,2844,18,501578,8,2843,96,2844,365,0
20150106.005822,2843,10,501588,6,2843,95,2844,361,0
20150106.005823,2844,6,501594,6,2843,97,2844,435,1
20150106.005824,2844,16,501610,16,2843,100,2844,427,1
20150106.005824,2844,884,502494,-92,2844,59,2845,842,1
20150106.005825,2845,4,502498,0,2844,59,2845,841,1
20150106.005825,2844,2,502500,0,2844,59,2845,844,0
20150106.005826,2844,136,502636,-124,2844,30,2845,845,0
20150106.005827,2844,60,502696,0,2843,141,2845,859,0
20150106.005829,2845,1032,503728,-920,2844,2,2845,332,1
20150106.005829,2844,16,503744,14,2843,142,2844,12,0
20150106.00583,2844,2,503746,0,2843,144,2844,12,0
20150106.005831,2844,4,503750,2,2843,234,2844,10,0
20150106.005831,2844,20,503770,-2,2844,2,2845,346,0
20150106.005832,2844,4,503774,2,2844,23,2845,356,0
20150106.005832,2844,2,503776,2,2844,23,2845,359,0
20150106.005833,2844,8,503784,2,2844,82,2845,348,0
20150106.005833,2845,738,504522,-506,2845,132,2846,913,1
20150106.005834,2845,30,504552,-26,2845,131,2846,864,1
20150106.005834,2845,232,504784,-226,2845,121,2846,760,1
20150106.005835,2846,90,504874,-2,2845,118,2846,718,1
20150106.005835,2846,1336,506210,-1226,2845,112,2847,378,1
20150106.005836,2845,28,506238,-4,2845,135,2847,378,0
20150106.005836,2845,2,506240,0,2845,134,2846,51,0
20150106.005837,2846,12,506252,4,2845,134,2847,378,1
20150106.005837,2846,28,506280,24,2845,144,2847,468,1
20150106.005838,2845,4,506284,0,2845,143,2847,468,0
20150106.005838,2846,48,506332,-16,2845,143,2847,469,1
20150106.005839,2846,12,506344,0,2845,145,2847,509,1
20150106.005839,2847,10,506354,-8,2845,143,2847,507,1
20150106.00584,2846,390,506744,4,2845,144,2847,339,0
20150106.00584,2846,26,506770,22,2845,144,2846,1,0
20150106.005841,2847,10,506780,-4,2845,145,2847,336,1
20150106.005842,2846,6,506786,-2,2845,156,2846,14,0
20150106.005843,2846,50,506836,-20,2846,477,2847,361,0
20150106.005843,2847,2,506838,0,2846,493,2847,359,1
20150106.005844,2847,12,506850,0,2846,510,2847,346,1
20150106.005844,2846,10,506860,-8,2846,510,2847,346,0
20150106.005845,2846,4,506864,-2,2846,510,2847,346,0
20150106.005845,2847,6,506870,0,2846,579,2847,345,1
20150106.005846,2847,10,506880,-2,2846,579,2847,342,1
20150106.005846,2846,2,506882,0,2846,578,2847,342,0
20150106.005847,2847,44,506926,0,2846,580,2847,321,1
20150106.005848,2847,112,507038,0,2846,581,2847,269,1
20150106.005848,2847,26,507064,0,2846,578,2847,261,1
20150106.005849,2847,10,507074,-6,2846,577,2847,272,1
20150106.005849,2847,28,507102,-26,2846,576,2847,261,1
20150106.00585,2847,210,507312,0,2846,477,2847,248,1
20150106.00585,2847,8,507320,-6,2846,476,2847,248,1
20150106.005851,2847,52,507372,-10,2846,470,2847,234,1
20150106.005852,2847,2,507374,-2,2846,470,2847,234,1
20150106.005852,2846,14,507388,-12,2846,467,2847,292,0
20150106.005853,2846,18,507406,-4,2846,465,2847,290,0
20150106.005854,2846,58,507464,-32,2846,466,2847,264,0
20150106.005854,2846,302,507766,-302,2846,323,2847,173,0
20150106.005855,2847,2,507768,0,2846,332,2847,192,1
20150106.005855,2846,112,507880,-102,2846,282,2847,188,0
20150106.005856,2847,14,507894,10,2846,267,2847,270,1
20150106.005856,2847,212,508106,-190,2846,176,2847,280,1
20150106.005857,2846,2,508108,0,2846,175,2847,282,0
20150106.005857,2846,380,508488,-40,2846,60,2847,219,0
20150106.005858,2846,124,508612,-38,2846,3,2847,225,0
20150106.005858,2845,10,508622,0,2845,178,2846,8,0
20150106.005859,2846,2,508624,0,2845,179,2846,7,1
20150106.0059,2845,4,508628,-4,2845,187,2846,22,0
20150106.0059,2846,16,508644,6,2845,186,2846,24,1
20150106.005901,2845,40,508684,0,2845,186,2846,45,0
20150106.005902,2845,2,508686,-2,2845,184,2846,55,0
20150106.005903,2846,2,508688,2,2845,185,2846,104,1
20150106.005903,2846,2,508690,2,2845,186,2846,105,1
20150106.005904,2845,6,508696,2,2845,215,2846,128,0
20150106.005904,2846,6,508702,6,2845,210,2846,125,1
20150106.005906,2846,20,508722,8,2845,200,2846,126,1
20150106.005906,2845,6,508728,-2,2845,197,2846,129,0
20150106.005907,2846,10,508738,0,2845,192,2846,131,1
20150106.005907,2845,12,508750,0,2845,186,2846,143,0
20150106.005908,2845,2,508752,0,2845,184,2846,149,0
20150106.005908,2846,2,508754,2,2845,221,2846,149,1
20150106.005909,2845,8,508762,-6,2845,219,2846,124,0
20150106.00591,2845,4,508766,-2,2845,217,2846,134,0
20150106.00591,2845,4,508770,-4,2845,236,2846,155,0
20150106.00591,2845,2,508772,-2,2845,235,2846,156,0
20150106.005911,2845,284,509056,-50,2845,234,2846,17,0
20150106.005911,2845,4,509060,-2,2845,233,2846,17,0
20150106.005912,2846,18,509078,-16,2845,234,2846,22,1
20150106.005913,2845,4,509082,0,2845,232,2846,24,0
20150106.005914,2845,24,509106,0,2845,220,2846,23,0
20150106.005915,2845,26,509132,12,2845,217,2846,27,0
20150106.005916,2846,18,509150,-4,2845,217,2846,18,1
20150106.005916,2845,10,509160,0,2845,212,2846,24,0
20150106.005916,2845,2,509162,0,2845,211,2846,24,0
20150106.005917,2845,2,509164,-2,2845,212,2846,24,0
20150106.005918,2846,2,509166,2,2845,212,2846,54,1
20150106.005919,2845,10,509176,0,2845,214,2846,54,0
20150106.005919,2846,8,509184,-2,2845,214,2846,51,1
20150106.00592,2846,4,509188,4,2845,214,2846,50,1
20150106.005921,2846,126,509314,88,2846,299,2847,346,1
20150106.005922,2846,2,509316,2,2846,298,2847,322,1
20150106.005922,2846,22,509338,14,2846,290,2847,304,1
20150106.005923,2847,726,510064,-192,2847,179,2848,1494,1
20150106.005924,2847,38,510102,-38,2847,162,2848,1494,1
20150106.005924,2847,12,510114,-6,2847,156,2848,1494,1
20150106.005925,2847,126,510240,0,2847,93,2848,1455,1
20150106.005925,2847,8,510248,-6,2847,94,2848,1455,1
20150106.005926,2847,6,510254,-4,2847,92,2848,1454,1
20150106.005926,2847,4,510258,-4,2847,90,2848,1459,1
20150106.005927,2847,398,510656,-96,2846,275,2847,88,1
20150106.005927,2847,2,510658,2,2846,275,2847,111,1
20150106.005928,2846,22,510680,6,2846,282,2847,109,0
20150106.00593,2847,40,510720,40,2846,285,2847,143,1
20150106.00593,2846,2,510722,0,2846,285,2847,144,0
20150106.005931,2847,4,510726,4,2846,285,2847,175,1
20150106.005931,2847,2,510728,0,2846,285,2847,175,1
20150106.005932,2847,2,510730,2,2846,285,2847,175,1
20150106.005932,2847,26,510756,26,2846,286,2847,162,1
20150106.005933,2847,2,510758,2,2846,291,2847,162,1
20150106.005933,2847,4,510762,4,2846,291,2847,163,1
20150106.005934,2847,40,510802,40,2846,279,2847,153,1
20150106.005934,2847,24,510826,12,2846,279,2847,148,1
20150106.005935,2846,2,510828,0,2846,279,2847,149,0
20150106.005936,2847,4,510832,2,2846,289,2847,150,1
20150106.005936,2847,8,510840,4,2846,289,2847,146,1
20150106.005936,2847,294,511134,158,2847,18,2848,1361,1
20150106.005937,2847,4,511138,2,2847,38,2848,1361,1
20150106.005938,2847,2,511140,2,2847,37,2848,1351,1
20150106.005938,2847,50,511190,30,2847,12,2848,1351,1
20150106.005939,2847,20,511210,0,2847,3,2848,1360,1
20150106.005939,2847,2,511212,0,2847,2,2848,1362,1
20150106.00594,2847,10,511222,-2,2847,243,2848,1360,1
20150106.005941,2848,24,511246,16,2847,240,2848,1351,1
20150106.005941,2848,10,511256,0,2847,243,2848,1346,1
20150106.005942,2848,200,511456,-94,2847,240,2848,1251,1
20150106.005942,2847,16,511472,-14,2847,239,2848,1248,0
20150106.005943,2847,2,511474,-2,2847,248,2848,1248,0
20150106.005943,2848,2,511476,0,2847,248,2848,1247,1
20150106.005944,2847,30,511506,-30,2847,233,2848,1243,0
20150106.005945,2847,12,511518,-2,2847,232,2848,1237,0
20150106.005945,2847,2,511520,0,2847,232,2848,1237,0
20150106.005947,2848,42,511562,0,2847,234,2848,1222,1
20150106.005947,2847,30,511592,-10,2847,219,2848,1252,0
20150106.005948,2848,4,511596,0,2847,233,2848,1259,1
20150106.005949,2848,2002,513598,-1830,2847,739,2848,258,1
20150106.005949,2848,508,514106,-204,2847,737,2849,1565,1
20150106.00595,2849,120,514226,102,2847,740,2849,1506,1
20150106.005951,2849,88,514314,6,2848,112,2849,1468,1
20150106.005951,2848,4,514318,0,2848,111,2849,1468,0
20150106.005951,2849,20,514338,0,2848,116,2849,1459,1
20150106.005952,2848,4,514342,4,2848,130,2849,1459,0
20150106.005952,2849,86,514428,82,2848,128,2849,1425,1
20150106.005953,2849,18,514446,4,2848,133,2849,1418,1
20150106.005953,2849,6,514452,0,2848,133,2849,1415,1
20150106.005954,2848,22,514474,18,2848,235,2849,1406,0
20150106.005955,2848,16,514490,0,2848,232,2849,1440,0
20150106.005955,2849,180,514670,142,2848,153,2849,1431,1
20150106.005956,2848,114,514784,64,2848,202,2849,1425,0
20150106.005956,2849,2,514786,2,2848,202,2849,1424,1
20150106.005957,2848,100,514886,100,2848,167,2849,1424,0
20150106.005958,2848,4,514890,2,2848,177,2849,1425,0
20150106.005959,2849,24,514914,2,2848,178,2849,1420,1
20150106.005959,2849,4,514918,4,2848,178,2849,1418,1
20150106.005959,2849,8,514926,6,2848,178,2849,1414,1
20150106.01,2848,126,515052,126,2848,190,2849,1356,0
20150106.010001,2849,730,515782,106,2848,209,2849,993,1
20150106.010001,2848,272,516054,252,2848,199,2849,870,0
20150106.010002,2849,8,516062,2,2848,197,2849,867,1
20150106.010002,2849,646,516708,12,2848,197,2849,547,1
20150106.010003,2848,6,516714,0,2848,199,2849,547,0
20150106.010004,2848,16,516730,14,2848,236,2849,543,0
20150106.010004,2849,4,516734,0,2848,239,2849,541,1
20150106.010005,2849,10,516744,2,2848,237,2849,549,1
20150106.010005,2848,2,516746,0,2848,215,2849,549,0
20150106.010006,2848,60,516806,6,2848,209,2849,527,0
20150106.010007,2848,12,516818,10,2848,211,2849,534,0
20150106.010008,2849,398,517216,-322,2848,211,2849,339,1
20150106.010008,2849,20,517236,4,2848,254,2849,336,1
20150106.010009,2849,22,517258,18,2848,255,2849,326,1
20150106.010009,2848,186,517444,0,2848,193,2849,315,0
20150106.01001,2848,4,517448,4,2848,176,2849,328,0
20150106.01001,2848,44,517492,0,2848,155,2849,344,0
20150106.010011,2848,22,517514,12,2848,147,2849,341,0
20150106.010011,2848,294,517808,174,2847,560,2848,33,0
20150106.010013,2848,74,517882,-2,2847,559,2848,17,0
20150106.010014,2847,18,517900,-8,2847,552,2848,19,0
20150106.010014,2848,2,517902,0,2847,574,2848,23,1
20150106.010015,2848,38,517940,-32,2847,612,2848,26,1
20150106.010016,2848,16,517956,14,2847,612,2848,18,1
20150106.010016,2848,6,517962,4,2847,612,2848,37,1
20150106.010017,2848,16,517978,16,2847,612,2848,29,1
20150106.010018,2848,2,517980,0,2847,682,2848,40,1
20150106.010019,2847,6,517986,-2,2847,680,2848,95,0
20150106.01002,2848,4,517990,-2,2847,679,2848,91,1
20150106.010021,2847,22,518012,10,2847,674,2848,128,0
20150106.010022,2847,32,518044,32,2847,659,2848,107,0
20150106.010023,2847,2,518046,2,2847,658,2848,110,0
20150106.010023,2847,4,518050,0,2847,656,2848,112,0
20150106.010023,2847,12,518062,8,2847,652,2848,150,0
20150106.010024,2847,6,518068,6,2847,649,2848,201,0
20150106.010025,2847,4,518072,4,2847,646,2848,202,0
20150106.010025,2847,16,518088,16,2847,642,2848,201,0
20150106.010026,2847,6,518094,2,2847,639,2848,204,0
20150106.010027,2847,10,518104,8,2847,584,2848,405,0
20150106.010027,2848,30,518134,30,2847,586,2848,391,1
20150106.010028,2848,788,518922,360,2848,8,2849,495,1
20150106.010028,2848,24,518946,18,2847,583,2848,2,1
20150106.010029,2848,664,519610,-364,2848,14,2849,176,1
20150106.010029,2847,102,519712,-2,2847,685,2849,177,0
20150106.01003,2847,64,519776,-12,2847,682,2848,1,0
20150106.01003,2847,2,519778,2,2847,681,2848,2,0
20150106.010031,2848,2,519780,2,2847,681,2848,1,1
20150106.010031,2848,32,519812,30,2847,682,2848,5,1
20150106.010032,2848,12,519824,-2,2848,9,2849,251,1
20150106.010032,2847,6,519830,0,2847,530,2848,41,0
20150106.010034,2848,4,519834,0,2847,684,2848,58,1
20150106.010035,2848,82,519916,-78,2847,687,2848,19,1
20150106.010035,2848,40,519956,2,2847,539,2848,3,1
20150106.010035,2848,8,519964,-8,2847,540,2849,293,1
20150106.010036,2848,30,519994,-2,2848,40,2849,293,1
20150106.010037,2848,4,519998,2,2848,40,2849,293,1
20150106.010037,2848,4,520002,0,2848,189,2849,293,1
20150106.010038,2848,664,520666,-204,2848,186,2850,2363,1
20150106.010038,2848,316,520982,-14,2848,60,2850,2221,1
20150106.010039,2848,2,520984,2,2848,53,2849,3,1
20150106.01004,2849,2,520986,2,2848,114,2849,30,1
20150106.010041,2848,32,521018,28,2848,112,2849,134,0
20150106.010041,2848,22,521040,20,2848,98,2849,176,0
20150106.010041,2848,6,521046,0,2848,95,2849,176,0
20150106.010042,2849,6,521052,2,2848,105,2849,176,1
20150106.010043,2848,4,521056,2,2848,105,2849,385,0
20150106.010044,2849,2,521058,0,2848,105,2849,384,1
20150106.010044,2849,4,521062,0,2848,105,2849,634,1
20150106.010045,2848,4,521066,2,2848,104,2849,638,0
20150106.010046,2849,12,521078,0,2848,105,2849,633,1
20150106.010047,2848,4,521082,4,2848,104,2849,760,0
20150106.010047,2848,22,521104,16,2848,93,2849,763,0
20150106.010049,2849,40,521144,10,2848,84,2849,778,1
20150106.01005,2848,14,521158,4,2848,277,2849,764,0
20150106.01005,2849,612,521770,-224,2848,272,2849,440,1
20150106.010051,2848,44,521814,44,2848,252,2849,441,0
20150106.010051,2849,76,521890,74,2848,280,2849,402,1
20150106.010052,2848,4,521894,0,2848,278,2849,403,0
20150106.010052,2848,36,521930,-10,2848,248,2849,407,0
20150106.010053,2848,148,522078,-30,2848,183,2849,440,0
20150106.010054,2848,4,522082,2,2848,185,2849,448,0
20150106.010054,2848,2,522084,2,2848,200,2849,449,0
20150106.010056,2849,12,522096,10,2848,213,2849,449,1
20150106.010056,2849,902,522998,-446,2849,64,2850,1852,1
20150106.010057,2849,84,523082,0,2849,22,2850,1852,1
20150106.010057,2849,46,523128,-42,2848,240,2850,1852,1
20150106.010058,2849,2,523130,2,2848,252,2849,5,1
20150106.010058,2849,14,523144,10,2848,287,2850,1852,1
20150106.010059,2850,20,523164,-18,2848,287,2850,1842,1
20150106.010059,2850,42,523206,-40,2849,21,2850,1824,1
20150106.0101,2850,86,523292,-46,2849,33,2850,1877,1
20150106.010101,2850,4,523296,2,2849,32,2850,1876,1
20150106.010101,2849,8,523304,-6,2849,28,2850,1876,0
20150106.010102,2849,56,523360,-12,2848,311,2849,1,0
20150106.010102,2850,26,523386,-16,2848,317,2850,1866,1
20150106.010103,2850,2,523388,0,2848,316,2850,1867,1
20150106.010103,2850,34,523422,2,2848,316,2850,1851,1
20150106.010106,2849,2,523424,-2,2848,335,2849,4,0
20150106.010107,2849,8,523432,-4,2848,335,2850,1859,0
20150106.010107,2849,8,523440,0,2848,341,2849,496,0
20150106.010108,2849,4,523444,0,2848,337,2849,495,0
20150106.010109,2848,10,523454,0,2848,333,2849,500,0
20150106.01011,2849,8,523462,0,2848,342,2849,496,1
20150106.010111,2849,254,523716,146,2848,242,2849,469,1
20150106.010111,2849,2,523718,0,2848,244,2849,475,1
20150106.010112,2849,8,523726,2,2848,243,2849,474,1
20150106.010112,2849,4,523730,-2,2848,262,2849,473,1
20150106.010113,2848,2,523732,0,2848,237,2849,488,0
20150106.010114,2848,42,523774,42,2848,215,2849,490,0
20150106.010115,2848,22,523796,4,2848,258,2849,492,0
20150106.010115,2848,10,523806,10,2848,253,2849,494,0
20150106.010116,2848,2,523808,2,2848,252,2849,492,0
20150106.010117,2849,6,523814,2,2848,252,2849,492,1
20150106.010118,2848,42,523856,38,2848,229,2849,500,0
20150106.010118,2849,46,523902,38,2848,231,2849,329,1
20150106.010119,2849,2,523904,2,2848,242,2849,328,1
20150106.010119,2848,4,523908,4,2848,240,2849,328,0
20150106.01012,2849,32,523940,2,2848,235,2849,312,1
20150106.01012,2848,2,523942,2,2848,234,2849,312,0
20150106.01012,2848,2,523944,2,2848,233,2849,312,0
20150106.010121,2848,18,523962,0,2848,225,2849,314,0
20150106.010122,2848,120,524082,-4,2848,166,2849,321,0
20150106.010122,2848,2,524084,2,2848,185,2849,324,0
20150106.010123,2848,112,524196,-2,2848,116,2849,326,0
20150106.010124,2848,8,524204,4,2848,113,2849,328,0
20150106.010124,2849,4,524208,2,2848,112,2849,328,1
20150106.010124,2849,20,524228,20,2848,112,2849,318,1
20150106.010125,2848,38,524266,18,2848,118,2849,308,0
20150106.010125,2849,28,524294,26,2848,91,2849,309,1
20150106.010126,2849,4,524298,4,2848,91,2849,311,1
20150106.010127,2848,102,524400,100,2847,548,2849,313,0
20150106.010127,2848,2,524402,0,2847,548,2849,313,0
20150106.010128,2848,8,524410,0,2847,548,2849,317,0
20150106.010129,2848,4,524414,0,2848,50,2849,318,0
20150106.010129,2849,2,524416,2,2848,50,2849,322,1
20150106.01013,2848,4,524420,-4,2848,198,2849,322,0
20150106.010131,2848,2,524422,0,2848,216,2849,322,0
20150106.010132,2848,410,524832,310,2848,31,2849,316,0
20150106.010133,2848,22,524854,-22,2847,590,2849,332,0
20150106.010133,2848,2,524856,0,2847,590,2849,332,0
20150106.010134,2848,20,524876,-2,2847,662,2848,2,0
20150106.010134,2848,26,524902,-18,2847,658,2848,1,0
20150106.010135,2849,42,524944,18,2847,659,2849,331,1
20150106.010135,2847,60,525004,0,2847,624,2849,331,0
20150106.010136,2847,2,525006,-2,2848,71,2849,332,0
20150106.010136,2848,2,525008,-2,2848,70,2849,333,1
20150106.010137,2848,44,525052,-40,2848,100,2849,339,1
20150106.010138,2848,58,525110,24,2848,71,2849,539,1
20150106.010139,2848,2,525112,0,2848,70,2849,540,1
20150106.010139,2848,8,525120,2,2848,66,2849,541,1
20150106.01014,2848,2,525122,0,2848,67,2849,542,1
20150106.01014,2848,8,525130,2,2848,72,2849,543,1
20150106.010141,2849,20,525150,0,2848,72,2849,534,1
20150106.010142,2848,8,525158,8,2848,71,2849,589,0
20150106.010142,2848,2,525160,0,2848,70,2849,587,0
20150106.010143,2848,4,525164,2,2848,68,2849,589,0
20150106.010143,2848,2,525166,2,2848,70,2849,595,0
20150106.010144,2848,4,525170,0,2848,22,2849,597,0
20150106.010145,2848,32,525202,4,2848,9,2849,595,0
20150106.010145,2848,2,525204,2,2848,9,2849,596,0
20150106.010146,2848,18,525222,4,2847,633,2848,10,0
20150106.010146,2847,26,525248,-2,2847,694,2849,646,0
20150106.010147,2848,18,525266,-10,2847,634,2849,649,1
20150106.010148,2848,18,525284,0,2848,1,2849,651,1
20150106.010149,2848,6,525290,-2,2847,649,2849,651,1
20150106.010149,2847,40,525330,0,2847,629,2849,651,0
20150106.01015,2847,4,525334,4,2847,628,2848,2,0
20150106.010151,2847,2,525336,0,2847,629,2848,3,0
20150106.010152,2847,2,525338,2,2847,627,2848,5,0
20150106.010153,2847,42,525380,2,2847,546,2848,5,0
20150106.010154,2847,4,525384,2,2847,546,2848,6,0
20150106.010154,2848,4,525388,2,2847,547,2848,5,1
20150106.010155,2847,2,525390,2,2847,546,2848,15,0
20150106.010155,2847,12,525402,0,2847,545,2848,10,0
20150106.010156,2847,2,525404,0,2847,545,2848,10,0
20150106.010157,2848,2,525406,2,2847,548,2848,13,1
20150106.010159,2847,4,525410,0,2847,557,2848,20,0
20150106.010159,2848,4,525414,4,2847,557,2848,28,1
20150106.0102,2848,2,525416,2,2847,558,2848,71,1
20150106.0102,2847,6,525422,0,2847,555,2848,172,0
20150106.010201,2848,64,525486,26,2847,556,2848,151,1
20150106.010202,2847,6,525492,6,2847,554,2848,250,0
20150106.010202,2847,2,525494,2,2847,554,2848,250,0
20150106.010203,2847,40,525534,0,2847,534,2848,255,0
20150106.010204,2847,4,525538,4,2847,531,2848,305,0
20150106.010205,2847,32,525570,-28,2847,530,2848,290,0
20150106.010205,2847,2,525572,2,2847,528,2848,290,0
20150106.010206,2847,4,525576,4,2847,526,2848,290,0
20150106.010207,2847,2,525578,2,2847,527,2848,297,0
20150106.010208,2847,20,525598,0,2847,517,2848,298,0
20150106.01021,2847,4,525602,4,2847,516,2848,338,0
20150106.010211,2847,2,525604,0,2847,515,2848,338,0
20150106.010212,2847,24,525628,20,2847,503,2848,341,0
20150106.010212,2848,12,525640,0,2847,487,2848,346,1
20150106.010213,2847,4,525644,4,2847,485,2848,346,0
20150106.010214,2847,4,525648,2,2847,482,2848,382,0
20150106.010215,2847,2,525650,2,2847,486,2848,384,0
20150106.010216,2847,4,525654,0,2847,484,2848,385,0
20150106.010217,2848,6,525660,0,2847,483,2848,383,1
20150106.010218,2847,22,525682,4,2847,479,2848,366,0
20150106.010219,2847,2,525684,2,2847,478,2848,370,0
20150106.010219,2847,4,525688,0,2847,477,2848,370,0
20150106.010221,2848,746,526434,-296,2848,628,2849,859,1
20150106.010221,2848,18,526452,-6,2848,662,2849,859,1
20150106.010223,2848,18,526470,-14,2848,654,2849,845,1
20150106.010224,2849,20,526490,20,2848,654,2849,843,1
20150106.010225,2849,52,526542,-32,2848,633,2849,837,1
20150106.010226,2849,20,526562,10,2848,633,2849,833,1
20150106.010226,2849,20,526582,20,2848,637,2849,818,1
20150106.010227,2848,4,526586,-4,2848,635,2849,818,0
20150106.010228,2848,4,526590,0,2848,634,2849,819,0
20150106.010228,2849,20,526610,20,2848,634,2849,824,1
20150106.010229,2848,20,526630,0,2848,635,2849,823,0
20150106.010229,2848,4,526634,0,2848,633,2849,824,0
20150106.01023,2848,2,526636,0,2848,697,2849,824,0
20150106.010232,2848,18,526654,-2,2848,771,2849,848,0
20150106.010233,2849,10,526664,10,2848,771,2849,847,1
20150106.010233,2848,10,526674,0,2848,767,2849,847,0
20150106.010234,2848,2,526676,0,2848,766,2849,847,0
20150106.010235,2848,2,526678,-2,2848,766,2849,843,0
20150106.010235,2849,6,526684,6,2848,768,2849,791,1
20150106.010237,2849,4,526688,4,2848,772,2849,780,1
20150106.010237,2849,1080,527768,-378,2848,774,2849,236,1
20150106.010238,2849,94,527862,94,2848,774,2849,189,1
20150106.010238,2849,20,527882,10,2848,695,2849,179,1
20150106.010239,2849,82,527964,38,2848,694,2850,1767,1
20150106.010239,2849,20,527984,4,2848,709,2849,143,1
20150106.010239,2849,298,528282,278,2849,149,2850,1876,1
20150106.010241,2849,30,528312,20,2849,141,2850,1861,1
20150106.010241,2850,6,528318,-6,2849,144,2850,1858,1
20150106.010242,2850,10,528328,4,2849,227,2850,1855,1
20150106.010243,2850,72,528400,8,2849,271,2850,1818,1
20150106.010245,2850,44,528444,38,2849,309,2850,1790,1
20150106.010245,2849,12,528456,12,2849,369,2850,1794,0
20150106.010246,2849,6,528462,4,2849,366,2850,1792,0
20150106.010246,2850,102,528564,76,2849,517,2850,1741,1
20150106.010247,2850,16,528580,-6,2849,518,2850,1732,1
20150106.010248,2849,22,528602,22,2849,492,2850,1732,0
20150106.010248,2850,28,528630,24,2849,511,2850,1719,1
20150106.010249,2850,2304,530934,-1780,2849,524,2850,565,1
20150106.010249,2850,50,530984,0,2849,527,2850,547,1
20150106.01025,2850,152,531136,-100,2849,527,2850,471,1
20150106.01025,2850,942,532078,494,2850,296,2851,519,1
20150106.010251,2850,36,532114,-30,2850,316,2851,428,1
20150106.010251,2851,56,532170,-22,2850,406,2851,402,1
20150106.010252,2851,608,532778,-506,2850,398,2851,107,1
20150106.010252,2851,238,533016,-114,2851,3,2852,703,1
20150106.010253,2852,176,533192,68,2851,1,2852,685,1
20150106.010253,2851,228,533420,-126,2850,352,2851,529,0
20150106.010254,2851,100,533520,10,2850,343,2851,485,0
20150106.010254,2851,20,533540,18,2850,347,2851,486,0
20150106.010255,2851,8,533548,6,2850,347,2851,482,0
20150106.010255,2851,26,533574,16,2850,342,2851,474,0
20150106.010256,2851,10,533584,8,2850,341,2851,471,0
20150106.010256,2851,46,533630,46,2850,352,2851,448,0
20150106.010257,2851,14,533644,14,2850,344,2851,444,0
20150106.010257,2850,20,533664,20,2850,345,2851,507,0
20150106.010258,2851,28,533692,24,2850,353,2851,490,1
20150106.010259,2851,2,533694,2,2850,554,2851,489,1
20150106.0103,2851,72,533766,70,2850,556,2851,477,1
20150106.0103,2850,14,533780,14,2850,557,2851,473,0
20150106.010301,2851,602,534382,600,2850,556,2851,175,1
20150106.010302,2851,46,534428,34,2850,562,2851,161,1
20150106.010302,2851,32,534460,32,2850,567,2851,156,1
20150106.010303,2851,32,534492,32,2850,574,2851,143,1
20150106.010303,2851,28,534520,26,2850,607,2851,129,1
20150106.010304,2851,50,534570,4,2850,607,2851,105,1
20150106.010304,2850,28,534598,28,2850,611,2851,108,0
20150106.010305,2851,10,534608,4,2850,614,2851,106,1
20150106.010305,2851,32,534640,-28,2850,614,2851,95,1
20150106.010306,2851,106,534746,72,2850,618,2852,341,1
20150106.010307,2851,26,534772,2,2850,617,2852,345,1
20150106.010307,2850,18,534790,16,2850,645,2852,350,0
20150106.010307,2851,32,534822,12,2850,645,2851,11,1
20150106.010308,2851,4,534826,-2,2850,659,2852,371,1
20150106.010309,2851,20,534846,0,2851,27,2852,495,1
20150106.010309,2851,58,534904,-54,2851,203,2852,487,1
20150106.01031,2851,2,534906,0,2851,217,2852,487,1
20150106.010311,2851,14,534920,2,2851,214,2852,487,1
20150106.010312,2851,2,534922,2,2851,220,2852,489,1
20150106.010313,2852,10,534932,2,2851,219,2852,489,1
20150106.010313,2852,6,534938,2,2851,312,2852,488,1
20150106.010314,2852,34,534972,-32,2851,316,2852,471,1
20150106.010314,2851,4,534976,0,2851,320,2852,456,0
20150106.010315,2852,612,535588,48,2851,320,2852,143,1
20150106.010315,2852,8,535596,-4,2851,320,2852,140,1
20150106.010316,2852,2,535598,2,2851,322,2852,139,1
20150106.010316,2851,16,535614,14,2851,321,2852,507,0
20150106.010317,2851,4,535618,4,2851,321,2852,507,0
20150106.010318,2852,126,535744,24,2851,320,2852,446,1
20150106.010318,2852,22,535766,0,2851,315,2852,442,1
20150106.010319,2852,4,535770,0,2851,334,2852,640,1
20150106.010319,2851,4,535774,2,2851,323,2852,649,0
20150106.01032,2852,8,535782,0,2851,339,2852,643,1
20150106.01032,2852,12,535794,-8,2851,339,2852,636,1
20150106.010322,2851,120,535914,-78,2851,318,2852,514,0
20150106.010322,2852,78,535992,0,2851,319,2852,476,1
20150106.010323,2852,2,535994,0,2851,320,2852,487,1
20150106.010324,2851,10,536004,10,2851,365,2852,642,0
20150106.010327,2851,2,536006,2,2851,414,2852,651,0
20150106.010328,2851,2,536008,0,2851,412,2852,652,0
20150106.010328,2852,10,536018,-10,2851,422,2852,637,1
20150106.010329,2851,22,536040,20,2851,411,2852,642,0
20150106.010331,2851,2,536042,2,2851,420,2852,646,0
20150106.010331,2852,10,536052,2,2851,451,2852,642,1
20150106.010333,2852,120,536172,0,2851,452,2852,600,1
20150106.010333,2851,6,536178,-2,2851,450,2852,599,0
20150106.010335,2852,400,536578,16,2851,452,2852,402,1
20150106.010336,2851,60,536638,60,2851,443,2852,403,0
20150106.010337,2852,2,536640,0,2851,443,2852,403,1
20150106.010338,2852,2,536642,0,2851,442,2852,453,1
20150106.010338,2852,2,536644,0,2851,443,2852,502,1
20150106.010338,2851,22,536666,0,2851,411,2852,502,0
20150106.010339,2851,8,536674,8,2851,413,2852,568,0
20150106.01034,2852,2,536676,0,2851,413,2852,568,1
20150106.01034,2852,2,536678,-2,2851,413,2852,575,1
20150106.010341,2851,8,536686,2,2851,412,2852,572,0
20150106.010341,2852,2,536688,0,2851,412,2852,573,1
20150106.010342,2851,2,536690,2,2851,420,2852,573,0
20150106.010343,2852,10,536700,-4,2851,420,2852,568,1
20150106.010344,2852,2,536702,-2,2851,420,2852,568,1
20150106.010345,2852,12,536714,0,2851,421,2852,564,1
20150106.010345,2852,74,536788,0,2851,419,2852,526,1
20150106.010346,2851,30,536818,0,2851,406,2852,532,0
20150106.010347,2852,2,536820,0,2851,406,2852,532,1
20150106.010348,2851,4,536824,0,2851,404,2852,535,0
20150106.010348,2851,2,536826,0,2851,403,2852,541,0
20150106.010349,2852,4,536830,0,2851,403,2852,539,1
20150106.010349,2851,4,536834,4,2851,401,2852,539,0
20150106.01035,2851,2,536836,0,2851,400,2852,539,0
20150106.010351,2852,12,536848,-4,2851,439,2852,534,1
20150106.010351,2851,4,536852,4,2851,437,2852,534,0
20150106.010351,2851,4,536856,0,2851,435,2852,591,0
20150106.010352,2851,112,536968,4,2851,371,2852,600,0
20150106.010353,2852,10,536978,2,2851,370,2852,589,1
20150106.010353,2851,2,536980,2,2851,369,2852,589,0
20150106.010354,2851,322,537302,312,2851,207,2852,589,0
20150106.010354,2851,416,537718,150,2850,348,2852,628,0
20150106.010355,2851,86,537804,-54,2850,320,2851,585,0
20150106.010356,2850,2,537806,-2,2850,308,2851,747,0
20150106.010357,2850,602,538408,2,2850,297,2851,457,0
20150106.010357,2850,18,538426,-2,2850,301,2851,449,0
20150106.010358,2851,92,538518,0,2850,294,2851,410,1
20150106.010358,2850,62,538580,-62,2850,254,2851,414,0
20150106.010359,2850,4,538584,-2,2850,252,2851,410,0
20150106.010359,2850,4,538588,0,2850,251,2851,410,0
20150106.0104,2850,30,538618,-22,2850,248,2851,408,0
20150106.0104,2850,4,538622,0,2850,254,2851,409,0
20150106.010401,2850,6,538628,0,2850,235,2851,408,0
20150106.010401,2850,32,538660,10,2850,155,2851,413,0
20150106.010402,2850,28,538688,0,2850,154,2851,401,0
20150106.010402,2850,10,538698,10,2850,144,2851,402,0
20150106.010403,2850,2,538700,2,2850,143,2851,414,0
20150106.010404,2851,6,538706,4,2850,141,2851,417,1
20150106.010404,2850,306,539012,50,2849,188,2851,408,0
20150106.010405,2850,2,539014,0,2850,1,2851,425,0
20150106.010405,2850,6,539020,4,2850,4,2851,448,0
20150106.010406,2849,12,539032,-2,2849,199,2851,448,0
20150106.010406,2849,16,539048,-16,2849,191,2850,3,0
20150106.010407,2849,34,539082,-22,2849,175,2850,2,0
20150106.010407,2850,48,539130,-8,2849,161,2851,454,1
20150106.010408,2849,8,539138,0,2849,164,2850,5,0
20150106.010409,2850,30,539168,10,2850,25,2851,454,1
20150106.01041,2851,54,539222,-2,2849,163,2850,11,1
20150106.01041,2850,2,539224,2,2849,163,2850,38,0
20150106.010411,2850,2,539226,2,2849,163,2850,38,0
20150106.010412,2850,8,539234,8,2849,169,2850,38,0
20150106.010412,2850,2,539236,2,2849,170,2850,38,0
20150106.010413,2849,2,539238,0,2849,169,2850,61,0
20150106.010413,2850,2,539240,2,2849,169,2850,61,1
20150106.010414,2850,6,539246,6,2849,169,2850,60,1
20150106.010415,2850,8,539254,-4,2849,216,2850,81,1
20150106.010415,2850,26,539280,0,2849,216,2850,69,1
20150106.010416,2850,30,539310,20,2849,210,2850,120,1
20150106.010417,2849,2,539312,0,2849,220,2850,125,0
20150106.010418,2849,2,539314,0,2849,219,2850,126,0
20150106.010418,2849,324,539638,114,2849,209,2850,164,0
20150106.010419,2849,2,539640,0,2849,174,2850,203,0
20150106.01042,2849,4,539644,2,2849,176,2850,214,0
20150106.01042,2849,24,539668,10,2849,185,2850,200,0
20150106.010421,2850,6,539674,-2,2849,173,2850,201,1
20150106.010422,2849,8,539682,-6,2849,190,2850,205,0
20150106.010423,2849,32,539714,0,2849,225,2850,261,0
20150106.010424,2849,6,539720,2,2849,246,2850,258,0
20150106.010425,2849,20,539740,-20,2849,236,2850,273,0
20150106.010425,2850,2,539742,0,2849,236,2850,267,1
20150106.010426,2850,4,539746,0,2849,246,2850,266,1
20150106.010428,2849,2,539748,0,2849,239,2850,289,0
20150106.01043,2850,26,539774,0,2849,241,2850,423,1
20150106.01043,2849,40,539814,4,2849,223,2850,423,0
20150106.010432,2849,24,539838,6,2849,215,2850,416,0
20150106.010432,2849,2,539840,0,2849,214,2850,416,0
20150106.010433,2849,54,539894,-6,2849,197,2850,403,0
20150106.010434,2849,60,539954,30,2849,168,2850,373,0
20150106.010435,2849,62,540016,2,2849,137,2850,374,0
20150106.010435,2849,6,540022,6,2849,134,2850,371,0
20150106.010435,2849,18,540040,0,2849,126,2850,371,0
20150106.010436,2849,44,540084,-14,2849,104,2850,370,0
20150106.010437,2849,2,540086,0,2849,104,2850,380,0
20150106.010437,2849,218,540304,44,2848,1539,2849,1,0
20150106.010438,2849,4,540308,-2,2848,1540,2849,4,0
20150106.010438,2849,12,540320,2,2848,1539,2850,555,0
20150106.010439,2850,402,540722,320,2848,1542,2850,366,1
20150106.010442,2849,2,540724,0,2849,4,2850,372,0
20150106.010443,2849,6,540730,-2,2849,12,2850,174,0
20150106.010443,2849,6,540736,-2,2849,10,2850,185,0
20150106.010444,2849,2,540738,2,2849,24,2850,185,0
20150106.010445,2849,8,540746,8,2849,111,2850,190,0
20150106.010445,2849,4,540750,4,2849,113,2850,191,0
20150106.010446,2849,42,540792,-4,2849,113,2850,204,0
20150106.010448,2849,4,540796,-2,2849,128,2850,211,0
20150106.010449,2849,6,540802,0,2849,132,2850,230,0
20150106.01045,2849,2,540804,-2,2849,131,2850,246,0
20150106.01045,2849,20,540824,0,2849,121,2850,246,0
20150106.010451,2849,12,540836,0,2849,119,2850,246,0
20150106.010453,2849,4,540840,-4,2849,122,2850,254,0
20150106.010454,2849,8,540848,-8,2849,127,2850,262,0
20150106.010456,2849,2,540850,0,2849,132,2850,271,0
20150106.010456,2849,12,540862,-10,2849,126,2850,271,0
20150106.010457,2849,2,540864,-2,2849,135,2850,272,0
20150106.010458,2849,2,540866,-2,2849,124,2850,279,0
20150106.010459,2849,2,540868,0,2849,123,2850,280,0
20150106.010501,2849,4,540872,-2,2849,142,2850,276,0
20150106.010501,2850,238,541110,234,2849,142,2850,157,1
20150106.010501,2849,2,541112,0,2849,141,2850,167,0
20150106.010502,2850,4,541116,4,2849,146,2850,165,1
20150106.010503,2849,2,541118,0,2849,146,2850,165,0
20150106.010503,2850,2,541120,2,2849,147,2850,164,1
20150106.010506,2850,184,541304,152,2849,148,2850,89,1
20150106.010506,2850,4,541308,-2,2849,181,2850,84,1
20150106.010507,2850,10,541318,2,2849,181,2850,79,1
20150106.010509,2850,6,541324,6,2849,205,2850,80,1
20150106.01051,2850,20,541344,18,2849,220,2850,77,1
20150106.010511,2849,4,541348,-2,2849,233,2850,94,0
20150106.010512,2850,4,541352,0,2849,232,2850,100,1
20150106.010512,2850,2,541354,0,2849,234,2850,99,1
20150106.010513,2850,12,541366,-4,2849,234,2850,96,1
20150106.010513,2850,2,541368,0,2849,235,2850,101,1
20150106.010515,2850,246,541614,202,2850,1,2851,741,1
20150106.010516,2849,24,541638,-4,2849,224,2850,20,0
20150106.010516,2849,2,541640,0,2849,223,2850,21,0
20150106.010517,2849,4,541644,2,2849,222,2850,21,0
20150106.010518,2849,10,541654,10,2849,222,2850,22,0
20150106.010518,2850,12,541666,0,2849,198,2850,216,1
20150106.010519,2850,6,541672,-6,2849,198,2850,213,1
20150106.01052,2850,12,541684,0,2849,209,2850,207,1
20150106.01052,2850,2,541686,0,2849,208,2850,206,1
20150106.01052,2850,2,541688,0,2849,209,2850,212,1
20150106.010521,2850,180,541868,176,2849,210,2851,530,1
20150106.010522,2850,6,541874,4,2849,206,2850,152,1
20150106.010523,2850,4,541878,0,2849,206,2850,150,1
20150106.010524,2850,40,541918,28,2849,206,2850,178,1
20150106.010524,2850,2,541920,2,2849,196,2850,177,1
20150106.010526,2849,2,541922,0,2849,196,2850,182,0
20150106.010529,2850,4,541926,0,2849,223,2850,264,1
20150106.010529,2849,202,542128,-78,2849,142,2850,275,0
20150106.01053,2850,20,542148,20,2849,153,2850,305,1
20150106.010531,2849,2,542150,-2,2849,154,2850,343,0
20150106.010532,2849,4,542154,-4,2849,152,2850,344,0
20150106.010534,2849,30,542184,0,2849,128,2850,465,0
20150106.010537,2849,2,542186,0,2849,130,2850,476,0
20150106.010537,2849,4,542190,0,2849,128,2850,488,0
20150106.010538,2849,2,542192,-2,2849,128,2850,488,0
20150106.010539,2850,8,542200,8,2849,130,2850,495,1
20150106.01054,2849,24,542224,-2,2849,118,2850,497,0
20150106.010541,2849,14,542238,2,2849,111,2850,497,0
20150106.010543,2849,2,542240,2,2849,110,2850,483,0
20150106.010546,2849,2,542242,2,2849,115,2850,488,0
20150106.010546,2850,4,542246,-2,2849,115,2850,487,1
20150106.010548,2849,14,542260,-12,2849,113,2850,488,0
20150106.010549,2849,4,542264,-4,2849,111,2850,488,0
20150106.010549,2849,2,542266,0,2849,110,2850,488,0
20150106.010552,2849,2,542268,0,2849,109,2850,572,0
20150106.010553,2849,22,542290,6,2849,98,2850,577,0
20150106.010554,2849,2,542292,0,2849,97,2850,579,0
20150106.010556,2849,4,542296,4,2849,97,2850,580,0
20150106.010557,2849,2,542298,0,2849,96,2850,581,0
20150106.010558,2849,72,542370,-2,2849,61,2850,579,0
20150106.010559,2849,10,542380,2,2849,56,2850,579,0
20150106.0106,2849,14,542394,0,2849,150,2850,579,0
20150106.0106,2849,10,542404,2,2849,161,2850,578,0
20150106.010602,2850,14,542418,-14,2849,214,2850,573,1
20150106.010602,2849,4,542422,0,2849,212,2850,573,0
20150106.010603,2849,2,542424,0,2849,211,2850,571,0
20150106.010604,2849,22,542446,-6,2849,201,2850,571,0
20150106.010605,2849,2,542448,2,2849,200,2850,570,0
20150106.010607,2850,10,542458,0,2849,200,2850,515,1
20150106.010607,2850,6,542464,0,2849,200,2850,502,1
20150106.010609,2849,402,542866,322,2849,227,2850,310,0
20150106.010611,2850,2,542868,0,2849,218,2850,309,1
20150106.010614,2849,2,542870,0,2849,232,2850,305,0
20150106.010615,2849,2,542872,2,2849,228,2850,317,0
20150106.010619,2849,28,542900,2,2849,229,2850,341,0
20150106.010621,2849,4,542904,-4,2849,235,2850,348,0
20150106.010622,2849,2,542906,-2,2849,234,2850,349,0
20150106.010623,2849,4,542910,2,2849,231,2850,399,0
20150106.010624,2849,2,542912,2,2849,231,2850,400,0
20150106.010625,2849,2,542914,0,2849,240,2850,393,0
20150106.010627,2849,4,542918,0,2849,252,2850,403,0
20150106.010628,2849,2,542920,0,2849,249,2850,403,0
20150106.010629,2849,262,543182,16,2849,118,2850,429,0
20150106.01063,2849,42,543224,-40,2849,97,2850,440,0
20150106.01063,2849,74,543298,-66,2849,72,2850,433,0
20150106.010631,2849,2,543300,-2,2849,71,2850,433,0
20150106.010631,2849,6,543306,-6,2849,68,2850,433,0
20150106.010632,2849,80,543386,-62,2849,28,2850,435,0
20150106.010632,2849,100,543486,28,2849,1,2850,446,0
20150106.010633,2849,6,543492,2,2848,1455,2849,3,0
20150106.010633,2849,12,543504,0,2848,1455,2849,1,0
20150106.010634,2849,2,543506,0,2849,10,2850,433,0
20150106.010634,2849,2,543508,0,2848,1454,2849,1,0
20150106.010635,2849,6,543514,0,2848,1454,2850,461,0
20150106.010636,2849,2,543516,-2,2849,10,2850,436,0
20150106.010637,2849,10,543526,10,2849,2,2850,461,0
20150106.010637,2849,2,543528,2,2849,2,2850,461,0
20150106.010638,2849,6,543534,4,2848,1453,2849,8,0
20150106.010638,2849,18,543552,-2,2848,1453,2850,461,0
20150106.010639,2850,6,543558,2,2849,1,2850,439,1
20150106.010639,2849,2,543560,2,2848,1453,2849,23,0
20150106.01064,2849,60,543620,-2,2848,1450,2850,454,0
20150106.010641,2850,14,543634,-10,2848,1450,2850,601,1
20150106.010641,2849,16,543650,16,2849,2,2850,442,0
20150106.010642,2848,6,543656,4,2849,10,2850,432,0
20150106.010642,2849,2,543658,0,2849,10,2850,473,1
20150106.010643,2849,20,543678,0,2848,1441,2850,474,1
20150106.010644,2849,6,543684,-6,2848,1439,2850,487,1
20150106.010645,2849,8,543692,-2,2848,1438,2850,496,1
20150106.010645,2848,2,543694,0,2848,1437,2850,481,0
20150106.010646,2850,18,543712,12,2848,1437,2850,468,1
20150106.010648,2848,12,543724,-2,2848,1450,2850,777,0
20150106.010649,2849,4,543728,-4,2849,2,2850,778,1
20150106.010649,2849,8,543736,0,2848,1444,2849,1,1
20150106.01065,2848,4,543740,-2,2848,1443,2849,1,0
20150106.01065,2849,4,543744,-2,2849,3,2850,777,1
20150106.010651,2849,2,543746,0,2849,2,2850,980,1
20150106.010651,2849,10,543756,-10,2848,1442,2849,1,1
20150106.010652,2848,6,543762,2,2848,1441,2850,976,0
20150106.010653,2849,4,543766,0,2848,1439,2849,6,1
20150106.010653,2849,12,543778,-8,2848,1439,2850,264,1
20150106.010654,2848,14,543792,-2,2848,1438,2849,4,0
20150106.010655,2849,2,543794,2,2848,1438,2849,303,1
20150106.010657,2849,8,543802,8,2848,1438,2849,306,1
20150106.010658,2848,22,543824,-18,2848,1428,2849,311,0
20150106.010701,2849,8,543832,0,2848,1429,2849,338,1
20150106.010701,2848,6,543838,-6,2848,1426,2849,341,0
20150106.010702,2849,2,543840,2,2848,1427,2849,345,1
20150106.010702,2848,2,543842,-2,2848,1426,2849,350,0
20150106.010703,2848,2,543844,0,2848,1425,2849,380,0
20150106.010704,2848,4,543848,-4,2848,1424,2849,380,0
20150106.010705,2848,12,543860,-6,2848,1429,2849,581,0
20150106.010706,2848,100,543960,0,2848,1370,2849,592,0
20150106.010707,2848,42,544002,-42,2848,1357,2849,583,0
20150106.010708,2848,4,544006,0,2848,1365,2849,601,0
20150106.010709,2848,6,544012,0,2848,1413,2849,705,0
20150106.01071,2849,2,544014,2,2848,1413,2849,724,1
20150106.010711,2848,220,544234,-20,2848,1407,2849,684,0
20150106.010712,2848,4,544238,0,2848,1405,2849,684,0
20150106.010713,2848,2,544240,0,2848,1406,2849,684,0
20150106.010714,2848,6,544246,-6,2848,1408,2849,685,0
20150106.010714,2848,18,544264,-18,2848,1398,2849,686,0
20150106.010715,2848,4,544268,2,2848,1397,2849,691,0
20150106.010717,2848,8,544276,-4,2848,1393,2849,711,0
20150106.01072,2848,2,544278,-2,2848,1347,2849,723,0
20150106.01072,2849,8,544286,0,2848,1344,2849,722,1
20150106.010721,2848,2,544288,-2,2848,1340,2849,723,0
20150106.010722,2848,6,544294,-6,2848,1306,2849,728,0
20150106.010723,2848,2,544296,-2,2848,1304,2849,748,0
20150106.010724,2848,8,544304,-6,2848,1300,2849,723,0
20150106.010725,2848,6,544310,2,2848,1298,2849,725,0
20150106.010725,2849,6,544316,6,2848,1298,2849,722,1
20150106.010728,2848,6,544322,0,2848,1295,2849,723,0
20150106.010729,2848,4,544326,0,2848,1295,2849,725,0
20150106.01073,2848,2,544328,-2,2848,1294,2849,727,0
20150106.01073,2848,2,544330,0,2848,1293,2849,727,0
20150106.010731,2848,2,544332,0,2848,1291,2849,726,0
20150106.010733,2848,2,544334,0,2848,1290,2849,727,0
20150106.010734,2849,6,544340,6,2848,1290,2849,724,1
20150106.010735,2848,2,544342,-2,2848,1289,2849,724,0
20150106.010736,2848,2,544344,0,2848,1291,2849,724,0
20150106.010737,2848,50,544394,-50,2848,1266,2849,724,0
20150106.010738,2848,8,544402,-8,2848,1263,2849,724,0
20150106.010738,2848,6,544408,0,2848,1260,2849,726,0
20150106.010739,2849,2,544410,2,2848,1260,2849,726,1
20150106.01074,2848,4,544414,-4,2848,1258,2849,726,0
20150106.010742,2848,2,544416,0,2848,1257,2849,739,0
20150106.010743,2848,10,544426,0,2848,1252,2849,739,0
20150106.010744,2848,2,544428,-2,2848,1253,2849,734,0
20150106.010746,2848,2,544430,0,2848,1252,2849,1264,0
20150106.010747,2848,2,544432,-2,2848,1251,2849,1265,0
20150106.010747,2848,40,544472,0,2848,1231,2849,1265,0
20150106.010748,2848,8,544480,-4,2848,1217,2849,1278,0
20150106.010748,2848,18,544498,-8,2848,1202,2849,1279,0
20150106.010749,2848,2,544500,0,2848,1201,2849,1279,0
20150106.010749,2848,4,544504,-4,2848,1199,2849,1285,0
20150106.010749,2848,12,544516,-12,2848,1193,2849,1285,0
20150106.01075,2848,2,544518,-2,2848,1192,2849,1285,0
20150106.010751,2848,800,545318,-624,2848,792,2849,1297,0
20150106.010752,2848,36,545354,8,2848,774,2849,1296,0
20150106.010752,2848,152,545506,128,2848,691,2849,1296,0
20150106.010753,2848,92,545598,28,2848,645,2849,1290,0
20150106.010753,2848,30,545628,24,2848,630,2849,1296,0
20150106.010754,2848,122,545750,18,2848,569,2849,1306,0
20150106.010754,2848,4,545754,2,2848,567,2849,1304,0
20150106.010755,2848,4,545758,2,2848,564,2849,1305,0
20150106.010756,2848,16,545774,12,2848,556,2849,1305,0
20150106.010757,2848,4,545778,0,2848,554,2849,1298,0
20150106.010757,2848,14,545792,12,2848,547,2849,1303,0
20150106.010758,2848,10,545802,2,2848,541,2849,1303,0
20150106.010758,2849,36,545838,0,2848,541,2849,1286,1
20150106.010759,2848,2,545840,2,2848,539,2849,1287,0
20150106.010759,2848,4,545844,0,2848,537,2849,1292,0
20150106.0108,2848,2,545846,0,2848,541,2849,1292,0
20150106.010801,2849,12,545858,4,2848,537,2849,1291,1
20150106.010801,2848,8,545866,4,2848,533,2849,1281,0
20150106.010802,2848,14,545880,0,2848,546,2849,1281,0
20150106.010803,2848,2,545882,2,2848,549,2849,1281,0
20150106.010805,2848,2,545884,0,2848,559,2849,1276,0
20150106.010806,2848,8,545892,8,2848,555,2849,1279,0
20150106.010807,2848,4,545896,4,2848,563,2849,1079,0
20150106.010807,2848,2,545898,2,2848,562,2849,1079,0
20150106.010808,2848,400,546298,96,2848,367,2849,1095,0
20150106.010808,2848,2,546300,0,2848,367,2849,1095,0
20150106.010809,2848,24,546324,-20,2848,379,2849,1095,0
20150106.01081,2849,2250,548574,-330,2848,357,2850,524,1
20150106.01081,2848,82,548656,-78,2848,316,2850,524,0
20150106.010811,2848,4,548660,0,2848,325,2850,519,0
20150106.010812,2848,2,548662,-2,2848,328,2849,71,0
20150106.010812,2848,2,548664,-2,2848,327,2849,71,0
20150106.010813,2848,2,548666,0,2848,477,2849,71,0
20150106.010813,2849,40,548706,-38,2848,517,2849,51,1
20150106.010814,2849,122,548828,-82,2848,543,2850,516,1
20150106.010817,2848,10,548838,2,2848,545,2850,497,0
20150106.010817,2849,4,548842,0,2849,2,2850,497,1
20150106.010818,2849,6,548848,2,2848,545,2850,497,1
20150106.010819,2848,8,548856,-8,2848,542,2850,497,0
20150106.01082,2849,40,548896,-38,2848,557,2849,1,1
20150106.01082,2849,2,548898,0,2848,559,2850,499,1
20150106.010821,2848,2,548900,0,2848,557,2849,2,0
20150106.010821,2849,6,548906,-4,2849,7,2850,545,1
20150106.010822,2850,44,548950,4,2849,5,2850,476,1
20150106.010823,2849,102,549052,-64,2848,576,2849,1,0
20150106.010823,2849,4,549056,4,2849,50,2850,476,0
20150106.010824,2848,602,549658,-394,2848,320,2850,476,0
20150106.010824,2848,32,549690,16,2848,326,2850,466,0
20150106.010826,2848,600,550290,-448,2848,22,2849,11,0
20150106.010827,2849,8,550298,0,2848,33,2849,8,1
20150106.010829,2848,4,550302,0,2848,40,2849,23,0
20150106.01083,2849,20,550322,6,2848,41,2849,15,1
20150106.010833,2849,18,550340,6,2848,214,2849,13,1
20150106.010833,2849,4,550344,0,2848,239,2849,11,1
20150106.010834,2849,22,550366,18,2848,240,2849,2,1
20150106.010834,2849,6,550372,6,2848,286,2850,492,1
20150106.010837,2849,4,550376,4,2848,299,2849,1,1
20150106.010838,2849,2,550378,2,2848,301,2850,493,1
20150106.010839,2849,4,550382,4,2848,322,2849,1,1
20150106.010839,2849,12,550394,12,2848,292,2849,5,1
20150106.01084,2849,2,550396,0,2848,296,2849,5,1
20150106.010841,2849,2,550398,0,2848,298,2849,57,1
20150106.010844,2849,2,550400,2,2848,297,2849,79,1
20150106.010845,2849,4,550404,0,2848,306,2849,79,1
20150106.010846,2848,4,550408,2,2848,325,2849,79,0
20150106.010848,2849,156,550564,-128,2849,94,2850,503,1
20150106.010848,2849,8,550572,0,2849,102,2850,503,1
20150106.010851,2849,4,550576,0,2849,106,2850,501,1
20150106.010853,2849,12,550588,-10,2849,106,2850,501,1
20150106.010856,2850,40,550628,40,2849,142,2850,489,1
20150106.010901,2849,4,550632,0,2849,167,2850,489,0
20150106.010901,2849,2,550634,0,2849,166,2850,489,0
20150106.010903,2849,40,550674,-40,2849,147,2850,489,0
20150106.010904,2849,2,550676,0,2849,147,2850,490,0
20150106.010907,2850,100,550776,78,2849,118,2850,446,1
20150106.010909,2850,40,550816,2,2849,124,2850,377,1
20150106.01091,2850,784,551600,-138,2850,150,2851,889,1
20150106.01091,2850,172,551772,-76,2850,64,2851,904,1
20150106.010911,2851,144,551916,-116,2849,149,2851,886,1
20150106.010911,2851,18,551934,-10,2849,148,2851,878,1
20150106.010912,2851,36,551970,-26,2850,2,2851,869,1
20150106.010913,2850,4,551974,4,2849,148,2851,869,0
20150106.010913,2850,2,551976,2,2850,1,2851,869,0
20150106.010914,2850,112,552088,108,2850,86,2851,869,0
20150106.010914,2850,172,552260,98,2849,159,2851,872,0
20150106.010915,2851,4,552264,4,2849,161,2851,871,1
20150106.010917,2850,2,552266,2,2849,162,2850,1,0
20150106.010918,2849,20,552286,-20,2849,153,2850,2,0
20150106.010919,2851,10,552296,4,2849,156,2851,871,1
20150106.01092,2850,22,552318,0,2849,206,2851,871,0
20150106.010922,2849,2,552320,0,2849,206,2850,8,0
20150106.010923,2850,18,552338,10,2849,352,2850,5,1
20150106.010923,2850,2,552340,0,2849,355,2850,4,1
20150106.010924,2850,8,552348,2,2849,360,2850,1,1
20150106.010925,2850,2,552350,2,2849,360,2850,10,1
20150106.010926,2850,2,552352,2,2849,362,2850,38,1
20150106.010927,2850,4,552356,0,2849,212,2850,47,1
20150106.010927,2850,2,552358,2,2849,213,2850,48,1
20150106.010929,2850,2,552360,2,2849,218,2850,50,1
20150106.010931,2850,36,552396,-10,2849,217,2850,37,1
20150106.010932,2850,18,552414,18,2849,317,2850,28,1
20150106.010933,2850,56,552470,-28,2849,317,2851,876,1
20150106.010934,2850,40,552510,0,2849,321,2850,81,1
20150106.010935,2850,164,552674,16,2849,322,2851,879,1
20150106.010935,2851,56,552730,36,2850,1,2851,869,1
20150106.010936,2850,4,552734,2,2849,321,2850,1,0
20150106.010936,2850,2,552736,0,2849,322,2851,869,0
20150106.010937,2850,6,552742,2,2850,1,2851,868,0
20150106.010937,2851,4,552746,0,2849,330,2851,867,1
20150106.010938,2850,2,552748,2,2849,330,2850,1,0
20150106.010939,2850,6,552754,4,2850,1,2851,867,0
20150106.010939,2850,8,552762,-2,2849,334,2850,6,0
20150106.01094,2850,12,552774,0,2850,180,2851,867,0
20150106.010941,2850,42,552816,2,2850,161,2851,867,0
20150106.010942,2850,2,552818,2,2850,164,2851,867,0
20150106.010944,2850,22,552840,22,2850,161,2851,880,0
20150106.010945,2850,4,552844,4,2850,159,2851,880,0
20150106.010946,2851,2,552846,0,2850,169,2851,879,1
20150106.010946,2850,2,552848,2,2850,168,2851,879,0
20150106.010947,2850,336,553184,-10,2849,328,2850,437,0
20150106.010947,2850,4,553188,0,2849,294,2850,446,0
20150106.010948,2850,6,553194,0,2849,294,2850,443,0
20150106.010948,2850,100,553294,-100,2849,314,2850,383,0
20150106.010949,2850,2,553296,-2,2849,304,2850,393,0
20150106.010951,2850,14,553310,0,2849,306,2850,387,0
20150106.010952,2850,4,553314,0,2849,316,2850,386,0
20150106.010955,2850,40,553354,-40,2849,327,2850,358,0
20150106.010959,2849,2,553356,-2,2849,333,2850,371,0
20150106.011001,2850,230,553586,0,2849,341,2850,270,1
20150106.011001,2850,30,553616,-16,2849,341,2850,255,1
20150106.011002,2850,30,553646,-14,2849,341,2850,240,1
20150106.011002,2850,8,553654,-4,2849,341,2850,238,1
20150106.011006,2849,2,553656,0,2849,339,2850,264,0
20150106.011008,2850,4,553660,-4,2849,340,2850,268,1
20150106.011009,2850,2,553662,0,2849,341,2850,267,1
20150106.01101,2849,24,553686,0,2849,330,2850,266,0
20150106.011011,2850,2,553688,-2,2849,342,2850,280,1
20150106.011012,2849,2,553690,0,2849,341,2850,318,0
20150106.011012,2849,6,553696,0,2849,327,2850,330,0
20150106.011013,2849,2,553698,-2,2849,340,2850,330,0
20150106.011014,2849,2,553700,0,2849,338,2850,330,0
20150106.011016,2849,4,553704,0,2849,344,2850,334,0
20150106.011018,2849,20,553724,0,2849,335,2850,387,0
20150106.011019,2849,2,553726,0,2849,346,2850,382,0
20150106.011019,2850,10,553736,-10,2849,351,2850,377,1
20150106.011022,2849,2,553738,-2,2849,351,2850,385,0
20150106.011026,2849,2,553740,0,2849,355,2850,430,0
20150106.011027,2849,6,553746,-6,2849,353,2850,429,0
20150106.011028,2849,102,553848,-64,2849,354,2850,445,0
20150106.011029,2849,28,553876,6,2849,349,2850,435,0
20150106.011029,2849,4,553880,0,2849,347,2850,435,0
20150106.011033,2849,2,553882,0,2849,353,2850,450,0
20150106.011034,2850,2,553884,0,2849,353,2850,454,1
20150106.011035,2849,4,553888,-4,2849,350,2850,456,0
20150106.011038,2850,400,554288,-360,2849,365,2850,318,1
20150106.01104,2850,2,554290,0,2849,466,2850,318,1
20150106.01104,2850,2,554292,0,2849,465,2850,320,1
20150106.011044,2850,2,554294,2,2849,462,2850,319,1
20150106.011045,2849,2,554296,0,2849,481,2850,319,0
20150106.011045,2850,10,554306,10,2849,482,2850,313,1
20150106.011046,2850,2,554308,2,2849,487,2850,312,1
20150106.011052,2850,8,554316,0,2849,473,2850,320,1
20150106.011055,2849,6,554322,-6,2849,472,2850,330,0
20150106.011055,2850,660,554982,-206,2850,670,2851,818,1
20150106.011056,2850,4,554986,-4,2850,669,2851,798,1
20150106.011057,2851,6,554992,0,2850,670,2851,795,1
20150106.011059,2850,2,554994,0,2850,669,2851,795,0
20150106.011059,2850,2,554996,0,2850,668,2851,795,0
20150106.0111,2850,10,555006,-10,2850,664,2851,795,0
20150106.011101,2851,2,555008,0,2850,664,2851,793,1
20150106.011102,2851,116,555124,6,2850,664,2851,736,1
20150106.011104,2850,2,555126,0,2850,667,2851,737,0
20150106.011105,2851,2,555128,0,2850,670,2851,739,1
20150106.011106,2850,2,555130,0,2850,669,2851,738,0
20150106.011107,2851,4,555134,-2,2850,677,2851,736,1
20150106.011108,2850,2,555136,0,2850,676,2851,736,0
20150106.011109,2851,6,555142,-6,2850,677,2851,734,1
20150106.011111,2850,2,555144,0,2850,678,2851,729,0
20150106.011114,2850,2,555146,0,2850,684,2851,1083,0
20150106.011115,2850,22,555168,0,2850,673,2851,1094,0
20150106.011118,2850,14,555182,0,2850,657,2851,1096,0
20150106.011119,2851,10,555192,0,2850,657,2851,1091,1
20150106.011124,2850,2,555194,-2,2850,684,2851,1103,0
20150106.011124,2850,4,555198,0,2850,682,2851,1103,0
20150106.011127,2851,4,555202,-2,2850,681,2851,1104,1
20150106.011129,2850,2,555204,-2,2850,691,2851,1084,0
20150106.011132,2850,2,555206,0,2850,692,2851,1082,0
20150106.011133,2850,2,555208,0,2850,691,2851,1082,0
20150106.011136,2850,942,556150,0,2850,226,2851,1101,0
20150106.011137,2850,2,556152,0,2850,225,2851,1101,0
20150106.011138,2850,2,556154,-2,2850,224,2851,1101,0
20150106.011139,2850,10,556164,-4,2850,249,2851,1101,0
20150106.011139,2850,4,556168,0,2850,246,2851,1106,0
20150106.01114,2850,20,556188,0,2850,236,2851,1106,0
20150106.011141,2850,16,556204,-12,2850,228,2851,1106,0
20150106.011142,2850,14,556218,0,2850,221,2851,1106,0
20150106.011142,2850,4,556222,0,2850,219,2851,1106,0
20150106.011143,2850,24,556246,-20,2850,192,2851,1107,0
20150106.011143,2850,10,556256,-8,2850,187,2851,1108,0
20150106.011144,2850,8,556264,-6,2850,183,2851,1108,0
20150106.011144,2850,132,556396,-40,2850,117,2851,1108,0
20150106.011144,2850,234,556630,128,2849,318,2851,1123,0
20150106.011146,2850,2,556632,2,2849,318,2850,200,0
20150106.011148,2850,10,556642,-2,2849,318,2850,201,0
20150106.01115,2850,4,556646,4,2849,316,2850,243,0
20150106.011152,2850,2,556648,0,2849,316,2850,242,0
20150106.011154,2849,2,556650,-2,2849,312,2850,242,0
20150106.011156,2850,10,556660,0,2849,312,2850,236,1
20150106.011158,2849,2,556662,-2,2849,303,2850,239,0
20150106.011159,2849,2,556664,-2,2849,304,2850,240,0
20150106.011204,2849,2,556666,0,2849,287,2850,255,0
20150106.011209,2849,224,556890,-122,2849,204,2850,260,0
20150106.011211,2849,2,556892,-2,2849,202,2850,85,0
20150106.011216,2850,2,556894,-2,2849,218,2850,99,1
20150106.011217,2849,2,556896,-2,2849,213,2850,113,0
20150106.011219,2849,10,556906,-10,2849,208,2850,113,0
20150106.011222,2849,2,556908,0,2849,199,2850,197,0
20150106.011225,2849,2,556910,-2,2849,277,2850,319,0
20150106.011227,2849,2,556912,0,2849,276,2850,320,0
20150106.011229,2849,2,556914,0,2849,273,2850,454,0
20150106.01123,2849,2,556916,0,2849,272,2850,454,0
20150106.011231,2850,10,556926,4,2849,272,2850,569,1
20150106.011232,2849,300,557226,190,2849,122,2850,570,0
20150106.011233,2850,10,557236,6,2849,122,2850,567,1
20150106.011233,2849,2,557238,0,2849,129,2850,559,0
20150106.011234,2849,20,557258,20,2849,119,2850,560,0
20150106.011235,2849,14,557272,10,2849,103,2850,562,0
20150106.011238,2850,2,557274,0,2849,100,2850,572,1
20150106.01124,2849,2,557276,2,2849,99,2850,577,0
20150106.01124,2849,82,557358,-12,2848,144,2850,577,0
20150106.011242,2849,150,557508,-100,2848,203,2849,27,0
20150106.011242,2849,54,557562,-54,2849,65,2850,670,0
20150106.011244,2849,132,557694,-126,2848,188,2849,117,0
20150106.011244,2848,2,557696,0,2848,187,2849,117,0
20150106.011246,2849,2,557698,0,2848,195,2849,116,1
20150106.011247,2848,2,557700,-2,2848,195,2849,116,0
20150106.011247,2848,2,557702,0,2848,194,2849,116,0
20150106.011248,2848,14,557716,-6,2848,186,2849,117,0
20150106.01125,2848,4,557720,0,2848,205,2849,117,0
20150106.01125,2848,4,557724,4,2848,202,2849,117,0
20150106.01125,2849,2,557726,0,2848,202,2849,116,1
20150106.011251,2848,2,557728,2,2848,201,2849,116,0
20150106.011256,2848,2,557730,2,2848,268,2849,130,0
20150106.011257,2849,2,557732,-2,2848,270,2849,130,1
20150106.011258,2848,20,557752,-2,2848,252,2849,141,0
20150106.011258,2849,2,557754,0,2848,247,2849,150,1
20150106.0113,2848,2,557756,0,2848,253,2849,153,0
20150106.011306,2848,12,557768,-8,2848,252,2849,176,0
20150106.011309,2848,20,557788,-2,2848,243,2849,177,0
20150106.011311,2848,8,557796,6,2848,249,2849,169,0
20150106.011312,2848,2,557798,0,2848,238,2849,191,0
20150106.011313,2848,2,557800,-2,2848,214,2849,191,0
20150106.011314,2848,2,557802,0,2848,223,2849,193,0
20150106.011315,2848,4,557806,-4,2848,221,2849,193,0
20150106.011315,2848,2,557808,0,2848,219,2849,193,0
20150106.011316,2849,62,557870,30,2848,189,2849,192,1
20150106.011318,2848,40,557910,-10,2848,169,2849,189,0
20150106.011318,2849,6,557916,2,2848,167,2849,187,1
20150106.011319,2849,28,557944,-20,2848,185,2849,180,1
20150106.01132,2848,206,558150,-150,2848,82,2849,180,0
20150106.01132,2848,4,558154,-2,2848,81,2849,203,0
20150106.011321,2848,226,558380,112,2847,565,2848,2,0
20150106.011321,2848,12,558392,-4,2847,567,2849,206,0
20150106.011322,2848,4,558396,-2,2847,566,2848,1,0
20150106.011323,2848,2,558398,0,2847,566,2849,206,0
20150106.011326,2848,6,558404,-4,2847,560,2848,1,0
20150106.011326,2848,2,558406,2,2848,5,2849,220,0
20150106.011328,2848,2,558408,0,2848,5,2849,221,0
20150106.011328,2848,2,558410,0,2848,4,2849,221,0
20150106.011329,2848,8,558418,6,2848,3,2849,223,0
20150106.01133,2848,6,558424,6,2847,557,2849,228,0
20150106.01133,2848,2,558426,0,2848,11,2849,228,0
20150106.011331,2848,34,558460,-22,2848,45,2849,228,0
20150106.011331,2848,10,558470,10,2848,42,2849,228,0
20150106.011332,2848,6,558476,0,2848,41,2849,233,0
20150106.011333,2847,418,558894,40,2847,395,2849,283,0
20150106.011333,2847,6,558900,2,2847,394,2848,29,0
20150106.011334,2848,106,559006,0,2848,21,2849,283,1
20150106.011335,2849,8,559014,-4,2848,99,2849,283,1
20150106.011336,2848,14,559028,-4,2848,94,2849,282,0
20150106.011336,2848,2,559030,0,2848,93,2849,283,0
20150106.011337,2848,2,559032,-2,2848,95,2849,283,0
20150106.011337,2848,2,559034,-2,2848,114,2849,273,0
20150106.011339,2849,2,559036,0,2848,118,2849,272,1
20150106.011339,2848,46,559082,-18,2848,96,2849,274,0
20150106.01134,2848,12,559094,0,2848,71,2849,274,0
20150106.011341,2848,40,559134,0,2848,51,2849,284,0
20150106.011342,2848,4,559138,0,2848,50,2849,284,0
20150106.011343,2849,4,559142,2,2848,49,2849,283,1
20150106.011343,2848,20,559162,20,2848,40,2849,283,0
20150106.011344,2848,2,559164,2,2848,40,2849,286,0
20150106.011344,2848,6,559170,0,2848,37,2849,636,0
20150106.011345,2848,20,559190,20,2848,27,2849,636,0
20150106.011345,2848,8,559198,8,2848,23,2849,636,0
20150106.011346,2848,2,559200,0,2848,22,2849,634,0
20150106.011347,2848,4,559204,4,2848,20,2849,643,0
20150106.011347,2848,2,559206,0,2848,20,2849,643,0
20150106.011348,2848,40,559246,-6,2847,377,2848,30,0
20150106.011348,2848,8,559254,-8,2847,370,2848,37,0
20150106.011349,2848,2,559256,0,2847,349,2848,61,0
20150106.011351,2847,2,559258,2,2847,358,2848,68,0
20150106.011352,2847,6,559264,2,2847,356,2848,70,0
20150106.011354,2847,78,559342,0,2847,345,2848,73,0
20150106.011356,2847,572,559914,304,2847,60,2848,129,0
20150106.011357,2848,116,560030,-114,2847,40,2848,134,1
20150106.011357,2847,20,560050,-20,2847,38,2848,134,0
20150106.011358,2847,6,560056,-2,2847,36,2848,132,0
20150106.011359,2847,26,560082,-22,2846,1163,2848,148,0
20150106.0114,2847,4,560086,-2,2847,14,2848,146,0
20150106.011402,2847,6,560092,0,2847,7,2848,152,0
20150106.011402,2847,16,560108,-12,2847,3,2848,163,0
20150106.011403,2847,2,560110,2,2847,2,2848,164,0
20150106.011404,2847,10,560120,10,2846,1167,2848,172,0
20150106.011405,2848,8,560128,-6,2847,59,2848,170,1
20150106.011406,2847,2,560130,2,2847,369,2848,166,0
20150106.011407,2847,16,560146,10,2847,366,2848,257,0
20150106.011411,2848,702,560848,44,2847,74,2848,472,1
20150106.011412,2847,4,560852,-4,2847,72,2848,475,0
20150106.011412,2848,100,560952,30,2847,75,2848,425,1
20150106.011413,2847,12,560964,0,2847,69,2848,425,0
20150106.011415,2847,8,560972,0,2847,101,2848,425,0
20150106.011417,2847,2,560974,-2,2847,115,2848,425,0
20150106.011419,2847,10,560984,0,2847,116,2848,444,0
20150106.01142,2847,2,560986,-2,2847,115,2848,444,0
20150106.011423,2847,144,561130,-128,2847,37,2848,453,0
20150106.011423,2847,4,561134,-2,2847,35,2848,475,0
20150106.011424,2847,80,561214,56,2846,1030,2847,219,0
20150106.011424,2846,206,561420,-194,2846,777,2847,219,0
20150106.011425,2846,36,561456,-36,2846,760,2847,219,0
20150106.011425,2846,80,561536,-80,2846,720,2847,219,0
20150106.011426,2846,48,561584,12,2846,697,2847,205,0
20150106.011428,2846,2,561586,0,2846,696,2847,206,0
20150106.011428,2846,4,561590,-2,2846,696,2847,206,0
20150106.011429,2846,4,561594,0,2846,695,2847,206,0
20150106.011429,2846,4,561598,-4,2846,693,2847,206,0
20150106.01143,2847,2,561600,2,2846,692,2847,210,1
20150106.011432,2846,2,561602,0,2846,712,2847,220,0
20150106.011433,2847,2,561604,0,2846,787,2847,224,1
20150106.011433,2847,82,561686,80,2846,787,2847,189,1
20150106.011435,2847,4,561690,0,2846,782,2847,197,1
20150106.011435,2846,14,561704,-8,2846,777,2847,196,0
20150106.011436,2847,10,561714,0,2846,777,2847,192,1
20150106.011437,2846,2,561716,-2,2846,776,2847,193,0
20150106.011438,2847,2,561718,0,2846,786,2847,192,1
20150106.011438,2846,2,561720,-2,2846,784,2847,193,0
20150106.011439,2846,404,562124,-230,2846,582,2847,193,0
20150106.01144,2846,50,562174,8,2846,558,2847,192,0
20150106.01144,2847,2,562176,2,2846,558,2847,191,1
20150106.011441,2847,12,562188,12,2846,553,2847,184,1
20150106.011441,2846,20,562208,0,2846,544,2847,184,0
20150106.011442,2846,200,562408,200,2846,444,2847,184,0
20150106.011443,2846,20,562428,2,2846,453,2847,182,0
20150106.011444,2847,14,562442,14,2846,468,2847,247,1
20150106.011445,2846,26,562468,0,2846,461,2847,247,0
20150106.011445,2846,2,562470,0,2846,460,2847,247,0
20150106.011446,2846,8,562478,0,2846,460,2847,248,0
20150106.011446,2846,2,562480,2,2846,460,2847,258,0
20150106.011447,2846,2,562482,0,2846,460,2847,263,0
20150106.011448,2846,4,562486,0,2846,463,2847,261,0
20150106.011449,2846,12,562498,10,2846,460,2847,263,0
20150106.011449,2846,2,562500,0,2846,460,2847,263,0
20150106.01145,2846,2,562502,0,2846,459,2847,263,0
20150106.011451,2846,2,562504,2,2846,459,2847,273,0
20150106.011451,2846,60,562564,60,2846,429,2847,278,0
20150106.011452,2846,100,562664,0,2846,380,2847,278,0
20150106.011454,2846,36,562700,2,2846,374,2847,278,0
20150106.011455,2846,6,562706,0,2846,375,2847,279,0
20150106.011455,2846,2,562708,2,2846,375,2847,279,0
20150106.011456,2846,50,562758,50,2846,363,2847,300,0
20150106.011458,2846,2,562760,0,2846,385,2847,304,0
20150106.011501,2846,10,562770,4,2846,540,2847,304,0
20150106.011501,2846,4,562774,2,2846,538,2847,306,0
20150106.011502,2846,60,562834,60,2846,510,2847,306,0
20150106.011502,2847,2,562836,0,2846,518,2847,297,1
20150106.011503,2846,2,562838,2,2846,517,2847,296,0
20150106.011503,2846,4,562842,0,2846,516,2847,295,0
20150106.011504,2847,6,562848,0,2846,516,2847,293,1
20150106.011505,2847,10,562858,2,2846,515,2847,289,1
20150106.011509,2847,4,562862,2,2846,528,2847,287,1
20150106.01151,2847,2,562864,2,2846,528,2847,286,1
20150106.011511,2846,2,562866,0,2846,530,2847,291,0
20150106.011511,2847,2,562868,0,2846,530,2847,290,1
20150106.011512,2847,2,562870,0,2846,530,2847,294,1
20150106.011514,2847,70,562940,70,2846,532,2847,286,1
20150106.011515,2846,22,562962,0,2846,526,2847,289,0
20150106.011515,2846,2,562964,2,2846,525,2847,309,0
20150106.011516,2847,6,562970,6,2846,531,2847,307,1
20150106.011516,2847,2,562972,2,2846,531,2847,306,1
20150106.011518,2847,2,562974,0,2846,538,2847,305,1
20150106.011519,2846,2,562976,0,2846,538,2847,305,0
20150106.01152,2847,2,562978,2,2846,538,2847,304,1
20150106.011526,2847,4,562982,4,2846,555,2847,298,1
20150106.011527,2847,4,562986,0,2846,555,2847,296,1
20150106.011527,2846,2,562988,0,2846,554,2847,296,0
20150106.011528,2847,2,562990,2,2846,566,2847,295,1
20150106.01153,2847,56,563046,0,2846,596,2847,277,1
20150106.011531,2847,6,563052,2,2846,595,2847,274,1
20150106.011531,2847,2,563054,2,2846,596,2847,273,1
20150106.011532,2847,10,563064,0,2846,587,2847,268,1
20150106.011532,2847,14,563078,10,2846,587,2847,262,1
20150106.011533,2847,2,563080,0,2846,586,2847,261,1
20150106.011535,2847,38,563118,4,2846,579,2847,242,1
20150106.011535,2847,2,563120,0,2846,584,2847,241,1
20150106.011536,2847,2,563122,0,2846,586,2847,240,1
20150106.011537,2847,2,563124,2,2846,586,2847,241,1
20150106.011539,2847,10,563134,4,2846,601,2847,256,1
20150106.01154,2847,152,563286,-102,2846,603,2847,180,1
20150106.01154,2847,2,563288,0,2846,604,2847,179,1
20150106.011541,2847,358,563646,-160,2846,603,2848,561,1
20150106.011546,2847,2,563648,-2,2847,169,2848,561,1
20150106.011547,2847,2,563650,0,2847,170,2848,561,1
20150106.011548,2847,52,563702,-32,2847,156,2848,561,1
20150106.011549,2848,40,563742,40,2847,163,2848,577,1
20150106.011549,2848,26,563768,-14,2847,159,2848,573,1
20150106.01155,2848,14,563782,-6,2847,210,2848,570,1
20150106.011551,2848,40,563822,30,2847,212,2848,550,1
20150106.011551,2847,30,563852,0,2847,197,2848,550,0
20150106.011552,2848,112,563964,112,2847,198,2848,494,1
20150106.011559,2848,80,564044,80,2847,266,2848,461,1
20150106.011603,2848,10,564054,4,2847,296,2848,456,1
20150106.011605,2848,40,564094,24,2847,301,2848,445,1
20150106.011607,2848,28,564122,28,2847,301,2848,431,1
20150106.011609,2847,2,564124,0,2847,302,2848,431,0
20150106.011611,2847,2,564126,0,2847,302,2848,431,0
20150106.011612,2848,20,564146,20,2847,303,2848,422,1
20150106.011613,2847,6,564152,-6,2847,302,2848,422,0
20150106.011614,2848,12,564164,12,2847,306,2848,416,1
20150106.011615,2848,200,564364,200,2847,313,2848,314,1
20150106.011617,2848,2,564366,0,2847,303,2848,321,1
20150106.011619,2848,2,564368,2,2847,306,2848,318,1
20150106.01162,2847,2,564370,0,2847,333,2848,316,0
20150106.011623,2848,6,564376,0,2847,334,2848,314,1
20150106.011624,2848,2,564378,0,2847,337,2848,313,1
20150106.011625,2848,8,564386,8,2847,320,2848,310,1
20150106.011626,2848,20,564406,20,2847,321,2848,299,1
20150106.011627,2848,2,564408,0,2847,322,2848,298,1
20150106.011629,2848,2,564410,2,2847,322,2848,297,1
20150106.011632,2847,300,564710,176,2847,165,2848,302,0
20150106.011632,2847,20,564730,-20,2847,156,2848,302,0
20150106.011634,2847,2,564732,0,2847,166,2848,302,0
20150106.011634,2847,12,564744,-6,2847,160,2848,302,0
20150106.011635,2848,2,564746,2,2847,166,2848,302,1
20150106.011636,2847,2,564748,0,2847,166,2848,303,0
20150106.011636,2847,2,564750,0,2847,173,2848,303,0
20150106.011638,2847,2,564752,-2,2847,223,2848,303,0
20150106.01164,2847,4,564756,-4,2847,221,2848,302,0
20150106.01164,2847,4,564760,-2,2847,220,2848,301,0
20150106.01164,2847,2,564762,-2,2847,219,2848,302,0
20150106.011641,2848,2,564764,0,2847,219,2848,339,1
20150106.011642,2847,102,564866,12,2847,168,2848,339,0
20150106.011642,2847,2,564868,0,2847,204,2848,339,0
20150106.011643,2847,2,564870,0,2847,203,2848,339,0
20150106.011644,2847,134,565004,-74,2847,132,2848,338,0
20150106.011645,2847,4,565008,0,2847,130,2848,339,0
20150106.011647,2847,2,565010,0,2847,129,2848,338,0
20150106.011647,2848,80,565090,0,2847,129,2848,298,1
20150106.011648,2847,24,565114,-16,2847,117,2848,298,0
20150106.011649,2847,84,565198,84,2847,116,2848,258,0
20150106.01165,2848,10,565208,10,2847,115,2848,255,1
20150106.011651,2847,2,565210,2,2847,115,2848,255,0
20150106.011653,2848,10,565220,0,2847,115,2848,250,1
20150106.011702,2848,18,565238,18,2847,179,2848,310,1
20150106.011702,2847,10,565248,10,2847,174,2848,310,0
20150106.011704,2847,2,565250,0,2847,173,2848,310,0
20150106.011705,2848,60,565310,0,2847,193,2848,280,1
20150106.011708,2847,2,565312,2,2847,195,2848,280,0
20150106.011712,2847,2,565314,2,2847,207,2848,280,0
20150106.011715,2847,2,565316,2,2847,209,2848,304,0
20150106.011719,2848,600,565916,-314,2847,236,2848,14,1
20150106.01172,2848,8,565924,8,2847,236,2849,851,1
20150106.01172,2848,22,565946,20,2848,1,2849,851,1
20150106.011721,2848,4,565950,2,2848,3,2849,851,1
20150106.011722,2848,6,565956,0,2848,1,2849,851,1
20150106.011722,2848,2,565958,0,2847,239,2849,851,1
20150106.011723,2849,4,565962,-2,2847,239,2848,10,1
20150106.011723,2849,2,565964,0,2847,240,2848,2,1
20150106.011724,2848,8,565972,4,2847,239,2848,10,0
20150106.011724,2848,2,565974,2,2847,240,2849,850,0
20150106.011726,2848,12,565986,-6,2847,240,2848,46,0
20150106.011727,2848,26,566012,-16,2847,321,2848,37,0
20150106.011728,2848,2,566014,-2,2847,345,2848,36,0
20150106.011729,2848,2,566016,-2,2847,346,2848,35,0
20150106.011729,2848,2,566018,-2,2847,346,2848,34,0
20150106.011731,2848,40,566058,-40,2847,396,2848,14,0
20150106.011732,2848,8,566066,-2,2847,366,2848,10,0
20150106.011733,2848,60,566126,4,2848,2,2849,851,0
20150106.011734,2848,10,566136,-8,2847,366,2849,850,0
20150106.011736,2848,2,566138,0,2847,386,2848,5,0
20150106.011738,2848,14,566152,10,2848,42,2849,850,0
20150106.011739,2848,86,566238,82,2847,383,2849,850,0
20150106.01174,2848,96,566334,86,2847,385,2849,850,0
20150106.011742,2848,6,566340,4,2848,11,2849,851,0
20150106.011743,2847,40,566380,-6,2847,379,2849,851,0
20150106.011744,2848,24,566404,6,2847,380,2848,3,1
20150106.011746,2848,10,566414,4,2848,6,2849,851,1
20150106.011747,2848,8,566422,4,2848,2,2849,851,1
20150106.011748,2848,4,566426,2,2847,388,2849,851,1
20150106.011748,2848,4,566430,4,2847,388,2849,851,1
20150106.01175,2848,2,566432,-2,2848,2,2849,850,1
20150106.011751,2848,2,566434,2,2848,3,2849,850,1
20150106.011754,2848,2,566436,0,2848,2,2849,860,1
20150106.011754,2848,4,566440,0,2847,388,2848,8,1
20150106.011755,2848,20,566460,-20,2847,388,2849,861,1
20150106.011757,2848,2,566462,2,2848,1,2849,861,1
20150106.011757,2849,2,566464,2,2848,1,2849,861,1
20150106.011801,2848,10,566474,0,2848,13,2849,863,0
20150106.011801,2848,6,566480,0,2848,10,2849,864,0
20150106.011803,2848,2,566482,2,2848,10,2849,864,0
20150106.011805,2848,2,566484,2,2848,10,2849,864,0
20150106.011806,2848,26,566510,16,2847,363,2848,1,0
20150106.011806,2848,2,566512,0,2847,364,2849,864,0
20150106.011806,2849,2,566514,2,2847,363,2849,863,1
20150106.011807,2848,2,566516,0,2847,363,2849,863,0
20150106.011808,2848,24,566540,-20,2847,364,2849,863,0
20150106.011809,2848,2,566542,0,2847,364,2849,868,0
20150106.011809,2848,2,566544,0,2847,364,2848,10,0
20150106.01181,2848,2,566546,0,2847,363,2849,868,0
20150106.011811,2848,6,566552,4,2848,2,2849,868,0
20150106.011812,2848,4,566556,0,2847,363,2849,868,0
20150106.011813,2848,2,566558,0,2848,500,2849,868,0
20150106.011813,2848,6,566564,-2,2848,497,2849,866,0
20150106.011815,2848,262,566826,-80,2848,367,2849,867,0
20150106.011816,2848,8,566834,0,2848,363,2849,867,0
20150106.011819,2848,748,567582,-738,2847,370,2848,9,0
20150106.011819,2848,64,567646,-18,2848,70,2849,867,0
20150106.01182,2848,4,567650,-4,2848,68,2849,867,0
20150106.01182,2848,8,567658,0,2848,64,2849,867,0
20150106.011821,2848,130,567788,0,2847,253,2848,21,0
20150106.011823,2848,4,567792,4,2847,253,2848,38,0
20150106.011825,2848,2,567794,2,2847,252,2848,167,0
20150106.011825,2848,2,567796,2,2847,241,2848,167,0
20150106.011827,2848,2,567798,0,2847,241,2848,168,0
20150106.011828,2847,2,567800,0,2847,240,2848,692,0
20150106.011829,2847,20,567820,-10,2847,231,2848,722,0
20150106.011831,2847,42,567862,42,2847,189,2848,850,0
20150106.011832,2847,8,567870,6,2847,183,2848,877,0
20150106.011833,2847,2,567872,2,2847,182,2848,880,0
20150106.011834,2847,8,567880,8,2847,178,2848,859,0
20150106.011834,2847,52,567932,0,2847,152,2848,859,0
20150106.011835,2847,2,567934,2,2847,154,2848,859,0
20150106.011836,2847,82,568016,-80,2847,113,2848,860,0
20150106.011837,2847,12,568028,-12,2847,106,2848,859,0
20150106.011837,2847,14,568042,-12,2847,99,2848,861,0
20150106.011838,2847,80,568122,0,2847,59,2848,853,0
20150106.011839,2847,12,568134,-12,2847,53,2848,837,0
20150106.011839,2847,2,568136,0,2847,52,2848,837,0
20150106.011839,2847,2,568138,-2,2847,51,2848,836,0
20150106.01184,2847,10,568148,10,2847,47,2848,836,0
20150106.011841,2847,4,568152,2,2847,45,2848,841,0
20150106.011841,2847,30,568182,28,2847,30,2848,848,0
20150106.011842,2847,44,568226,-34,2847,8,2848,848,0
20150106.011842,2847,56,568282,-12,2846,855,2847,2,0
20150106.011843,2847,8,568290,-6,2846,855,2847,1,0
20150106.011843,2846,4,568294,2,2846,855,2848,898,0
20150106.011844,2847,20,568314,0,2847,492,2848,888,1
20150106.011845,2847,10,568324,-10,2847,487,2848,887,1
20150106.011847,2847,6,568330,-6,2847,485,2848,885,1
20150106.011848,2847,42,568372,-42,2847,464,2848,885,1
20150106.011849,2848,6,568378,2,2847,464,2848,884,1
20150106.011851,2847,2,568380,0,2847,468,2848,883,0
20150106.011852,2847,2,568382,-2,2847,467,2848,893,0
20150106.011857,2847,18,568400,-8,2847,459,2848,897,0
20150106.011858,2847,2,568402,-2,2847,460,2848,905,0
20150106.011858,2848,2,568404,2,2847,460,2848,904,1
20150106.011859,2847,2,568406,0,2847,459,2848,904,0
20150106.0119,2847,10,568416,-10,2847,454,2848,905,0
20150106.011902,2847,918,569334,6,2846,1361,2847,542,0
20150106.011902,2847,312,569646,312,2846,1361,2847,386,0
20150106.011905,2847,4,569650,0,2846,1361,2847,385,0
20150106.011906,2846,4,569654,0,2846,1349,2847,895,0
20150106.011908,2847,4,569658,2,2846,1349,2847,1023,1
20150106.01191,2847,2,569660,2,2846,1338,2847,1023,1
20150106.011911,2846,4,569664,2,2846,1336,2847,1022,0
20150106.011912,2846,106,569770,2,2846,1333,2847,972,0
20150106.011916,2846,14,569784,4,2846,1328,2847,1014,0
20150106.011916,2846,2,569786,2,2846,1326,2847,1024,0
20150106.011919,2846,2,569788,0,2846,1325,2847,1024,0
20150106.01192,2846,2,569790,0,2846,1324,2847,1024,0
20150106.011923,2846,100,569890,86,2846,1275,2847,1035,0
20150106.011924,2846,2,569892,2,2846,1274,2847,1035,0
20150106.011927,2846,500,570392,-236,2846,1023,2847,1084,0
20150106.011928,2847,4,570396,0,2846,1023,2847,1082,1
20150106.011929,2846,8,570404,0,2846,1019,2847,1083,0
20150106.011934,2846,10,570414,0,2846,1012,2847,1089,0
20150106.011936,2846,1002,571416,834,2846,512,2847,591,0
20150106.011937,2846,2,571418,2,2846,520,2847,628,0
20150106.011937,2846,8,571426,0,2846,516,2847,628,0
20150106.011938,2846,8,571434,0,2846,505,2847,627,0
20150106.011939,2847,1294,572728,-360,2847,354,2848,321,1
20150106.011939,2847,32,572760,0,2847,348,2848,311,1
20150106.01194,2847,14,572774,-4,2847,331,2848,306,1
20150106.011941,2847,10,572784,-10,2847,326,2848,309,1
20150106.011942,2847,2,572786,0,2847,325,2848,311,1
20150106.011942,2847,2,572788,0,2847,334,2848,311,1
20150106.011944,2847,22,572810,0,2847,334,2848,312,1
20150106.011945,2847,12,572822,-12,2847,318,2848,332,1
20150106.011947,2848,2,572824,2,2847,319,2848,320,1
20150106.011949,2847,2,572826,0,2847,318,2848,323,0
20150106.011951,2847,10,572836,-6,2847,320,2848,322,0
20150106.011952,2847,2,572838,0,2847,319,2848,322,0
20150106.011953,2847,20,572858,0,2847,309,2848,330,0
20150106.011958,2847,2,572860,-2,2847,309,2848,374,0
20150106.012004,2847,2,572862,0,2847,311,2848,407,0
20150106.012005,2848,4,572866,2,2847,341,2848,396,1
20150106.012008,2848,4,572870,0,2847,342,2848,385,1
20150106.012009,2847,4,572874,-4,2847,347,2848,386,0
20150106.012012,2848,4,572878,0,2847,348,2848,384,1
20150106.012017,2848,2,572880,2,2847,351,2848,367,1
20150106.012026,2848,10,572890,0,2847,354,2848,362,1
20150106.012028,2848,2,572892,-2,2847,354,2848,379,1
20150106.012029,2847,430,573322,0,2847,129,2848,389,0
20150106.01203,2847,258,573580,-180,2846,529,2847,29,0
20150106.012033,2847,2,573582,-2,2846,533,2847,29,0
20150106.012034,2847,58,573640,-56,2846,533,2848,414,0
20150106.012034,2847,2,573642,0,2846,533,2848,424,0
20150106.01204,2846,2,573644,-2,2846,531,2848,420,0
20150106.012041,2847,82,573726,-80,2846,532,2848,420,1
20150106.012042,2847,8,573734,-6,2846,532,2848,420,1
20150106.012043,2846,2,573736,-2,2846,531,2848,420,0
20150106.012044,2847,2,573738,-2,2846,532,2847,1,1
20150106.012044,2847,8,573746,0,2846,530,2848,419,1
20150106.012046,2847,44,573790,20,2847,60,2848,418,1
20150106.012047,2848,2,573792,-2,2847,60,2848,417,1
20150106.012047,2847,2,573794,0,2847,59,2848,417,0
20150106.012047,2847,2,573796,2,2847,58,2848,417,0
20150106.012048,2847,4,573800,4,2847,56,2848,447,0
20150106.012049,2847,2,573802,0,2847,56,2848,447,0
20150106.012051,2847,4,573806,0,2847,55,2848,446,0
20150106.012052,2847,20,573826,20,2847,45,2848,530,0
20150106.012052,2847,4,573830,2,2847,43,2848,530,0
20150106.012053,2847,26,573856,26,2847,32,2848,530,0
20150106.012053,2847,4,573860,0,2847,30,2848,530,0
20150106.012054,2847,4,573864,0,2847,29,2848,532,0
20150106.012055,2848,80,573944,-74,2847,29,2848,492,1
20150106.012056,2847,2,573946,0,2847,28,2848,492,0
20150106.012056,2848,80,574026,0,2847,28,2848,452,1
20150106.012058,2847,14,574040,14,2847,22,2848,455,0
20150106.012102,2847,2,574042,2,2847,24,2848,456,0
20150106.012103,2847,30,574072,26,2847,9,2848,458,0
20150106.012105,2847,20,574092,10,2847,6,2848,458,0
20150106.012106,2847,2,574094,0,2847,5,2848,458,0
20150106.012106,2847,10,574104,0,2846,546,2848,458,0
20150106.012114,2847,4,574108,-4,2847,15,2848,449,0
20150106.012117,2847,2,574110,0,2847,68,2848,454,0
20150106.01212,2847,2,574112,-2,2847,74,2848,453,0
20150106.012124,2847,2,574114,0,2847,73,2848,454,0
20150106.012125,2847,2,574116,-2,2847,74,2848,456,0
20150106.012128,2847,4,574120,-4,2847,72,2848,454,0
20150106.012131,2847,2,574122,-2,2847,81,2848,458,0
20150106.012134,2847,6,574128,0,2847,79,2848,459,0
20150106.01214,2848,4,574132,-4,2847,77,2848,459,1
20150106.012146,2847,2,574134,0,2847,124,2848,468,0
20150106.012152,2847,2,574136,0,2847,132,2848,468,0
20150106.012153,2847,2,574138,-2,2847,132,2848,468,0
20150106.012159,2847,200,574338,10,2847,40,2848,468,0
20150106.012201,2847,2,574340,0,2847,39,2848,470,0
20150106.012204,2847,4,574344,-4,2847,37,2848,584,0
20150106.012205,2847,40,574384,0,2847,17,2848,584,0
20150106.012206,2847,2,574386,2,2847,16,2848,584,0
20150106.012209,2847,2,574388,2,2847,16,2848,585,0
20150106.012209,2847,2,574390,2,2847,26,2848,585,0
20150106.012211,2847,20,574410,-18,2847,56,2848,586,0
20150106.012213,2847,20,574430,12,2847,46,2848,585,0
20150106.012214,2847,4,574434,4,2847,44,2848,585,0
20150106.012215,2847,2,574436,0,2847,43,2848,585,0
20150106.012216,2847,20,574456,20,2847,85,2848,581,0
20150106.012217,2847,16,574472,16,2847,77,2848,581,0
20150106.012225,2847,2,574474,0,2847,77,2848,586,0
20150106.012227,2847,2,574476,2,2847,76,2848,575,0
20150106.01223,2847,20,574496,20,2847,92,2848,597,0
20150106.012233,2848,2,574498,-2,2847,93,2848,595,1
20150106.012233,2847,6,574504,0,2847,90,2848,595,0
20150106.012235,2847,2,574506,2,2847,90,2848,595,0
20150106.012245,2847,2,574508,2,2847,92,2848,608,0
20150106.012247,2848,2,574510,0,2847,92,2848,607,1
20150106.012248,2847,2,574512,0,2847,91,2848,607,0
20150106.012251,2848,14,574526,-14,2847,91,2848,601,1
20150106.012255,2848,2,574528,-2,2847,101,2848,600,1
20150106.012311,2848,2,574530,-2,2847,135,2848,599,1
20150106.012318,2847,2,574532,0,2847,140,2848,600,0
20150106.012319,2847,2,574534,2,2847,139,2848,600,0
20150106.01232,2847,10,574544,10,2847,134,2848,600,0
20150106.012322,2848,2,574546,-2,2847,135,2848,596,1
20150106.012324,2847,2,574548,0,2847,134,2848,596,0
20150106.012328,2847,4,574552,0,2847,138,2848,597,0
20150106.012329,2847,20,574572,0,2847,128,2848,597,0
20150106.012333,2848,10,574582,-10,2847,121,2848,592,1
20150106.012336,2847,2,574584,0,2847,125,2848,632,0
20150106.012338,2847,16,574600,-16,2847,117,2848,634,0
20150106.01234,2847,4,574604,-4,2847,115,2848,634,0
20150106.012342,2847,2,574606,-2,2847,113,2848,657,0
20150106.012345,2848,16,574622,-14,2847,113,2848,649,1
20150106.012349,2848,40,574662,-18,2847,113,2848,630,1
20150106.01235,2848,2,574664,-2,2847,113,2848,629,1
20150106.012353,2847,2,574666,-2,2847,112,2848,629,0
20150106.012358,2847,4,574670,-4,2847,112,2848,629,0
20150106.012406,2847,2,574672,-2,2847,112,2848,641,0
20150106.012409,2847,40,574712,0,2847,91,2848,711,0
20150106.01241,2847,182,574894,-128,2846,547,2847,244,0
20150106.012416,2846,496,575390,-492,2846,290,2847,10,0
20150106.012419,2846,2,575392,-2,2846,294,2847,15,0
20150106.012422,2847,4,575396,2,2846,294,2847,16,1
20150106.012423,2847,12,575408,0,2846,294,2847,10,1
20150106.012425,2846,2,575410,0,2846,293,2847,15,0
20150106.012427,2846,2,575412,-2,2846,292,2847,19,0
20150106.01243,2847,12,575424,-2,2846,291,2847,14,1
20150106.012434,2847,4,575428,-4,2846,292,2847,70,1
20150106.012436,2847,2,575430,0,2846,292,2847,72,1
20150106.012438,2847,2,575432,0,2846,293,2847,81,1
20150106.012439,2847,2,575434,-2,2846,293,2847,87,1
20150106.01244,2847,2,575436,0,2846,293,2847,87,1
20150106.012443,2847,2,575438,2,2846,298,2847,86,1
20150106.012445,2847,2,575440,0,2846,298,2847,96,1
20150106.012447,2846,8,575448,-2,2846,294,2847,100,0
20150106.01251,2847,2,575450,0,2846,297,2847,139,1
20150106.012514,2846,42,575492,0,2846,278,2847,191,0
20150106.012515,2846,6,575498,-6,2846,276,2847,181,0
20150106.012517,2847,2,575500,0,2846,277,2847,180,1
20150106.012517,2847,2,575502,2,2846,277,2847,180,1
20150106.012522,2846,568,576070,-502,2845,600,2846,114,0
20150106.012522,2846,60,576130,-60,2845,600,2846,87,0
20150106.012523,2846,174,576304,-174,2845,600,2847,192,0
20150106.012524,2846,2,576306,0,2845,595,2847,192,0
20150106.012526,2846,2,576308,0,2846,6,2847,195,0
20150106.01253,2846,2,576310,0,2846,58,2847,200,0
20150106.012531,2846,2,576312,0,2846,61,2847,199,0
20150106.012532,2846,10,576322,-8,2846,76,2847,225,0
20150106.012537,2846,8,576330,0,2846,73,2847,224,0
20150106.01254,2847,2,576332,0,2846,130,2847,222,1
20150106.012544,2847,2,576334,0,2846,164,2847,175,1
20150106.012546,2846,6,576340,-6,2846,165,2847,177,0
20150106.012548,2847,2,576342,0,2846,196,2847,193,1
20150106.012548,2847,4,576346,0,2846,197,2847,191,1
20150106.012549,2846,2,576348,0,2846,196,2847,191,0
20150106.012552,2847,2,576350,0,2846,203,2847,191,1
20150106.012555,2847,2,576352,0,2846,231,2847,191,1
20150106.012557,2847,2,576354,-2,2846,238,2847,190,1
20150106.012558,2847,2,576356,0,2846,240,2847,189,1
20150106.012601,2847,2,576358,0,2846,240,2847,208,1
20150106.012603,2847,2,576360,0,2846,245,2847,207,1
20150106.012606,2847,12,576372,0,2846,273,2847,214,1
20150106.012612,2847,2,576374,-2,2846,264,2847,213,1
20150106.012615,2846,2,576376,-2,2846,264,2847,214,0
20150106.012617,2847,2,576378,-2,2846,264,2847,214,1
20150106.012618,2847,2,576380,-2,2846,264,2847,213,1
20150106.012619,2846,2,576382,0,2846,264,2847,213,0
20150106.012627,2846,4,576386,0,2846,256,2847,290,0
20150106.012628,2846,2,576388,-2,2846,254,2847,290,0
20150106.012631,2846,20,576408,-20,2846,245,2847,290,0
20150106.012643,2846,20,576428,0,2846,248,2847,289,0
20150106.012646,2846,2,576430,0,2846,253,2847,289,0
20150106.012649,2846,102,576532,-100,2846,202,2847,292,0
20150106.012651,2846,2,576534,-2,2846,201,2847,292,0
20150106.012652,2846,2,576536,-2,2846,200,2847,307,0
20150106.012653,2846,2,576538,-2,2846,199,2847,307,0
20150106.012702,2846,6,576544,-6,2846,196,2847,307,0
20150106.012703,2846,10,576554,-10,2846,193,2847,308,0
20150106.012704,2846,10,576564,-10,2846,188,2847,308,0
20150106.012706,2847,128,576692,-54,2846,188,2847,300,1
20150106.012708,2847,4,576696,-4,2846,187,2847,298,1
20150106.012713,2846,2,576698,-2,2846,189,2847,298,0
20150106.012713,2846,8,576706,0,2846,185,2847,344,0
20150106.012714,2846,4,576710,4,2846,185,2847,342,0
20150106.012716,2846,12,576722,-12,2846,179,2847,372,0
20150106.012717,2846,90,576812,60,2846,135,2847,328,0
20150106.012719,2846,2,576814,0,2846,135,2847,338,0
20150106.012722,2846,2,576816,0,2846,124,2847,338,0
20150106.012724,2847,104,576920,46,2846,74,2847,336,1
20150106.01273,2847,2,576922,0,2846,88,2847,342,1
20150106.012732,2846,12,576934,-2,2846,87,2847,548,0
20150106.012737,2847,2,576936,-2,2846,88,2847,334,1
20150106.012737,2846,60,576996,0,2846,58,2847,314,0
20150106.012738,2846,2,576998,0,2846,57,2847,314,0
20150106.012738,2846,2,577000,-2,2846,56,2847,314,0
20150106.01274,2847,42,577042,-28,2846,36,2847,313,1
20150106.012741,2846,20,577062,-20,2846,26,2847,316,0
20150106.012742,2846,2,577064,0,2846,25,2847,316,0
20150106.012743,2846,74,577138,12,2845,1582,2846,4,0
20150106.012743,2846,8,577146,-8,2846,10,2847,306,0
20150106.012744,2846,2,577148,-2,2846,1,2847,316,0
20150106.012745,2846,2,577150,2,2846,1,2847,316,0
20150106.012746,2846,2,577152,-2,2846,3,2847,316,0
20150106.012746,2846,2,577154,0,2846,2,2847,315,0
20150106.012747,2846,8,577162,-2,2845,1582,2847,315,0
20150106.01275,2846,2,577164,-2,2846,15,2847,315,0
20150106.012751,2847,10,577174,0,2846,19,2847,310,1
20150106.012752,2846,24,577198,-4,2846,7,2847,310,0
20150106.012754,2846,38,577236,24,2845,1581,2846,1,0
20150106.012754,2846,16,577252,2,2846,76,2847,304,0
20150106.012801,2846,10,577262,10,2846,159,2847,301,0
20150106.012801,2846,2,577264,0,2846,158,2847,303,0
20150106.012805,2846,46,577310,0,2846,163,2847,309,0
20150106.012807,2846,220,577530,-4,2846,54,2847,309,0
20150106.012807,2846,4,577534,0,2846,52,2847,309,0
20150106.012809,2846,12,577546,10,2846,48,2847,302,0
20150106.01281,2846,6,577552,2,2846,56,2847,317,0
20150106.012811,2846,46,577598,-4,2846,33,2847,317,0
20150106.012811,2846,2,577600,2,2846,32,2847,317,0
20150106.012812,2846,10,577610,0,2846,27,2847,317,0
20150106.012813,2846,16,577626,-2,2846,19,2847,317,0
20150106.012814,2846,12,577638,-12,2846,13,2847,312,0
20150106.012814,2846,4,577642,4,2846,12,2847,312,0
20150106.012815,2846,2,577644,0,2846,11,2847,312,0
20150106.012816,2846,4,577648,0,2846,9,2847,313,0
20150106.012819,2846,18,577666,-16,2846,6,2847,409,0
20150106.012819,2846,12,577678,4,2845,1590,2846,14,0
20150106.01282,2846,32,577710,28,2845,1590,2847,409,0
20150106.012822,2846,12,577722,-12,2846,35,2847,609,0
20150106.012823,2847,2,577724,-2,2846,35,2847,608,1
20150106.012825,2846,4,577728,0,2846,33,2847,409,0
20150106.012827,2846,48,577776,-48,2846,11,2847,431,0
20150106.012829,2846,20,577796,-18,2846,2,2847,431,0
20150106.01283,2846,2,577798,0,2846,1,2847,432,0
20150106.012831,2846,14,577812,-12,2846,564,2847,632,0
20150106.012832,2846,2,577814,-2,2846,563,2847,632,0
20150106.012833,2847,4,577818,0,2846,563,2847,420,1
20150106.012837,2846,2,577820,-2,2846,575,2847,402,0
20150106.012839,2846,2,577822,-2,2846,588,2847,402,0
20150106.012839,2846,32,577854,-2,2846,573,2847,406,0
20150106.01284,2847,2,577856,0,2846,573,2847,405,1
20150106.012842,2847,10,577866,-10,2846,573,2847,400,1
20150106.012842,2846,2,577868,-2,2846,572,2847,401,0
20150106.012844,2846,2,577870,-2,2846,582,2847,396,0
20150106.012845,2847,8,577878,-8,2846,582,2847,392,1
20150106.012846,2847,170,578048,54,2846,582,2847,307,1
20150106.012847,2847,6,578054,-6,2846,582,2847,304,1
20150106.012848,2847,2,578056,-2,2846,582,2847,303,1
20150106.012848,2846,2,578058,-2,2846,581,2847,303,0
20150106.012849,2847,42,578100,4,2846,580,2847,293,1
20150106.012849,2847,2,578102,0,2846,580,2847,292,1
20150106.01285,2847,80,578182,72,2846,580,2847,252,1
20150106.01285,2847,22,578204,0,2846,580,2847,241,1
20150106.012851,2847,2,578206,2,2846,580,2847,240,1
20150106.012851,2847,6,578212,2,2846,581,2847,237,1
20150106.012852,2847,80,578292,78,2846,583,2847,197,1
20150106.012853,2847,2,578294,0,2846,583,2847,196,1
20150106.012853,2847,2,578296,0,2846,583,2847,195,1
20150106.012854,2847,2,578298,0,2846,583,2847,194,1
20150106.012854,2847,16,578314,10,2846,583,2847,186,1
20150106.012856,2847,6,578320,-2,2846,572,2847,183,1
20150106.012857,2847,6,578326,0,2846,574,2847,180,1
20150106.012858,2847,2,578328,0,2846,574,2847,179,1
20150106.012859,2846,8,578336,-2,2846,572,2847,177,0
20150106.0129,2847,2,578338,-2,2846,582,2847,176,1
20150106.012901,2847,8,578346,-2,2846,582,2847,172,1
20150106.012904,2846,140,578486,-100,2846,545,2847,152,0
20150106.012905,2847,6,578492,0,2846,545,2847,151,1
20150106.012905,2847,6,578498,4,2846,545,2847,148,1
20150106.012905,2847,2,578500,0,2846,545,2847,147,1
20150106.012906,2846,6,578506,-6,2846,544,2847,148,0
20150106.012906,2847,2,578508,2,2846,544,2847,147,1
20150106.012908,2847,2,578510,0,2846,542,2847,146,1
20150106.012908,2847,6,578516,6,2846,542,2847,143,1
20150106.012909,2847,40,578556,40,2846,541,2847,123,1
20150106.012911,2847,92,578648,46,2846,544,2847,77,1
20150106.012913,2846,18,578666,-2,2846,548,2847,70,0
20150106.012913,2847,8,578674,2,2846,548,2847,66,1
20150106.012914,2847,46,578720,2,2846,548,2847,46,1
20150106.012914,2847,10,578730,-4,2846,548,2847,41,1
20150106.012915,2847,2,578732,2,2846,548,2847,41,1
20150106.012915,2847,54,578786,30,2846,548,2847,16,1
20150106.012916,2847,32,578818,-26,2847,3,2848,450,1
20150106.012916,2847,6,578824,-2,2846,549,2847,48,1
20150106.012917,2847,22,578846,-22,2846,549,2847,38,1
20150106.012919,2847,2,578848,0,2846,559,2847,348,1
20150106.01292,2846,2,578850,-2,2846,548,2847,358,0
20150106.012921,2847,2,578852,0,2846,548,2847,357,1
20150106.012922,2846,70,578922,-70,2846,512,2847,323,0
20150106.012925,2847,8,578930,6,2846,506,2847,319,1
20150106.012928,2846,8,578938,0,2846,501,2847,319,0
20150106.012929,2847,2,578940,0,2846,503,2847,319,1
20150106.01293,2846,2,578942,-2,2846,502,2847,319,0
20150106.012934,2847,10,578952,0,2846,517,2847,314,1
20150106.01294,2846,6,578958,-6,2846,516,2847,119,0
20150106.01294,2847,10,578968,0,2846,516,2847,114,1
20150106.012942,2847,10,578978,0,2846,507,2847,109,1
20150106.012943,2847,6,578984,6,2846,520,2847,106,1
20150106.012944,2847,2,578986,0,2846,520,2847,105,1
20150106.012947,2847,4,578990,4,2846,628,2847,103,1
20150106.012948,2847,2,578992,2,2846,628,2847,102,1
20150106.012949,2846,4,578996,-4,2846,631,2847,101,0
20150106.012955,2847,2,578998,2,2846,635,2847,130,1
20150106.012955,2847,12,579010,0,2846,635,2847,124,1
20150106.012956,2847,52,579062,0,2846,635,2847,398,1
20150106.012956,2846,140,579202,-60,2846,585,2847,378,0
20150106.013001,2846,432,579634,-432,2846,370,2847,382,0
20150106.013002,2847,76,579710,-6,2846,360,2847,544,1
20150106.013002,2847,30,579740,8,2846,360,2847,549,1
20150106.013003,2847,10,579750,10,2846,360,2847,544,1
20150106.013003,2847,24,579774,24,2846,360,2847,332,1
20150106.013015,2847,2,579776,0,2846,731,2847,325,1
20150106.013019,2847,4,579780,0,2846,732,2847,323,1
20150106.01302,2847,2,579782,2,2846,734,2847,322,1
20150106.013023,2847,2,579784,2,2846,734,2847,321,1
20150106.013026,2846,2,579786,-2,2846,733,2847,332,0
20150106.013028,2847,8,579794,0,2846,733,2847,328,1
20150106.013031,2847,656,580450,546,2847,56,2848,444,1
20150106.013033,2847,2,580452,0,2847,56,2848,444,1
20150106.013041,2848,2,580454,-2,2847,70,2848,442,1
20150106.013041,2848,2,580456,-2,2847,73,2848,441,1
20150106.013053,2848,2,580458,-2,2847,684,2848,440,1
20150106.013056,2848,24,580482,2,2847,695,2848,428,1
20150106.013056,2848,886,581368,-682,2848,562,2849,403,1
20150106.013058,2848,30,581398,0,2848,547,2849,403,1
20150106.013059,2848,32,581430,-30,2848,531,2849,403,1
20150106.013103,2849,10,581440,0,2848,533,2849,398,1
20150106.013103,2849,2,581442,-2,2848,533,2849,397,1
20150106.013104,2849,2,581444,-2,2848,533,2849,406,1
20150106.013105,2849,24,581468,12,2848,544,2849,394,1
20150106.013106,2849,4,581472,-4,2848,544,2849,382,1
20150106.013107,2849,22,581494,0,2848,544,2849,381,1
20150106.013107,2848,4,581498,-4,2848,542,2849,381,0
20150106.013109,2849,2,581500,0,2848,543,2849,380,1
20150106.013109,2849,4,581504,0,2848,543,2849,378,1
20150106.01311,2849,6,581510,0,2848,543,2849,384,1
20150106.013113,2849,100,581610,0,2848,562,2849,334,1
20150106.013113,2849,2,581612,0,2848,562,2849,333,1
20150106.013114,2848,20,581632,-20,2848,552,2849,333,0
20150106.013114,2849,90,581722,-86,2848,553,2849,288,1
20150106.013115,2849,2,581724,0,2848,553,2849,287,1
20150106.013116,2849,180,581904,-180,2848,553,2849,214,1
20150106.013116,2849,24,581928,-8,2848,553,2849,202,1
20150106.013117,2849,2,581930,-2,2848,553,2849,201,1
20150106.013118,2849,8,581938,0,2848,553,2849,200,1
20150106.01312,2849,2,581940,-2,2848,553,2849,199,1
20150106.01312,2849,2,581942,0,2848,553,2849,201,1
20150106.013121,2848,40,581982,-38,2848,541,2849,201,0
20150106.013122,2849,10,581992,0,2848,541,2849,196,1
20150106.013123,2849,8,582000,-8,2848,541,2849,192,1
20150106.013125,2849,2,582002,0,2848,33,2849,565,1
20150106.013126,2848,2,582004,-2,2848,32,2849,565,0
20150106.013128,2848,2,582006,2,2848,31,2849,565,0
20150106.01313,2848,8,582014,2,2848,43,2849,564,0
20150106.01313,2849,200,582214,6,2848,43,2849,464,1
20150106.013132,2848,20,582234,0,2848,53,2849,464,0
20150106.013133,2849,2,582236,0,2848,53,2849,548,1
20150106.013133,2848,2,582238,2,2848,52,2849,548,0
20150106.013136,2848,80,582318,-20,2848,13,2849,548,0
20150106.013139,2848,18,582336,-12,2848,4,2849,549,0
20150106.01314,2848,2,582338,0,2848,3,2849,549,0
20150106.01314,2848,6,582344,-4,2847,770,2848,2,0
20150106.01314,2848,6,582350,-6,2847,820,2849,550,0
20150106.013144,2848,2,582352,0,2848,7,2849,550,0
20150106.013146,2848,4,582356,-2,2848,13,2849,550,0
20150106.013148,2848,2,582358,0,2848,12,2849,550,0
20150106.013149,2848,2,582360,0,2848,12,2849,570,0
20150106.013151,2848,2,582362,2,2848,11,2849,570,0
20150106.013151,2848,4,582366,4,2848,9,2849,570,0
20150106.013153,2848,44,582410,-42,2847,875,2848,1,0
20150106.013157,2847,20,582430,0,2847,865,2848,34,0
20150106.013201,2848,10,582440,-10,2847,864,2848,81,1
20150106.013201,2848,16,582456,0,2847,864,2848,73,1
20150106.013204,2848,2,582458,0,2847,864,2848,78,1
20150106.013208,2848,162,582620,-58,2848,919,2849,557,1
20150106.013208,2848,2,582622,0,2848,929,2849,547,1
20150106.013211,2848,2,582624,0,2848,946,2849,547,1
20150106.013214,2848,2,582626,-2,2848,943,2849,547,1
20150106.013215,2849,2,582628,0,2848,949,2849,546,1
20150106.013218,2848,10,582638,-10,2848,944,2849,546,0
20150106.013225,2849,6,582644,0,2848,944,2849,563,1
20150106.013229,2848,40,582684,-40,2848,927,2849,563,0
20150106.013232,2849,2,582686,-2,2848,927,2849,562,1
20150106.013236,2849,2,582688,0,2848,927,2849,561,1
20150106.013237,2848,10,582698,-10,2848,922,2849,561,0
20150106.013244,2848,20,582718,0,2848,917,2849,564,0
20150106.013246,2849,4,582722,-4,2848,917,2849,562,1
20150106.013249,2849,14,582736,-14,2848,917,2849,555,1
20150106.01325,2849,4,582740,0,2848,917,2849,553,1
20150106.013252,2849,4,582744,-4,2848,915,2849,551,1
20150106.013252,2849,4,582748,0,2848,915,2849,549,1
20150106.013257,2849,2,582750,0,2848,917,2849,560,1
20150106.013304,2848,2,582752,-2,2848,917,2849,573,0
20150106.013306,2849,1146,583898,-334,2849,439,2850,219,1
20150106.013307,2849,200,584098,-200,2849,339,2850,219,1
20150106.01331,2849,10,584108,-10,2849,445,2850,218,1
20150106.013312,2850,2,584110,0,2849,446,2850,217,1
20150106.013312,2850,14,584124,-8,2849,446,2850,209,1
20150106.013313,2850,38,584162,-24,2849,446,2850,182,1
20150106.013314,2850,20,584182,-2,2849,448,2850,171,1
20150106.013315,2850,4,584186,-4,2849,450,2850,169,1
20150106.013315,2850,26,584212,-10,2849,450,2850,156,1
20150106.013316,2850,8,584220,2,2849,452,2850,152,1
20150106.013317,2850,4,584224,-2,2849,456,2850,151,1
20150106.013318,2849,2,584226,-2,2849,455,2850,165,0
20150106.013318,2850,14,584240,-6,2849,455,2850,157,1
20150106.01332,2850,2,584242,0,2849,455,2850,200,1
20150106.013324,2850,4,584246,-4,2849,135,2850,210,1
20150106.013325,2850,4,584250,0,2849,135,2850,208,1
20150106.013325,2849,24,584274,-2,2849,113,2850,218,0
20150106.013326,2850,2,584276,0,2849,114,2850,217,1
20150106.013327,2850,6,584282,0,2849,114,2850,205,1
20150106.013329,2850,2,584284,-2,2849,115,2850,205,1
20150106.013329,2850,2,584286,0,2849,115,2850,204,1
20150106.01333,2850,8,584294,-4,2849,116,2850,200,1
20150106.01333,2849,2,584296,0,2849,115,2850,205,0
20150106.013332,2850,2,584298,0,2849,116,2850,206,1
20150106.013337,2850,378,584676,72,2849,131,2850,22,1
20150106.01334,2850,4,584680,-2,2849,163,2850,25,1
20150106.01334,2850,2,584682,0,2849,163,2850,24,1
20150106.013342,2850,24,584706,-4,2849,164,2850,12,1
20150106.013343,2850,20,584726,8,2849,169,2850,3,1
20150106.013343,2850,2,584728,-2,2849,169,2850,4,1
20150106.013344,2850,62,584790,-46,2849,170,2851,308,1
20150106.013347,2850,2,584792,0,2849,180,2850,2,1
20150106.013348,2850,2,584794,-2,2849,180,2850,1,1
20150106.013349,2850,2,584796,0,2849,180,2851,308,1
20150106.013349,2850,4,584800,2,2849,181,2850,2,1
20150106.013352,2850,20,584820,-16,2849,181,2850,4,1
20150106.013353,2850,2,584822,0,2849,181,2850,3,1
20150106.013355,2850,20,584842,14,2849,181,2850,25,1
20150106.013357,2850,2,584844,2,2849,181,2850,180,1
20150106.013402,2850,2,584846,0,2849,164,2850,179,1
20150106.013403,2850,4,584850,4,2849,164,2850,177,1
20150106.013408,2850,2,584852,2,2849,184,2850,201,1
20150106.013409,2850,4,584856,0,2849,183,2850,204,1
20150106.013411,2849,70,584926,70,2849,138,2850,214,0
20150106.013426,2849,2,584928,2,2849,150,2850,262,0
20150106.013433,2849,2,584930,0,2849,211,2850,279,0
20150106.013434,2849,2,584932,2,2849,210,2850,279,0
20150106.013435,2849,2,584934,2,2849,209,2850,282,0
20150106.013436,2849,10,584944,10,2849,194,2850,771,0
20150106.013437,2849,2,584946,0,2849,193,2850,771,0
20150106.013438,2849,82,585028,2,2849,152,2850,772,0
20150106.013439,2849,2,585030,0,2849,151,2850,784,0
20150106.013439,2849,2,585032,0,2849,150,2850,794,0
20150106.013441,2849,40,585072,0,2849,130,2850,795,0
20150106.013443,2849,2,585074,2,2849,117,2850,795,0
20150106.013444,2849,2,585076,0,2849,118,2850,795,0
20150106.013448,2849,2,585078,0,2849,117,2850,796,0
20150106.013452,2849,10,585088,6,2849,152,2850,796,0
20150106.013454,2849,10,585098,-6,2849,147,2850,796,0
20150106.013458,2849,8,585106,-8,2849,143,2850,798,0
20150106.013458,2849,6,585112,0,2849,140,2850,798,0
20150106.013501,2849,4,585116,-4,2849,138,2850,798,0
20150106.013504,2849,2,585118,0,2849,150,2850,878,0
20150106.013508,2849,2,585120,0,2849,249,2850,877,0
20150106.013515,2849,4,585124,-4,2849,249,2850,877,0
20150106.013517,2849,10,585134,8,2849,244,2850,878,0
20150106.013528,2849,2,585136,0,2849,265,2850,887,0
20150106.013529,2849,20,585156,0,2849,256,2850,887,0
20150106.013533,2849,2,585158,2,2849,256,2850,928,0
20150106.013534,2849,2,585160,2,2849,255,2850,928,0
20150106.013538,2850,2,585162,2,2849,255,2850,928,1
20150106.013545,2850,2,585164,2,2849,306,2850,927,1
20150106.013546,2850,2,585166,2,2849,306,2850,926,1
20150106.013548,2850,2,585168,2,2849,306,2850,925,1
20150106.01355,2850,2,585170,2,2849,311,2850,924,1
20150106.01355,2850,1868,587038,-518,2850,67,2851,337,1
20150106.013551,2851,2,587040,-2,2850,68,2851,337,1
20150106.013551,2851,16,587056,-4,2850,68,2851,319,1
20150106.013552,2851,6,587062,4,2850,68,2851,326,1
20150106.013552,2851,12,587074,-6,2850,68,2851,310,1
20150106.013553,2851,8,587082,0,2850,68,2851,314,1
20150106.013556,2851,608,587690,-214,2851,697,2852,359,1
20150106.013556,2852,44,587734,-40,2851,687,2852,332,1
20150106.013557,2852,18,587752,-16,2851,685,2852,323,1
20150106.013557,2852,128,587880,-126,2851,686,2852,259,1
20150106.013558,2852,16,587896,-10,2851,685,2852,251,1
20150106.013558,2852,36,587932,0,2851,685,2852,233,1
20150106.013559,2852,4,587936,0,2851,685,2852,231,1
20150106.013559,2852,6,587942,0,2851,685,2852,228,1
20150106.0136,2852,4,587946,-2,2851,685,2852,226,1
20150106.013601,2852,2,587948,-2,2851,685,2852,225,1
20150106.013601,2852,8,587956,-6,2851,685,2852,221,1
20150106.013602,2851,6,587962,0,2851,682,2852,220,0
20150106.013603,2852,12,587974,-12,2851,682,2852,215,1
20150106.013603,2852,2,587976,0,2851,682,2852,214,1
20150106.013603,2851,10,587986,-2,2851,679,2852,211,0
20150106.013605,2852,2,587988,2,2851,679,2852,199,1
20150106.013606,2852,4,587992,4,2851,679,2852,201,1
20150106.013607,2852,22,588014,0,2851,680,2852,201,1
20150106.013608,2852,4,588018,2,2851,680,2852,200,1
20150106.013608,2852,2,588020,2,2851,680,2852,199,1
20150106.01361,2852,4,588024,0,2851,680,2852,204,1
20150106.013611,2852,50,588074,-46,2851,9,2852,214,1
20150106.013613,2852,18,588092,-18,2851,9,2852,214,1
20150106.013615,2851,2,588094,0,2851,8,2852,223,0
20150106.013616,2851,4,588098,0,2851,7,2852,222,0
20150106.013617,2852,444,588542,-262,2852,446,2853,682,1
20150106.013617,2852,6,588548,-4,2852,444,2853,667,1
20150106.013618,2853,6,588554,0,2852,449,2853,664,1
20150106.013618,2853,330,588884,-70,2852,425,2853,542,1
20150106.013619,2853,162,589046,-158,2852,429,2853,457,1
20150106.013619,2853,8,589054,0,2852,429,2853,450,1
20150106.01362,2853,4,589058,-4,2852,429,2853,444,1
20150106.01362,2853,4,589062,-2,2852,429,2853,442,1
20150106.013622,2853,66,589128,-6,2852,430,2853,409,1
20150106.013622,2852,12,589140,-12,2852,430,2853,408,0
20150106.013623,2853,2,589142,0,2852,430,2853,407,1
20150106.013624,2853,206,589348,0,2852,430,2853,306,1
20150106.013625,2853,2,589350,0,2852,430,2853,304,1
20150106.013625,2852,2,589352,0,2852,429,2853,305,0
20150106.013626,2853,6,589358,-4,2852,429,2853,304,1
20150106.013627,2853,2,589360,0,2852,449,2853,308,1
20150106.013628,2853,24,589384,-18,2852,442,2853,298,1
20150106.013629,2853,4,589388,-4,2852,442,2853,298,1
20150106.013629,2853,10,589398,-2,2852,442,2853,288,1
20150106.01363,2853,20,589418,0,2852,442,2853,278,1
20150106.013631,2852,4,589422,-4,2852,440,2853,279,0
20150106.013631,2853,50,589472,-16,2852,419,2853,341,1
20150106.013631,2853,20,589492,0,2852,419,2853,331,1
20150106.013632,2852,168,589660,0,2852,361,2853,257,0
20150106.013633,2853,4,589664,0,2852,401,2853,255,1
20150106.013634,2853,6,589670,0,2852,401,2853,254,1
20150106.013634,2853,12,589682,0,2852,401,2853,248,1
20150106.013635,2853,2,589684,0,2852,401,2853,250,1
20150106.013636,2853,506,590190,-230,2853,249,2854,695,1
20150106.013636,2853,28,590218,12,2853,256,2854,685,1
20150106.013637,2853,66,590284,32,2853,257,2854,653,1
20150106.013638,2854,12,590296,-2,2853,258,2854,648,1
20150106.013638,2854,362,590658,-96,2853,258,2854,474,1
20150106.013639,2854,18,590676,-4,2853,270,2854,465,1
20150106.013639,2854,4,590680,0,2853,270,2854,463,1
20150106.01364,2854,2,590682,-2,2853,270,2854,462,1
20150106.01364,2853,372,591054,0,2853,74,2854,290,0
20150106.013641,2853,4,591058,-2,2853,85,2854,289,0
20150106.013641,2854,30,591088,0,2853,80,2854,282,1
20150106.013642,2853,30,591118,-30,2853,66,2854,283,0
20150106.013642,2853,2,591120,0,2853,66,2854,285,0
20150106.013643,2853,12,591132,-12,2853,61,2854,288,0
20150106.013643,2853,2,591134,0,2853,60,2854,291,0
20150106.013644,2854,10,591144,0,2853,61,2854,286,1
20150106.013644,2854,8,591152,-6,2853,58,2854,285,1
20150106.013645,2854,2,591154,-2,2853,59,2854,284,1
20150106.013645,2854,4,591158,-4,2853,72,2854,282,1
20150106.013646,2853,200,591358,42,2852,379,2854,302,0
20150106.013646,2853,4,591362,-2,2852,379,2853,1,0
20150106.013647,2853,20,591382,-10,2853,501,2854,293,0
20150106.013647,2854,88,591470,0,2853,501,2854,249,1
20150106.013648,2853,16,591486,-2,2853,498,2854,249,0
20150106.013651,2854,10,591496,-10,2853,500,2854,251,1
20150106.013651,2853,4,591500,-4,2853,501,2854,251,0
20150106.013652,2854,6,591506,0,2853,501,2854,251,1
20150106.013653,2854,180,591686,4,2853,432,2854,343,1
20150106.013654,2854,2,591688,0,2853,433,2854,344,1
20150106.013655,2853,2,591690,0,2853,432,2854,344,0
20150106.013656,2853,4,591694,0,2853,430,2854,346,0
20150106.013656,2854,4,591698,0,2853,431,2854,366,1
20150106.013658,2854,6,591704,0,2853,432,2854,370,1
20150106.013658,2854,6,591710,-4,2853,438,2854,367,1
20150106.013659,2853,4,591714,-4,2853,436,2854,377,0
20150106.0137,2853,12,591726,-10,2853,425,2854,2393,0
20150106.013702,2853,864,592590,-128,2853,3,2854,3861,0
20150106.013702,2853,4,592594,-4,2853,1,2854,3862,0
20150106.013703,2853,2,592596,-2,2852,39,2853,7,0
20150106.013703,2853,66,592662,2,2853,18,2854,3862,0
20150106.013704,2853,2,592664,0,2853,17,2854,3863,0
20150106.013704,2853,2,592666,0,2853,18,2854,3864,0
20150106.013705,2854,20,592686,-20,2853,29,2854,3855,1
20150106.013705,2853,2,592688,0,2853,30,2854,3857,0
20150106.013706,2853,592,593280,-360,2853,28,2854,3565,0
20150106.013706,2853,8,593288,8,2853,50,2854,3564,0
20150106.013707,2853,2,593290,0,2853,49,2854,3565,0
20150106.013707,2853,56,593346,-28,2853,23,2854,3565,0
20150106.013708,2853,6,593352,-4,2853,19,2854,3565,0
20150106.013708,2853,2,593354,-2,2853,18,2854,3565,0
20150106.013709,2853,36,593390,4,2852,59,2853,3,0
20150106.013709,2853,2,593392,2,2852,57,2853,25,0
20150106.01371,2853,4,593396,4,2852,57,2853,31,0
20150106.01371,2853,2,593398,2,2852,57,2853,33,0
20150106.013711,2853,2,593400,2,2852,57,2853,34,0
20150106.013711,2853,70,593470,-42,2853,66,2854,3595,0
20150106.013712,2854,4,593474,0,2853,66,2854,3595,1
20150106.013712,2854,156,593630,86,2853,67,2854,3517,1
20150106.013713,2853,362,593992,106,2852,55,2854,3517,0
20150106.013713,2853,4,593996,4,2852,41,2853,24,0
20150106.013714,2853,202,594198,-12,2852,41,2853,24,0
20150106.013714,2853,30,594228,30,2852,41,2853,11,0
20150106.013715,2853,48,594276,-6,2853,77,2854,3523,0
20150106.013716,2853,2,594278,-2,2853,76,2854,3522,0
20150106.013716,2854,2,594280,2,2853,76,2854,3521,1
20150106.013717,2854,112,594392,-2,2853,75,2854,3466,1
20150106.013717,2853,4,594396,0,2853,74,2854,3466,0
20150106.013718,2853,10,594406,0,2853,69,2854,3466,0
20150106.013719,2853,6,594412,0,2853,66,2854,3466,0
20150106.01372,2853,2,594414,-2,2853,66,2854,3465,0
20150106.013721,2853,100,594514,0,2853,18,2854,3465,0
20150106.013722,2853,2,594516,0,2853,17,2854,3465,0
20150106.013722,2853,6,594522,-4,2853,33,2854,3463,0
20150106.013723,2853,6,594528,-2,2853,30,2854,3463,0
20150106.013723,2853,10,594538,-2,2853,25,2854,3463,0
20150106.013724,2853,2,594540,0,2853,24,2854,3463,0
20150106.013725,2853,10,594550,2,2853,30,2854,3462,0
20150106.013726,2853,2,594552,0,2853,29,2854,3467,0
20150106.013727,2853,4,594556,4,2853,27,2854,3467,0
20150106.013727,2853,4,594560,4,2853,26,2854,3467,0
20150106.013728,2853,14,594574,10,2853,21,2854,3465,0
20150106.013729,2853,6,594580,2,2853,19,2854,3467,0
20150106.01373,2853,38,594618,24,2852,111,2853,81,0
20150106.013731,2853,204,594822,-36,2852,87,2853,10,0
20150106.013731,2853,24,594846,-22,2853,89,2854,3467,0
20150106.013732,2854,2,594848,2,2853,89,2854,3466,1
20150106.013732,2853,2,594850,0,2853,88,2854,3466,0
20150106.013733,2853,30,594880,-30,2853,73,2854,3466,0
20150106.013733,2853,6,594886,0,2853,93,2854,3465,0
20150106.013734,2854,10,594896,0,2853,93,2854,3460,1
20150106.013735,2853,6,594902,-2,2853,91,2854,3461,0
20150106.013736,2853,10,594912,0,2853,86,2854,3461,0
20150106.013737,2853,44,594956,-40,2853,74,2854,3461,0
20150106.013738,2854,2,594958,0,2853,74,2854,3460,1
20150106.013739,2853,10,594968,0,2853,84,2854,3460,0
20150106.013739,2853,2,594970,0,2853,123,2854,3460,0
20150106.01374,2853,8,594978,0,2853,120,2854,3460,0
20150106.013741,2853,2,594980,0,2853,119,2854,3460,0
20150106.013743,2853,2,594982,0,2853,162,2854,3461,0
20150106.013743,2854,2,594984,0,2853,162,2854,3460,1
20150106.013745,2853,12,594996,10,2853,163,2854,3455,0
20150106.013746,2853,20,595016,-20,2853,194,2854,3456,0
20150106.013747,2853,4,595020,-4,2853,193,2854,3456,0
20150106.013747,2853,4,595024,0,2853,191,2854,3456,0
20150106.013748,2853,2,595026,0,2853,190,2854,3456,0
20150106.013749,2853,2,595028,-2,2853,241,2854,3455,0
20150106.01375,2854,2022,597050,-2,2853,240,2854,2445,1
20150106.013751,2854,2002,599052,0,2853,239,2854,1445,1
20150106.013752,2854,106,599158,-82,2854,962,2855,1057,1
20150106.013753,2854,108,599266,0,2854,965,2855,1004,1
20150106.013753,2854,4,599270,0,2854,965,2855,1003,1
20150106.013754,2855,16,599286,12,2854,963,2855,997,1
20150106.013754,2855,228,599514,82,2854,945,2855,899,1
20150106.013755,2855,56,599570,6,2854,945,2855,871,1
20150106.013755,2855,68,599638,26,2854,995,2855,839,1
20150106.013757,2855,128,599766,22,2854,995,2855,777,1
20150106.013757,2855,6,599772,0,2854,996,2855,774,1
20150106.013757,2854,2,599774,0,2854,995,2855,774,0
20150106.013759,2855,8,599782,0,2854,995,2855,772,1
20150106.013759,2855,2,599784,2,2854,997,2855,771,1
20150106.0138,2857,4188,603972,-2976,2854,996,2857,382,1
20150106.013801,2857,1082,605054,-714,2857,1275,2858,655,1
20150106.013801,2858,92,605146,-80,2857,1314,2858,611,1
20150106.013802,2858,64,605210,-36,2857,1309,2858,413,1
20150106.013802,2858,480,605690,-192,2857,1310,2858,141,1
20150106.013803,2858,302,605992,-202,2858,3,2859,772,1
20150106.013803,2858,116,606108,-82,2857,1310,2858,42,1
20150106.013804,2858,80,606188,-8,2857,1313,2858,5,1
20150106.013804,2857,34,606222,6,2857,1307,2859,773,0
20150106.013805,2857,6,606228,-2,2857,1305,2859,772,0
20150106.013805,2859,618,606846,-410,2858,13,2859,463,1
20150106.013806,2858,28,606874,-14,2857,1302,2858,1,0
20150106.013806,2858,46,606920,-32,2858,6,2859,446,0
20150106.013807,2858,16,606936,-10,2857,1295,2858,2,0
20150106.013807,2857,120,607056,-116,2858,7,2859,397,0
20150106.013808,2859,6,607062,-2,2858,7,2859,394,1
20150106.013808,2858,8,607070,6,2858,53,2859,394,0
20150106.013809,2859,114,607184,-62,2857,1285,2859,394,1
20150106.013809,2859,586,607770,-560,2858,10,2859,107,1
20150106.01381,2859,10,607780,-4,2858,10,2860,435,1
20150106.013811,2858,106,607886,-28,2857,1287,2858,248,0
20150106.013811,2858,10,607896,-8,2857,1284,2858,249,0
20150106.013812,2858,6,607902,-4,2857,1285,2858,246,0
20150106.013812,2858,2,607904,-2,2857,1486,2858,245,0
20150106.013813,2858,20,607924,0,2857,1486,2858,237,0
20150106.013813,2858,2,607926,-2,2857,1486,2858,238,0
20150106.013814,2859,676,608602,-630,2858,246,2859,85,1
20150106.013815,2858,110,608712,0,2858,202,2859,157,0
20150106.013815,2858,16,608728,-14,2858,186,2859,184,0
20150106.013816,2858,8,608736,0,2858,184,2859,190,0
20150106.013816,2858,4,608740,-4,2858,183,2859,214,0
20150106.013817,2858,28,608768,-6,2858,182,2859,253,0
20150106.013817,2858,14,608782,-8,2858,217,2859,303,0
20150106.013818,2858,2,608784,0,2858,216,2859,287,0
20150106.013818,2859,218,609002,0,2858,215,2859,199,1
20150106.013819,2859,2,609004,-2,2858,225,2859,191,1
20150106.013819,2859,34,609038,-18,2858,216,2859,186,1
20150106.01382,2859,462,609500,-184,2859,104,2860,708,1
20150106.01382,2860,228,609728,-142,2859,7,2860,709,1
20150106.013821,2860,312,610040,-122,2859,20,2860,554,1
20150106.013822,2860,202,610242,-72,2858,222,2860,495,1
20150106.013822,2859,10,610252,0,2859,5,2860,516,0
20150106.013822,2860,36,610288,-8,2858,239,2860,505,1
20150106.013824,2860,206,610494,-144,2859,21,2860,391,1
20150106.013825,2860,46,610540,2,2858,240,2859,22,1
20150106.013825,2860,2,610542,-2,2858,240,2859,21,1
20150106.013826,2858,26,610568,12,2858,277,2859,12,0
20150106.013827,2859,4,610572,0,2858,277,2859,12,1
20150106.013827,2859,26,610598,-4,2859,1,2860,410,1
20150106.013828,2859,20,610618,8,2859,5,2860,402,1
20150106.013828,2859,16,610634,14,2858,278,2859,4,1
20150106.013829,2861,1794,612428,-628,2858,281,2861,224,1
20150106.013829,2861,558,612986,-62,2861,1,2862,195,1
20150106.01383,2860,102,613088,-70,2860,9,2861,5,0
20150106.01383,2860,48,613136,-18,2860,19,2862,175,0
20150106.013831,2861,32,613168,-2,2861,1,2862,175,1
20150106.013831,2860,84,613252,-80,2859,69,2860,269,0
20150106.013832,2860,2,613254,0,2859,69,2860,269,0
20150106.013832,2860,2,613256,0,2859,69,2860,268,0
20150106.013833,2860,4,613260,0,2859,69,2860,266,0
20150106.013833,2860,4,613264,-4,2859,77,2860,267,0
20150106.013834,2860,568,613832,-528,2860,178,2861,312,0
20150106.013834,2860,18,613850,0,2860,183,2861,312,0
20150106.013835,2860,6,613856,-4,2860,491,2861,353,0
20150106.013836,2860,44,613900,-44,2860,751,2861,366,0
20150106.013836,2860,108,614008,-100,2860,697,2861,366,0
20150106.013837,2860,64,614072,-44,2860,720,2861,336,0
20150106.013837,2860,6,614078,-4,2860,717,2861,379,0
20150106.013838,2860,4,614082,-4,2860,718,2861,399,0
20150106.013839,2860,110,614192,0,2860,662,2861,399,0
20150106.013839,2860,270,614462,46,2860,562,2861,421,0
20150106.01384,2860,406,614868,-4,2860,559,2861,218,0
20150106.013841,2860,10,614878,-6,2860,558,2861,218,0
20150106.013841,2860,114,614992,-12,2860,515,2861,215,0
20150106.013842,2860,6,614998,-6,2860,512,2861,222,0
20150106.013842,2860,44,615042,0,2860,511,2861,201,0
20150106.013843,2860,10,615052,-10,2860,506,2861,202,0
20150106.013843,2860,4,615056,-2,2860,505,2861,208,0
20150106.013844,2861,20,615076,0,2860,504,2861,200,1
20150106.013844,2860,1034,616110,596,2859,162,2860,483,0
20150106.013845,2859,158,616268,66,2859,35,2860,507,0
20150106.013845,2859,332,616600,98,2859,44,2860,332,0
20150106.013846,2859,2,616602,0,2859,34,2860,347,0
20150106.013847,2859,4,616606,-2,2859,32,2860,353,0
20150106.013847,2859,64,616670,0,2858,149,2859,10,0
20150106.013848,2859,2,616672,2,2858,154,2859,17,0
20150106.013848,2858,2,616674,0,2858,153,2859,18,0
20150106.013849,2858,2,616676,2,2858,152,2859,19,0
20150106.013849,2858,20,616696,-2,2858,142,2859,19,0
20150106.01385,2860,40,616736,-18,2859,2,2860,349,1
20150106.01385,2859,4,616740,0,2858,181,2859,3,0
20150106.013851,2858,2,616742,0,2858,240,2859,4,0
20150106.013852,2859,2,616744,-2,2858,241,2859,53,1
20150106.013852,2858,14,616758,0,2858,221,2859,55,0
20150106.013853,2858,20,616778,0,2858,211,2859,55,0
20150106.013854,2858,72,616850,38,2858,151,2859,35,0
20150106.013854,2859,18,616868,-6,2858,145,2859,41,1
20150106.013855,2859,24,616892,24,2858,146,2859,29,1
20150106.013855,2859,2,616894,2,2858,146,2859,28,1
20150106.013856,2858,4,616898,-4,2858,187,2859,46,0
20150106.013857,2858,20,616918,-18,2858,178,2859,46,0
20150106.013857,2858,2,616920,-2,2858,182,2859,46,0
20150106.013858,2859,16,616936,0,2858,182,2859,41,1
20150106.0139,2858,8,616944,0,2858,185,2859,51,0
20150106.0139,2859,84,617028,-16,2858,184,2859,10,1
20150106.013901,2858,10,617038,-4,2858,180,2859,49,0
20150106.013901,2859,140,617178,0,2859,333,2860,409,1
20150106.013902,2859,2,617180,0,2859,335,2860,409,1
20150106.013902,2859,6,617186,0,2859,332,2860,410,1
20150106.013903,2859,8,617194,8,2859,328,2860,409,1
20150106.013904,2859,4,617198,4,2859,343,2860,410,1
20150106.013904,2860,4,617202,4,2859,362,2860,409,1
20150106.013905,2859,2,617204,0,2859,361,2860,409,0
20150106.013905,2859,104,617308,102,2859,310,2860,424,0
20150106.013906,2859,8,617316,0,2859,306,2860,424,0
20150106.013907,2860,900,618216,776,2860,401,2861,248,1
20150106.013907,2860,36,618252,36,2860,387,2861,225,1
20150106.013908,2861,2,618254,0,2860,1,2861,224,1
20150106.013909,2861,114,618368,82,2859,14,2861,250,1
20150106.013909,2859,28,618396,24,2858,189,2860,19,0
20150106.013911,2859,6,618402,2,2858,189,2860,35,0
20150106.013911,2860,4,618406,0,2859,7,2860,58,1
20150106.013912,2858,44,618450,16,2859,8,2860,69,0
20150106.013915,2859,8,618458,2,2859,14,2860,175,1
20150106.013916,2859,28,618486,8,2858,237,2860,162,1
20150106.013916,2858,12,618498,2,2858,232,2860,206,0
20150106.013918,2859,2,618500,0,2858,232,2859,5,1
20150106.013919,2859,2,618502,2,2858,232,2859,6,1
20150106.01392,2858,12,618514,-10,2858,225,2859,7,0
20150106.013921,2859,4,618518,-2,2858,225,2859,5,1
20150106.013922,2859,10,618528,-6,2859,7,2860,417,1
20150106.013923,2860,2,618530,2,2859,11,2860,416,1
20150106.013923,2859,2,618532,0,2859,11,2860,416,0
20150106.013924,2859,2,618534,-2,2859,12,2860,423,0
20150106.013925,2859,22,618556,-4,2859,3,2860,423,0
20150106.013926,2859,2,618558,2,2859,2,2860,423,0
20150106.013926,2859,4,618562,-2,2858,228,2860,423,0
20150106.013927,2858,4,618566,4,2858,226,2859,5,0
20150106.013929,2858,2,618568,2,2858,276,2859,7,0
20150106.01393,2859,14,618582,4,2859,74,2860,430,1
20150106.01393,2859,8,618590,6,2859,70,2860,430,1
20150106.013931,2859,12,618602,10,2859,66,2860,430,1
20150106.013932,2859,2,618604,0,2859,65,2860,445,1
20150106.013933,2859,6,618610,6,2859,63,2860,445,1
20150106.013933,2859,84,618694,84,2859,26,2860,478,1
20150106.013934,2859,4,618698,4,2859,24,2860,501,1
20150106.013934,2860,2,618700,0,2859,24,2860,500,1
20150106.013936,2859,2,618702,2,2859,23,2860,501,0
20150106.013936,2859,20,618722,20,2859,13,2860,501,0
20150106.013937,2859,2,618724,2,2859,12,2860,501,0
20150106.013937,2859,2,618726,0,2859,11,2860,501,0
20150106.013938,2859,4,618730,2,2859,9,2860,404,0
20150106.013938,2859,4,618734,4,2859,7,2860,405,0
20150106.013939,2859,14,618748,12,2858,228,2859,2,0
20150106.013941,2859,2,618750,2,2858,228,2859,8,0
20150106.013942,2859,4,618754,2,2858,228,2859,38,0
20150106.013943,2859,68,618822,52,2858,228,2860,376,0
20150106.013944,2859,4,618826,4,2858,229,2860,386,0
20150106.013946,2859,8,618834,8,2858,229,2859,2,0
20150106.013946,2858,12,618846,0,2858,223,2859,9,0
20150106.013947,2859,2,618848,2,2858,222,2859,8,1
20150106.013949,2858,2,618850,2,2858,222,2859,62,0
20150106.01395,2859,4,618854,2,2858,222,2859,62,1
20150106.01395,2859,2,618856,0,2858,220,2859,77,1
20150106.013951,2859,2,618858,0,2858,220,2859,76,1
20150106.013954,2858,4,618862,0,2858,216,2859,195,0
20150106.013955,2858,6,618868,0,2858,213,2859,201,0
20150106.013955,2859,2,618870,0,2858,204,2859,205,1
20150106.013957,2858,6,618876,0,2858,202,2859,234,0
20150106.013958,2858,8,618884,0,2858,198,2859,234,0
20150106.013958,2859,2,618886,0,2858,198,2859,238,1
20150106.013959,2859,476,619362,-100,2859,762,2860,457,1
20150106.013959,2859,24,619386,-2,2859,751,2860,453,1
20150106.014,2859,2,619388,0,2859,750,2860,453,1
20150106.014,2860,906,620294,324,2860,15,2861,254,1
20150106.014001,2860,270,620564,144,2860,10,2861,125,1
20150106.014001,2862,254,620818,128,2861,277,2862,977,1
20150106.014002,2861,88,620906,-8,2861,246,2862,964,0
20150106.014002,2861,14,620920,0,2860,37,2862,963,0
20150106.014003,2862,2,620922,0,2860,34,2862,977,1
20150106.014004,2862,92,621014,14,2860,34,2862,927,1
20150106.014004,2860,2,621016,0,2860,33,2862,928,0
20150106.014005,2860,6,621022,0,2860,30,2862,927,0
20150106.014006,2862,4,621026,0,2860,32,2862,925,1
20150106.014006,2860,12,621038,2,2860,26,2862,925,0
20150106.014007,2861,2,621040,0,2860,34,2861,7,1
20150106.014009,2860,116,621156,66,2859,863,2861,20,0
20150106.014009,2860,6,621162,6,2859,892,2861,78,0
20150106.01401,2860,102,621264,-22,2859,893,2861,98,0
20150106.01401,2861,20,621284,8,2860,16,2861,93,1
20150106.014012,2861,8,621292,0,2860,23,2861,121,1
20150106.014013,2860,2,621294,-2,2860,22,2861,161,0
20150106.014014,2861,2,621296,2,2860,22,2861,164,1
20150106.014014,2861,32,621328,-2,2860,16,2861,149,1
20150106.014014,2860,46,621374,20,2859,900,2861,149,0
20150106.014015,2859,2,621376,0,2859,900,2861,160,0
20150106.014017,2860,8,621384,2,2859,947,2861,161,1
20150106.014018,2859,54,621438,22,2859,994,2861,163,0
20150106.014019,2860,122,621560,-4,2860,2,2861,173,1
20150106.01402,2860,204,621764,0,2859,998,2861,193,1
20150106.014021,2859,4,621768,-4,2859,996,2861,163,0
20150106.014022,2860,72,621840,-22,2859,996,2861,166,1
20150106.014023,2860,30,621870,30,2859,996,2860,8,1
20150106.014024,2860,18,621888,14,2860,6,2861,174,1
20150106.014024,2859,60,621948,-56,2859,1056,2861,174,0
20150106.014025,2860,14,621962,0,2859,1058,2861,174,1
20150106.014026,2859,2,621964,0,2859,1067,2861,175,0
20150106.014027,2859,2,621966,0,2859,1117,2861,175,0
20150106.014029,2859,200,622166,0,2859,1018,2860,1,0
20150106.014029,2860,4,622170,-2,2859,1018,2860,1,1
20150106.01403,2860,2,622172,2,2859,1018,2860,1,1
20150106.01403,2860,4,622176,2,2860,4,2861,201,1
20150106.014031,2860,2,622178,2,2860,5,2861,201,1
20150106.014032,2860,10,622188,0,2859,1059,2860,4,1
20150106.014033,2860,10,622198,0,2859,1059,2860,50,1
20150106.014034,2860,2,622200,-2,2859,1059,2860,50,1
20150106.014035,2860,100,622300,0,2860,3,2861,198,1
20150106.014036,2859,200,622500,-194,2859,1039,2860,1,0
20150106.014036,2860,4,622504,2,2859,1047,2861,199,1
20150106.014037,2860,2,622506,0,2860,5,2861,198,1
20150106.014038,2860,16,622522,10,2860,18,2861,199,1
20150106.01404,2859,200,622722,14,2859,1001,2860,40,0
20150106.014042,2859,2,622724,-2,2859,999,2860,43,0
20150106.014043,2860,2,622726,2,2859,970,2860,42,1
20150106.014043,2860,18,622744,10,2859,970,2860,33,1
20150106.014044,2860,68,622812,-2,2860,967,2861,284,1
20150106.014044,2860,84,622896,-84,2860,929,2861,260,1
20150106.014045,2860,2,622898,-2,2860,929,2861,260,1
20150106.014046,2860,2,622900,0,2860,940,2861,260,1
20150106.014047,2861,4,622904,-4,2860,940,2861,255,1
20150106.014048,2861,6,622910,0,2860,948,2861,252,1
20150106.014048,2861,2,622912,0,2860,954,2861,252,1
20150106.014049,2860,28,622940,-26,2860,961,2861,240,0
20150106.014049,2860,2,622942,0,2860,963,2861,250,0
20150106.014051,2860,2,622944,0,2860,962,2861,250,0
20150106.014052,2860,2,622946,0,2860,968,2861,266,0
20150106.014053,2860,6,622952,-2,2860,967,2861,270,0
20150106.014053,2860,70,623022,0,2860,914,2861,270,0
20150106.014053,2860,4,623026,0,2860,922,2861,270,0
20150106.014055,2860,2,623028,0,2860,921,2861,278,0
20150106.014055,2860,8,623036,-8,2860,917,2861,278,0
20150106.014056,2860,6,623042,-2,2860,913,2861,289,0
20150106.014058,2860,20,623062,0,2860,904,2861,289,0
20150106.014058,2860,256,623318,0,2860,781,2861,324,0
20150106.014058,2860,2,623320,-2,2860,780,2861,324,0
20150106.014059,2861,2,623322,2,2860,840,2861,323,1
20150106.0141,2861,200,623522,116,2860,840,2861,223,1
20150106.014102,2860,112,623634,-10,2860,797,2861,177,0
20150106.014102,2861,2,623636,0,2860,801,2861,186,1
20150106.014103,2860,42,623678,-42,2860,781,2861,188,0
20150106.014104,2861,8,623686,-8,2860,780,2861,185,1
20150106.014106,2861,2,623688,0,2860,789,2861,185,1
20150106.014106,2861,4,623692,0,2860,789,2861,185,1
20150106.014107,2860,12,623704,0,2860,783,2861,186,0
20150106.014108,2861,4,623708,0,2860,783,2861,185,1
20150106.014109,2860,30,623738,0,2860,767,2861,185,0
20150106.01411,2860,2,623740,-2,2860,766,2861,205,0
20150106.014111,2861,16,623756,-14,2860,759,2861,205,1
20150106.014111,2860,4,623760,0,2860,757,2861,203,0
20150106.014112,2860,2,623762,-2,2860,756,2861,204,0
20150106.014112,2860,20,623782,0,2860,746,2861,306,0
20150106.014115,2860,6,623788,-4,2860,746,2861,309,0
20150106.014115,2860,2,623790,0,2860,742,2861,308,0
20150106.014117,2860,16,623806,0,2860,734,2861,314,0
20150106.014118,2860,1434,625240,-1344,2860,19,2861,314,0
20150106.014119,2860,4,625244,-2,2860,17,2861,314,0
20150106.014119,2860,200,625444,84,2859,835,2860,3,0
20150106.014121,2859,50,625494,-50,2859,809,2860,5,0
20150106.014121,2859,2,625496,-2,2859,807,2860,5,0
20150106.014122,2860,10,625506,0,2860,7,2861,324,1
20150106.014123,2860,4,625510,4,2860,5,2861,324,1
20150106.014123,2860,4,625514,4,2860,3,2861,324,1
20150106.014125,2860,8,625522,4,2859,809,2861,328,1
20150106.014128,2859,2,625524,0,2859,799,2860,39,0
20150106.014132,2859,4,625528,0,2859,797,2860,72,0
20150106.014133,2859,14,625542,-2,2859,795,2860,76,0
20150106.014135,2859,2,625544,0,2859,809,2860,130,0
20150106.014136,2859,6,625550,2,2859,807,2860,131,0
20150106.014137,2859,2,625552,0,2859,806,2860,132,0
20150106.014137,2859,2,625554,-2,2859,805,2860,135,0
20150106.014139,2859,4,625558,0,2859,783,2860,139,0
20150106.01414,2859,2,625560,0,2859,782,2860,142,0
20150106.014141,2859,4,625564,-2,2859,780,2860,144,0
20150106.014141,2860,8,625572,2,2859,780,2860,141,1
20150106.014142,2859,2,625574,0,2859,784,2860,141,0
20150106.014143,2859,2,625576,0,2859,783,2860,145,0
20150106.014144,2859,2,625578,-2,2859,782,2860,160,0
20150106.014146,2859,2,625580,0,2859,781,2860,173,0
20150106.014147,2859,22,625602,-20,2859,770,2860,173,0
20150106.014148,2860,38,625640,16,2859,770,2860,154,1
20150106.014149,2859,4,625644,0,2859,769,2860,183,0
20150106.01415,2859,2,625646,-2,2859,768,2860,183,0
20150106.01415,2859,2,625648,-2,2859,767,2860,184,0
20150106.014151,2859,14,625662,-14,2859,760,2860,203,0
20150106.014153,2859,4,625666,-4,2859,742,2860,205,0
20150106.014154,2859,2,625668,0,2859,742,2860,260,0
20150106.014154,2859,4,625672,0,2859,739,2860,259,0
20150106.014155,2859,2,625674,0,2859,738,2860,260,0
20150106.014156,2859,2,625676,0,2859,737,2860,261,0
20150106.014157,2859,12,625688,-2,2859,732,2860,268,0
20150106.014158,2859,2,625690,0,2859,731,2860,269,0
20150106.014158,2860,28,625718,-2,2859,731,2860,255,1
20150106.014158,2860,6,625724,4,2859,730,2860,254,1
20150106.014159,2859,2,625726,0,2859,729,2860,254,0
20150106.014201,2859,34,625760,-14,2859,712,2860,268,0
20150106.014205,2859,60,625820,-60,2859,682,2860,307,0
20150106.014206,2859,4,625824,-2,2859,665,2860,308,0
20150106.014207,2859,2,625826,0,2859,664,2860,309,0
20150106.014209,2859,10,625836,-2,2859,683,2860,315,0
20150106.014209,2859,6,625842,-6,2859,680,2860,327,0
20150106.01421,2859,30,625872,-30,2859,665,2860,328,0
20150106.014211,2859,30,625902,-24,2859,652,2860,326,0
20150106.014213,2859,8,625910,-4,2859,648,2860,415,0
20150106.014213,2859,2,625912,0,2859,647,2860,415,0
20150106.014214,2859,2,625914,0,2859,656,2860,415,0
20150106.014217,2859,14,625928,-6,2859,649,2860,421,0
20150106.014217,2859,2,625930,0,2859,648,2860,411,0
20150106.01422,2859,4,625934,0,2859,651,2860,428,0
20150106.01422,2859,2,625936,0,2859,650,2860,428,0
20150106.014222,2859,2,625938,0,2859,649,2860,428,0
20150106.014223,2859,2,625940,-2,2859,648,2860,439,0
20150106.014223,2859,2,625942,-2,2859,647,2860,438,0
20150106.014224,2859,2,625944,0,2859,646,2860,437,0
20150106.014226,2859,2,625946,0,2859,646,2860,437,0
20150106.014228,2859,128,626074,-2,2859,582,2860,426,0
20150106.014229,2859,2,626076,0,2859,581,2860,428,0
20150106.01423,2859,2,626078,-2,2859,430,2860,429,0
20150106.01423,2859,20,626098,0,2859,420,2860,429,0
20150106.014231,2859,98,626196,-38,2859,372,2860,429,0
20150106.014231,2859,68,626264,-62,2859,338,2860,429,0
20150106.014232,2859,4,626268,-2,2859,336,2860,428,0
20150106.014232,2859,206,626474,174,2859,233,2860,428,0
20150106.014233,2859,16,626490,14,2859,225,2860,429,0
20150106.014233,2859,128,626618,72,2859,161,2860,429,0
20150106.014234,2859,2,626620,2,2859,160,2860,429,0
20150106.014234,2859,2,626622,2,2859,159,2860,428,0
20150106.014235,2859,8,626630,6,2859,155,2860,428,0
20150106.014235,2859,4,626634,2,2859,153,2860,442,0
20150106.014236,2859,314,626948,74,2858,178,2860,442,0
20150106.014236,2859,2,626950,0,2858,178,2859,86,0
20150106.014237,2859,10,626960,0,2858,177,2859,85,0
20150106.014238,2858,2,626962,0,2858,176,2859,85,0
20150106.014238,2858,2,626964,0,2858,175,2859,85,0
20150106.01424,2858,2,626966,2,2858,178,2859,87,0
20150106.014241,2858,4,626970,2,2858,177,2859,87,0
20150106.014241,2858,4,626974,4,2858,175,2859,97,0
20150106.014243,2858,20,626994,0,2858,170,2859,162,0
20150106.014244,2858,2,626996,2,2858,192,2859,166,0
20150106.014247,2858,4,627000,0,2858,190,2859,186,0
20150106.014247,2858,20,627020,0,2858,182,2859,186,0
20150106.014248,2858,2,627022,2,2858,184,2859,186,0
20150106.014249,2858,10,627032,0,2858,187,2859,186,0
20150106.014249,2858,4,627036,0,2858,185,2859,186,0
20150106.01425,2858,2,627038,2,2858,185,2859,187,0
20150106.014251,2858,2,627040,0,2858,184,2859,189,0
20150106.014252,2858,2,627042,2,2858,193,2859,189,0
20150106.014253,2858,2,627044,2,2858,193,2859,236,0
20150106.014255,2858,8,627052,8,2858,189,2859,236,0
20150106.014257,2858,4,627056,4,2858,187,2859,216,0
20150106.0143,2858,10,627066,10,2858,183,2859,213,0
20150106.014301,2859,2,627068,0,2858,189,2859,214,1
20150106.014302,2859,4,627072,-4,2858,189,2859,213,1
20150106.014302,2858,10,627082,10,2858,234,2859,226,0
20150106.014303,2858,2,627084,2,2858,233,2859,226,0
20150106.014304,2858,4,627088,4,2858,231,2859,226,0
20150106.014305,2859,468,627556,120,2859,167,2860,389,1
20150106.014306,2859,4,627560,4,2859,165,2860,407,1
20150106.014307,2859,10,627570,10,2859,162,2860,397,1
20150106.014311,2859,10,627580,10,2859,1224,2860,372,1
20150106.014313,2860,2,627582,-2,2859,1264,2860,391,1
20150106.014314,2859,10,627592,10,2859,1259,2860,391,0
20150106.014315,2860,2,627594,-2,2859,1259,2860,400,1
20150106.014316,2859,10,627604,10,2859,1254,2860,400,0
20150106.014317,2860,10,627614,2,2859,1254,2860,396,1
20150106.014317,2860,2,627616,2,2859,1254,2860,397,1
20150106.014319,2860,80,627696,0,2859,1256,2860,357,1
20150106.014319,2859,2,627698,2,2859,1265,2860,357,0
20150106.014321,2860,6,627704,4,2859,1285,2860,354,1
20150106.014325,2859,280,627984,28,2859,1166,2860,222,0
20150106.014326,2860,20,628004,-2,2859,1166,2860,212,1
20150106.014327,2860,106,628110,40,2859,1166,2860,161,1
20150106.014328,2860,66,628176,-20,2859,1153,2860,127,1
20150106.014329,2860,16,628192,-2,2859,1153,2860,119,1
20150106.014331,2860,18,628210,-8,2859,1158,2860,122,1
20150106.014333,2860,114,628324,18,2859,1158,2860,65,1
20150106.014333,2860,42,628366,38,2859,1138,2860,64,1
20150106.014334,2860,16,628382,6,2859,1139,2860,56,1
20150106.014334,2860,36,628418,8,2859,1130,2860,47,1
20150106.014335,2860,94,628512,0,2860,7,2861,444,1
20150106.014336,2859,100,628612,-94,2859,1099,2861,444,0
20150106.014337,2860,2,628614,-2,2860,9,2861,444,1
20150106.014337,2860,2,628616,0,2860,8,2861,444,1
20150106.014338,2860,16,628632,-10,2859,1099,2861,444,1
20150106.014339,2859,2,628634,-2,2859,1108,2860,2,0
20150106.014341,2860,12,628646,-12,2860,20,2861,438,1
20150106.014342,2861,6,628652,0,2860,20,2861,435,1
20150106.014343,2861,8,628660,-8,2860,23,2861,432,1
20150106.014345,2860,6,628666,-4,2860,21,2861,430,0
20150106.014345,2861,2,628668,-2,2860,31,2861,428,1
20150106.014346,2860,2,628670,-2,2860,30,2861,428,0
20150106.014346,2860,4,628674,-2,2860,29,2861,427,0
20150106.014348,2860,6,628680,-6,2860,63,2861,430,0
20150106.014349,2861,6,628686,-6,2860,61,2861,429,1
20150106.01435,2860,26,628712,-22,2860,48,2861,429,0
20150106.014353,2860,2,628714,2,2860,51,2861,464,0
20150106.014354,2860,2,628716,0,2860,100,2861,464,0
20150106.014355,2860,2,628718,-2,2860,101,2861,464,0
20150106.014355,2860,4,628722,0,2860,99,2861,466,0
20150106.014356,2861,4,628726,0,2860,399,2861,464,1
20150106.014356,2860,2,628728,0,2860,399,2861,464,0
20150106.014357,2861,4,628732,0,2860,397,2861,463,1
20150106.014358,2860,100,628832,12,2860,350,2861,461,0
20150106.014406,2861,2,628834,-2,2860,353,2861,405,1
20150106.014407,2860,14,628848,-6,2860,352,2861,404,0
20150106.01441,2860,736,629584,24,2859,1143,2861,340,0
20150106.014412,2860,14,629598,12,2859,1142,2861,442,0
20150106.014414,2860,2,629600,0,2859,1142,2860,31,0
20150106.014414,2860,62,629662,0,2859,1142,2860,1,0
20150106.014415,2860,6,629668,-2,2859,1212,2860,2,0
20150106.014416,2860,4,629672,-2,2859,1212,2860,6,0
20150106.014417,2859,2,629674,0,2859,1211,2860,12,0
20150106.014419,2859,4,629678,-4,2859,1209,2860,13,0
20150106.014421,2860,2,629680,0,2859,1209,2860,31,1
20150106.014423,2859,2,629682,0,2859,1207,2860,53,0
20150106.014425,2859,40,629722,0,2859,1187,2860,68,0
20150106.014426,2860,4,629726,0,2859,1187,2860,70,1
20150106.014428,2860,74,629800,-14,2859,1188,2860,33,1
20150106.014429,2860,14,629814,12,2859,1188,2860,27,1
20150106.01443,2859,4,629818,0,2859,1186,2860,49,0
20150106.014431,2859,2,629820,0,2859,1185,2860,49,0
20150106.014432,2860,10,629830,-4,2859,1183,2860,47,1
20150106.014433,2860,2,629832,2,2859,1183,2860,47,1
20150106.014433,2859,4,629836,0,2859,1200,2860,47,0
20150106.014435,2859,2,629838,0,2859,1199,2860,48,0
20150106.014437,2860,10,629848,-2,2859,1199,2860,44,1
20150106.014437,2859,2,629850,0,2859,1198,2860,56,0
20150106.014438,2860,2,629852,0,2859,1198,2860,55,1
20150106.014438,2860,100,629952,78,2859,1198,2860,5,1
20150106.014439,2859,2,629954,0,2859,1197,2860,5,0
20150106.014439,2860,8,629962,6,2859,1197,2860,2,1
20150106.01444,2860,12,629974,-10,2859,1192,2860,1,1
20150106.01444,2860,22,629996,2,2859,1192,2861,535,1
20150106.014441,2859,2,629998,0,2859,1191,2861,535,0
20150106.014443,2860,22,630020,22,2859,1191,2861,535,1
20150106.014444,2859,2,630022,0,2859,1190,2861,535,0
20150106.014449,2861,30,630052,4,2860,6,2861,525,1
20150106.014449,2860,2,630054,2,2860,6,2861,525,0
20150106.01445,2860,16,630070,16,2860,90,2861,525,0
20150106.014451,2860,2,630072,2,2860,165,2861,521,0
20150106.014452,2861,26,630098,24,2860,154,2861,520,1
20150106.014452,2860,2,630100,2,2860,313,2861,520,0
20150106.014452,2861,2,630102,0,2860,315,2861,519,1
20150106.014453,2861,102,630204,0,2860,265,2861,502,1
20150106.014454,2861,2,630206,0,2860,268,2861,501,1
20150106.014456,2860,2,630208,0,2860,276,2861,517,0
20150106.014456,2860,4,630212,2,2860,274,2861,517,0
20150106.014457,2860,4,630216,4,2860,272,2861,517,0
20150106.014458,2860,6,630222,4,2860,273,2861,517,0
20150106.014459,2860,2,630224,2,2860,273,2861,517,0
20150106.0145,2861,22,630246,0,2860,283,2861,506,1
20150106.014501,2861,34,630280,-20,2860,283,2861,490,1
20150106.014501,2861,16,630296,-10,2860,283,2861,482,1
20150106.014502,2861,230,630526,176,2860,283,2861,367,1
20150106.014503,2860,100,630626,-12,2860,243,2861,367,0
20150106.014504,2860,2,630628,0,2860,242,2861,367,0
20150106.014505,2861,2,630630,2,2860,256,2861,366,1
20150106.014505,2861,2,630632,2,2860,256,2861,365,1
20150106.014506,2861,400,631032,-178,2860,256,2861,165,1
20150106.014507,2861,330,631362,-42,2860,261,2862,428,1
20150106.014507,2861,4,631366,4,2860,261,2861,1,1
20150106.014508,2861,2,631368,0,2860,261,2862,427,1
20150106.014508,2861,6,631374,0,2860,262,2862,427,1
20150106.014509,2861,12,631386,0,2860,278,2862,417,1
20150106.014512,2861,2,631388,-2,2860,338,2862,423,1
20150106.014513,2862,100,631488,0,2861,1,2862,373,1
20150106.014514,2862,4,631492,-4,2861,1,2862,371,1
20150106.014514,2862,2,631494,0,2861,401,2862,370,1
20150106.014515,2862,20,631514,-8,2861,406,2862,362,1
20150106.014515,2862,10,631524,-10,2861,411,2862,357,1
20150106.014516,2862,20,631544,0,2861,412,2862,347,1
20150106.014517,2862,2,631546,0,2861,417,2862,347,1
20150106.014518,2862,746,632292,-518,2862,652,2863,1006,1
20150106.01452,2863,6,632298,0,2862,654,2863,804,1
20150106.01452,2862,80,632378,-56,2862,669,2863,769,0
20150106.014521,2863,20,632398,-16,2862,669,2863,754,1
20150106.014521,2863,20,632418,-18,2862,669,2863,745,1
20150106.014522,2863,206,632624,-190,2862,669,2863,642,1
20150106.014522,2863,230,632854,188,2862,669,2863,526,1
20150106.014523,2863,194,633048,-2,2862,668,2863,431,1
20150106.014523,2863,36,633084,-34,2862,668,2863,413,1
20150106.014524,2863,42,633126,-10,2862,668,2863,396,1
20150106.014524,2863,142,633268,-104,2862,665,2863,326,1
20150106.014525,2863,40,633308,-40,2862,666,2863,305,1
20150106.014525,2863,2,633310,-2,2862,667,2863,305,1
20150106.014526,2863,44,633354,-44,2862,667,2863,295,1
20150106.014526,2863,2,633356,0,2862,668,2863,296,1
20150106.014527,2863,2,633358,0,2862,668,2863,293,1
20150106.014527,2863,12,633370,-12,2862,691,2863,287,1
20150106.014528,2863,594,633964,-486,2863,708,2864,663,1
20150106.014528,2863,4,633968,0,2863,708,2864,663,1
20150106.014529,2863,24,633992,-2,2863,696,2864,667,1
20150106.014529,2863,32,634024,-32,2863,683,2864,667,1
20150106.01453,2863,14,634038,-6,2863,1682,2864,662,1
20150106.014531,2864,22,634060,-20,2863,1688,2864,655,1
20150106.014531,2864,14,634074,2,2863,1688,2864,634,1
20150106.014532,2864,50,634124,-40,2863,1693,2864,611,1
20150106.014532,2864,2,634126,0,2863,1693,2864,610,1
20150106.014533,2864,60,634186,-48,2863,1694,2864,581,1
20150106.014533,2864,2,634188,2,2863,1694,2864,580,1
20150106.014533,2864,32,634220,2,2863,1694,2864,565,1
20150106.014534,2863,164,634384,-4,2863,1692,2864,484,0
20150106.014534,2864,4,634388,0,2863,1707,2864,482,1
20150106.014535,2864,26,634414,-14,2863,1706,2864,499,1
20150106.014536,2864,2,634416,-2,2863,1706,2864,503,1
20150106.014536,2864,2,634418,0,2863,1706,2864,522,1
20150106.014537,2864,6,634424,0,2863,766,2864,529,1
20150106.014538,2864,4,634428,-2,2863,758,2864,527,1
20150106.014539,2864,16,634444,-8,2863,754,2864,521,1
20150106.014539,2864,40,634484,-20,2863,703,2864,502,1
20150106.01454,2864,82,634566,-76,2863,697,2864,473,1
20150106.01454,2863,6,634572,0,2863,696,2864,472,0
20150106.014541,2864,36,634608,-10,2863,684,2864,465,1
20150106.014542,2863,2,634610,0,2863,683,2864,467,0
20150106.014543,2863,80,634690,0,2863,653,2864,467,0
20150106.014544,2863,6,634696,-4,2863,650,2864,467,0
20150106.014544,2863,4,634700,-4,2863,652,2864,466,0
20150106.014546,2863,6,634706,-6,2863,660,2864,482,0
20150106.014548,2863,4,634710,-2,2863,660,2864,513,0
20150106.014548,2863,2,634712,0,2863,659,2864,514,0
20150106.014549,2863,2,634714,0,2863,659,2864,516,0
20150106.01455,2863,4,634718,0,2863,658,2864,515,0
20150106.01455,2863,6,634724,0,2863,656,2864,501,0
20150106.014551,2863,208,634932,0,2863,552,2864,501,0
20150106.014551,2863,2,634934,0,2863,563,2864,501,0
20150106.014552,2863,2,634936,-2,2863,560,2864,499,0
20150106.014552,2863,2,634938,-2,2863,559,2864,500,0
20150106.014553,2863,10,634948,0,2863,554,2864,500,0
20150106.014553,2864,1002,635950,-630,2864,500,2865,1067,1
20150106.014554,2864,14,635964,-4,2864,493,2865,1067,1
20150106.014554,2865,988,636952,-984,2863,553,2865,1074,1
20150106.014555,2865,10,636962,2,2863,542,2865,1088,1
20150106.014556,2863,118,637080,-84,2863,506,2865,1079,0
20150106.014556,2863,4,637084,0,2863,504,2864,6,0
20150106.014557,2864,202,637286,2,2863,454,2864,7,1
20150106.014558,2864,4,637290,2,2863,504,2864,11,1
20150106.014559,2864,12,637302,8,2863,504,2864,21,1
20150106.0146,2864,4,637306,2,2863,504,2864,21,1
20150106.0146,2864,2,637308,0,2863,504,2864,23,1
20150106.014601,2863,4,637312,0,2863,502,2864,35,0
20150106.014602,2864,2,637314,0,2863,504,2864,35,1
20150106.014603,2864,76,637390,58,2863,515,2865,985,1
20150106.014605,2864,14,637404,-10,2864,8,2865,985,1
20150106.014605,2864,22,637426,-18,2863,521,2865,987,1
20150106.014606,2863,36,637462,-36,2863,504,2865,988,0
20150106.014607,2865,14,637476,0,2863,494,2865,981,1
20150106.014608,2863,42,637518,2,2863,579,2864,86,0
20150106.014609,2864,2,637520,-2,2863,579,2864,92,1
20150106.014611,2864,2,637522,0,2863,580,2864,101,1
20150106.014611,2864,42,637564,-4,2863,579,2864,82,1
20150106.014612,2863,22,637586,12,2863,578,2865,738,0
20150106.014613,2864,2,637588,-2,2863,603,2864,125,1
20150106.014614,2863,10,637598,0,2863,598,2864,225,0
20150106.014614,2863,6,637604,-4,2863,597,2864,224,0
20150106.014615,2863,4,637608,4,2863,597,2864,223,0
20150106.014616,2864,4,637612,-2,2863,596,2864,222,1
20150106.014616,2864,446,638058,-104,2864,779,2865,947,1
20150106.014617,2864,60,638118,0,2864,751,2865,947,1
20150106.014617,2864,42,638160,-2,2864,730,2865,952,1
20150106.014618,2864,72,638232,0,2864,694,2865,952,1
20150106.014618,2864,6,638238,-4,2864,700,2865,953,1
20150106.01462,2864,2,638240,0,2864,700,2865,955,1
20150106.01462,2864,2,638242,0,2864,699,2865,956,1
20150106.014622,2864,10,638252,-10,2864,695,2865,957,1
20150106.014622,2865,10,638262,-2,2864,698,2865,953,1
20150106.014622,2865,4,638266,0,2864,704,2865,952,1
20150106.014623,2865,8,638274,0,2864,702,2865,944,1
20150106.014625,2864,6,638280,0,2864,689,2865,965,0
20150106.014625,2864,2,638282,0,2864,688,2865,965,0
20150106.014625,2865,2,638284,0,2864,688,2865,968,1
20150106.014626,2865,4,638288,0,2864,692,2865,967,1
20150106.014628,2864,2,638290,0,2864,691,2865,957,0
20150106.014629,2865,2,638292,0,2864,695,2865,961,1
20150106.01463,2864,12,638304,-2,2864,689,2865,969,0
20150106.014631,2864,2,638306,-2,2864,688,2865,976,0
20150106.014632,2864,400,638706,0,2864,488,2865,891,0
20150106.014633,2865,8,638714,-4,2864,488,2865,888,1
20150106.014633,2864,2,638716,-2,2864,487,2865,888,0
20150106.014636,2864,42,638758,-40,2864,469,2865,891,0
20150106.014637,2865,2,638760,0,2864,469,2865,890,1
20150106.014638,2865,2,638762,0,2864,469,2865,889,1
20150106.014638,2864,2,638764,0,2864,468,2865,890,0
20150106.014639,2864,72,638836,-72,2864,432,2865,891,0
20150106.01464,2864,6,638842,-2,2864,433,2865,891,0
20150106.01464,2864,2,638844,0,2864,432,2865,891,0
20150106.014641,2865,4,638848,-2,2864,432,2865,889,1
20150106.014642,2864,18,638866,0,2864,434,2865,893,0
20150106.014644,2864,2,638868,0,2864,433,2865,894,0
20150106.014644,2864,202,639070,106,2864,432,2865,696,0
20150106.014646,2865,4,639074,4,2864,452,2865,694,1
20150106.014648,2864,14,639088,-8,2864,456,2865,727,0
20150106.014649,2864,60,639148,0,2864,426,2865,741,0
20150106.014649,2864,262,639410,-62,2864,296,2865,741,0
20150106.014649,2864,20,639430,0,2864,286,2865,739,0
20150106.01465,2865,4,639434,2,2864,285,2865,739,1
20150106.014651,2864,96,639530,-96,2864,237,2865,739,0
20150106.014651,2864,2,639532,0,2864,409,2865,739,0
20150106.014652,2864,14,639546,-6,2864,412,2865,739,0
20150106.014652,2864,4,639550,-2,2864,420,2865,739,0
20150106.014652,2865,60,639610,-44,2864,423,2865,709,1
20150106.014654,2864,28,639638,-28,2864,410,2865,709,0
20150106.014655,2865,34,639672,0,2864,410,2865,691,1
20150106.014655,2864,2,639674,-2,2864,409,2865,691,0
20150106.014656,2864,58,639732,-58,2864,380,2865,692,0
20150106.014657,2864,80,639812,0,2864,342,2865,814,0
20150106.014659,2865,4,639816,-2,2864,342,2865,809,1
20150106.0147,2865,10,639826,0,2864,342,2865,807,1
20150106.014702,2864,12,639838,-4,2864,335,2865,815,0
20150106.014702,2865,2,639840,0,2864,335,2865,820,1
20150106.014703,2864,98,639938,-16,2864,316,2865,670,0
20150106.014705,2865,102,640040,32,2864,140,2865,619,1
20150106.014705,2864,108,640148,-18,2864,86,2865,620,0
20150106.014706,2864,172,640320,-34,2863,457,2865,627,0
20150106.014706,2865,8,640328,-8,2863,457,2864,100,1
20150106.014707,2864,24,640352,-4,2863,455,2864,91,0
20150106.014707,2864,2,640354,2,2863,455,2864,91,0
20150106.01471,2864,6,640360,2,2863,454,2864,97,0
20150106.014711,2863,2,640362,-2,2863,453,2864,133,0
20150106.014712,2864,206,640568,198,2863,453,2864,41,1
20150106.014713,2864,82,640650,62,2864,362,2865,638,1
20150106.014714,2864,4,640654,0,2864,371,2865,651,1
20150106.014714,2864,202,640856,0,2864,270,2865,650,1
20150106.014714,2864,202,641058,200,2864,170,2865,648,1
20150106.014715,2864,122,641180,82,2864,119,2865,638,1
20150106.014716,2864,188,641368,168,2864,35,2865,628,1
20150106.014716,2864,78,641446,76,2863,464,2864,82,1
20150106.014716,2864,2,641448,2,2863,464,2864,83,1
20150106.014718,2864,12,641460,12,2863,464,2864,79,1
20150106.014722,2863,40,641500,-40,2863,454,2864,64,0
20150106.014723,2864,16,641516,16,2863,454,2864,57,1
20150106.014726,2863,4,641520,-4,2863,452,2864,71,0
20150106.014727,2863,2,641522,-2,2863,451,2864,72,0
20150106.014728,2863,2,641524,0,2863,450,2864,80,0
20150106.014728,2863,28,641552,-28,2863,436,2864,83,0
20150106.014729,2864,2,641554,2,2863,436,2864,95,1
20150106.01473,2864,10,641564,0,2863,436,2864,90,1
20150106.014731,2863,2,641566,-2,2863,435,2864,90,0
20150106.014732,2864,50,641616,50,2863,436,2864,67,1
20150106.014732,2863,4,641620,0,2863,434,2864,67,0
20150106.014733,2864,2,641622,2,2863,434,2864,87,1
20150106.014735,2864,2,641624,2,2863,434,2864,139,1
20150106.014736,2863,6,641630,-6,2863,431,2864,123,0
20150106.01474,2863,2,641632,0,2863,430,2864,127,0
20150106.014741,2863,18,641650,-16,2863,421,2864,133,0
20150106.014741,2863,18,641668,2,2863,413,2864,132,0
20150106.014742,2863,2,641670,0,2863,412,2864,172,0
20150106.014745,2864,2,641672,2,2863,413,2864,196,1
20150106.014745,2863,2,641674,0,2863,412,2864,217,0
20150106.014748,2863,8,641682,-6,2863,408,2864,226,0
20150106.014748,2863,20,641702,-20,2863,398,2864,226,0
20150106.014755,2863,6,641708,-6,2863,399,2864,227,0
20150106.014755,2863,2,641710,-2,2863,398,2864,236,0
20150106.014757,2863,42,641752,32,2863,397,2864,213,0
20150106.014758,2863,2,641754,-2,2863,396,2864,214,0
20150106.0148,2863,40,641794,-40,2863,377,2864,316,0
20150106.0148,2863,28,641822,-28,2863,363,2864,316,0
20150106.014802,2864,2,641824,0,2863,366,2864,319,1
20150106.014803,2863,20,641844,-20,2863,359,2864,321,0
20150106.014805,2863,4,641848,0,2863,357,2864,322,0
20150106.014808,2864,600,642448,-244,2863,357,2864,22,1
20150106.014809,2864,72,642520,-30,2863,357,2864,16,1
20150106.014812,2864,2,642522,2,2863,530,2864,26,1
20150106.014813,2864,20,642542,20,2863,530,2864,16,1
20150106.014815,2863,2,642544,-2,2863,529,2864,26,0
20150106.014817,2864,14,642558,14,2863,529,2864,23,1
20150106.014817,2864,12,642570,0,2863,529,2864,17,1
20150106.014817,2863,2,642572,0,2863,528,2864,17,0
20150106.014819,2864,36,642608,8,2864,2,2865,631,1
20150106.01482,2864,2,642610,2,2864,12,2865,631,1
20150106.01482,2865,2,642612,0,2864,12,2865,630,1
20150106.014821,2864,22,642634,2,2864,12,2865,620,0
20150106.014823,2864,30,642664,24,2863,528,2864,7,0
20150106.014824,2863,8,642672,0,2863,524,2864,9,0
20150106.014826,2864,4,642676,0,2863,522,2864,209,1
20150106.014828,2863,6,642682,0,2863,520,2864,214,0
20150106.014837,2864,2,642684,2,2863,532,2864,289,1
20150106.014839,2863,4,642688,-4,2863,540,2864,294,0
20150106.01484,2864,2,642690,2,2863,540,2864,294,1
20150106.014843,2864,6,642696,-2,2863,540,2864,293,1
20150106.014845,2863,60,642756,-60,2863,510,2864,294,0
20150106.014846,2864,2,642758,-2,2863,510,2864,293,1
20150106.014848,2864,650,643408,-468,2864,175,2865,660,1
20150106.01485,2865,12,643420,0,2864,177,2865,618,1
20150106.014851,2865,40,643460,-40,2864,177,2865,598,1
20150106.014852,2864,16,643476,0,2864,170,2865,598,0
20150106.014854,2864,6,643482,0,2864,167,2865,590,0
20150106.014856,2865,2,643484,0,2864,167,2865,594,1
20150106.014857,2865,6,643490,0,2864,167,2865,590,1
20150106.014859,2865,8,643498,-2,2864,166,2865,589,1
20150106.014901,2865,20,643518,0,2864,213,2865,579,1
20150106.014902,2864,4,643522,0,2864,211,2865,574,0
20150106.014904,2864,2,643524,0,2864,213,2865,575,0
20150106.014904,2864,120,643644,-120,2864,153,2865,576,0
20150106.014907,2864,100,643744,0,2864,106,2865,576,0
20150106.014908,2864,6,643750,0,2864,103,2865,576,0
20150106.014908,2864,8,643758,0,2864,99,2865,576,0
20150106.014909,2865,60,643818,-60,2864,99,2865,546,1
20150106.01491,2864,2,643820,-2,2864,53,2865,547,0
20150106.014911,2864,20,643840,0,2864,44,2865,552,0
20150106.014911,2864,2,643842,-2,2864,43,2865,552,0
20150106.014912,2864,86,643928,-68,2863,508,2864,160,0
20150106.014914,2864,4,643932,0,2863,508,2864,163,0
20150106.014915,2864,2,643934,0,2863,508,2864,162,0
20150106.014915,2864,60,643994,-60,2863,508,2864,132,0
20150106.014918,2864,16,644010,0,2863,508,2864,124,0
20150106.014919,2863,2,644012,0,2863,506,2864,127,0
20150106.01492,2864,20,644032,0,2863,506,2864,118,1
20150106.014924,2863,2,644034,0,2863,560,2864,143,0
20150106.014929,2863,2,644036,-2,2863,559,2864,147,0
20150106.014932,2864,16,644052,0,2863,559,2864,142,1
20150106.014934,2864,60,644112,0,2863,560,2864,118,1
20150106.014934,2864,16,644128,0,2863,560,2864,110,1
20150106.014935,2863,2,644130,0,2863,559,2864,130,0
20150106.014936,2864,260,644390,-198,2864,1021,2865,526,1
20150106.014938,2864,2,644392,-2,2864,1044,2865,522,1
20150106.014938,2864,6,644398,-6,2864,1050,2865,522,1
20150106.014939,2864,10,644408,-10,2864,1057,2865,522,1
20150106.014939,2864,2,644410,-2,2864,1062,2865,522,1
20150106.01494,2865,6,644416,-2,2864,1068,2865,519,1
20150106.014941,2864,2,644418,0,2864,1067,2865,519,0
20150106.014941,2865,2,644420,0,2864,1010,2865,518,1
20150106.014941,2864,2,644422,0,2864,1009,2865,518,0
20150106.014944,2864,8,644430,-8,2864,1035,2865,518,0
20150106.014945,2865,500,644930,-480,2864,1036,2865,268,1
20150106.014945,2865,12,644942,-12,2864,1036,2865,262,1
20150106.014945,2864,6,644948,0,2864,1033,2865,253,0
20150106.014946,2865,6,644954,-6,2864,1033,2865,250,1
20150106.014947,2865,36,644990,-30,2864,1033,2865,232,1
20150106.014947,2865,4,644994,0,2864,1033,2865,230,1
20150106.014947,2865,34,645028,-30,2864,1033,2865,213,1
20150106.014948,2865,2,645030,0,2864,1033,2865,212,1
20150106.014948,2865,30,645060,6,2864,1033,2865,197,1
20150106.014949,2865,36,645096,30,2864,1003,2865,180,1
20150106.01495,2865,14,645110,2,2864,1003,2865,173,1
20150106.014951,2865,6,645116,0,2864,1003,2865,170,1
20150106.014951,2864,2,645118,-2,2864,1002,2865,170,0
20150106.014952,2864,2,645120,-2,2864,1001,2865,170,0
20150106.014953,2865,22,645142,14,2864,1000,2865,160,1
20150106.014954,2865,320,645462,-28,2864,1001,2866,1132,1
20150106.014954,2865,2,645464,0,2864,1001,2865,1,1
20150106.014955,2865,2,645466,-2,2864,1001,2866,1132,1
20150106.014955,2865,2,645468,2,2865,27,2866,1133,1
20150106.014956,2865,2,645470,2,2865,26,2866,1133,1
20150106.014957,2865,6,645476,6,2865,101,2866,1134,1
20150106.014958,2865,2,645478,2,2865,100,2866,1119,1
20150106.014958,2865,140,645618,-118,2865,30,2866,1119,1
20150106.014959,2865,60,645678,0,2864,1012,2866,1137,1
20150106.015,2865,2,645680,2,2864,1012,2865,18,1
20150106.015001,2866,268,645948,2,2865,10,2866,1035,1
20150106.015001,2866,34,645982,-12,2865,11,2866,1018,1
20150106.015002,2866,22,646004,-20,2865,11,2866,1008,1
20150106.015002,2866,4,646008,-2,2865,10,2866,1007,1
20150106.015003,2865,6,646014,0,2865,21,2866,1007,0
20150106.015003,2865,4,646018,-2,2865,20,2866,1006,0
20150106.015004,2865,4,646022,-4,2865,20,2866,1007,0
20150106.015005,2865,2,646024,0,2865,19,2866,1007,0
20150106.015005,2865,8,646032,2,2865,14,2866,1007,0
20150106.015006,2865,2,646034,0,2865,13,2866,1008,0
20150106.015006,2865,28,646062,4,2864,1010,2865,17,0
20150106.015007,2865,36,646098,0,2865,5,2866,1008,0
20150106.015007,2866,20,646118,-20,2865,5,2866,998,1
20150106.015008,2866,80,646198,-80,2865,7,2866,959,1
20150106.015009,2865,4,646202,4,2865,16,2866,959,0
20150106.015009,2865,22,646224,-12,2865,19,2866,960,0
20150106.01501,2865,4,646228,0,2865,17,2866,961,0
20150106.015011,2866,80,646308,18,2865,19,2866,921,1
20150106.015011,2865,18,646326,0,2865,98,2866,906,0
20150106.015015,2865,2,646328,0,2865,132,2866,926,0
20150106.015015,2866,2,646330,0,2865,133,2866,925,1
20150106.015016,2865,2,646332,-2,2865,140,2866,925,0
20150106.015017,2865,2,646334,0,2865,151,2866,926,0
20150106.015018,2866,1852,648186,-1682,2866,76,2867,963,1
20150106.015019,2866,2,648188,0,2866,81,2867,964,1
20150106.015019,2866,40,648228,0,2866,61,2867,964,1
20150106.015019,2866,38,648266,0,2866,42,2867,964,1
20150106.01502,2866,6,648272,0,2866,83,2867,965,1
20150106.015021,2866,10,648282,-2,2866,79,2867,968,1
20150106.015022,2866,38,648320,-28,2866,101,2867,952,1
20150106.015023,2866,12,648332,0,2866,95,2867,953,1
20150106.015023,2866,2,648334,-2,2866,94,2867,953,1
20150106.015024,2866,6,648340,-4,2866,94,2867,953,1
20150106.015025,2866,4,648344,-2,2866,93,2867,954,1
20150106.015026,2867,2,648346,-2,2866,93,2867,954,1
20150106.015027,2866,24,648370,-22,2866,98,2867,948,0
20150106.015027,2867,16,648386,-14,2866,94,2867,945,1
20150106.015028,2867,22,648408,-18,2866,102,2867,937,1
20150106.015028,2867,676,649084,-350,2866,99,2867,610,1
20150106.015028,2866,16,649100,-4,2866,97,2867,603,0
20150106.015029,2867,2,649102,0,2866,100,2867,602,1
20150106.01503,2866,2,649104,-2,2866,99,2867,602,0
20150106.01503,2867,1012,650116,-986,2867,71,2868,866,1
20150106.015031,2867,40,650156,-30,2867,52,2868,866,1
20150106.015031,2868,20,650176,0,2867,49,2868,859,1
20150106.015032,2868,222,650398,-80,2867,42,2868,760,1
20150106.015032,2868,40,650438,-32,2867,85,2868,745,1
20150106.015033,2867,102,650540,-76,2867,94,2868,695,0
20150106.015033,2868,122,650662,-12,2867,88,2868,632,1
20150106.015034,2867,36,650698,-22,2867,74,2868,628,0
20150106.015034,2868,6,650704,-4,2867,74,2868,642,1
20150106.015035,2867,10,650714,0,2867,68,2868,642,0
20150106.015035,2867,20,650734,2,2867,58,2868,645,0
20150106.015036,2867,120,650854,10,2866,165,2867,6,0
20150106.015036,2867,12,650866,0,2866,166,2868,594,0
20150106.015037,2867,2,650868,2,2866,166,2868,594,0
20150106.015037,2867,2,650870,0,2866,178,2868,645,0
20150106.015038,2867,8,650878,6,2866,171,2868,654,0
20150106.015039,2868,2,650880,0,2867,2,2868,654,1
20150106.015039,2868,150,651030,-146,2867,1,2868,588,1
20150106.01504,2867,98,651128,-94,2867,6,2868,540,0
20150106.01504,2868,30,651158,-30,2867,6,2868,525,1
20150106.01504,2867,2,651160,0,2867,5,2868,525,0
20150106.015042,2867,12,651172,10,2866,176,2868,527,0
20150106.015042,2867,4,651176,0,2866,177,2867,1,0
20150106.015043,2866,34,651210,-2,2866,131,2868,529,0
20150106.015043,2866,10,651220,0,2866,126,2868,527,0
20150106.015044,2867,6,651226,0,2867,28,2868,527,1
20150106.015044,2867,56,651282,2,2866,126,2868,527,1
20150106.015045,2867,2,651284,2,2866,126,2867,2,1
20150106.015045,2868,16,651300,2,2866,126,2868,528,1
20150106.015046,2866,2,651302,0,2866,125,2867,2,0
20150106.015046,2868,10,651312,4,2866,125,2867,1,1
20150106.015047,2868,4,651316,0,2866,125,2868,525,1
20150106.015047,2866,4,651320,0,2866,124,2868,524,0
20150106.015048,2868,400,651720,-370,2867,9,2868,317,1
20150106.015048,2866,30,651750,-28,2866,119,2868,317,0
20150106.015049,2867,4,651754,-2,2867,14,2868,309,1
20150106.015049,2867,2,651756,2,2867,19,2868,309,1
20150106.01505,2867,2,651758,2,2867,48,2868,289,1
20150106.01505,2868,28,651786,0,2867,40,2868,283,1
20150106.015051,2867,14,651800,-6,2867,68,2868,279,0
20150106.015051,2868,2,651802,0,2867,68,2868,281,1
20150106.015053,2867,2,651804,2,2867,78,2868,280,0
20150106.015055,2868,494,652298,-394,2867,84,2868,46,1
20150106.015056,2868,102,652400,-70,2868,500,2869,823,1
20150106.015056,2868,4,652404,-2,2868,499,2869,822,1
20150106.015057,2868,6,652410,0,2868,496,2869,822,1
20150106.015057,2868,8,652418,0,2868,492,2869,822,1
20150106.015058,2868,2,652420,0,2868,491,2869,822,1
20150106.015058,2869,108,652528,52,2868,488,2869,772,1
20150106.015059,2868,6,652534,0,2868,487,2869,771,0
20150106.015059,2868,108,652642,-82,2868,485,2869,719,0
20150106.0151,2868,28,652670,-22,2868,482,2869,703,0
20150106.0151,2868,10,652680,0,2868,480,2869,701,0
20150106.015101,2869,2,652682,0,2868,480,2869,700,1
20150106.015101,2869,12,652694,0,2868,479,2869,695,1
20150106.015102,2868,86,652780,-84,2868,437,2869,699,0
20150106.015102,2868,6,652786,0,2868,434,2869,699,0
20150106.015103,2869,20,652806,0,2868,435,2869,692,1
20150106.015103,2869,1384,654190,-768,2869,58,2870,2465,1
20150106.015104,2870,2,654192,-2,2869,64,2870,2460,1
20150106.015104,2870,36,654228,-2,2869,94,2870,2444,1
20150106.015105,2869,626,654854,-10,2869,49,2870,2256,0
20150106.015105,2869,2,654856,-2,2869,48,2870,2257,0
20150106.015106,2869,24,654880,0,2869,94,2870,2249,0
20150106.015107,2869,50,654930,20,2869,137,2870,2244,0
20150106.015107,2869,34,654964,14,2869,140,2870,2234,0
20150106.015108,2870,38,655002,22,2869,171,2870,2208,1
20150106.015108,2870,10,655012,10,2869,167,2870,2205,1
20150106.015109,2870,30,655042,24,2869,141,2870,2206,1
20150106.015109,2869,24,655066,12,2869,129,2870,2209,0
20150106.01511,2869,82,655148,-20,2869,91,2870,2216,0
20150106.015111,2869,12,655160,2,2869,85,2870,2215,0
20150106.015111,2869,6,655166,4,2869,83,2870,2216,0
20150106.015111,2870,20,655186,12,2869,78,2870,2212,1
20150106.015112,2870,202,655388,100,2869,28,2870,2210,1
20150106.015113,2869,540,655928,-70,2869,63,2870,1962,0
20150106.015113,2870,18,655946,-16,2869,63,2870,1953,1
20150106.015114,2869,4,655950,0,2869,63,2870,1954,0
20150106.015114,2869,6,655956,0,2869,60,2870,1954,0
20150106.015115,2870,32,655988,-10,2869,53,2870,1954,1
20150106.015116,2870,408,656396,-354,2869,53,2870,1731,1
20150106.015116,2869,26,656422,-16,2869,40,2870,1732,0
20150106.015117,2869,24,656446,-12,2869,30,2870,1732,0
20150106.015118,2869,4,656450,0,2869,29,2870,1732,0
20150106.015118,2870,6,656456,0,2869,27,2870,1736,1
20150106.015119,2869,2,656458,0,2869,27,2870,1740,0
20150106.015119,2869,46,656504,22,2869,4,2870,1761,0
20150106.01512,2870,12,656516,0,2869,3,2870,1763,1
20150106.01512,2869,6,656522,2,2868,109,2869,14,0
20150106.015122,2868,14,656536,0,2868,102,2869,17,0
20150106.015122,2869,58,656594,-12,2869,12,2870,1771,1
20150106.015123,2869,42,656636,0,2869,2,2870,1784,1
20150106.015124,2868,6,656642,2,2868,130,2869,14,0
20150106.015125,2869,2,656644,-2,2868,135,2869,38,1
20150106.015126,2869,2,656646,0,2868,135,2869,42,1
20150106.015127,2869,4,656650,-4,2868,134,2869,45,1
20150106.015127,2869,10,656660,0,2868,134,2869,40,1
20150106.015127,2869,2,656662,0,2868,134,2869,40,1
20150106.015128,2868,38,656700,-8,2868,129,2869,34,0
20150106.015128,2869,8,656708,2,2868,127,2869,33,1
20150106.015129,2869,2,656710,2,2868,126,2869,32,1
20150106.015129,2869,14,656724,14,2868,136,2869,28,1
20150106.01513,2869,2,656726,2,2868,136,2869,28,1
20150106.015131,2869,12,656738,12,2868,136,2869,36,1
20150106.015131,2869,10,656748,0,2868,141,2869,31,1
20150106.015134,2869,4,656752,2,2868,152,2869,63,1
20150106.015134,2869,4,656756,2,2868,162,2869,61,1
20150106.015135,2869,24,656780,4,2868,161,2869,51,1
20150106.015137,2868,10,656790,0,2868,156,2869,62,0
20150106.01514,2869,22,656812,-12,2868,164,2869,52,1
20150106.015142,2869,2,656814,0,2868,164,2869,158,1
20150106.015142,2869,318,657132,-262,2869,851,2870,1799,1
20150106.015143,2869,28,657160,-26,2869,838,2870,1799,1
20150106.015143,2869,2,657162,-2,2869,837,2870,1799,1
20150106.015144,2869,4,657166,-2,2869,836,2870,1799,1
20150106.015145,2869,20,657186,-20,2869,827,2870,1803,1
20150106.015145,2870,4,657190,0,2869,826,2870,1802,1
20150106.015146,2870,22,657212,-2,2869,830,2870,1796,1
20150106.015146,2870,20,657232,-20,2869,830,2870,1787,1
20150106.015147,2869,2,657234,-2,2869,833,2870,1787,0
20150106.015148,2870,2,657236,-2,2869,835,2870,1778,1
20150106.015148,2870,400,657636,0,2869,835,2870,1577,1
20150106.015149,2870,466,658102,-22,2869,644,2870,1547,1
20150106.015149,2869,2,658104,0,2869,643,2870,1546,0
20150106.01515,2870,36,658140,-34,2869,643,2870,1528,1
20150106.015151,2869,4,658144,0,2869,642,2870,1530,0
20150106.015152,2870,20,658164,0,2869,642,2870,1545,1
20150106.015153,2870,2,658166,0,2869,641,2870,1526,1
20150106.015154,2870,2,658168,0,2869,641,2870,1520,1
20150106.015156,2870,4,658172,-4,2869,631,2870,1518,1
20150106.015157,2869,10,658182,0,2869,627,2870,1515,0
20150106.015159,2869,28,658210,-12,2869,635,2870,1514,0
20150106.015159,2870,38,658248,-38,2869,635,2870,1495,1
20150106.0152,2870,10,658258,-2,2869,637,2870,1490,1
20150106.015201,2870,26,658284,-24,2869,634,2870,1481,1
20150106.015202,2870,2,658286,0,2869,644,2870,1480,1
20150106.015202,2869,4,658290,0,2869,642,2870,1481,0
20150106.015206,2869,4,658294,-2,2869,648,2870,1491,0
20150106.015207,2869,2,658296,-2,2869,647,2870,1492,0
20150106.015209,2870,120,658416,-120,2869,647,2870,1433,1
20150106.015209,2869,2,658418,0,2869,646,2870,1434,0
20150106.01521,2869,2,658420,-2,2869,645,2870,1434,0
20150106.015211,2870,2004,660424,-948,2869,669,2870,451,1
20150106.015212,2869,442,660866,114,2869,671,2871,457,0
20150106.015212,2871,1452,662318,-362,2871,174,2872,483,1
20150106.015213,2871,310,662628,-24,2870,119,2871,1,1
20150106.015213,2872,398,663026,-338,2871,1,2872,240,1
20150106.015214,2872,40,663066,-12,2871,116,2872,222,1
20150106.015214,2872,42,663108,-36,2871,116,2872,201,1
20150106.015215,2871,12,663120,-10,2871,113,2872,202,0
20150106.015215,2872,2,663122,-2,2871,141,2872,201,1
20150106.015217,2871,8,663130,-6,2871,144,2872,196,0
20150106.015218,2871,100,663230,0,2871,94,2872,206,0
20150106.015219,2871,12,663242,-2,2871,93,2872,294,0
20150106.015219,2871,2,663244,0,2871,92,2872,295,0
20150106.01522,2871,184,663428,-174,2870,114,2871,27,0
20150106.015221,2871,14,663442,-2,2870,114,2871,25,0
20150106.015222,2871,2,663444,0,2870,114,2871,124,0
20150106.015222,2871,8,663452,0,2870,102,2871,146,0
20150106.015223,2871,322,663774,-66,2871,11,2872,292,0
20150106.015223,2871,40,663814,-20,2871,1,2872,283,0
20150106.015224,2871,16,663830,2,2871,213,2872,283,0
20150106.015224,2871,16,663846,12,2871,207,2872,284,0
20150106.015225,2871,66,663912,64,2871,178,2872,284,0
20150106.015225,2871,484,664396,-60,2871,88,2872,116,0
20150106.015225,2871,2,664398,2,2871,87,2872,116,0
20150106.015226,2872,14,664412,12,2871,85,2872,117,1
20150106.015227,2871,10,664422,10,2871,85,2872,117,0
20150106.015227,2871,12,664434,12,2871,79,2872,122,0
20150106.015228,2871,14,664448,0,2871,72,2872,236,0
20150106.015229,2871,164,664612,-8,2870,159,2872,256,0
20150106.015229,2871,2,664614,2,2870,159,2871,2,0
20150106.01523,2871,2,664616,0,2870,170,2871,2,0
20150106.01523,2871,20,664636,-18,2870,186,2871,105,0
20150106.015231,2871,2,664638,0,2870,186,2871,104,0
20150106.015231,2870,2,664640,2,2870,185,2871,104,0
20150106.015232,2870,4,664644,0,2870,183,2871,104,0
20150106.015233,2871,10,664654,0,2870,189,2871,115,1
20150106.015233,2870,4,664658,0,2870,187,2871,120,0
20150106.015234,2871,2,664660,0,2870,187,2871,119,1
20150106.015234,2871,18,664678,-18,2870,178,2871,121,1
20150106.015235,2870,8,664686,0,2870,177,2871,122,0
20150106.015236,2870,2,664688,-2,2870,176,2871,222,0
20150106.015237,2870,2,664690,0,2870,151,2871,222,0
20150106.015237,2870,164,664854,-98,2870,69,2871,222,0
20150106.015238,2870,2,664856,-2,2870,68,2871,222,0
20150106.015239,2870,126,664982,-40,2870,5,2871,274,0
20150106.015239,2870,50,665032,0,2870,22,2871,277,0
20150106.01524,2870,4,665036,0,2870,24,2871,277,0
20150106.015241,2870,2,665038,2,2870,23,2871,288,0
20150106.015241,2870,12,665050,2,2870,18,2871,288,0
20150106.015242,2870,6,665056,6,2870,16,2871,288,0
20150106.015242,2870,4,665060,4,2870,14,2871,288,0
20150106.015244,2871,12,665072,2,2870,12,2871,291,1
20150106.015244,2870,110,665182,110,2869,679,2870,1,0
20150106.015245,2870,2,665184,-2,2869,679,2870,2,0
20150106.015245,2870,8,665192,0,2869,679,2871,293,0
20150106.015246,2870,8,665200,0,2870,19,2871,292,0
20150106.015246,2870,2,665202,0,2870,24,2871,312,0
20150106.015248,2870,28,665230,2,2870,61,2871,313,0
20150106.015249,2870,20,665250,-8,2870,51,2871,313,0
20150106.01525,2870,20,665270,-4,2870,41,2871,314,0
20150106.01525,2870,6,665276,0,2870,41,2871,313,0
20150106.015251,2870,2,665278,0,2870,46,2871,311,0
20150106.015251,2870,14,665292,0,2870,38,2871,314,0
20150106.015252,2870,8,665300,-6,2870,34,2871,315,0
20150106.015253,2870,4,665304,0,2870,37,2871,318,0
20150106.015253,2870,98,665402,-58,2869,681,2870,53,0
20150106.015254,2869,2,665404,0,2869,680,2870,74,0
20150106.015255,2870,4,665408,0,2869,679,2870,76,1
20150106.015256,2870,60,665468,0,2869,679,2870,150,1
20150106.015257,2870,44,665512,0,2869,674,2870,200,1
20150106.015257,2870,2,665514,2,2869,674,2870,211,1
20150106.015258,2869,2,665516,0,2869,673,2870,231,0
20150106.015258,2870,10,665526,-8,2869,673,2870,226,1
20150106.015259,2869,2,665528,-2,2869,672,2870,227,0
20150106.015301,2869,8,665536,-2,2869,671,2870,231,0
20150106.015302,2870,2,665538,-2,2869,671,2870,244,1
20150106.015303,2869,2,665540,-2,2869,670,2870,243,0
20150106.015304,2869,4,665544,-2,2869,669,2870,267,0
20150106.015304,2869,16,665560,-16,2869,658,2870,267,0
20150106.015306,2869,22,665582,-2,2869,647,2870,367,0
20150106.015307,2869,1288,666870,80,2868,159,2869,358,0
20150106.015309,2868,136,667006,-82,2868,91,2869,363,0
20150106.015309,2868,2,667008,-2,2868,90,2869,363,0
20150106.015309,2868,36,667044,18,2868,72,2869,373,0
20150106.01531,2868,24,667068,10,2868,60,2869,374,0
20150106.015311,2868,2,667070,0,2868,59,2869,462,0
20150106.015311,2869,130,667200,0,2867,38,2869,455,1
20150106.015311,2868,2,667202,2,2867,51,2868,12,0
20150106.015312,2868,8,667210,-2,2867,60,2868,11,0
20150106.015313,2867,2,667212,0,2867,59,2868,11,0
20150106.015314,2867,2,667214,-2,2867,58,2868,16,0
20150106.015314,2867,8,667222,-2,2867,57,2868,18,0
20150106.015315,2867,6,667228,0,2867,56,2868,16,0
20150106.015315,2867,144,667372,-34,2866,397,2867,933,0
20150106.015316,2867,8,667380,0,2866,368,2867,965,0
20150106.015316,2867,8,667388,-8,2866,348,2867,963,0
20150106.015317,2866,22,667410,-14,2866,321,2867,970,0
20150106.015318,2867,6,667416,-2,2866,285,2867,974,1
20150106.015319,2866,32,667448,-12,2866,261,2867,933,0
20150106.01532,2867,10,667458,-10,2866,203,2867,928,1
20150106.01532,2866,22,667480,6,2866,192,2867,928,0
20150106.015321,2866,230,667710,52,2866,97,2867,928,0
20150106.015322,2866,190,667900,8,2865,28,2867,928,0
20150106.015322,2866,184,668084,-132,2864,76,2865,84,0
20150106.015323,2864,18,668102,-12,2864,90,2865,85,0
20150106.015324,2865,66,668168,-56,2864,82,2865,85,1
20150106.015325,2864,114,668282,-108,2863,346,2865,110,0
20150106.015325,2863,12,668294,0,2863,340,2865,110,0
20150106.015326,2863,12,668306,-10,2864,8,2865,86,0
20150106.015326,2863,26,668332,-20,2863,330,2864,8,0
20150106.015327,2863,38,668370,-10,2863,329,2865,113,0
20150106.015327,2864,30,668400,-2,2863,330,2865,79,1
20150106.015328,2864,48,668448,-46,2863,331,2865,76,1
20150106.015328,2864,78,668526,-78,2864,32,2865,38,1
20150106.015329,2865,14,668540,-14,2864,29,2865,35,1
20150106.015329,2864,10,668550,0,2864,24,2865,33,0
20150106.01533,2865,8,668558,0,2864,26,2865,31,1
20150106.01533,2864,20,668578,-20,2864,21,2865,31,0
20150106.015331,2864,34,668612,-4,2864,8,2865,56,0
20150106.015332,2864,30,668642,-20,2863,355,2865,60,0
20150106.015332,2864,10,668652,2,2863,355,2865,84,0
20150106.015333,2864,6,668658,-6,2864,51,2865,62,0
20150106.015333,2864,2,668660,0,2864,54,2865,62,0
20150106.015334,2865,6,668666,-2,2864,109,2865,63,1
20150106.015334,2864,4,668670,-4,2864,133,2865,96,0
20150106.015335,2865,20,668690,-20,2864,143,2865,86,1
20150106.015336,2864,72,668762,-70,2864,130,2865,96,0
20150106.015336,2864,2,668764,0,2864,159,2865,96,0
20150106.015337,2865,196,668960,-178,2865,13,2866,58,1
20150106.015337,2865,6,668966,-2,2865,10,2866,60,1
20150106.015338,2865,2,668968,-2,2865,9,2866,60,1
20150106.015339,2866,2,668970,2,2865,9,2866,56,1
20150106.01534,2865,2,668972,0,2865,35,2866,58,0
20150106.01534,2864,200,669172,102,2864,190,2866,58,0
20150106.015341,2866,2,669174,0,2864,194,2865,1,1
20150106.015342,2865,4,669178,-2,2864,185,2866,58,0
20150106.015342,2865,4,669182,4,2865,10,2866,58,0
20150106.015343,2865,24,669206,-6,2864,180,2865,90,0
20150106.015344,2864,86,669292,-82,2864,172,2865,55,0
20150106.015345,2866,304,669596,-214,2866,848,2867,946,1
20150106.015346,2866,2,669598,0,2866,849,2867,944,1
20150106.015346,2866,20,669618,0,2866,839,2867,944,1
20150106.015347,2866,2,669620,0,2866,840,2867,944,1
20150106.015348,2867,210,669830,-8,2866,738,2867,939,1
20150106.015349,2866,20,669850,-20,2866,728,2867,939,0
20150106.015349,2866,2,669852,0,2866,727,2867,939,0
20150106.01535,2866,2,669854,-2,2866,826,2867,940,0
20150106.015351,2867,2,669856,0,2866,826,2867,939,1
20150106.015352,2866,2,669858,0,2866,825,2867,940,0
20150106.015352,2866,2,669860,-2,2866,824,2867,990,0
20150106.015354,2866,46,669906,0,2866,802,2867,1005,0
20150106.015355,2866,30,669936,-30,2866,788,2867,1001,0
20150106.015357,2866,6,669942,-6,2866,790,2867,1002,0
20150106.015357,2866,2,669944,-2,2866,788,2867,1001,0
20150106.015359,2866,196,670140,-6,2866,690,2867,1006,0
20150106.015403,2867,10,670150,0,2866,703,2867,1066,1
20150106.015404,2866,2,670152,-2,2866,702,2867,1062,0
20150106.015405,2867,2,670154,0,2866,702,2867,1061,1
20150106.015406,2866,10,670164,-2,2866,698,2867,1060,0
20150106.015406,2866,28,670192,0,2866,684,2867,1060,0
20150106.015407,2866,80,670272,0,2866,644,2867,1061,0
20150106.015408,2866,6,670278,-4,2866,646,2867,1061,0
20150106.015409,2866,40,670318,-40,2866,626,2867,1061,0
20150106.01541,2866,2,670320,0,2866,625,2867,1061,0
20150106.01541,2866,6,670326,0,2866,622,2867,1061,0
20150106.015411,2866,4,670330,-2,2866,621,2867,1061,0
20150106.015411,2866,14,670344,-2,2866,635,2867,1060,0
20150106.015412,2866,2,670346,0,2866,634,2867,1060,0
20150106.015415,2866,2162,672508,-2014,2866,639,2868,146,0
20150106.015415,2866,4,672512,0,2866,637,2868,146,0
20150106.015416,2866,22,672534,-2,2866,678,2868,97,0
20150106.015416,2868,2,672536,-2,2867,117,2868,96,1
20150106.015417,2867,24,672560,-24,2867,139,2868,115,0
20150106.015421,2868,12,672572,-2,2867,227,2868,121,1
20150106.015424,2868,60,672632,-24,2867,106,2868,114,1
20150106.015426,2867,6,672638,0,2867,104,2868,122,0
20150106.015427,2867,112,672750,4,2867,68,2868,106,0
20150106.015428,2867,80,672830,0,2867,28,2868,107,0
20150106.01543,2868,18,672848,0,2867,20,2868,124,1
20150106.01543,2868,2,672850,2,2867,20,2868,125,1
20150106.015431,2867,40,672890,-8,2867,16,2868,126,0
20150106.015431,2867,2,672892,0,2867,17,2868,156,0
20150106.015432,2867,20,672912,20,2867,16,2868,156,0
20150106.015432,2867,4,672916,0,2867,15,2868,156,0
20150106.015433,2868,8,672924,8,2867,15,2868,152,1
20150106.015433,2868,2,672926,2,2867,15,2868,151,1
20150106.015434,2867,8,672934,0,2867,12,2868,147,0
20150106.015435,2867,20,672954,18,2867,5,2868,147,0
20150106.015435,2868,2,672956,2,2867,5,2868,152,1
20150106.015436,2868,6,672962,2,2867,4,2868,151,1
20150106.015437,2867,14,672976,0,2866,660,2868,150,0
20150106.015438,2868,2,672978,2,2867,21,2868,174,1
20150106.015438,2867,4,672982,-4,2867,19,2868,176,0
20150106.015439,2867,4,672986,0,2867,18,2868,176,0
20150106.01544,2868,4,672990,0,2867,22,2868,175,1
20150106.015442,2868,80,673070,60,2867,18,2868,150,1
20150106.015445,2867,10,673080,-10,2867,16,2868,154,0
20150106.015448,2867,2,673082,0,2867,17,2868,155,0
20150106.015454,2868,356,673438,-18,2868,823,2869,714,1
20150106.015455,2869,60,673498,0,2868,823,2869,684,1
20150106.015455,2869,4,673502,0,2868,823,2869,682,1
20150106.015456,2868,18,673520,-6,2868,816,2869,680,0
20150106.015457,2868,2,673522,0,2868,815,2869,686,0
20150106.015458,2868,4,673526,0,2868,813,2869,686,0
20150106.015459,2869,2,673528,2,2868,813,2869,386,1
20150106.015501,2868,12,673540,0,2868,817,2869,382,0
20150106.015502,2868,2,673542,0,2868,816,2869,380,0
20150106.015502,2868,2,673544,-2,2868,815,2869,380,0
20150106.015503,2868,4,673548,0,2868,813,2869,379,0
20150106.015505,2868,10,673558,-2,2868,809,2869,380,0
20150106.015506,2868,2,673560,0,2868,808,2869,381,0
20150106.015511,2868,20,673580,0,2868,803,2869,387,0
20150106.015512,2868,2,673582,0,2868,802,2869,387,0
20150106.015512,2868,2,673584,-2,2868,801,2869,387,0
20150106.015513,2868,40,673624,0,2868,781,2869,387,0
20150106.015515,2868,2,673626,0,2868,780,2869,391,0
20150106.015516,2868,2,673628,0,2868,779,2869,392,0
20150106.015517,2868,6,673634,0,2868,776,2869,399,0
20150106.015518,2868,14,673648,-14,2868,769,2869,502,0
20150106.01552,2868,2,673650,0,2868,768,2869,496,0
20150106.015522,2869,60,673710,60,2868,768,2869,465,1
20150106.015522,2868,20,673730,-20,2868,758,2869,471,0
20150106.015524,2869,6,673736,6,2868,773,2869,684,1
20150106.015526,2869,2,673738,2,2868,773,2869,683,1
20150106.015527,2868,20,673758,-20,2868,763,2869,715,0
20150106.015527,2869,2,673760,0,2868,763,2869,719,1
20150106.015527,2868,80,673840,-80,2868,723,2869,719,0
20150106.015529,2868,8,673848,0,2868,719,2869,719,0
20150106.01553,2869,10,673858,8,2868,718,2869,744,1
20150106.015532,2868,2,673860,-2,2868,717,2869,764,0
20150106.015533,2868,6,673866,-2,2868,716,2869,764,0
20150106.015534,2869,8,673874,8,2868,716,2869,760,1
20150106.015534,2868,2,673876,-2,2868,715,2869,760,0
20150106.015537,2868,2,673878,0,2868,714,2869,764,0
20150106.015539,2868,2,673880,-2,2868,724,2869,768,0
20150106.015541,2868,60,673940,0,2868,694,2869,768,0
20150106.015542,2868,24,673964,-22,2868,682,2869,768,0
20150106.015545,2868,4,673968,-4,2868,680,2869,779,0
20150106.015545,2868,2,673970,0,2868,679,2869,780,0
20150106.015547,2868,16,673986,-16,2868,671,2869,780,0
20150106.015547,2868,2,673988,-2,2868,670,2869,780,0
20150106.015549,2868,2,673990,0,2868,669,2869,780,0
20150106.01555,2868,2,673992,0,2868,668,2869,780,0
20150106.015553,2869,44,674036,36,2868,666,2869,764,1
20150106.015555,2868,2,674038,0,2868,665,2869,763,0
20150106.015556,2868,4,674042,0,2868,663,2869,769,0
20150106.015559,2869,2,674044,0,2868,663,2869,769,1
20150106.0156,2868,14,674058,2,2868,657,2869,770,0
20150106.015601,2868,2,674060,-2,2868,656,2869,770,0
20150106.015603,2868,4,674064,0,2868,654,2869,770,0
20150106.015603,2869,2,674066,2,2868,654,2869,769,1
20150106.015604,2869,2,674068,0,2868,654,2869,769,1
20150106.015605,2868,60,674128,-40,2868,624,2869,769,0
20150106.015608,2869,40,674168,40,2868,624,2869,769,1
20150106.015609,2869,1538,675706,-256,2869,102,2870,561,1
20150106.015609,2869,2,675708,0,2869,101,2870,563,1
20150106.01561,2869,2,675710,0,2869,100,2870,563,1
20150106.015612,2869,6,675716,-6,2869,198,2870,563,1
20150106.015615,2869,80,675796,0,2869,163,2870,566,1
20150106.015616,2869,2,675798,0,2869,162,2870,572,1
20150106.015617,2869,2,675800,0,2869,161,2870,573,1
20150106.01562,2869,40,675840,-40,2869,141,2870,584,1
20150106.01562,2869,2,675842,0,2869,140,2870,584,1
20150106.015621,2869,10,675852,0,2869,135,2870,585,1
20150106.015622,2869,6,675858,0,2869,137,2870,585,1
20150106.015623,2869,2,675860,0,2869,136,2870,585,1
20150106.015625,2869,2,675862,-2,2869,139,2870,590,1
20150106.015625,2869,2,675864,0,2869,138,2870,590,1
20150106.015627,2869,2,675866,0,2869,138,2870,591,1
20150106.015631,2870,10,675876,8,2869,162,2870,409,1
20150106.015631,2869,330,676206,14,2868,629,2869,8,0
20150106.015632,2869,14,676220,14,2868,629,2869,4,0
20150106.015634,2869,2,676222,2,2868,629,2869,96,0
20150106.015636,2869,4,676226,0,2868,629,2869,96,0
20150106.015636,2869,2,676228,-2,2868,629,2869,96,0
20150106.015639,2869,12,676240,6,2868,629,2869,99,0
20150106.01564,2869,62,676302,58,2868,628,2869,70,0
20150106.015641,2868,2,676304,0,2868,627,2869,78,0
20150106.015641,2869,10,676314,10,2868,627,2869,74,1
20150106.015644,2869,2,676316,2,2868,627,2869,106,1
20150106.015645,2869,8,676324,0,2868,627,2869,102,1
20150106.015645,2869,80,676404,80,2868,627,2869,62,1
20150106.015647,2869,2,676406,2,2868,627,2869,61,1
20150106.015648,2869,2,676408,2,2868,627,2869,82,1
20150106.015652,2868,2,676410,-2,2868,639,2869,149,0
20150106.015653,2868,2,676412,0,2868,638,2869,154,0
20150106.015654,2869,2,676414,0,2868,638,2869,154,1
20150106.015656,2868,20,676434,0,2868,628,2869,155,0
20150106.015657,2869,60,676494,-42,2868,628,2869,126,1
20150106.0157,2869,206,676700,-34,2868,628,2869,34,1
20150106.015701,2869,14,676714,-4,2868,628,2869,27,1
20150106.015704,2869,10,676724,10,2868,628,2869,42,1
20150106.015705,2869,2,676726,0,2868,628,2869,41,1
20150106.015705,2869,2,676728,2,2868,628,2869,41,1
20150106.015706,2869,6,676734,2,2868,627,2869,38,1
20150106.015707,2869,2,676736,0,2868,627,2869,38,1
20150106.015708,2869,2,676738,2,2868,628,2869,37,1
20150106.015708,2869,2,676740,0,2868,628,2869,36,1
20150106.015709,2868,2,676742,0,2868,627,2869,36,0
20150106.015713,2868,246,676988,-46,2868,504,2869,461,0
20150106.015715,2868,2,676990,0,2868,503,2869,475,0
20150106.015715,2868,10,677000,0,2868,498,2869,475,0
20150106.015716,2868,2,677002,-2,2868,497,2869,475,0
20150106.015716,2868,2,677004,0,2868,499,2869,475,0
20150106.015717,2868,56,677060,-56,2868,471,2869,475,0
20150106.015717,2868,6,677066,-6,2868,468,2869,476,0
20150106.015718,2868,936,678002,106,2867,39,2868,534,0
20150106.015718,2867,78,678080,-12,2866,516,2868,578,0
20150106.01572,2866,2,678082,0,2866,515,2867,2,0
20150106.01572,2866,20,678102,0,2866,505,2867,2,0
20150106.015725,2867,2,678104,-2,2866,505,2867,2,1
20150106.015725,2866,4,678108,-4,2866,504,2867,2,0
20150106.015727,2867,572,678680,-572,2866,221,2867,10,1
20150106.015727,2866,4,678684,0,2866,219,2867,34,0
20150106.015729,2866,2,678686,-2,2866,257,2867,52,0
20150106.01573,2866,20,678706,0,2866,247,2867,53,0
20150106.015732,2866,16,678722,-10,2866,253,2867,338,0
20150106.015733,2866,8,678730,0,2866,250,2867,340,0
20150106.015734,2866,6,678736,0,2866,248,2867,340,0
20150106.015734,2866,100,678836,-100,2866,198,2867,341,0
20150106.015735,2866,4,678840,-2,2866,196,2867,308,0
20150106.015736,2866,2,678842,-2,2866,195,2867,308,0
20150106.015736,2866,2,678844,-2,2866,194,2867,309,0
20150106.015737,2866,62,678906,-62,2866,164,2867,309,0
20150106.015738,2866,4,678910,-4,2866,162,2867,311,0
20150106.015738,2866,2,678912,-2,2866,161,2867,311,0
20150106.015739,2866,26,678938,-10,2866,148,2867,311,0
20150106.015739,2866,296,679234,-250,2865,255,2867,461,0
20150106.01574,2866,2,679236,0,2865,255,2866,531,0
20150106.015741,2865,2,679238,-2,2865,254,2866,532,0
20150106.015741,2865,2,679240,0,2865,248,2866,717,0
20150106.015742,2865,40,679280,-38,2865,228,2866,717,0
20150106.015742,2865,2,679282,-2,2865,227,2866,717,0
20150106.015743,2865,2,679284,-2,2865,226,2866,717,0
20150106.015743,2865,4,679288,0,2865,224,2866,717,0
20150106.015744,2865,16,679304,0,2865,222,2866,712,0
20150106.015745,2865,366,679670,-302,2865,39,2866,712,0
20150106.015746,2865,6,679676,-6,2865,36,2866,712,0
20150106.015746,2865,12,679688,-12,2865,30,2866,712,0
20150106.015747,2865,22,679710,-10,2865,19,2866,713,0
20150106.015747,2865,48,679758,-36,2864,137,2865,21,0
20150106.015748,2865,4,679762,-4,2864,136,2865,44,0
20150106.015749,2865,10,679772,0,2864,136,2865,220,0
20150106.015749,2865,4,679776,-4,2864,136,2865,229,0
20150106.01575,2864,4,679780,0,2864,134,2865,229,0
20150106.01575,2864,2,679782,-2,2864,133,2865,230,0
20150106.015751,2864,2,679784,0,2864,132,2865,231,0
20150106.015752,2864,22,679806,-18,2864,124,2865,229,0
20150106.015752,2864,4,679810,-2,2864,143,2865,229,0
20150106.015753,2864,2,679812,0,2864,152,2865,230,0
20150106.015754,2864,104,679916,-104,2864,100,2865,231,0
20150106.015754,2864,48,679964,-48,2864,82,2865,207,0
20150106.015755,2864,50,680014,-30,2864,70,2865,202,0
20150106.015755,2864,102,680116,-56,2864,20,2865,202,0
20150106.015756,2864,36,680152,-22,2864,4,2865,201,0
20150106.015756,2864,20,680172,-12,2864,1,2865,202,0
20150106.015757,2864,2,680174,0,2863,309,2864,4,0
20150106.015758,2864,2,680176,-2,2863,309,2864,164,0
20150106.015758,2864,4,680180,-2,2863,309,2864,178,0
20150106.015759,2863,4,680184,-4,2863,301,2864,178,0
20150106.0158,2863,568,680752,-504,2863,202,2864,53,0
20150106.015801,2863,20,680772,-2,2863,194,2864,56,0
20150106.015801,2864,2,680774,0,2863,194,2864,55,1
20150106.015802,2864,84,680858,82,2863,199,2864,14,1
20150106.015802,2864,28,680886,-10,2864,41,2865,80,1
20150106.015803,2864,4,680890,-4,2864,40,2865,81,1
20150106.015803,2865,16,680906,16,2864,40,2865,73,1
20150106.015805,2864,40,680946,0,2864,39,2865,73,0
20150106.015806,2864,42,680988,-40,2864,63,2865,73,0
20150106.015806,2864,100,681088,-86,2864,13,2865,73,0
20150106.015806,2864,2,681090,0,2864,13,2865,73,0
20150106.015807,2864,2,681092,-2,2864,15,2865,93,0
20150106.015807,2864,68,681160,-60,2864,64,2865,95,0
20150106.015809,2865,200,681360,96,2864,76,2865,39,1
20150106.01581,2865,68,681428,-68,2865,91,2866,602,1
20150106.015811,2866,14,681442,0,2865,90,2866,597,1
20150106.015811,2866,2,681444,0,2865,90,2866,596,1
20150106.015812,2865,2,681446,0,2865,90,2866,596,0
20150106.015814,2866,36,681482,0,2865,73,2866,596,1
20150106.015814,2865,146,681628,0,2864,122,2865,1,0
20150106.015818,2865,38,681666,0,2864,157,2865,14,0
20150106.015818,2865,4,681670,-2,2864,157,2865,62,0
20150106.015819,2864,8,681678,0,2864,159,2865,60,0
20150106.015819,2864,2,681680,2,2864,158,2865,71,0
20150106.01582,2865,8,681688,-8,2864,158,2865,67,1
20150106.015823,2864,12,681700,0,2864,150,2865,122,0
20150106.015823,2864,2,681702,2,2864,149,2865,122,0
20150106.015824,2865,48,681750,-30,2864,129,2865,118,1
20150106.015824,2865,72,681822,0,2864,129,2865,82,1
20150106.015825,2864,2,681824,-2,2864,128,2865,83,0
20150106.015826,2865,4,681828,0,2864,129,2865,83,1
20150106.015829,2865,2,681830,0,2864,136,2865,126,1
20150106.015829,2864,2,681832,0,2864,140,2865,127,0
20150106.015831,2864,2,681834,0,2864,160,2865,136,0
20150106.015832,2865,22,681856,-2,2864,160,2865,125,1
20150106.015834,2865,2,681858,-2,2864,161,2865,128,1
20150106.015834,2865,4,681862,0,2864,162,2865,126,1
20150106.015836,2864,2,681864,0,2864,161,2865,129,0
20150106.015837,2865,2,681866,2,2864,164,2865,130,1
20150106.015839,2864,2,681868,0,2864,172,2865,138,0
20150106.015842,2864,14,681882,14,2864,153,2865,206,0
20150106.015843,2864,2,681884,2,2864,172,2865,206,0
20150106.015844,2864,2,681886,0,2864,170,2865,235,0
20150106.015845,2864,36,681922,4,2864,161,2865,235,0
20150106.015847,2865,20,681942,20,2864,162,2865,225,1
20150106.015848,2864,402,682344,-144,2863,217,2865,226,0
20150106.015848,2864,8,682352,0,2863,217,2865,224,0
20150106.01585,2864,10,682362,-10,2864,4,2865,224,0
20150106.01585,2864,2,682364,-2,2864,3,2865,226,0
20150106.01585,2864,2,682366,-2,2864,2,2865,193,0
20150106.015851,2864,48,682414,-4,2863,234,2864,2,0
20150106.015851,2864,6,682420,0,2863,232,2865,217,0
20150106.015852,2863,6,682426,-2,2863,231,2865,217,0
20150106.015852,2863,2,682428,-2,2863,234,2865,217,0
20150106.015853,2865,2,682430,0,2863,234,2865,216,1
20150106.015854,2863,10,682440,-10,2864,3,2865,218,0
20150106.015855,2865,72,682512,2,2863,253,2865,218,1
20150106.015859,2865,2,682514,0,2864,2,2865,229,1
20150106.015901,2864,6,682520,2,2864,21,2865,225,0
20150106.015901,2864,2,682522,0,2864,21,2865,224,0
20150106.015902,2865,6,682528,0,2864,22,2865,221,1
20150106.015903,2864,10,682538,10,2864,17,2865,223,0
20150106.015903,2864,20,682558,0,2864,18,2865,223,0
20150106.015904,2864,10,682568,10,2864,20,2865,222,0
20150106.015904,2864,2,682570,0,2864,19,2865,223,0
20150106.015905,2864,8,682578,-6,2864,25,2865,223,0
20150106.015906,2864,18,682596,4,2864,17,2865,229,0
20150106.015911,2864,2,682598,-2,2864,63,2865,227,0
20150106.015912,2865,6,682604,0,2864,82,2865,220,1
20150106.015913,2864,4,682608,0,2864,86,2865,220,0
20150106.015916,2865,20,682628,-20,2864,128,2865,210,1
20150106.015917,2864,442,683070,-300,2863,265,2865,211,0
20150106.015918,2864,8,683078,-8,2863,265,2864,7,0
20150106.015919,2864,18,683096,8,2864,6,2865,211,0
20150106.015921,2864,2,683098,0,2864,27,2865,210,0
20150106.015922,2864,42,683140,28,2864,34,2865,212,0
20150106.015923,2864,66,683206,-64,2864,7,2865,212,0
20150106.015925,2864,2,683208,0,2864,13,2865,211,0
20150106.015925,2864,20,683228,-2,2864,3,2865,201,0
20150106.015926,2864,6,683234,6,2863,244,2864,1,0
20150106.015927,2863,10,683244,-4,2863,242,2865,201,0
20150106.015927,2864,4,683248,-2,2863,242,2864,160,1
20150106.015929,2864,12,683260,-12,2863,218,2864,155,1
20150106.015929,2864,4,683264,-4,2863,218,2864,153,1
20150106.015932,2864,2,683266,-2,2863,215,2864,152,1
20150106.015933,2864,14,683280,-12,2863,215,2864,146,1
20150106.015934,2863,2,683282,0,2863,215,2864,148,0
20150106.015934,2864,2,683284,0,2863,214,2864,147,1
20150106.015935,2864,2,683286,0,2863,215,2864,150,1
20150106.015936,2864,2,683288,-2,2863,218,2864,147,1
20150106.015937,2864,136,683424,-130,2863,153,2864,145,1
20150106.015937,2863,4,683428,0,2863,151,2864,145,0
20150106.01594,2864,298,683726,24,2863,176,2865,188,1
20150106.015941,2864,2,683728,0,2864,5,2865,189,1
20150106.015944,2864,4,683732,-4,2864,22,2865,188,1
20150106.015945,2864,2,683734,0,2864,23,2865,188,1
20150106.015946,2864,2,683736,-2,2864,25,2865,188,1
20150106.015946,2865,16,683752,-16,2864,26,2865,180,1
20150106.015948,2864,16,683768,-4,2864,45,2865,175,0
20150106.015949,2864,4,683772,-4,2864,40,2865,186,0
20150106.015951,2864,2,683774,2,2864,41,2865,196,0
20150106.015951,2865,20,683794,-20,2864,61,2865,186,1
20150106.015951,2865,20,683814,10,2864,63,2865,176,1
20150106.015954,2864,10,683824,0,2864,100,2865,176,0
20150106.015955,2865,20,683844,-10,2864,130,2865,166,1
20150106.015955,2865,4,683848,2,2864,133,2865,141,1
20150106.015956,2865,18,683866,0,2864,133,2865,132,1
20150106.015957,2865,40,683906,0,2864,116,2865,134,1
20150106.015958,2865,14,683920,0,2864,116,2865,129,1
20150106.015959,2865,2,683922,2,2864,120,2865,102,1
20150106.015959,2865,14,683936,14,2864,121,2865,95,1
20150106.020001,2865,150,684086,34,2864,122,2865,21,1
20150106.020002,2867,602,684688,348,2866,12,2868,38,1
20150106.020002,2868,176,684864,-8,2866,8,2869,82,1
20150106.020003,2868,6,684870,6,2867,45,2869,82,1
20150106.020004,2869,296,685166,-46,2869,31,2870,534,1
20150106.020004,2870,264,685430,-172,2869,56,2870,524,1
20150106.020005,2869,316,685746,30,2869,56,2870,534,0
20150106.020005,2870,86,685832,-6,2869,16,2870,531,1
20150106.020005,2870,8,685840,-8,2869,16,2870,527,1
20150106.020006,2870,24,685864,-12,2869,16,2870,512,1
20150106.020007,2870,122,685986,26,2869,16,2870,453,1
20150106.020008,2870,2,685988,0,2869,16,2870,452,1
20150106.020008,2870,36,686024,-2,2868,25,2870,516,1
20150106.020009,2868,6,686030,-2,2867,39,2868,9,0
20150106.020011,2867,2,686032,0,2867,14,2868,9,0
20150106.020013,2867,4,686036,-2,2867,13,2868,9,0
20150106.020014,2868,6,686042,0,2867,13,2868,7,1
20150106.020015,2868,2,686044,0,2867,14,2868,7,1
20150106.020017,2867,4,686048,0,2867,12,2868,11,0
20150106.020019,2867,18,686066,-12,2866,32,2868,39,0
20150106.02002,2867,2,686068,2,2867,21,2868,17,0
20150106.02002,2867,4,686072,4,2867,19,2868,17,0
20150106.020021,2867,4,686076,2,2867,18,2868,16,0
20150106.020023,2867,2,686078,2,2867,17,2868,48,0
20150106.020023,2867,2,686080,2,2867,18,2868,72,0
20150106.020031,2867,30,686110,20,2866,48,2867,36,0
20150106.020032,2866,2,686112,0,2866,23,2867,60,0
20150106.020033,2866,2,686114,-2,2866,26,2867,60,0
20150106.020036,2866,2,686116,0,2866,29,2867,54,0
20150106.020037,2866,2,686118,-2,2866,28,2867,54,0
20150106.02004,2866,2,686120,0,2866,27,2867,55,0
20150106.020041,2866,52,686172,-42,2865,68,2867,55,0
20150106.020046,2866,4,686176,2,2865,70,2867,63,0
20150106.020049,2865,4,686180,-2,2865,139,2867,66,0
20150106.020053,2865,2,686182,2,2866,11,2867,67,0
20150106.020054,2866,10,686192,0,2866,6,2867,67,1
20150106.020055,2866,2,686194,0,2866,5,2867,89,1
20150106.0201,2866,8,686202,2,2865,166,2866,2,1
20150106.020101,2866,8,686210,-2,2865,166,2867,96,1
20150106.020103,2866,2,686212,2,2865,150,2867,105,1
20150106.020106,2866,4,686216,2,2866,7,2867,104,1
20150106.020109,2866,2,686218,0,2866,11,2867,101,1
20150106.02011,2866,4,686222,2,2866,11,2867,100,1
20150106.020113,2866,2,686224,-2,2866,20,2867,100,1
20150106.020114,2866,8,686232,-8,2866,20,2867,100,1
20150106.020115,2866,6,686238,0,2866,17,2867,100,1
20150106.020116,2866,2,686240,2,2866,17,2867,100,1
20150106.020122,2866,10,686250,-2,2866,13,2867,92,1
20150106.020122,2866,16,686266,-2,2866,5,2867,164,1
20150106.020122,2866,4,686270,-4,2866,3,2867,164,1
20150106.020126,2866,6,686276,-6,2865,156,2866,2,1
20150106.020126,2866,4,686280,-4,2865,156,2866,2,1
20150106.020127,2866,4,686284,0,2865,156,2866,8,1
20150106.020127,2866,16,686300,-10,2865,156,2867,164,1
20150106.020128,2866,42,686342,0,2865,156,2867,164,1
20150106.020133,2866,4,686346,0,2866,10,2867,207,1
20150106.020134,2866,2,686348,0,2866,9,2867,207,1
20150106.020134,2866,2,686350,2,2866,8,2867,207,1
20150106.020135,2866,2,686352,2,2866,9,2867,207,1
20150106.020138,2866,18,686370,0,2866,1,2867,211,1
20150106.02014,2866,2,686372,2,2866,23,2867,222,1
20150106.020145,2866,6,686378,-6,2866,24,2867,221,1
20150106.020147,2866,2,686380,0,2866,23,2867,162,1
20150106.020149,2866,2,686382,0,2866,22,2867,147,1
20150106.02015,2867,20,686402,0,2866,44,2867,137,1
20150106.02015,2867,14,686416,4,2866,46,2867,130,1
20150106.020151,2867,8,686424,8,2866,55,2867,126,1
20150106.020152,2867,4,686428,4,2866,100,2867,102,1
20150106.020152,2867,100,686528,-20,2866,100,2867,52,1
20150106.020153,2867,104,686632,-88,2866,115,2868,69,1
20150106.020154,2868,2,686634,0,2866,115,2868,68,1
20150106.020155,2868,2,686636,-2,2866,116,2868,67,1
20150106.020155,2868,24,686660,12,2867,2,2868,55,1
20150106.020156,2866,242,686902,84,2865,158,2866,414,0
20150106.020156,2866,8,686910,8,2865,136,2866,410,0
20150106.020157,2866,4,686914,4,2865,136,2866,408,0
20150106.020157,2866,4,686918,4,2865,136,2866,406,0
20150106.020158,2866,12,686930,12,2865,134,2866,400,0
20150106.020159,2866,4,686934,4,2865,134,2866,398,0
20150106.020202,2865,2,686936,-2,2865,170,2866,398,0
20150106.020203,2865,120,687056,-38,2865,112,2866,398,0
20150106.020204,2865,8,687064,8,2865,115,2866,395,0
20150106.020207,2865,20,687084,18,2865,128,2866,395,0
20150106.020208,2866,64,687148,60,2865,128,2866,363,1
20150106.020209,2866,2,687150,2,2865,123,2866,362,1
20150106.02021,2866,10,687160,10,2865,130,2866,357,1
20150106.020216,2866,70,687230,70,2865,192,2866,322,1
20150106.020219,2866,2,687232,2,2865,214,2866,321,1
20150106.02022,2866,4,687236,4,2865,214,2866,319,1
20150106.02022,2865,14,687250,-14,2865,207,2866,319,0
20150106.020221,2865,12,687262,0,2865,204,2866,319,0
20150106.020223,2865,4,687266,-2,2865,204,2866,319,0
20150106.020226,2866,70,687336,0,2865,304,2866,285,1
20150106.020226,2865,2,687338,0,2865,318,2866,285,0
20150106.020227,2866,6,687344,0,2865,318,2866,282,1
20150106.02023,2866,574,687918,440,2865,353,2867,16,1
20150106.020234,2866,2,687920,2,2866,29,2867,96,1
20150106.020237,2866,4,687924,-2,2866,32,2867,112,1
20150106.020239,2866,2,687926,0,2866,32,2867,112,1
20150106.02024,2867,2,687928,0,2866,33,2867,111,1
20150106.020242,2866,2,687930,2,2866,37,2867,114,0
20150106.020243,2866,4,687934,0,2866,36,2867,114,0
20150106.020251,2867,4,687938,4,2866,111,2867,118,1
20150106.020253,2867,2,687940,2,2866,116,2867,117,1
20150106.020255,2867,2,687942,0,2866,118,2867,116,1
20150106.020256,2867,16,687958,-10,2866,140,2867,108,1
20150106.020257,2867,20,687978,-20,2866,142,2867,99,1
20150106.020259,2867,24,688002,-24,2866,143,2867,87,1
20150106.020259,2867,26,688028,-6,2866,143,2867,74,1
20150106.0203,2867,148,688176,10,2867,27,2868,146,1
20150106.020301,2867,4,688180,2,2867,37,2868,150,1
20150106.020305,2867,10,688190,0,2867,33,2868,150,1
20150106.020306,2867,2,688192,2,2867,32,2868,150,1
20150106.020308,2867,2,688194,0,2867,31,2868,150,1
20150106.020309,2868,2,688196,2,2867,43,2868,149,1
20150106.02031,2867,4,688200,0,2867,41,2868,148,0
20150106.020311,2868,2,688202,0,2867,43,2868,147,1
20150106.020311,2868,8,688210,6,2867,43,2868,143,1
20150106.020314,2868,286,688496,70,2868,67,2869,409,1
20150106.020314,2868,24,688520,18,2868,57,2869,395,1
20150106.020315,2869,18,688538,-2,2868,49,2869,394,1
20150106.020317,2869,10,688548,10,2868,49,2869,389,1
20150106.020318,2869,54,688602,0,2868,124,2869,390,1
20150106.020319,2869,4,688606,-4,2868,132,2869,387,1
20150106.02032,2869,2,688608,0,2868,132,2869,386,1
20150106.020321,2868,2,688610,2,2868,134,2869,386,0
20150106.020326,2868,2,688612,2,2868,136,2869,355,0
20150106.020327,2868,68,688680,40,2868,107,2869,357,0
20150106.020328,2868,6,688686,0,2868,104,2869,357,0
20150106.020329,2868,2,688688,0,2868,103,2869,358,0
20150106.020329,2868,10,688698,-10,2868,98,2869,360,0
20150106.02033,2868,2,688700,-2,2868,97,2869,360,0
20150106.020332,2868,6,688706,-6,2868,96,2869,363,0
20150106.020334,2868,2,688708,-2,2868,98,2869,372,0
20150106.020334,2868,4,688712,-2,2868,96,2869,372,0
20150106.020336,2869,4,688716,0,2868,96,2869,380,1
20150106.020337,2868,2,688718,-2,2868,95,2869,381,0
20150106.02034,2869,22,688740,0,2868,95,2869,370,1
20150106.020341,2868,2,688742,-2,2868,95,2869,371,0
20150106.020343,2868,10,688752,0,2868,90,2869,371,0
20150106.020346,2869,8,688760,-8,2868,87,2869,569,1
20150106.020347,2868,24,688784,-2,2868,86,2869,559,0
20150106.020348,2868,172,688956,-144,2867,105,2868,2,0
20150106.02035,2867,20,688976,0,2867,95,2868,3,0
20150106.020351,2868,12,688988,2,2868,1,2869,562,1
20150106.020352,2868,2,688990,0,2867,95,2868,14,1
20150106.020352,2868,2,688992,2,2867,95,2868,13,1
20150106.020354,2868,2,688994,2,2867,85,2868,12,1
20150106.020356,2868,6,689000,4,2867,85,2868,27,1
20150106.020356,2868,2,689002,2,2867,85,2868,26,1
20150106.020357,2868,4,689006,2,2867,89,2868,24,1
20150106.020358,2868,2,689008,2,2867,89,2868,23,1
20150106.020358,2867,2,689010,2,2867,88,2868,23,0
20150106.020402,2868,2,689012,2,2867,92,2868,46,1
20150106.020408,2867,14,689026,0,2867,91,2868,48,0
20150106.02041,2867,2,689028,0,2867,66,2868,141,0
20150106.020411,2867,2,689030,0,2867,67,2868,142,0
20150106.020421,2867,6,689036,6,2867,65,2868,138,0
20150106.020423,2867,2,689038,0,2867,64,2868,138,0
20150106.020424,2867,10,689048,10,2867,59,2868,139,0
20150106.020426,2867,2,689050,0,2867,58,2868,139,0
20150106.020429,2867,40,689090,-34,2867,38,2868,137,0
20150106.020429,2867,2,689092,0,2867,37,2868,137,0
20150106.02043,2867,14,689106,-8,2867,30,2868,137,0
20150106.02043,2867,2,689108,0,2867,29,2868,137,0
20150106.020433,2867,68,689176,50,2866,119,2867,17,0
20150106.020433,2867,4,689180,0,2866,119,2867,16,0
20150106.020435,2866,2,689182,2,2866,118,2867,16,0
20150106.020435,2867,18,689200,18,2866,118,2867,8,1
20150106.020436,2866,2,689202,2,2866,117,2867,9,0
20150106.020437,2867,2,689204,2,2866,117,2867,8,1
20150106.020441,2867,10,689214,8,2866,117,2867,4,1
20150106.020445,2866,6,689220,-4,2866,114,2867,55,0
20150106.020449,2866,2,689222,2,2866,115,2867,57,0
20150106.020453,2867,4,689226,2,2866,118,2867,107,1
20150106.020454,2866,148,689374,-10,2866,44,2867,107,0
20150106.0205,2866,2,689376,2,2866,44,2867,107,0
20150106.020502,2866,2,689378,2,2866,442,2867,110,0
20150106.020502,2867,4,689382,2,2866,442,2867,108,1
20150106.020503,2866,2,689384,2,2866,441,2867,108,0
20150106.020504,2866,2,689386,2,2866,440,2867,108,0
20150106.020505,2867,22,689408,-22,2866,440,2867,97,1
20150106.020506,2867,2,689410,0,2866,441,2867,95,1
20150106.020506,2867,30,689440,0,2866,441,2867,80,1
20150106.020507,2867,160,689600,-156,2866,443,2868,275,1
20150106.020508,2867,4,689604,-4,2866,443,2868,275,1
20150106.020509,2867,12,689616,8,2866,444,2867,6,1
20150106.02051,2867,18,689634,12,2867,2,2868,275,1
20150106.020512,2867,2,689636,-2,2867,4,2868,275,1
20150106.020514,2867,2,689638,0,2867,8,2868,277,1
20150106.020516,2867,8,689646,-6,2867,10,2868,277,1
20150106.020516,2867,2,689648,-2,2867,11,2868,277,1
20150106.020516,2867,2,689650,0,2867,10,2868,277,1
20150106.020521,2868,12,689662,10,2867,27,2868,251,1
20150106.020525,2867,2,689664,0,2867,52,2868,253,0
20150106.020527,2868,50,689714,50,2867,53,2868,228,1
20150106.020527,2867,22,689736,2,2867,54,2868,228,0
20150106.020536,2867,2,689738,2,2867,65,2868,227,0
20150106.020537,2868,6,689744,0,2867,65,2868,224,1
20150106.020546,2867,2,689746,0,2867,51,2868,227,0
20150106.020548,2867,2,689748,2,2867,47,2868,237,0
20150106.020552,2867,94,689842,-14,2866,64,2868,235,0
20150106.020555,2867,2,689844,-2,2867,1,2868,235,0
20150106.020555,2867,2,689846,0,2867,2,2868,235,0
20150106.020556,2867,6,689852,-4,2866,88,2868,235,0
20150106.020557,2867,6,689858,-4,2866,88,2867,3,0
20150106.020601,2866,20,689878,-4,2866,80,2867,15,0
20150106.020608,2866,10,689888,-8,2866,78,2867,15,0
20150106.020628,2867,2,689890,2,2866,53,2867,81,1
20150106.020633,2866,6,689896,0,2866,60,2867,83,0
20150106.020634,2866,10,689906,10,2866,57,2867,84,0
20150106.02064,2866,4,689910,-2,2866,55,2867,83,0
20150106.020642,2866,100,690010,48,2866,5,2867,83,0
20150106.020645,2866,10,690020,10,2865,160,2866,10,0
20150106.02065,2866,24,690044,20,2866,89,2867,179,0
20150106.020651,2866,8,690052,0,2866,86,2867,179,0
20150106.020652,2866,12,690064,10,2866,80,2867,179,0
20150106.020653,2866,166,690230,116,2865,165,2867,180,0
20150106.020654,2867,4,690234,-4,2865,165,2867,178,1
20150106.020655,2865,20,690254,-2,2865,155,2866,51,0
20150106.0207,2866,112,690366,8,2865,181,2867,179,1
20150106.020701,2866,2,690368,2,2866,1,2867,179,1
20150106.020702,2866,2,690370,0,2865,160,2867,188,1
20150106.020702,2865,2,690372,0,2865,160,2867,188,0
20150106.020709,2865,10,690382,0,2865,166,2866,35,0
20150106.020709,2866,6,690388,0,2865,166,2866,32,1
20150106.02071,2866,2,690390,0,2865,166,2866,36,1
20150106.020711,2865,2,690392,-2,2865,165,2866,36,0
20150106.020712,2865,2,690394,0,2865,164,2866,36,0
20150106.020712,2865,2,690396,2,2865,166,2866,36,0
20150106.020716,2865,10,690406,6,2865,171,2866,42,0
20150106.020716,2865,100,690506,92,2865,121,2866,52,0
20150106.020717,2865,2,690508,0,2865,116,2866,75,0
20150106.020718,2865,106,690614,34,2865,66,2866,72,0
20150106.020718,2865,78,690692,38,2865,27,2866,72,0
20150106.020719,2866,2,690694,0,2865,27,2866,71,1
20150106.020719,2864,56,690750,-10,2864,180,2865,20,0
20150106.02072,2864,4,690754,-4,2864,176,2865,23,0
20150106.020721,2864,2,690756,-2,2864,159,2865,25,0
20150106.020725,2864,72,690828,-60,2864,125,2865,22,0
20150106.020729,2865,10,690838,0,2864,127,2865,61,1
20150106.02073,2864,24,690862,-24,2864,115,2865,63,0
20150106.020732,2864,20,690882,-6,2864,105,2865,65,0
20150106.020734,2864,6,690888,6,2864,121,2865,67,0
20150106.020736,2864,2,690890,2,2864,121,2865,68,0
20150106.020736,2864,2,690892,0,2864,120,2865,68,0
20150106.020738,2864,8,690900,0,2864,128,2865,60,0
20150106.020738,2864,2,690902,0,2864,127,2865,63,0
20150106.020739,2864,2,690904,0,2864,126,2865,63,0
20150106.02074,2864,2,690906,0,2864,147,2865,70,0
20150106.02074,2864,2,690908,0,2864,146,2865,70,0
20150106.020741,2864,2,690910,2,2864,145,2865,70,0
20150106.020742,2864,4,690914,2,2864,143,2865,70,0
20150106.020743,2864,2,690916,0,2864,143,2865,72,0
20150106.020744,2864,40,690956,0,2864,125,2865,72,0
20150106.020746,2864,200,691156,158,2864,26,2865,72,0
20150106.020747,2864,32,691188,-16,2864,10,2865,72,0
20150106.020748,2864,2,691190,-2,2864,9,2865,72,0
20150106.020749,2864,28,691218,-20,2863,263,2865,72,0
20150106.02075,2863,18,691236,2,2863,257,2864,32,0
20150106.020751,2863,26,691262,-24,2863,256,2864,22,0
20150106.020751,2863,12,691274,-12,2863,243,2864,26,0
20150106.020751,2863,4,691278,-4,2863,241,2864,26,0
20150106.020752,2863,16,691294,0,2863,233,2864,26,0
20150106.020755,2863,14,691308,-2,2863,235,2864,21,0
20150106.020755,2863,2,691310,0,2863,237,2864,22,0
20150106.020757,2863,4,691314,0,2863,242,2864,22,0
20150106.020757,2864,74,691388,-22,2864,79,2865,81,1
20150106.020759,2864,14,691402,0,2864,83,2865,80,1
20150106.0208,2864,2,691404,0,2864,99,2865,80,1
20150106.020803,2864,38,691442,0,2864,85,2865,105,1
20150106.020803,2864,4,691446,0,2864,89,2865,105,1
20150106.020804,2864,16,691462,16,2864,82,2865,105,1
20150106.020805,2864,4,691466,2,2864,81,2865,105,1
20150106.020809,2864,8,691474,4,2864,79,2865,115,1
20150106.020811,2864,20,691494,20,2864,110,2865,117,1
20150106.020816,2864,2,691496,0,2864,109,2865,118,1
20150106.020816,2864,4,691500,2,2864,108,2865,117,1
20150106.02082,2865,2,691502,0,2864,137,2865,116,1
20150106.020824,2864,2,691504,0,2864,147,2865,116,0
20150106.020827,2864,10,691514,0,2864,148,2865,116,0
20150106.02083,2865,2,691516,0,2864,149,2865,118,1
20150106.020835,2865,2,691518,-2,2864,198,2865,117,1
20150106.020835,2864,20,691538,20,2864,188,2865,117,0
20150106.020838,2864,2,691540,0,2864,181,2865,118,0
20150106.020839,2864,10,691550,0,2864,176,2865,118,0
20150106.020843,2864,2,691552,0,2864,173,2865,123,0
20150106.020848,2865,60,691612,-58,2864,175,2865,88,1
20150106.020849,2865,2,691614,0,2864,201,2865,87,1
20150106.02085,2865,2,691616,0,2864,203,2865,86,1
20150106.020851,2864,2,691618,0,2864,202,2865,86,0
20150106.020853,2865,2,691620,0,2864,203,2865,85,1
20150106.020854,2865,34,691654,-12,2864,187,2865,84,1
20150106.020855,2865,6,691660,4,2864,187,2865,81,1
20150106.020857,2865,2,691662,2,2864,197,2865,80,1
20150106.020858,2864,2,691664,-2,2864,196,2865,200,0
20150106.020906,2865,2,691666,2,2864,169,2865,223,1
20150106.020911,2864,2,691668,-2,2864,167,2865,225,0
20150106.020913,2864,2,691670,-2,2864,166,2865,235,0
20150106.020914,2864,6,691676,-4,2864,163,2865,236,0
20150106.020917,2864,2,691678,0,2864,136,2865,242,0
20150106.02092,2864,12,691690,4,2864,138,2865,236,0
20150106.020922,2864,18,691708,12,2864,149,2865,235,0
20150106.020923,2864,6,691714,0,2864,148,2865,235,0
20150106.020924,2864,2,691716,-2,2864,147,2865,238,0
20150106.020929,2864,4,691720,-4,2864,146,2865,238,0
20150106.02093,2864,2,691722,0,2864,145,2865,241,0
20150106.020932,2865,2,691724,0,2864,147,2865,240,1
20150106.020933,2865,2,691726,2,2864,143,2865,238,1
20150106.020933,2865,6,691732,-4,2864,143,2865,235,1
20150106.020933,2865,4,691736,-2,2864,143,2865,233,1
20150106.020934,2865,4,691740,4,2864,143,2865,231,1
20150106.020936,2865,2,691742,0,2864,141,2865,230,1
20150106.020936,2865,10,691752,10,2864,145,2865,225,1
20150106.020937,2865,450,692202,108,2864,545,2866,108,1
20150106.020938,2866,2,692204,-2,2865,3,2866,105,1
20150106.020939,2864,22,692226,-20,2864,539,2866,104,0
20150106.02094,2866,2,692228,-2,2865,4,2866,73,1
20150106.020943,2865,12,692240,4,2864,534,2865,16,0
20150106.020944,2865,8,692248,8,2864,534,2865,12,0
20150106.020944,2865,2,692250,2,2864,534,2865,11,0
20150106.020945,2865,2,692252,0,2864,534,2865,10,0
20150106.020946,2865,20,692272,16,2865,64,2866,72,0
20150106.020946,2866,2,692274,0,2865,73,2866,47,1
20150106.021,2865,2,692276,2,2865,94,2866,51,0
20150106.021003,2866,16,692292,-16,2865,97,2866,44,1
20150106.02101,2866,6,692298,0,2865,108,2866,54,1
20150106.021016,2865,4,692302,0,2865,107,2866,57,0
20150106.021021,2866,20,692322,4,2865,111,2866,59,1
20150106.021023,2866,42,692364,0,2865,141,2866,43,1
20150106.021023,2866,20,692384,6,2865,139,2866,33,1
20150106.021024,2865,2,692386,2,2865,138,2866,33,0
20150106.021025,2866,4,692390,0,2865,138,2866,34,1
20150106.021028,2866,2,692392,0,2865,183,2866,33,1
20150106.021028,2866,2,692394,2,2865,184,2866,32,1
20150106.021029,2866,8,692402,0,2865,184,2866,28,1
20150106.021029,2866,6,692408,6,2865,184,2866,25,1
20150106.021032,2866,6,692414,4,2865,185,2866,22,1
20150106.021033,2866,46,692460,-36,2866,18,2867,155,1
20150106.021035,2866,10,692470,-10,2866,17,2867,156,1
20150106.021035,2865,36,692506,-32,2865,185,2867,156,0
20150106.021041,2866,4,692510,-2,2865,189,2867,173,1
20150106.021045,2866,6,692516,-2,2866,50,2867,183,1
20150106.021048,2867,6,692522,4,2866,101,2867,182,1
20150106.021049,2866,2,692524,0,2866,105,2867,182,0
20150106.021057,2867,8,692532,2,2866,68,2867,155,1
20150106.021057,2866,2,692534,-2,2866,67,2867,155,0
20150106.021101,2866,10,692544,-2,2866,67,2867,154,0
20150106.021104,2866,24,692568,16,2866,55,2867,146,0
20150106.021115,2867,10,692578,0,2866,57,2867,172,1
20150106.021115,2867,6,692584,0,2866,58,2867,169,1
20150106.021118,2866,116,692700,24,2865,237,2866,43,0
20150106.021118,2866,2,692702,2,2865,237,2866,42,0
20150106.021122,2866,2,692704,2,2865,248,2866,42,0
20150106.021124,2866,2,692706,0,2865,248,2866,41,0
20150106.021125,2867,88,692794,0,2866,12,2867,188,1
20150106.021127,2866,26,692820,-22,2865,249,2866,78,0
20150106.021128,2866,20,692840,-6,2865,249,2866,69,0
20150106.021129,2866,66,692906,-66,2865,249,2866,36,0
20150106.021131,2866,2,692908,-2,2865,248,2866,35,0
20150106.021132,2866,10,692918,0,2865,248,2866,30,0
20150106.021133,2866,4,692922,0,2865,249,2866,38,0
20150106.021136,2866,2,692924,0,2865,248,2866,40,0
20150106.021137,2866,6,692930,0,2865,248,2866,38,0
20150106.021138,2866,6,692936,0,2865,248,2866,35,0
20150106.021139,2866,14,692950,-8,2865,245,2866,29,0
20150106.021139,2866,6,692956,0,2865,245,2866,26,0
20150106.021139,2866,2,692958,-2,2865,245,2866,25,0
20150106.02114,2866,2,692960,-2,2865,245,2866,24,0
20150106.021141,2866,2,692962,0,2865,245,2866,23,0
20150106.021141,2866,4,692966,0,2865,245,2866,21,0
20150106.021142,2866,6,692972,-2,2865,246,2866,18,0
20150106.021142,2866,20,692992,12,2865,246,2866,9,0
20150106.021143,2866,2,692994,2,2865,246,2866,9,0
20150106.021144,2866,14,693008,2,2865,246,2866,2,0
20150106.021144,2866,12,693020,2,2865,246,2866,56,0
20150106.021145,2866,2,693022,-2,2865,246,2866,55,0
20150106.021145,2866,2,693024,0,2865,247,2866,54,0
20150106.021146,2866,4,693028,0,2865,235,2866,53,0
20150106.021147,2866,2,693030,-2,2865,235,2866,52,0
20150106.021147,2866,2,693032,-2,2865,235,2866,51,0
20150106.02115,2866,2,693034,0,2865,211,2866,50,0
20150106.021153,2866,2,693036,0,2865,211,2866,49,0
20150106.021156,2865,16,693052,-4,2865,208,2866,45,0
20150106.021156,2866,6,693058,-4,2865,208,2866,42,1
20150106.021201,2865,2,693060,0,2865,204,2866,48,0
20150106.021202,2866,4,693064,0,2865,203,2866,47,1
20150106.02121,2866,112,693176,18,2866,32,2867,194,1
20150106.021213,2866,68,693244,-2,2865,202,2866,177,1
20150106.021214,2866,2,693246,-2,2865,202,2866,377,1
20150106.021215,2866,2,693248,0,2865,202,2866,376,1
20150106.021216,2866,4,693252,0,2865,202,2866,374,1
20150106.021218,2866,2,693254,0,2865,202,2866,373,1
20150106.02122,2866,2,693256,-2,2865,202,2866,372,1
20150106.02122,2866,4,693260,-4,2865,202,2866,370,1
20150106.021221,2866,2,693262,0,2865,202,2866,369,1
20150106.021224,2865,8,693270,2,2865,196,2866,370,0
20150106.021227,2866,2,693272,-2,2865,207,2866,370,1
20150106.021238,2866,8,693280,-8,2865,200,2866,380,1
20150106.021251,2866,14,693294,-14,2865,253,2866,389,1
20150106.021251,2866,58,693352,-48,2865,224,2866,360,1
20150106.021304,2866,2,693354,-2,2865,223,2866,369,1
20150106.021318,2865,2,693356,0,2865,191,2866,364,0
20150106.021322,2865,2,693358,0,2865,210,2866,364,0
20150106.021325,2865,2,693360,0,2865,211,2866,369,0
20150106.021326,2865,22,693382,0,2865,201,2866,368,0
20150106.021328,2865,2,693384,0,2865,200,2866,368,0
20150106.021328,2866,2,693386,0,2865,200,2866,367,1
20150106.021329,2865,12,693398,10,2865,194,2866,367,0
20150106.021329,2865,2,693400,0,2865,193,2866,367,0
20150106.021331,2866,20,693420,0,2865,190,2866,362,1
20150106.021332,2865,2,693422,2,2865,189,2866,361,0
20150106.021336,2865,2,693424,0,2865,188,2866,363,0
20150106.02134,2865,8,693432,6,2865,184,2866,372,0
20150106.021341,2865,2,693434,0,2865,183,2866,372,0
20150106.021341,2865,16,693450,0,2865,175,2866,372,0
20150106.021341,2865,2,693452,2,2865,174,2866,372,0
20150106.021342,2865,2,693454,2,2865,173,2866,372,0
20150106.021343,2866,8,693462,-6,2865,172,2866,369,1
20150106.021344,2865,2,693464,2,2865,171,2866,369,0
20150106.021347,2865,4,693468,0,2865,171,2866,379,0
20150106.021349,2865,240,693708,-148,2865,51,2866,379,0
20150106.02135,2865,58,693766,-42,2865,56,2866,379,0
20150106.02135,2865,54,693820,14,2865,29,2866,379,0
20150106.021351,2865,2,693822,0,2865,28,2866,379,0
20150106.021351,2865,10,693832,0,2865,23,2866,380,0
20150106.021357,2866,2,693834,-2,2865,23,2866,379,1
20150106.021358,2865,4,693838,0,2865,421,2866,380,0
20150106.021358,2865,2,693840,2,2865,420,2866,381,0
20150106.0214,2866,100,693940,0,2865,421,2866,331,1
20150106.021403,2866,30,693970,0,2865,421,2866,316,1
20150106.021404,2866,100,694070,0,2865,422,2866,261,1
20150106.021408,2866,6,694076,0,2865,425,2866,258,1
20150106.021408,2866,2,694078,-2,2865,425,2866,257,1
20150106.021409,2866,2,694080,0,2865,425,2866,256,1
20150106.021409,2866,4,694084,-2,2865,425,2866,254,1
20150106.021412,2866,40,694124,0,2865,425,2866,234,1
20150106.021412,2866,22,694146,-22,2865,425,2866,224,1
20150106.021414,2866,2,694148,0,2865,428,2866,226,1
20150106.021418,2866,2,694150,0,2865,429,2866,224,1
20150106.021419,2866,100,694250,0,2865,429,2866,174,1
20150106.021419,2866,100,694350,0,2865,429,2866,124,1
20150106.02142,2866,2,694352,-2,2865,429,2866,123,1
20150106.021421,2865,2,694354,0,2865,428,2866,123,0
20150106.021422,2866,2,694356,-2,2865,428,2866,121,1
20150106.021423,2866,2,694358,-2,2865,427,2866,125,1
20150106.021424,2866,22,694380,-20,2865,427,2866,113,1
20150106.021425,2866,2,694382,-2,2865,427,2866,112,1
20150106.021425,2866,48,694430,-48,2865,27,2866,89,1
20150106.021427,2866,2,694432,0,2865,29,2866,112,1
20150106.021428,2866,2,694434,-2,2865,29,2866,112,1
20150106.021432,2866,2,694436,0,2865,43,2866,111,1
20150106.021432,2866,2,694438,-2,2865,45,2866,110,1
20150106.021435,2866,8,694446,-8,2865,45,2866,110,1
20150106.021435,2866,220,694666,64,2866,290,2867,220,1
20150106.021437,2867,12,694678,0,2866,306,2867,210,1
20150106.021437,2867,30,694708,-8,2866,306,2867,195,1
20150106.021438,2867,8,694716,-6,2866,309,2867,191,1
20150106.021438,2867,4,694720,0,2866,309,2867,189,1
20150106.021439,2867,12,694732,-12,2866,309,2867,183,1
20150106.02144,2867,40,694772,-40,2866,309,2867,163,1
20150106.021442,2867,24,694796,-4,2866,311,2867,148,1
20150106.021444,2867,6,694802,-6,2866,318,2867,128,1
20150106.021445,2867,4,694806,-4,2866,318,2867,118,1
20150106.021446,2867,2,694808,-2,2866,318,2867,117,1
20150106.021448,2867,54,694862,-28,2866,318,2867,89,1
20150106.021449,2867,2,694864,2,2866,318,2867,138,1
20150106.021449,2867,2,694866,2,2866,318,2867,137,1
20150106.021451,2867,6,694872,6,2866,318,2867,133,1
20150106.021451,2867,2,694874,0,2866,318,2867,132,1
20150106.021453,2867,4,694878,-2,2866,317,2867,218,1
20150106.021454,2867,2,694880,0,2866,318,2867,217,1
20150106.021455,2867,4,694884,-2,2866,319,2867,215,1
20150106.021455,2867,150,695034,26,2866,329,2867,140,1
20150106.021456,2867,28,695062,-18,2866,328,2867,131,1
20150106.021456,2867,56,695118,0,2866,333,2867,103,1
20150106.021457,2867,2,695120,0,2866,333,2867,102,1
20150106.021457,2867,106,695226,-104,2866,336,2867,51,1
20150106.021458,2867,60,695286,-54,2866,336,2867,21,1
20150106.021458,2867,6,695292,0,2866,336,2867,18,1
20150106.021459,2867,36,695328,-36,2867,11,2868,480,1
20150106.0215,2868,6,695334,-4,2867,17,2868,477,1
20150106.021501,2868,4,695338,2,2867,17,2868,475,1
20150106.021501,2868,2,695340,0,2867,17,2868,474,1
20150106.021502,2867,2,695342,0,2867,16,2868,474,0
20150106.021502,2867,32,695374,-18,2866,147,2868,474,0
20150106.021504,2868,4,695378,2,2866,147,2868,492,1
20150106.021505,2866,10,695388,0,2866,142,2868,543,0
20150106.021508,2867,4,695392,4,2866,140,2868,546,1
20150106.021511,2867,22,695414,2,2866,141,2867,23,1
20150106.021512,2867,2,695416,0,2866,142,2867,30,1
20150106.021512,2867,14,695430,10,2866,142,2867,79,1
20150106.021513,2867,4,695434,0,2866,142,2867,77,1
20150106.021513,2867,4,695438,4,2866,142,2867,75,1
20150106.021515,2867,2,695440,2,2866,142,2867,77,1
20150106.021517,2866,2,695442,0,2866,141,2867,86,0
20150106.021518,2867,4,695446,2,2866,140,2867,85,1
20150106.02152,2867,2,695448,2,2866,140,2867,84,1
20150106.021521,2867,2,695450,2,2866,141,2867,85,1
20150106.021522,2867,2,695452,0,2866,146,2867,84,1
20150106.021524,2867,4,695456,2,2866,146,2867,26,1
20150106.021528,2867,6,695462,-6,2866,145,2867,41,1
20150106.021529,2867,40,695502,24,2866,145,2867,21,1
20150106.02153,2867,2,695504,-2,2866,145,2867,20,1
20150106.021531,2867,20,695524,-20,2866,145,2867,83,1
20150106.021537,2867,20,695544,-2,2866,145,2867,93,1
20150106.021538,2867,150,695694,-136,2866,145,2867,19,1
20150106.021542,2867,30,695724,2,2866,146,2868,559,1
20150106.021552,2866,2,695726,2,2866,148,2867,128,0
20150106.021553,2867,10,695736,-6,2866,148,2867,124,1
20150106.021554,2867,4,695740,0,2866,148,2867,122,1
20150106.021603,2867,2,695742,-2,2866,150,2867,195,1
20150106.021604,2866,26,695768,0,2866,137,2867,195,0
20150106.02161,2866,4,695772,-2,2866,138,2867,223,0
20150106.02161,2866,8,695780,-8,2866,134,2867,223,0
20150106.021614,2866,2,695782,-2,2866,135,2867,225,0
20150106.021615,2866,40,695822,38,2866,114,2867,225,0
20150106.021616,2866,2,695824,0,2866,121,2867,225,0
20150106.021617,2866,20,695844,14,2866,111,2867,225,0
20150106.021618,2866,14,695858,0,2866,110,2867,225,0
20150106.021619,2866,2,695860,0,2866,109,2867,225,0
20150106.021623,2867,4,695864,-4,2866,123,2867,333,1
20150106.021635,2866,2,695866,0,2866,124,2867,234,0
20150106.021637,2866,20,695886,0,2866,114,2867,236,0
20150106.021642,2867,2,695888,-2,2866,114,2867,239,1
20150106.021643,2867,2,695890,-2,2866,114,2867,238,1
20150106.021645,2866,2,695892,0,2866,113,2867,238,0
20150106.021647,2867,6,695898,-6,2866,113,2867,235,1
20150106.021648,2866,2,695900,2,2866,112,2867,235,0
20150106.021651,2866,42,695942,0,2866,101,2867,237,0
20150106.021706,2866,132,696074,-6,2866,38,2867,262,0
20150106.021707,2866,20,696094,8,2866,28,2867,263,0
20150106.021708,2866,2,696096,-2,2866,27,2867,263,0
20150106.021709,2866,2,696098,-2,2866,26,2867,265,0
20150106.02171,2866,2,696100,-2,2866,25,2867,266,0
20150106.021711,2866,20,696120,-8,2866,15,2867,266,0
20150106.021712,2866,10,696130,0,2866,10,2867,266,0
20150106.021712,2866,2,696132,2,2866,9,2867,266,0
20150106.021712,2866,2,696134,2,2866,7,2867,266,0
20150106.021713,2866,2,696136,2,2866,7,2867,266,0
20150106.021715,2866,8,696144,8,2866,3,2867,268,0
20150106.021716,2866,2,696146,0,2866,2,2867,268,0
20150106.021722,2866,2,696148,0,2866,5,2867,271,0
20150106.021723,2867,2,696150,-2,2866,5,2867,270,1
20150106.021726,2866,2,696152,0,2866,7,2867,270,0
20150106.021731,2866,10,696162,4,2866,2,2867,295,0
20150106.021732,2866,4,696166,-4,2866,1,2867,295,0
20150106.021733,2866,2,696168,-2,2865,225,2866,152,0
20150106.021735,2866,2,696170,-2,2865,202,2866,151,0
20150106.021736,2866,2,696172,-2,2865,202,2866,150,0
20150106.02174,2866,8,696180,0,2865,202,2866,146,0
20150106.021743,2866,2,696182,-2,2865,203,2866,145,0
20150106.021745,2866,2,696184,0,2865,204,2866,144,0
20150106.021745,2865,18,696202,-4,2865,195,2866,144,0
20150106.021749,2866,2,696204,-2,2865,195,2866,143,1
20150106.021752,2865,50,696254,-30,2865,170,2866,155,0
20150106.021807,2865,2,696256,0,2865,178,2866,167,0
20150106.021808,2866,20,696276,-10,2865,214,2866,158,1
20150106.021809,2866,4,696280,0,2865,212,2866,156,1
20150106.021825,2865,352,696632,208,2865,17,2866,266,0
20150106.021826,2865,2,696634,0,2865,18,2866,268,0
20150106.021827,2865,4,696638,0,2865,16,2866,268,0
20150106.021828,2866,20,696658,0,2865,11,2866,258,1
20150106.021828,2865,10,696668,0,2865,6,2866,258,0
20150106.021833,2865,2,696670,2,2865,8,2866,288,0
20150106.02184,2865,88,696758,-56,2864,259,2865,7,0
20150106.02184,2865,14,696772,-14,2865,20,2866,287,0
20150106.021841,2865,12,696784,-10,2865,14,2866,287,0
20150106.021847,2865,2,696786,-2,2865,13,2866,298,0
20150106.021848,2865,2,696788,-2,2865,12,2866,298,0
20150106.021852,2865,20,696808,-20,2865,3,2866,298,0
20150106.021853,2865,6,696814,2,2864,300,2865,13,0
20150106.021853,2865,2,696816,0,2864,300,2865,12,0
20150106.021857,2864,10,696826,-10,2864,298,2865,12,0
20150106.021859,2865,2,696828,0,2864,299,2865,12,1
20150106.021903,2865,2,696830,2,2864,309,2865,108,1
20150106.021904,2865,216,697046,216,2864,309,2866,201,1
20150106.021904,2865,4,697050,-4,2864,309,2865,1,1
20150106.021905,2865,2,697052,0,2864,310,2866,201,1
20150106.021905,2865,2,697054,0,2864,310,2866,201,1
20150106.021906,2865,2,697056,-2,2865,20,2866,201,1
20150106.021908,2865,24,697080,-24,2865,8,2866,201,1
20150106.021909,2865,10,697090,-10,2865,4,2866,201,1
20150106.021911,2865,8,697098,-8,2864,310,2865,5,1
20150106.021913,2865,4,697102,-4,2864,311,2865,3,1
20150106.021915,2865,2,697104,0,2864,315,2865,2,1
20150106.021915,2865,4,697108,-2,2865,2,2866,201,1
20150106.021916,2866,10,697118,0,2865,2,2866,195,1
20150106.021917,2866,26,697144,-26,2865,29,2866,182,1
20150106.02192,2865,4,697148,-2,2865,46,2866,177,0
20150106.02192,2866,10,697158,0,2865,48,2866,172,1
20150106.021922,2865,8,697166,0,2865,49,2866,175,0
20150106.021923,2865,10,697176,0,2865,45,2866,175,0
20150106.021927,2865,10,697186,10,2865,42,2866,176,0
20150106.021927,2865,2,697188,0,2865,42,2866,176,0
20150106.021928,2865,84,697272,-58,2864,319,2865,9,0
20150106.02193,2865,2,697274,-2,2864,318,2865,20,0
20150106.02193,2865,40,697314,-36,2865,12,2866,178,0
20150106.021932,2865,10,697324,0,2865,11,2866,188,0
20150106.021936,2865,2,697326,0,2865,32,2866,188,0
20150106.021938,2865,2,697328,-2,2865,52,2866,188,0
20150106.021939,2865,8,697336,-8,2865,60,2866,193,0
20150106.02194,2865,10,697346,0,2865,55,2866,193,0
20150106.021947,2866,148,697494,-142,2865,85,2866,130,1
20150106.02195,2865,48,697542,-34,2865,66,2866,130,0
20150106.022007,2866,326,697868,-190,2866,13,2867,393,1
20150106.022008,2866,28,697896,-28,2865,122,2866,3,1
20150106.022009,2866,4,697900,-2,2865,121,2866,57,1
20150106.022012,2865,6,697906,0,2865,123,2866,56,0
20150106.022016,2866,4,697910,0,2865,130,2866,4,1
20150106.022019,2866,8,697918,-2,2866,1,2867,411,1
20150106.022019,2866,4,697922,-4,2865,134,2867,411,1
20150106.022022,2866,4,697926,0,2865,141,2867,411,1
20150106.022035,2866,2,697928,0,2865,141,2866,98,1
20150106.022044,2866,2,697930,0,2865,141,2866,103,1
20150106.022045,2866,2,697932,-2,2865,141,2866,113,1
20150106.022048,2866,24,697956,-22,2865,141,2866,104,1
20150106.02205,2866,12,697968,-6,2865,142,2866,98,1
20150106.022052,2866,2,697970,-2,2865,141,2866,97,1
20150106.022057,2866,2,697972,-2,2865,141,2866,96,1
20150106.022059,2866,6,697978,0,2865,141,2866,93,1
20150106.022102,2866,2,697980,0,2865,141,2866,107,1
20150106.022104,2866,2,697982,0,2865,174,2866,103,1
20150106.022108,2865,2,697984,0,2865,174,2866,103,0
20150106.022112,2866,2,697986,-2,2865,175,2866,157,1
20150106.022116,2865,48,698034,-20,2865,151,2866,209,0
20150106.022117,2865,100,698134,-90,2865,101,2866,209,0
20150106.02212,2865,192,698326,-170,2864,272,2866,215,0
20150106.022121,2865,4,698330,-4,2864,272,2865,14,0
20150106.022129,2865,2,698332,-2,2864,273,2865,32,0
20150106.022133,2865,54,698386,-16,2864,274,2865,9,0
20150106.022134,2865,6,698392,-4,2864,274,2865,7,0
20150106.022136,2865,14,698406,-4,2865,1,2866,166,0
20150106.022138,2866,2,698408,-2,2865,2,2866,165,1
20150106.022141,2865,2,698410,-2,2865,13,2866,165,0
20150106.022209,2865,4,698414,0,2865,86,2866,185,0
20150106.022209,2866,20,698434,-20,2865,110,2866,175,1
20150106.022211,2866,20,698454,0,2865,113,2866,165,1
20150106.022211,2865,20,698474,-2,2865,107,2866,165,0
20150106.02222,2866,402,698876,-342,2866,1,2867,233,1
20150106.02222,2866,2,698878,-2,2865,110,2867,233,1
20150106.022223,2866,8,698886,-8,2866,44,2867,233,1
20150106.022225,2866,90,698976,-88,2865,182,2867,233,1
20150106.022232,2865,10,698986,-10,2865,258,2867,209,0
20150106.022234,2865,10,698996,-10,2865,255,2867,209,0
20150106.022235,2867,2,698998,-2,2865,256,2867,208,1
20150106.022236,2867,2,699000,0,2865,253,2867,258,1
20150106.022242,2866,4,699004,2,2865,252,2867,300,0
20150106.022243,2866,2,699006,0,2865,253,2867,299,0
20150106.022245,2865,2,699008,-2,2865,253,2866,200,0
20150106.022246,2866,10,699018,0,2865,253,2866,197,1
20150106.022247,2866,2,699020,0,2865,273,2866,196,1
20150106.022249,2866,2,699022,2,2865,274,2866,205,1
20150106.02225,2866,2,699024,0,2865,274,2866,204,1
20150106.02225,2865,100,699124,34,2865,224,2866,204,0
20150106.022254,2866,2,699126,2,2865,227,2866,205,1
20150106.022256,2866,20,699146,10,2865,206,2866,195,1
20150106.022308,2866,4,699150,0,2865,309,2866,388,1
20150106.022318,2866,2,699152,2,2865,312,2866,387,1
20150106.022318,2866,2,699154,0,2865,313,2866,386,1
20150106.022319,2866,2,699156,0,2865,313,2866,385,1
20150106.022322,2866,2,699158,2,2865,311,2866,384,1
20150106.022323,2866,2,699160,2,2865,311,2866,383,1
20150106.022324,2866,2,699162,2,2865,311,2866,380,1
20150106.022324,2866,2,699164,2,2865,311,2866,379,1
20150106.022325,2866,4,699168,4,2865,311,2866,377,1
20150106.022325,2866,4,699172,0,2865,316,2866,375,1
20150106.022326,2866,2,699174,2,2865,316,2866,374,1
20150106.022328,2866,2,699176,-2,2865,336,2866,207,1
20150106.022328,2866,4,699180,-4,2865,336,2866,206,1
20150106.022329,2866,10,699190,-10,2865,336,2866,201,1
20150106.02233,2865,4,699194,4,2865,356,2866,201,0
20150106.022331,2866,2,699196,-2,2865,356,2866,200,1
20150106.022331,2866,2,699198,0,2865,339,2866,194,1
20150106.022332,2866,388,699586,362,2865,340,2867,207,1
20150106.022339,2866,4,699590,0,2866,128,2867,215,1
20150106.022341,2867,100,699690,0,2866,128,2867,165,1
20150106.022345,2867,2,699692,0,2866,117,2867,159,1
20150106.022347,2867,478,700170,46,2867,162,2868,507,1
20150106.022351,2867,20,700190,20,2867,161,2868,507,1
20150106.022352,2867,322,700512,176,2867,1,2868,507,1
20150106.022352,2867,8,700520,-6,2866,106,2867,1,1
20150106.022353,2867,4,700524,4,2867,1,2868,507,1
20150106.022354,2867,4,700528,-2,2866,106,2868,507,1
20150106.022355,2866,2,700530,-2,2866,105,2868,507,0
20150106.022356,2866,16,700546,-4,2866,99,2868,507,0
20150106.022357,2867,8,700554,-2,2866,99,2867,110,1
20150106.022358,2867,6,700560,0,2866,199,2867,107,1
20150106.0224,2867,40,700600,0,2866,200,2867,97,1
20150106.0224,2867,100,700700,0,2866,200,2867,47,1
20150106.022401,2867,10,700710,0,2866,200,2867,44,1
20150106.022401,2867,14,700724,-8,2866,203,2867,37,1
20150106.022402,2867,74,700798,-16,2867,135,2868,516,1
20150106.022402,2868,4,700802,-4,2867,136,2868,514,1
20150106.022403,2868,2,700804,-2,2867,136,2868,513,1
20150106.022403,2868,36,700840,0,2867,136,2868,495,1
20150106.022406,2868,10,700850,-10,2867,146,2868,492,1
20150106.022408,2867,6,700856,6,2867,144,2868,492,0
20150106.022411,2867,2,700858,0,2867,152,2868,492,0
20150106.022415,2867,6,700864,0,2867,155,2868,492,0
20150106.022416,2868,12,700876,0,2867,156,2868,486,1
20150106.022423,2867,22,700898,0,2867,145,2868,489,0
20150106.022425,2868,2,700900,0,2867,148,2868,489,1
20150106.022426,2867,2,700902,2,2867,147,2868,489,0
20150106.022428,2867,40,700942,0,2867,128,2868,492,0
20150106.022432,2867,2,700944,0,2867,227,2868,493,0
20150106.022432,2867,10,700954,0,2867,222,2868,493,0
20150106.022434,2868,2,700956,0,2867,230,2868,495,1
20150106.022435,2867,100,701056,100,2867,181,2868,496,0
20150106.022437,2868,2,701058,0,2867,187,2868,495,1
20150106.022439,2867,336,701394,20,2867,19,2868,495,0
20150106.02244,2868,2,701396,0,2867,23,2868,494,1
20150106.022441,2867,8,701404,2,2867,19,2868,494,0
20150106.022442,2867,2,701406,0,2867,18,2868,504,0
20150106.022442,2867,36,701442,-10,2866,193,2867,86,0
20150106.022443,2867,2,701444,0,2866,193,2867,97,0
20150106.022449,2867,14,701458,0,2866,205,2867,297,0
20150106.022452,2867,20,701478,0,2866,206,2867,237,0
20150106.022453,2867,2,701480,0,2866,193,2867,236,0
20150106.022454,2867,8,701488,-8,2866,199,2867,233,0
20150106.022456,2867,10,701498,0,2866,199,2867,228,0
20150106.022457,2867,2,701500,-2,2866,199,2867,227,0
20150106.0225,2865,620,702120,-318,2865,180,2867,233,0
20150106.022502,2865,2,702122,-2,2866,8,2867,234,0
20150106.022502,2866,16,702138,0,2865,179,2867,234,1
20150106.022503,2864,370,702508,278,2864,138,2867,234,0
20150106.022503,2864,22,702530,-2,2864,127,2866,53,0
20150106.022504,2865,20,702550,20,2864,127,2866,44,1
20150106.022505,2865,8,702558,-2,2864,126,2866,2,1
20150106.022506,2866,2,702560,0,2864,126,2866,81,1
20150106.022507,2866,2,702562,0,2864,126,2866,80,1
20150106.022508,2866,14,702576,2,2864,126,2866,161,1
20150106.02251,2866,2,702578,2,2864,127,2866,163,1
20150106.022511,2864,10,702588,2,2864,123,2866,162,0
20150106.022513,2865,6,702594,-2,2864,123,2866,162,1
20150106.022514,2865,2,702596,0,2864,123,2866,163,1
20150106.022516,2866,18,702614,-4,2865,56,2866,169,1
20150106.022516,2865,18,702632,-2,2865,55,2866,161,0
20150106.022518,2865,6,702638,0,2865,64,2866,161,0
20150106.022518,2865,22,702660,-22,2865,53,2866,161,0
20150106.022521,2865,2,702662,-2,2865,55,2866,233,0
20150106.022522,2865,6,702668,-6,2865,52,2866,233,0
20150106.022523,2866,4,702672,0,2865,52,2866,231,1
20150106.022531,2866,16,702688,-16,2865,122,2866,205,1
20150106.022531,2866,16,702704,0,2865,122,2866,197,1
20150106.022533,2866,4,702708,-2,2865,130,2866,189,1
20150106.022534,2865,2,702710,0,2865,135,2866,147,0
20150106.022536,2866,2,702712,0,2865,135,2866,146,1
20150106.022536,2866,4,702716,0,2865,135,2866,146,1
20150106.022539,2865,26,702742,-26,2865,125,2866,136,0
20150106.022546,2866,16,702758,-16,2865,128,2866,157,1
20150106.022546,2866,16,702774,0,2865,128,2866,149,1
20150106.022547,2865,100,702874,-90,2865,78,2866,149,0
20150106.022551,2865,2,702876,0,2865,81,2866,247,0
20150106.022554,2865,100,702976,-92,2865,31,2866,247,0
20150106.022557,2865,16,702992,-2,2865,25,2866,254,0
20150106.022558,2866,2,702994,-2,2865,25,2866,254,1
20150106.022559,2865,22,703016,0,2865,15,2866,254,0
20150106.0226,2865,80,703096,16,2864,162,2865,2,0
20150106.0226,2865,4,703100,-4,2865,1,2866,255,0
20150106.022602,2866,46,703146,2,2865,6,2866,252,1
20150106.022602,2865,6,703152,6,2865,3,2866,252,0
20150106.022603,2866,8,703160,-4,2865,3,2866,248,1
20150106.022603,2864,52,703212,-46,2864,140,2866,248,0
20150106.022604,2865,2,703214,-2,2864,140,2865,3,1
20150106.022604,2865,6,703220,-2,2864,145,2865,11,1
20150106.022606,2865,6,703226,-6,2864,145,2865,8,1
20150106.022606,2865,4,703230,0,2864,145,2865,6,1
20150106.022608,2865,2,703232,0,2864,145,2865,15,1
20150106.02261,2864,2,703234,0,2864,145,2865,15,0
20150106.02261,2865,2,703236,-2,2864,145,2865,14,1
20150106.022611,2865,2,703238,0,2864,146,2865,13,1
20150106.022613,2865,2,703240,-2,2864,147,2865,12,1
20150106.022616,2865,2,703242,-2,2864,147,2865,11,1
20150106.022617,2864,2,703244,-2,2864,146,2865,11,0
20150106.022618,2865,6,703250,-2,2864,147,2865,8,1
20150106.022618,2865,2,703252,0,2864,149,2865,7,1
20150106.02262,2865,14,703266,0,2865,396,2866,248,1
20150106.022622,2865,12,703278,2,2865,391,2866,248,1
20150106.022622,2866,4,703282,0,2865,391,2866,246,1
20150106.022627,2865,10,703292,0,2865,394,2866,449,0
20150106.022629,2865,4,703296,0,2865,402,2866,459,0
20150106.02263,2865,10,703306,0,2865,403,2866,459,0
20150106.022631,2865,2,703308,0,2865,403,2866,459,0
20150106.022632,2866,2,703310,-2,2865,403,2866,458,1
20150106.022633,2866,20,703330,-20,2865,403,2866,448,1
20150106.022637,2865,6,703336,6,2865,402,2866,449,0
20150106.022641,2866,2,703338,0,2865,441,2866,450,1
20150106.022643,2865,8,703346,0,2865,440,2866,447,0
20150106.022643,2865,360,703706,0,2865,260,2866,447,0
20150106.022649,2866,200,703906,44,2865,260,2866,363,1
20150106.02265,2866,100,704006,100,2865,261,2866,313,1
20150106.022651,2866,100,704106,100,2865,261,2866,263,1
20150106.022654,2866,4,704110,4,2865,264,2866,261,1
20150106.022655,2865,20,704130,0,2865,255,2866,260,0
20150106.022659,2866,6,704136,0,2865,256,2866,256,1
20150106.022659,2866,6,704142,6,2865,256,2866,253,1
20150106.022703,2866,4,704146,0,2865,260,2866,256,1
20150106.022707,2866,2,704148,0,2865,272,2866,258,1
20150106.022711,2866,22,704170,-22,2865,280,2866,47,1
20150106.022713,2866,2,704172,-2,2865,281,2866,47,1
20150106.022713,2866,2,704174,0,2865,280,2866,46,1
20150106.022714,2866,60,704234,-56,2865,282,2866,16,1
20150106.022715,2865,6,704240,0,2865,290,2866,12,0
20150106.022715,2865,24,704264,4,2865,287,2866,3,0
20150106.022715,2866,6,704270,0,2866,19,2867,270,1
20150106.022716,2866,2,704272,-2,2866,37,2867,270,1
20150106.022717,2866,6,704278,-6,2866,136,2867,270,1
20150106.022719,2866,2,704280,0,2866,140,2867,270,1
20150106.022719,2866,2,704282,-2,2866,140,2867,270,1
20150106.02272,2866,2,704284,0,2866,139,2867,270,1
20150106.022722,2866,12,704296,-12,2866,133,2867,271,1
20150106.022725,2866,36,704332,-14,2866,149,2867,271,1
20150106.022727,2866,2,704334,0,2866,152,2867,277,1
20150106.022728,2866,2,704336,2,2866,151,2867,277,1
20150106.02273,2867,6,704342,-6,2866,152,2867,274,1
20150106.022732,2866,2,704344,0,2866,153,2867,275,0
20150106.022733,2866,56,704400,50,2866,25,2867,275,0
20150106.022734,2866,6,704406,6,2866,31,2867,275,0
20150106.022734,2866,6,704412,4,2866,28,2867,275,0
20150106.022735,2866,48,704460,-20,2866,9,2867,275,0
20150106.022736,2867,2,704462,0,2866,9,2867,276,1
20150106.022737,2867,4,704466,-4,2866,14,2867,274,1
20150106.022739,2866,22,704488,-8,2866,10,2867,274,0
20150106.022739,2866,10,704498,-6,2866,6,2867,274,0
20150106.022741,2867,2,704500,0,2866,7,2867,274,1
20150106.022743,2867,36,704536,-32,2866,6,2867,258,1
20150106.022744,2867,2,704538,-2,2866,6,2867,267,1
20150106.022747,2866,2,704540,2,2866,13,2867,278,0
20150106.022752,2866,4,704544,0,2866,13,2867,278,0
20150106.022753,2866,2,704546,0,2866,12,2867,279,0
20150106.022755,2866,14,704560,-2,2866,223,2867,280,0
20150106.022759,2866,2,704562,2,2866,222,2867,272,0
20150106.0228,2866,32,704594,-16,2866,206,2867,273,0
20150106.0228,2866,2,704596,0,2866,205,2867,273,0
20150106.022801,2867,60,704656,0,2866,205,2867,243,1
20150106.022801,2866,2,704658,0,2866,204,2867,242,0
20150106.022802,2866,2,704660,-2,2866,273,2867,317,0
20150106.022804,2866,2,704662,0,2866,274,2867,316,0
20150106.022807,2866,2,704664,0,2866,320,2867,325,0
20150106.022807,2866,2,704666,-2,2866,319,2867,325,0
20150106.022812,2866,2,704668,2,2866,324,2867,330,0
20150106.022814,2866,8,704676,0,2866,320,2867,331,0
20150106.022816,2867,2,704678,0,2866,325,2867,373,1
20150106.022817,2866,2,704680,0,2866,324,2867,329,0
20150106.022818,2867,34,704714,0,2866,309,2867,328,1
20150106.022822,2867,2,704716,-2,2866,310,2867,391,1
20150106.022822,2866,2,704718,0,2866,309,2867,391,0
20150106.022822,2867,2,704720,-2,2866,309,2867,390,1
20150106.022825,2867,12,704732,0,2866,309,2867,486,1
20150106.022827,2866,2,704734,2,2866,309,2867,453,0
20150106.02283,2866,4,704738,4,2866,309,2867,454,0
20150106.022831,2867,8,704746,-8,2866,309,2867,450,1
20150106.022832,2867,6,704752,-6,2866,313,2867,447,1
20150106.022834,2866,10,704762,10,2866,305,2867,448,0
20150106.022835,2866,60,704822,0,2866,275,2867,440,0
20150106.022836,2866,2,704824,2,2866,275,2867,443,0
20150106.022837,2866,2,704826,0,2866,274,2867,448,0
20150106.022838,2866,2,704828,0,2866,274,2867,455,0
20150106.022839,2866,400,705228,272,2866,74,2867,458,0
20150106.02284,2867,2,705230,-2,2866,74,2867,458,1
20150106.02284,2866,132,705362,82,2866,7,2867,450,0
20150106.022841,2866,14,705376,2,2865,227,2866,283,0
20150106.022842,2865,18,705394,-14,2865,219,2866,302,0
20150106.022842,2866,12,705406,0,2865,219,2866,298,1
20150106.022844,2866,10,705416,10,2865,223,2866,296,1
20150106.022844,2866,8,705424,6,2865,222,2866,292,1
20150106.022845,2866,2,705426,0,2865,222,2866,291,1
20150106.022846,2866,60,705486,60,2865,222,2866,261,1
20150106.022848,2866,2,705488,0,2865,225,2866,266,1
20150106.022851,2865,70,705558,12,2865,209,2866,251,0
20150106.022855,2866,4,705562,0,2865,261,2866,250,1
20150106.022857,2865,18,705580,6,2865,264,2866,250,0
20150106.0229,2866,2,705582,0,2865,266,2866,252,1
20150106.022901,2866,28,705610,0,2865,266,2866,239,1
20150106.022901,2866,312,705922,0,2865,265,2866,84,1
20150106.022901,2866,6,705928,0,2865,265,2866,81,1
20150106.022902,2866,34,705962,6,2865,253,2866,79,1
20150106.022903,2866,10,705972,0,2865,260,2866,74,1
20150106.022904,2866,12,705984,0,2865,282,2866,68,1
20150106.022904,2866,2,705986,0,2865,282,2866,67,1
20150106.022905,2866,12,705998,-12,2865,280,2866,70,1
20150106.022905,2865,20,706018,-20,2865,270,2866,70,0
20150106.022907,2866,18,706036,-18,2865,270,2866,64,1
20150106.022907,2866,2,706038,-2,2865,274,2866,63,1
20150106.022908,2866,20,706058,-20,2865,274,2866,83,1
20150106.022908,2866,142,706200,-30,2865,259,2866,32,1
20150106.022909,2866,6,706206,-6,2865,258,2866,30,1
20150106.02291,2865,2,706208,-2,2865,257,2866,30,0
20150106.02291,2865,4,706212,-4,2865,254,2866,35,0
20150106.022911,2865,4,706216,-4,2865,253,2866,34,0
20150106.022912,2865,6,706222,0,2865,451,2866,35,0
20150106.022912,2866,4,706226,-4,2865,451,2866,34,1
20150106.022913,2866,2,706228,0,2865,457,2866,32,1
20150106.022913,2865,8,706236,-2,2865,454,2866,31,0
20150106.022914,2865,12,706248,-10,2865,453,2866,27,0
20150106.022915,2866,2,706250,-2,2865,458,2866,29,1
20150106.022916,2865,20,706270,20,2865,471,2866,30,0
20150106.022917,2866,402,706672,0,2865,471,2867,135,1
20150106.022918,2865,16,706688,0,2865,454,2866,2,0
20150106.022919,2866,14,706702,-6,2865,449,2866,2,1
20150106.022919,2866,4,706706,-4,2866,2,2867,135,1
20150106.02292,2866,4,706710,-4,2866,8,2867,135,1
20150106.022921,2866,38,706748,-26,2865,442,2866,9,1
20150106.022921,2865,66,706814,-4,2865,412,2866,23,0
20150106.022922,2865,6,706820,0,2865,411,2866,23,0
20150106.022922,2866,56,706876,-56,2866,77,2867,131,1
20150106.022923,2866,152,707028,-152,2866,7,2867,133,1
20150106.022924,2866,4,707032,-2,2866,6,2867,132,1
20150106.022924,2866,12,707044,8,2866,1,2867,132,1
20150106.022925,2866,2,707046,2,2865,420,2866,14,1
20150106.022925,2866,14,707060,12,2865,419,2866,14,1
20150106.022926,2866,28,707088,-10,2865,415,2867,138,1
20150106.022926,2866,2,707090,-2,2865,415,2866,49,1
20150106.022927,2866,10,707100,-10,2865,419,2866,44,1
20150106.022927,2866,14,707114,-2,2865,413,2866,44,1
20150106.022928,2866,8,707122,-8,2865,432,2866,43,1
20150106.022929,2866,6,707128,-2,2865,429,2866,40,1
20150106.022929,2866,46,707174,-42,2865,429,2866,17,1
20150106.02293,2866,2,707176,0,2865,430,2866,17,1
20150106.022931,2866,22,707198,10,2865,429,2866,6,1
20150106.022931,2866,14,707212,-12,2866,11,2867,139,1
20150106.022932,2867,4,707216,-4,2866,16,2867,142,1
20150106.022932,2867,10,707226,0,2866,16,2867,137,1
20150106.022933,2866,2,707228,-2,2866,16,2867,137,0
20150106.022934,2866,12,707240,0,2866,10,2867,138,0
20150106.022934,2866,30,707270,0,2866,195,2867,141,0
20150106.022935,2866,2,707272,-2,2866,194,2867,142,0
20150106.022935,2867,64,707336,-64,2866,167,2867,140,1
20150106.022939,2866,100,707436,-100,2866,122,2867,140,0
20150106.02294,2866,8,707444,0,2866,120,2867,137,0
20150106.022941,2867,10,707454,-10,2866,125,2867,136,1
20150106.022942,2866,64,707518,-64,2866,103,2867,137,0
20150106.022943,2867,4,707522,0,2866,103,2867,139,1
20150106.022946,2867,4,707526,-4,2866,104,2867,246,1
20150106.022947,2866,2,707528,-2,2866,137,2867,246,0
20150106.022948,2866,2,707530,-2,2866,136,2867,244,0
20150106.022948,2866,6,707536,-6,2866,133,2867,244,0
20150106.022949,2866,2,707538,0,2866,132,2867,259,0
20150106.02295,2867,2,707540,0,2866,132,2867,259,1
20150106.022952,2866,8,707548,-8,2866,128,2867,260,0
20150106.022953,2866,6,707554,-6,2866,125,2867,263,0
20150106.022953,2867,84,707638,-60,2866,125,2867,221,1
20150106.022954,2867,44,707682,0,2866,118,2867,199,1
20150106.022954,2866,52,707734,32,2866,116,2867,176,0
20150106.022955,2867,8,707742,-2,2866,116,2867,171,1
20150106.022955,2866,8,707750,-8,2866,112,2867,171,0
20150106.022955,2866,4,707754,-2,2866,110,2867,171,0
20150106.022956,2866,6,707760,-4,2866,129,2867,175,0
20150106.022957,2866,276,708036,-194,2865,181,2866,91,0
20150106.022958,2865,58,708094,-12,2865,158,2866,86,0
20150106.022958,2865,44,708138,36,2865,136,2866,86,0
20150106.022959,2865,6,708144,-2,2865,133,2866,119,0
20150106.022959,2865,6,708150,-6,2865,131,2866,118,0
20150106.023,2866,88,708238,-42,2865,107,2866,97,1
20150106.09,2866,194,708432,0,2866,6,2867,167,1
20150106.090001,2866,1938,710370,40,2866,29,2867,134,1
20150106.090001,2866,588,710958,-140,2866,28,2867,22,1
20150106.090002,2869,3052,714010,-52,2868,13,2869,243,1
20150106.090002,2866,334,714344,-56,2866,69,2869,164,0
20150106.090003,2868,290,714634,-86,2867,592,2868,9,1
20150106.090003,2868,426,715060,-154,2867,490,2868,9,1
20150106.090004,2869,506,715566,278,2869,17,2870,643,1
20150106.090004,2868,172,715738,52,2868,279,2869,178,0
20150106.090005,2868,144,715882,-34,2868,278,2869,242,0
20150106.090005,2868,74,715956,-56,2868,259,2869,225,0
20150106.090006,2868,488,716444,-106,2868,260,2869,24,0
20150106.090006,2869,892,717336,126,2869,11,2870,686,1
20150106.090007,2869,112,717448,-40,2868,3,2869,67,1
20150106.090007,2869,450,717898,-178,2868,21,2869,115,1
20150106.090008,2868,318,718216,-8,2867,190,2868,31,0
20150106.090008,2868,68,718284,-50,2867,171,2868,38,0
20150106.090009,2868,276,718560,-124,2867,166,2868,2,0
20150106.090009,2868,318,718878,16,2868,88,2870,653,0
20150106.09001,2867,800,719678,184,2867,238,2868,740,0
20150106.09001,2867,18,719696,-12,2867,225,2868,742,0
20150106.090011,2868,524,720220,88,2867,71,2868,638,1
20150106.090011,2870,2622,722842,-932,2870,759,2871,74,1
20150106.090012,2870,572,723414,-14,2870,736,2872,362,1
20150106.090012,2870,274,723688,-62,2870,608,2872,309,1
20150106.090013,2870,338,724026,-162,2870,512,2872,289,1
20150106.090013,2870,128,724154,-122,2870,470,2871,1,1
20150106.090014,2870,542,724696,-428,2870,461,2872,306,1
20150106.090014,2870,202,724898,-126,2870,418,2871,42,1
20150106.090015,2870,196,725094,-112,2870,405,2872,256,1
20150106.090015,2870,568,725662,-152,2870,154,2871,8,1
20150106.090016,2871,90,725752,-76,2870,103,2871,47,1
20150106.090016,2870,332,726084,-124,2869,58,2870,30,0
20150106.090017,2871,370,726454,142,2870,1,2871,144,1
20150106.090017,2871,692,727146,-224,2871,478,2872,180,1
20150106.090018,2871,190,727336,-164,2871,448,2872,128,1
20150106.090018,2871,506,727842,-202,2871,212,2872,101,1
20150106.090019,2872,984,728826,812,2872,27,2873,145,1
20150106.090019,2871,202,729028,-26,2871,179,2872,16,0
20150106.09002,2871,98,729126,-20,2872,1,2873,156,0
20150106.09002,2871,90,729216,-28,2871,235,2872,33,0
20150106.090021,2870,1100,730316,582,2869,406,2870,518,0
20150106.090021,2870,390,730706,224,2869,6,2870,400,0
20150106.090022,2870,1346,732052,934,2870,1,2871,1,0
20150106.090022,2869,392,732444,128,2868,49,2869,58,0
20150106.090023,2869,188,732632,2,2869,107,2871,232,0
20150106.090023,2870,270,732902,16,2870,40,2871,322,1
20150106.090024,2870,916,733818,-786,2869,343,2870,10,1
20150106.090024,2869,178,733996,-164,2869,306,2871,24,0
20150106.090025,2870,64,734060,2,2870,35,2871,62,1
20150106.090025,2869,1604,735664,-48,2869,332,2870,8,0
20150106.090026,2870,96,735760,-44,2869,301,2870,2,1
20150106.090026,2869,98,735858,-74,2869,293,2870,25,0
20150106.090027,2869,130,735988,32,2869,242,2870,54,0
20150106.090027,2870,72,736060,10,2870,980,2871,197,1
20150106.090028,2871,150,736210,-114,2870,1064,2871,143,1
20150106.090028,2870,318,736528,-8,2870,953,2871,138,0
20150106.090029,2870,190,736718,32,2870,951,2871,124,0
20150106.090029,2871,398,737116,-260,2870,882,2871,1,1
20150106.09003,2870,448,737564,-404,2870,691,2872,412,0
20150106.09003,2871,416,737980,14,2870,1158,2871,11,1
20150106.090031,2870,362,738342,-270,2870,985,2871,10,0
20150106.090031,2870,44,738386,-22,2870,969,2871,36,0
20150106.090032,2870,114,738500,0,2870,929,2871,24,0
20150106.090032,2871,98,738598,-2,2871,11,2872,581,1
20150106.090033,2870,394,738992,-242,2871,7,2872,567,0
20150106.090033,2870,218,739210,-20,2870,679,2871,57,0
20150106.090034,2870,1312,740522,220,2870,30,2871,166,0
20150106.090034,2870,84,740606,20,2869,576,2870,3,0
20150106.090035,2870,66,740672,18,2870,194,2871,292,0
20150106.090035,2870,590,741262,-124,2870,16,2871,416,0
20150106.090036,2869,56,741318,0,2869,534,2870,59,0
20150106.090036,2870,266,741584,78,2869,524,2870,14,1
20150106.090037,2870,70,741654,-32,2870,1067,2871,524,1
20150106.090038,2871,264,741918,-26,2870,980,2871,440,1
20150106.090038,2871,218,742136,188,2870,983,2871,340,1
20150106.090039,2870,90,742226,-80,2870,1016,2871,415,0
20150106.090039,2871,702,742928,234,2870,977,2871,109,1
20150106.09004,2870,670,743598,-512,2870,774,2872,794,0
20150106.09004,2870,136,743734,-120,2870,237,2871,4,0
20150106.09004,2870,26,743760,14,2870,233,2871,37,0
20150106.090041,2872,292,744052,-90,2871,440,2872,950,1
20150106.090041,2871,324,744376,-46,2871,391,2872,844,0
20150106.090042,2871,328,744704,-204,2871,350,2872,842,0
20150106.090043,2871,304,745008,-18,2871,319,2872,640,0
20150106.090043,2872,1092,746100,-242,2871,293,2873,158,1
20150106.090044,2872,396,746496,-266,2872,60,2873,158,1
20150106.090044,2872,52,746548,-4,2872,318,2873,146,1
20150106.090045,2872,114,746662,-2,2872,310,2873,149,1
20150106.090045,2872,234,746896,-52,2872,404,2873,109,1
20150106.090046,2872,102,746998,-4,2872,402,2873,80,1
20150106.090046,2873,42,747040,-12,2872,384,2873,101,1
20150106.090047,2873,966,748006,-540,2872,16,2873,472,1
20150106.090047,2872,304,748310,-218,2871,306,2872,1,0
20150106.090048,2872,92,748402,-34,2872,41,2873,433,0
20150106.090048,2870,1162,749564,556,2870,19,2872,2,0
20150106.090049,2872,24,749588,18,2870,71,2871,11,1
20150106.090049,2871,144,749732,-54,2870,63,2871,256,0
20150106.09005,2871,1092,750824,-398,2871,2,2872,970,0
20150106.090051,2871,118,750942,-46,2871,33,2872,953,0
20150106.090051,2870,110,751052,-60,2870,111,2871,6,0
20150106.090052,2870,252,751304,-134,2871,2,2872,1001,0
20150106.090052,2871,138,751442,-16,2871,438,2872,1065,1
20150106.090053,2871,236,751678,-106,2871,413,2872,954,1
20150106.090053,2872,126,751804,-36,2871,374,2872,955,1
20150106.090054,2872,64,751868,8,2871,362,2872,952,1
20150106.090054,2870,766,752634,-372,2870,160,2871,150,0
20150106.090055,2870,100,752734,-74,2870,211,2871,155,0
20150106.090055,2871,2068,754802,36,2871,93,2872,332,1
20150106.090056,2871,244,755046,-34,2870,283,2871,46,1
20150106.090056,2871,528,755574,-182,2871,244,2872,536,1
20150106.090057,2871,350,755924,-334,2871,72,2872,578,1
20150106.090057,2871,26,755950,-14,2871,169,2872,592,1
20150106.090058,2871,150,756100,-140,2871,96,2872,651,1
20150106.090058,2871,200,756300,-144,2870,298,2871,79,1
20150106.090059,2871,78,756378,-4,2870,285,2871,68,1
20150106.090059,2871,116,756494,-4,2870,787,2871,330,1
20150106.0901,2871,284,756778,274,2870,648,2871,510,1
20150106.090101,2871,78,756856,-26,2870,643,2871,528,1
20150106.090101,2870,42,756898,22,2870,639,2871,523,0
20150106.090102,2871,72,756970,66,2870,1463,2871,539,1
20150106.090102,2871,652,757622,140,2870,1477,2871,44,1
20150106.090103,2871,252,757874,-146,2871,227,2872,827,1
20150106.090103,2871,10,757884,-10,2871,225,2872,816,1
20150106.090104,2872,92,757976,-56,2871,904,2872,768,1
20150106.090104,2871,282,758258,78,2871,770,2872,751,0
20150106.090105,2872,94,758352,-64,2871,740,2872,793,1
20150106.090105,2872,30,758382,-8,2871,741,2872,799,1
20150106.090106,2871,80,758462,-50,2871,708,2872,792,0
20150106.090106,2871,546,759008,-134,2871,441,2872,819,0
20150106.090107,2871,886,759894,90,2870,1014,2872,644,0
20150106.090107,2870,8,759902,-8,2870,1014,2871,15,0
20150106.090108,2871,36,759938,-12,2870,1004,2871,57,1
20150106.090108,2871,76,760014,0,2870,972,2871,190,1
20150106.090109,2870,122,760136,-62,2870,917,2871,383,0
20150106.090109,2871,1292,761428,-406,2870,795,2871,1,1
20150106.09011,2870,164,761592,106,2870,793,2871,31,0
20150106.09011,2871,134,761726,-92,2870,774,2871,272,1
20150106.090111,2871,144,761870,54,2870,750,2871,230,1
20150106.090111,2871,56,761926,6,2870,715,2871,350,1
20150106.090112,2871,6,761932,4,2870,716,2871,369,1
20150106.090112,2871,868,762800,-132,2871,100,2872,1343,1
20150106.090113,2870,420,763220,-64,2870,668,2871,6,0
20150106.090113,2870,96,763316,10,2870,666,2871,75,0
20150106.090114,2870,24,763340,-14,2870,658,2871,94,0
20150106.090114,2870,24,763364,4,2870,675,2871,100,0
20150106.090115,2871,20,763384,-12,2870,668,2871,164,1
20150106.090115,2870,64,763448,-4,2870,656,2871,200,0
20150106.090116,2871,290,763738,-44,2870,654,2871,252,1
20150106.090116,2870,22,763760,-2,2870,661,2871,247,0
20150106.090117,2870,1664,765424,-1152,2870,349,2871,222,0
20150106.090117,2871,116,765540,6,2870,340,2871,212,1
20150106.090118,2870,68,765608,-16,2870,329,2871,209,0
20150106.090118,2870,84,765692,-2,2870,348,2871,243,0
20150106.090119,2870,698,766390,204,2869,595,2870,652,0
20150106.090119,2870,86,766476,4,2869,582,2870,1131,0
20150106.09012,2869,12,766488,0,2869,519,2870,1134,0
20150106.09012,2869,194,766682,70,2869,413,2870,1214,0
20150106.090121,2869,124,766806,120,2869,402,2870,1145,0
20150106.090121,2869,100,766906,28,2869,352,2870,1164,0
20150106.090122,2869,130,767036,10,2869,298,2870,1169,0
20150106.090122,2869,94,767130,36,2869,278,2870,1162,0
20150106.090123,2869,94,767224,22,2869,237,2870,1156,0
20150106.090123,2869,58,767282,4,2869,208,2870,1158,0
20150106.090124,2869,180,767462,102,2869,182,2870,1101,0
20150106.090124,2869,54,767516,12,2869,157,2870,1112,0
20150106.090125,2870,92,767608,20,2869,132,2870,1121,1
20150106.090125,2867,914,768522,-412,2866,201,2867,3,0
20150106.090126,2866,152,768674,-16,2866,200,2868,152,0
20150106.090126,2866,2,768676,-2,2867,1,2868,153,0
20150106.090127,2868,1192,769868,-694,2868,72,2869,67,1
20150106.090128,2868,94,769962,-32,2868,115,2869,175,1
20150106.090128,2869,1046,771008,-212,2869,6,2870,731,1
20150106.090129,2869,262,771270,-112,2868,93,2869,42,1
20150106.090129,2868,118,771388,-4,2868,124,2869,78,0
20150106.09013,2868,262,771650,-222,2867,329,2868,413,0
20150106.09013,2868,4,771654,0,2867,328,2868,427,0
20150106.090131,2867,4,771658,-4,2867,328,2868,461,0
20150106.090131,2868,1046,772704,-834,2868,7,2869,414,1
20150106.090132,2868,428,773132,-118,2867,791,2868,19,1
20150106.090132,2867,142,773274,-42,2867,792,2869,262,0
20150106.090133,2867,144,773418,-126,2867,727,2868,11,0
20150106.090133,2868,58,773476,-10,2867,724,2868,519,1
20150106.090134,2867,48,773524,6,2867,686,2868,552,0
20150106.090134,2868,264,773788,-238,2867,556,2868,551,1
20150106.090135,2867,30,773818,-22,2867,542,2868,572,0
20150106.090135,2867,230,774048,-216,2867,429,2868,583,0
20150106.090136,2867,106,774154,-104,2867,393,2868,589,0
20150106.090136,2868,80,774234,-6,2867,392,2868,545,1
20150106.090137,2867,212,774446,-168,2867,334,2868,553,0
20150106.090137,2867,228,774674,-82,2867,318,2868,568,0
20150106.090138,2867,62,774736,-30,2867,494,2868,552,0
20150106.090138,2867,30,774766,-8,2867,480,2868,667,0
20150106.090139,2867,704,775470,-636,2867,128,2868,668,0
20150106.090139,2867,16,775486,-2,2867,126,2868,675,0
20150106.09014,2867,254,775740,-46,2866,572,2867,912,0
20150106.09014,2866,114,775854,-10,2866,565,2867,3,0
20150106.09014,2867,20,775874,-16,2866,556,2867,21,1
20150106.090141,2866,40,775914,-36,2866,537,2867,53,0
20150106.090141,2866,266,776180,-88,2866,436,2867,38,0
20150106.090142,2866,20,776200,0,2866,426,2867,348,0
20150106.090143,2866,920,777120,24,2865,237,2866,498,0
20150106.090143,2865,32,777152,0,2865,224,2866,534,0
20150106.090144,2866,180,777332,166,2865,218,2866,537,1
20150106.090144,2865,42,777374,-2,2865,208,2866,649,0
20150106.090145,2865,28,777402,-16,2865,197,2866,645,0
20150106.090145,2865,58,777460,-22,2865,177,2866,645,0
20150106.090146,2865,26,777486,4,2865,168,2866,658,0
20150106.090146,2865,40,777526,-12,2865,172,2866,675,0
20150106.090147,2866,108,777634,-46,2865,129,2866,570,1
20150106.090147,2865,360,777994,-20,2865,50,2866,561,0
20150106.090148,2865,122,778116,-30,2864,103,2865,7,0
20150106.090148,2865,144,778260,6,2865,29,2866,596,0
20150106.090149,2865,140,778400,-126,2865,58,2866,601,0
20150106.090149,2865,374,778774,86,2864,126,2865,574,0
20150106.09015,2865,32,778806,-2,2864,166,2865,692,0
20150106.09015,2864,14,778820,-10,2864,161,2865,798,0
20150106.090151,2864,56,778876,-10,2864,145,2865,814,0
20150106.090151,2864,8,778884,-2,2864,142,2865,824,0
20150106.090152,2864,130,779014,-80,2864,62,2865,841,0
20150106.090152,2864,152,779166,32,2863,264,2864,109,0
20150106.090153,2865,348,779514,-174,2863,216,2865,873,1
20150106.090153,2863,20,779534,-12,2863,243,2864,2,0
20150106.090154,2863,328,779862,-52,2863,86,2865,902,0
20150106.090154,2862,460,780322,150,2863,25,2864,72,0
20150106.090155,2863,58,780380,-34,2862,1134,2864,215,1
20150106.090155,2863,272,780652,-144,2863,18,2864,247,1
20150106.090156,2864,70,780722,-2,2863,403,2864,246,1
20150106.090156,2863,104,780826,46,2863,392,2864,293,0
20150106.090157,2864,584,781410,-122,2864,19,2865,1051,1
20150106.090157,2863,256,781666,172,2863,324,2865,1131,0
20150106.090158,2863,48,781714,2,2863,303,2864,154,0
20150106.090158,2864,320,782034,-206,2863,275,2864,404,1
20150106.090159,2863,16,782050,-6,2863,307,2864,509,0
20150106.090159,2864,68,782118,-48,2863,301,2864,498,1
20150106.0902,2863,48,782166,-4,2863,291,2864,549,0
20150106.0902,2864,60,782226,-22,2863,286,2864,540,1
20150106.090201,2863,222,782448,128,2863,123,2864,465,0
20150106.090201,2864,80,782528,-58,2863,104,2864,464,1
20150106.090202,2863,222,782750,-70,2863,4,2864,492,0
20150106.090202,2863,74,782824,-14,2862,1087,2863,86,0
20150106.090203,2862,192,783016,-10,2862,1097,2863,13,0
20150106.090203,2863,66,783082,-38,2863,206,2864,579,1
20150106.090204,2863,162,783244,-28,2863,183,2864,524,1
20150106.090204,2863,52,783296,-42,2863,170,2864,566,1
20150106.090205,2863,128,783424,-56,2863,110,2864,568,1
20150106.090205,2863,22,783446,-10,2863,105,2864,570,1
20150106.090206,2863,232,783678,-200,2862,1102,2863,649,1
20150106.090206,2863,26,783704,-14,2862,1116,2863,675,1
20150106.090207,2863,2,783706,0,2862,1126,2863,714,1
20150106.090207,2863,254,783960,-234,2862,1247,2863,557,1
20150106.090208,2862,762,784722,214,2862,1241,2863,185,0
20150106.090208,2863,630,785352,196,2863,194,2864,433,1
20150106.090209,2863,1056,786408,-440,2862,1243,2863,1,1
20150106.090209,2863,30,786438,14,2863,23,2864,174,1
20150106.09021,2863,76,786514,22,2863,85,2864,207,1
20150106.09021,2863,106,786620,6,2863,200,2864,186,1
20150106.090211,2864,34,786654,6,2863,192,2864,193,1
20150106.090211,2864,34,786688,18,2863,194,2864,252,1
20150106.090212,2863,650,787338,524,2862,1469,2863,45,0
20150106.090212,2863,136,787474,-120,2862,1425,2863,113,0
20150106.090213,2863,72,787546,-68,2862,1419,2863,90,0
20150106.090213,2862,10,787556,-6,2862,1425,2863,16,0
20150106.090214,2863,6,787562,-4,2862,1342,2863,16,1
20150106.090214,2863,38,787600,10,2863,3,2864,387,1
20150106.090215,2863,298,787898,-150,2863,7,2864,466,1
20150106.090215,2863,108,788006,-4,2862,1281,2863,4,1
20150106.090216,2862,178,788184,-44,2862,1195,2863,112,0
20150106.090217,2862,32,788216,-12,2862,1190,2863,150,0
20150106.090217,2863,224,788440,-216,2862,1097,2863,297,1
20150106.090217,2863,78,788518,-74,2862,1068,2863,401,1
20150106.090218,2862,56,788574,-10,2862,1065,2863,478,0
20150106.090218,2862,68,788642,-68,2862,1040,2863,548,0
20150106.090219,2862,24,788666,-22,2862,1039,2863,546,0
20150106.09022,2862,14,788680,-4,2862,1035,2863,568,0
20150106.09022,2862,822,789502,-410,2862,635,2863,584,0
20150106.090221,2862,70,789572,-24,2862,610,2863,581,0
20150106.090221,2862,1224,790796,-146,2861,1556,2862,565,0
20150106.090222,2861,32,790828,-26,2861,1480,2862,601,0
20150106.090222,2862,384,791212,0,2861,1377,2862,617,1
20150106.090223,2861,2,791214,-2,2861,1378,2862,659,0
20150106.090223,2861,136,791350,-22,2861,1401,2862,567,0
20150106.090224,2861,24,791374,-6,2861,1445,2862,559,0
20150106.090224,2862,36,791410,-34,2861,1457,2862,546,1
20150106.090225,2861,228,791638,-28,2861,1452,2862,451,0
20150106.090225,2862,340,791978,-32,2861,1443,2862,304,1
20150106.090225,2862,618,792596,-572,2862,187,2863,380,1
20150106.090226,2862,324,792920,-128,2862,127,2863,330,1
20150106.090227,2862,52,792972,-6,2862,334,2863,332,1
20150106.090227,2863,114,793086,50,2862,343,2863,289,1
20150106.090228,2862,72,793158,-30,2862,259,2863,320,0
20150106.090228,2862,18,793176,-6,2862,250,2863,327,0
20150106.090229,2862,138,793314,-122,2862,332,2863,296,0
20150106.090229,2862,136,793450,38,2862,298,2863,217,0
20150106.09023,2862,216,793666,134,2862,195,2863,316,0
20150106.090231,2862,144,793810,0,2862,223,2863,271,0
20150106.090231,2862,54,793864,6,2862,221,2863,272,0
20150106.090232,2862,84,793948,58,2862,190,2863,368,0
20150106.090232,2862,18,793966,6,2862,182,2863,371,0
20150106.090233,2863,46,794012,2,2862,260,2863,363,1
20150106.090233,2862,316,794328,-8,2862,288,2863,363,0
20150106.090233,2862,46,794374,36,2862,351,2863,364,0
20150106.090234,2862,338,794712,124,2862,334,2863,336,0
20150106.090235,2862,42,794754,-2,2862,330,2863,410,0
20150106.090236,2862,86,794840,-26,2862,295,2863,391,0
20150106.090236,2862,132,794972,-114,2862,254,2863,387,0
20150106.090237,2862,44,795016,-6,2862,245,2863,373,0
20150106.090237,2862,184,795200,12,2862,211,2863,315,0
20150106.090238,2862,22,795222,4,2862,239,2863,318,0
20150106.090238,2863,78,795300,-58,2862,258,2863,294,1
20150106.090239,2862,6,795306,2,2862,258,2863,289,0
20150106.090239,2862,44,795350,4,2862,243,2863,284,0
20150106.09024,2863,2,795352,0,2862,243,2863,284,1
20150106.09024,2862,482,795834,-52,2861,1410,2863,318,0
20150106.090241,2862,470,796304,-392,2861,1441,2862,102,0
20150106.090241,2862,6,796310,-2,2861,1441,2862,403,0
20150106.090242,2861,14,796324,-4,2861,1440,2862,489,0
20150106.090243,2862,34,796358,-20,2861,1479,2862,641,1
20150106.090243,2862,102,796460,0,2861,1481,2862,650,1
20150106.090244,2862,22,796482,-22,2861,1476,2862,695,1
20150106.090244,2862,20,796502,-20,2861,1477,2862,690,1
20150106.090245,2862,104,796606,-74,2861,1429,2862,692,1
20150106.090245,2861,206,796812,-196,2861,1326,2862,702,0
20150106.090246,2861,20,796832,-6,2861,1319,2862,1062,0
20150106.090246,2861,40,796872,-16,2861,1301,2862,1065,0
20150106.090247,2862,84,796956,-68,2861,1289,2862,1048,1
20150106.090247,2861,22,796978,-8,2861,1278,2862,1008,0
20150106.090248,2861,186,797164,-180,2861,1160,2862,1077,0
20150106.090248,2861,3302,800466,-706,2860,1275,2861,382,0
20150106.090249,2860,12,800478,-10,2860,1228,2861,476,0
20150106.090249,2860,58,800536,-46,2860,1264,2861,748,0
20150106.09025,2860,144,800680,-94,2860,1212,2861,733,0
20150106.09025,2860,288,800968,-258,2860,1097,2861,777,0
20150106.090251,2860,228,801196,-226,2860,986,2861,777,0
20150106.090251,2861,118,801314,-48,2860,955,2861,730,1
20150106.090252,2860,44,801358,-10,2860,934,2861,789,0
20150106.090252,2860,36,801394,0,2860,919,2861,793,0
20150106.090253,2860,122,801516,6,2860,862,2861,796,0
20150106.090253,2860,34,801550,20,2860,855,2861,795,0
20150106.090254,2860,74,801624,-34,2860,821,2861,798,0
20150106.090254,2860,56,801680,0,2860,802,2861,794,0
20150106.090255,2860,66,801746,-2,2860,782,2861,785,0
20150106.090255,2860,172,801918,-10,2860,735,2861,759,0
20150106.090256,2860,62,801980,-30,2860,708,2861,763,0
20150106.090256,2861,2100,804080,-1226,2861,270,2862,510,1
20150106.090257,2861,160,804240,-70,2861,234,2862,474,1
20150106.090258,2861,216,804456,-68,2861,129,2862,469,1
20150106.090258,2862,1062,805518,-398,2862,515,2863,437,1
20150106.090259,2862,584,806102,76,2863,24,2864,511,1
20150106.090259,2863,52,806154,-16,2862,549,2864,418,1
20150106.0903,2863,110,806264,34,2863,99,2864,470,1
20150106.0903,2863,1018,807282,78,2862,148,2863,136,1
20150106.090301,2862,110,807392,0,2862,53,2863,172,0
20150106.090301,2863,6,807398,0,2862,155,2863,227,1
20150106.090302,2862,22,807420,0,2862,224,2863,228,0
20150106.090302,2862,470,807890,-414,2862,330,2864,575,0
20150106.090303,2862,8,807898,-4,2862,367,2863,1,0
20150106.090303,2863,4,807902,0,2863,6,2864,575,1
20150106.090304,2862,180,808082,-94,2862,325,2864,569,0
20150106.090304,2862,18,808100,0,2862,397,2864,635,0
20150106.090305,2863,26,808126,26,2862,445,2863,20,1
20150106.090305,2863,114,808240,24,2863,1,2864,622,1
20150106.090305,2862,270,808510,-6,2862,371,2863,1,0
20150106.090306,2863,100,808610,36,2863,1,2864,603,1
20150106.090307,2862,272,808882,-132,2862,406,2864,603,0
20150106.090307,2862,62,808944,-20,2862,374,2864,600,0
20150106.090308,2863,6,808950,0,2862,377,2863,5,1
20150106.090308,2862,52,809002,-6,2862,371,2863,96,0
20150106.090309,2863,6,809008,-4,2862,350,2863,100,1
20150106.090309,2862,12,809020,-12,2862,363,2863,100,0
20150106.09031,2863,24,809044,-14,2862,431,2863,156,1
20150106.09031,2862,10,809054,-2,2862,425,2863,156,0
20150106.090311,2862,16,809070,-4,2862,440,2863,166,0
20150106.090311,2863,2004,811074,-916,2863,81,2864,85,1
20150106.090312,2863,722,811796,-174,2862,286,2863,22,1
20150106.090312,2863,96,811892,16,2863,39,2864,102,1
20150106.090313,2864,24,811916,10,2863,95,2864,114,1
20150106.090313,2864,454,812370,-420,2864,780,2865,902,1
20150106.090314,2864,212,812582,-140,2864,686,2865,898,1
20150106.090314,2864,16,812598,-2,2864,677,2865,977,1
20150106.090314,2864,318,812916,-304,2864,522,2865,953,1
20150106.090315,2864,42,812958,-24,2864,503,2865,978,1
20150106.090316,2864,42,813000,-14,2864,483,2865,870,1
20150106.090316,2864,4,813004,-2,2864,481,2865,881,1
20150106.090317,2864,14,813018,-4,2864,474,2865,881,1
20150106.090317,2864,8,813026,2,2864,474,2865,878,1
20150106.090318,2864,70,813096,2,2864,441,2865,877,1
20150106.090318,2864,8,813104,-2,2864,437,2865,878,1
20150106.090319,2864,628,813732,-276,2864,128,2865,886,1
20150106.090319,2864,280,814012,-256,2863,555,2864,212,1
20150106.09032,2863,2,814014,0,2863,555,2864,214,0
20150106.09032,2863,72,814086,-24,2863,524,2864,184,0
20150106.090321,2863,8,814094,-2,2863,524,2864,190,0
20150106.090321,2864,402,814496,-294,2864,799,2865,906,1
20150106.090322,2864,80,814576,-2,2864,827,2865,880,1
20150106.090322,2864,20,814596,-18,2864,817,2865,880,1
20150106.090323,2864,18,814614,-12,2864,810,2865,947,1
20150106.090323,2864,114,814728,-18,2864,771,2865,1015,1
20150106.090324,2864,1240,815968,-1202,2864,149,2865,1035,1
20150106.090324,2863,300,816268,50,2863,525,2864,222,0
20150106.090325,2864,22,816290,6,2863,519,2864,104,1
20150106.090325,2863,8,816298,-2,2863,527,2864,171,0
20150106.090326,2864,348,816646,-60,2864,829,2865,1093,1
20150106.090326,2865,268,816914,56,2864,731,2865,1045,1
20150106.090327,2864,18,816932,6,2864,729,2865,981,0
20150106.090327,2864,10,816942,-6,2864,784,2865,995,0
20150106.090328,2864,6,816948,-2,2864,782,2865,996,0
20150106.090328,2864,8,816956,-2,2864,810,2865,995,0
20150106.090329,2865,16,816972,6,2864,811,2865,989,1
20150106.090329,2864,14,816986,-14,2864,806,2865,997,0
20150106.09033,2864,4,816990,0,2864,805,2865,1000,0
20150106.09033,2865,2208,819198,-266,2865,166,2866,690,1
20150106.090331,2865,10,819208,2,2865,172,2866,663,1
20150106.090331,2866,64,819272,12,2865,259,2866,698,1
20150106.090332,2866,284,819556,-48,2865,196,2866,680,1
20150106.090332,2866,6,819562,0,2865,220,2866,726,1
20150106.090333,2865,830,820392,-680,2864,680,2865,137,0
20150106.090333,2864,304,820696,-204,2864,665,2865,37,0
20150106.090334,2864,6,820702,-2,2864,659,2865,88,0
20150106.090334,2865,2,820704,0,2864,764,2865,192,1
20150106.090335,2865,94,820798,-62,2864,861,2865,152,1
20150106.090335,2865,8,820806,0,2864,861,2865,162,1
20150106.090336,2865,20,820826,0,2864,864,2865,160,1
20150106.090336,2864,304,821130,98,2864,763,2865,113,0
20150106.090337,2864,56,821186,44,2864,764,2865,126,0
20150106.090337,2865,26,821212,-14,2864,754,2865,136,1
20150106.090338,2865,8,821220,4,2864,761,2865,144,1
20150106.090338,2865,6,821226,-2,2864,776,2865,143,1
20150106.090339,2864,36,821262,-4,2864,788,2865,439,0
20150106.09034,2865,280,821542,-90,2864,758,2865,413,1
20150106.09034,2864,82,821624,36,2864,754,2865,387,0
20150106.090341,2865,426,822050,400,2864,751,2865,268,1
20150106.090341,2865,42,822092,38,2864,750,2865,254,1
20150106.090342,2864,10,822102,2,2864,748,2865,170,0
20150106.090342,2865,130,822232,-4,2864,746,2865,111,1
20150106.090343,2865,274,822506,-250,2865,279,2866,563,1
20150106.090344,2865,108,822614,-8,2865,227,2866,564,1
20150106.090344,2865,250,822864,-16,2865,15,2866,566,1
20150106.090345,2865,38,822902,0,2865,496,2866,567,1
20150106.090345,2865,58,822960,0,2865,489,2866,563,1
20150106.090346,2866,8,822968,0,2865,497,2866,563,1
20150106.090346,2866,62,823030,4,2865,496,2866,537,1
20150106.090347,2865,24,823054,0,2865,484,2866,537,0
20150106.090347,2865,18,823072,-8,2865,476,2866,537,0
20150106.090348,2865,210,823282,-6,2865,374,2866,536,0
20150106.090348,2866,4,823286,0,2865,381,2866,534,1
20150106.090349,2865,120,823406,-112,2865,325,2866,536,0
20150106.090349,2865,4,823410,-2,2865,382,2866,636,0
20150106.09035,2865,4,823414,-2,2865,380,2866,636,0
20150106.09035,2865,6,823420,-6,2865,375,2866,641,0
20150106.090351,2865,14,823434,0,2865,372,2866,644,0
20150106.090351,2865,38,823472,-6,2865,361,2866,642,0
20150106.090351,2866,34,823506,0,2865,335,2866,646,1
20150106.090352,2865,838,824344,-96,2865,248,2866,345,0
20150106.090352,2865,8,824352,-2,2865,247,2866,343,0
20150106.090353,2865,838,825190,506,2865,320,2866,97,0
20150106.090353,2866,194,825384,102,2865,300,2866,2,1
20150106.090354,2866,34,825418,10,2865,300,2866,76,1
20150106.090355,2865,78,825496,-30,2865,277,2866,84,0
20150106.090355,2865,300,825796,-134,2865,143,2866,146,0
20150106.090356,2865,10,825806,6,2865,179,2866,231,0
20150106.090357,2866,556,826362,-186,2866,246,2867,492,1
20150106.090357,2866,10,826372,-4,2866,331,2867,423,1
20150106.090358,2866,6,826378,-6,2866,330,2867,423,1
20150106.090358,2867,16,826394,-12,2866,317,2867,422,1
20150106.090359,2866,6,826400,-4,2866,314,2867,441,0
20150106.090359,2866,4,826404,0,2866,312,2867,441,0
20150106.0904,2866,10,826414,-2,2866,320,2867,442,0
20150106.0904,2866,44,826458,-38,2866,300,2867,423,0
20150106.090401,2867,218,826676,-6,2866,298,2867,318,1
20150106.090401,2866,50,826726,-38,2866,339,2867,301,0
20150106.090402,2866,102,826828,0,2866,339,2867,353,0
20150106.090402,2867,108,826936,-2,2866,289,2867,314,1
20150106.090403,2867,214,827150,-204,2866,293,2867,208,1
20150106.090403,2867,60,827210,-60,2866,293,2867,325,1
20150106.090404,2867,288,827498,-278,2866,139,2867,332,1
20150106.090404,2866,292,827790,-164,2865,452,2866,50,0
20150106.090405,2866,2,827792,0,2865,353,2866,151,0
20150106.090405,2866,6,827798,6,2865,352,2866,206,0
20150106.090406,2866,18,827816,4,2865,352,2866,198,0
20150106.090406,2866,22,827838,2,2865,352,2866,189,0
20150106.090407,2866,10,827848,8,2865,354,2866,230,0
20150106.090407,2866,2,827850,0,2865,354,2866,233,0
20150106.090408,2866,510,828360,-42,2866,331,2867,1040,0
20150106.090408,2866,104,828464,-2,2866,330,2867,914,0
20150106.090409,2866,36,828500,-22,2866,365,2867,918,0
20150106.090409,2866,26,828526,-22,2866,373,2867,927,0
20150106.09041,2866,40,828566,0,2866,307,2867,927,0
20150106.09041,2866,420,828986,-382,2866,104,2867,978,0
20150106.090411,2866,310,829296,-16,2865,355,2866,8,0
20150106.090411,2866,16,829312,4,2865,360,2866,7,0
20150106.090412,2866,28,829340,2,2865,361,2866,69,0
20150106.090412,2865,60,829400,16,2865,346,2866,98,0
20150106.090413,2866,8,829408,0,2865,349,2866,141,1
20150106.090413,2866,514,829922,32,2866,387,2867,952,1
20150106.090414,2866,8,829930,-6,2866,464,2867,954,1
20150106.090415,2866,322,830252,-92,2866,498,2867,812,1
20150106.090415,2866,534,830786,-6,2866,236,2867,824,1
20150106.090416,2866,250,831036,34,2866,64,2867,793,1
20150106.090416,2865,186,831222,-128,2865,279,2866,28,0
20150106.090417,2866,2,831224,-2,2865,279,2866,64,1
20150106.090417,2865,2,831226,-2,2865,279,2866,77,0
20150106.090418,2866,802,832028,-664,2865,279,2867,642,1
20150106.090418,2866,4,832032,0,2865,280,2866,1,1
20150106.090419,2866,188,832220,-2,2866,84,2867,634,1
20150106.090419,2866,12,832232,10,2866,88,2867,588,1
20150106.09042,2867,860,833092,-716,2867,177,2868,1371,1
20150106.09042,2867,368,833460,-228,2866,920,2867,52,1
20150106.090421,2866,20,833480,20,2866,831,2867,56,0
20150106.090421,2867,58,833538,-38,2866,876,2867,131,1
20150106.090422,2867,8,833546,-4,2866,1178,2867,204,1
20150106.090423,2866,174,833720,-134,2866,1128,2867,232,0
20150106.090423,2866,14,833734,4,2866,1127,2867,230,0
20150106.090423,2867,16,833750,-4,2866,1124,2867,225,1
20150106.090424,2867,42,833792,4,2866,1118,2867,566,1
20150106.090425,2866,18,833810,-10,2866,1111,2867,577,0
20150106.090425,2866,4,833814,0,2866,631,2867,576,0
20150106.090426,2866,220,834034,-4,2866,521,2867,589,0
20150106.090426,2867,20,834054,0,2866,520,2867,654,1
20150106.090427,2867,4,834058,2,2866,518,2867,673,1
20150106.090427,2866,100,834158,0,2866,470,2867,774,0
20150106.090428,2866,22,834180,0,2866,469,2867,765,0
20150106.090429,2866,4,834184,-4,2866,467,2867,839,0
20150106.090429,2867,4,834188,4,2866,976,2867,842,1
20150106.09043,2866,44,834232,0,2866,974,2867,822,0
20150106.09043,2866,76,834308,0,2866,936,2867,838,0
20150106.090431,2867,12,834320,0,2866,931,2867,837,1
20150106.090431,2866,30,834350,0,2866,923,2867,876,0
20150106.090432,2866,6,834356,0,2866,920,2867,876,0
20150106.090432,2866,104,834460,-100,2866,869,2867,867,0
20150106.090433,2867,8,834468,4,2866,867,2867,869,1
20150106.090433,2866,8,834476,2,2866,865,2867,867,0
20150106.090434,2866,12,834488,-8,2866,858,2867,884,0
20150106.090434,2867,364,834852,-62,2866,784,2867,782,1
20150106.090435,2866,616,835468,-584,2866,490,2867,789,0
20150106.090435,2866,14,835482,-10,2866,484,2867,792,0
20150106.090436,2866,16,835498,0,2866,476,2867,798,0
20150106.090436,2866,8,835506,-8,2866,474,2867,859,0
20150106.090437,2866,12,835518,-10,2866,468,2867,853,0
20150106.090437,2866,24,835542,-10,2866,458,2867,859,0
20150106.090438,2866,14,835556,-10,2866,457,2867,861,0
20150106.090438,2866,204,835760,-200,2866,365,2867,877,0
20150106.090439,2866,148,835908,-44,2866,444,2867,827,0
20150106.090439,2866,2,835910,0,2866,449,2867,827,0
20150106.09044,2866,30,835940,-14,2866,624,2867,643,0
20150106.09044,2866,80,836020,-24,2866,593,2867,643,0
20150106.090441,2866,14,836034,-10,2866,596,2867,644,0
20150106.090441,2866,112,836146,-4,2866,577,2867,645,0
20150106.090442,2867,10,836156,-2,2866,592,2867,635,1
20150106.090442,2866,90,836246,-46,2866,525,2867,615,0
20150106.090443,2867,6,836252,-4,2866,393,2867,615,1
20150106.090443,2866,18,836270,-6,2866,453,2867,621,0
20150106.090444,2866,4,836274,0,2866,451,2867,621,0
20150106.090444,2867,8,836282,-2,2866,571,2867,621,1
20150106.090445,2867,1310,837592,-954,2866,521,2867,22,1
20150106.090445,2867,82,837674,-12,2867,126,2868,1617,1
20150106.090446,2868,40,837714,-34,2867,151,2868,1611,1
20150106.090447,2867,10,837724,-4,2867,325,2868,1473,0
20150106.090448,2868,28,837752,-22,2867,345,2868,1473,1
20150106.090448,2867,22,837774,-4,2867,405,2868,1470,0
20150106.090449,2867,10,837784,-6,2867,906,2868,1465,0
20150106.090449,2867,138,837922,-20,2867,857,2868,1465,0
20150106.090449,2867,12,837934,0,2867,849,2868,1474,0
20150106.09045,2867,14,837948,14,2867,845,2868,1497,0
20150106.090451,2867,88,838036,56,2867,804,2868,1494,0
20150106.090451,2868,10,838046,-8,2867,804,2868,1499,1
20150106.090452,2867,12,838058,-6,2867,801,2868,1404,0
20150106.090453,2868,122,838180,-118,2867,754,2868,1357,1
20150106.090453,2867,2,838182,-2,2867,773,2868,1398,0
20150106.090454,2867,6,838188,-4,2867,750,2868,1477,0
20150106.090454,2867,20,838208,-14,2867,742,2868,1442,0
20150106.090455,2867,616,838824,-544,2867,435,2868,1482,0
20150106.090455,2868,24,838848,-2,2867,439,2868,1460,1
20150106.090455,2867,6,838854,-6,2867,437,2868,1460,0
20150106.090456,2867,54,838908,-50,2867,418,2868,1471,0
20150106.090457,2868,6,838914,-2,2867,598,2868,1467,1
20150106.090457,2867,6,838920,-4,2867,595,2868,1468,0
20150106.090458,2867,24,838944,-14,2867,583,2868,1469,0
20150106.090458,2868,1606,840550,-522,2867,593,2868,666,1
20150106.090459,2869,1544,842094,298,2868,249,2869,440,1
20150106.090459,2869,60,842154,20,2868,227,2869,432,1
20150106.0905,2868,222,842376,2,2868,234,2869,460,0
20150106.0905,2869,434,842810,186,2868,239,2869,282,1
20150106.090501,2869,560,843370,354,2869,4,2870,2034,1
20150106.090501,2869,12,843382,6,2869,69,2870,1984,1
20150106.090502,2869,20,843402,-2,2869,84,2870,2033,1
20150106.090502,2870,46,843448,0,2869,78,2870,2036,1
20150106.090503,2869,146,843594,6,2869,120,2870,1979,0
20150106.090503,2869,12,843606,-10,2869,135,2870,1974,0
20150106.090504,2869,82,843688,-46,2869,99,2870,1986,0
20150106.090504,2870,102,843790,8,2869,62,2870,1957,1
20150106.090505,2870,22,843812,-2,2869,124,2870,1956,1
20150106.090505,2870,60,843872,-4,2869,112,2870,1942,1
20150106.090506,2869,4,843876,2,2869,122,2870,2965,0
20150106.090506,2869,2,843878,0,2869,121,2870,2965,0
20150106.090507,2869,238,844116,-134,2869,100,2870,2964,0
20150106.090507,2869,90,844206,8,2869,189,2870,2961,0
20150106.090508,2869,218,844424,-2,2869,586,2870,2963,0
20150106.090508,2869,14,844438,-4,2869,583,2870,2977,0
20150106.090509,2869,6,844444,-4,2869,582,2870,2980,0
20150106.090509,2870,10,844454,0,2869,589,2870,2977,1
20150106.09051,2869,4,844458,0,2869,598,2870,2977,0
20150106.09051,2870,62,844520,0,2869,575,2870,2984,1
20150106.090511,2869,110,844630,-100,2869,523,2870,2990,0
20150106.090512,2869,112,844742,-58,2869,492,2870,3071,0
20150106.090512,2870,78,844820,-30,2869,490,2870,3043,1
20150106.090513,2869,236,845056,-14,2869,475,2870,2946,0
20150106.090513,2869,24,845080,-24,2869,471,2870,2950,0
20150106.090514,2870,18,845098,-16,2869,468,2870,2951,1
20150106.090514,2869,20,845118,-8,2869,467,2870,2948,0
20150106.090515,2869,2,845120,-2,2869,466,2870,2947,0
20150106.090515,2869,102,845222,-66,2869,421,2870,2985,0
20150106.090516,2869,896,846118,-594,2868,586,2869,196,0
20150106.090517,2869,10,846128,10,2868,316,2869,401,0
20150106.090517,2869,12,846140,2,2868,223,2869,450,0
20150106.090518,2869,4,846144,0,2868,221,2869,420,0
20150106.090518,2869,14,846158,6,2868,225,2869,522,0
20150106.090519,2869,2,846160,2,2868,223,2869,521,0
20150106.090519,2868,4,846164,2,2868,225,2869,527,0
20150106.09052,2869,60,846224,0,2868,201,2869,538,1
20150106.09052,2868,56,846280,50,2868,178,2869,533,0
20150106.090521,2869,20,846300,20,2868,178,2869,528,1
20150106.090521,2868,2,846302,2,2868,181,2869,1667,0
20150106.090522,2868,362,846664,-36,2867,654,2868,71,0
20150106.090522,2868,1034,847698,-376,2867,654,2869,1205,0
20150106.090523,2869,4,847702,-2,2868,170,2869,1231,1
20150106.090523,2868,12,847714,0,2868,196,2869,1222,0
20150106.090524,2868,14,847728,-10,2868,252,2869,1181,0
20150106.090525,2868,226,847954,-24,2868,141,2869,1152,0
20150106.090525,2868,2,847956,0,2868,143,2869,1082,0
20150106.090526,2868,8,847964,-4,2868,139,2869,1168,0
20150106.090526,2869,14,847978,-4,2868,139,2869,1164,1
20150106.090527,2868,14,847992,-10,2868,133,2869,1167,0
20150106.090527,2869,254,848246,-54,2868,31,2869,1201,1
20150106.090527,2869,20,848266,-4,2868,32,2869,1228,1
20150106.090528,2868,386,848652,132,2868,80,2869,1169,0
20150106.090529,2869,152,848804,10,2868,155,2869,1108,1
20150106.090529,2869,4012,852816,-2488,2869,2,2870,1495,1
20150106.090529,2870,2224,855040,-598,2869,224,2871,801,1
20150106.09053,2869,140,855180,-64,2869,240,2871,792,0
20150106.090531,2869,94,855274,44,2869,219,2871,794,0
20150106.090531,2870,40,855314,14,2870,25,2871,1102,1
20150106.090532,2869,162,855476,142,2869,291,2870,55,0
20150106.090532,2870,112,855588,110,2870,69,2871,1113,1
20150106.090533,2871,386,855974,114,2869,332,2870,1,1
20150106.090533,2871,58,856032,-20,2870,15,2871,1040,1
20150106.090533,2871,24,856056,-4,2870,17,2871,1036,1
20150106.090534,2870,52,856108,12,2870,20,2871,1020,0
20150106.090535,2870,306,856414,-184,2870,50,2871,1020,0
20150106.090535,2870,4,856418,4,2870,151,2871,1027,0
20150106.090535,2870,26,856444,26,2870,142,2871,1021,0
20150106.090536,2870,100,856544,88,2870,130,2871,992,0
20150106.090537,2870,30,856574,10,2870,118,2871,1001,0
20150106.090537,2870,78,856652,44,2870,96,2871,992,0
20150106.090538,2870,206,856858,-150,2869,219,2870,209,0
20150106.090538,2870,438,857296,-422,2870,158,2871,996,0
20150106.090539,2870,26,857322,-20,2870,146,2871,1007,0
20150106.090539,2871,8,857330,-4,2870,143,2871,1004,1
20150106.090539,2870,86,857416,-68,2870,106,2871,994,0
20150106.09054,2871,22,857438,-12,2870,99,2871,991,1
20150106.090541,2870,266,857704,-144,2870,1,2871,969,0
20150106.090541,2870,6,857710,0,2869,197,2870,57,0
20150106.090542,2870,6,857716,0,2869,196,2870,153,0
20150106.090542,2870,94,857810,28,2869,200,2870,124,0
20150106.090543,2870,28,857838,12,2869,200,2870,163,0
20150106.090543,2870,452,858290,-90,2870,1022,2871,1120,0
20150106.090544,2870,224,858514,-18,2869,225,2870,53,0
20150106.090544,2870,126,858640,8,2869,218,2870,59,0
20150106.090545,2870,148,858788,92,2870,65,2871,1110,0
20150106.090545,2870,132,858920,-102,2869,298,2870,41,0
20150106.090546,2870,92,859012,44,2869,299,2870,46,0
20150106.090546,2871,266,859278,246,2870,56,2871,1097,1
20150106.090547,2870,130,859408,20,2869,301,2870,104,0
20150106.090547,2870,304,859712,186,2869,299,2870,20,0
20150106.090548,2871,74,859786,-8,2870,135,2871,1094,1
20150106.090548,2870,176,859962,140,2870,100,2871,1051,0
20150106.090549,2870,26,859988,26,2870,100,2871,1045,0
20150106.090549,2870,6,859994,0,2870,113,2871,1098,0
20150106.09055,2871,54,860048,-20,2870,102,2871,1092,1
20150106.09055,2870,34,860082,-10,2870,588,2871,1090,0
20150106.090551,2870,10,860092,2,2870,573,2871,1143,0
20150106.090551,2870,2550,862642,952,2870,305,2872,1281,0
20150106.090552,2870,22,862664,-12,2870,388,2871,170,0
20150106.090552,2871,82,862746,50,2870,507,2872,1282,1
20150106.090553,2870,30,862776,0,2870,497,2871,187,0
20150106.090553,2870,4,862780,-2,2870,498,2871,187,0
20150106.090554,2872,562,863342,-254,2871,10,2872,1330,1
20150106.090554,2872,20,863362,-14,2871,130,2872,1292,1
20150106.090555,2872,24,863386,-22,2871,131,2872,1281,1
20150106.090555,2871,8,863394,-8,2871,164,2872,1278,0
20150106.090556,2871,40,863434,-4,2871,166,2872,1264,0
20150106.090556,2872,1668,865102,-416,2871,154,2872,444,1
20150106.090557,2871,126,865228,10,2871,145,2872,396,0
20150106.090557,2871,228,865456,50,2871,128,2872,394,0
20150106.090558,2871,30,865486,8,2871,117,2872,391,0
20150106.090558,2872,20,865506,0,2871,119,2872,400,1
20150106.090559,2872,34,865540,-4,2871,108,2872,416,1
20150106.090559,2872,30,865570,-8,2871,190,2872,407,1
20150106.0906,2872,4,865574,0,2871,192,2872,405,1
20150106.0906,2872,10,865584,6,2871,206,2872,404,1
20150106.090601,2872,2,865586,2,2871,207,2872,411,1
20150106.090601,2872,146,865732,88,2871,198,2872,352,1
20150106.090602,2872,20,865752,18,2871,204,2872,359,1
20150106.090602,2872,120,865872,-6,2871,201,2872,304,1
20150106.090603,2872,10,865882,-4,2871,204,2872,451,1
20150106.090603,2871,14,865896,8,2871,200,2872,448,0
20150106.090604,2871,16,865912,0,2871,200,2872,448,0
20150106.090604,2872,608,866520,-448,2871,197,2872,161,1
20150106.090605,2871,118,866638,-96,2871,225,2872,117,0
20150106.090605,2872,256,866894,30,2871,137,2872,90,1
20150106.090606,2872,24,866918,-22,2871,133,2872,220,1
20150106.090607,2872,132,867050,-70,2871,157,2872,378,1
20150106.090607,2872,228,867278,140,2871,166,2872,368,1
20150106.090608,2872,136,867414,-30,2871,168,2872,393,1
20150106.090608,2871,388,867802,100,2870,442,2871,822,0
20150106.090609,2871,502,868304,400,2870,302,2871,581,0
20150106.090609,2871,2,868306,0,2870,282,2871,618,0
20150106.09061,2870,52,868358,50,2870,288,2871,655,0
20150106.090611,2871,104,868462,2,2870,287,2871,606,1
20150106.090611,2871,12,868474,4,2870,281,2871,608,1
20150106.090612,2870,12,868486,2,2870,286,2871,603,0
20150106.090612,2870,12,868498,6,2870,283,2871,601,0
20150106.090613,2871,4,868502,4,2870,283,2871,603,1
20150106.090613,2870,166,868668,2,2870,280,2871,525,0
20150106.090614,2870,8,868676,8,2870,276,2871,526,0
20150106.090614,2870,110,868786,110,2870,227,2871,522,0
20150106.090615,2870,26,868812,20,2870,740,2871,522,0
20150106.090615,2871,16,868828,10,2870,1101,2871,460,1
20150106.090616,2871,1276,870104,296,2870,803,2871,124,1
20150106.090616,2871,260,870364,-28,2871,32,2872,1158,1
20150106.090617,2871,8,870372,4,2871,27,2872,1160,1
20150106.090617,2871,2,870374,2,2871,26,2872,1158,1
20150106.090618,2871,12,870386,6,2871,532,2872,1140,1
20150106.090618,2871,44,870430,32,2871,517,2872,1124,1
20150106.090619,2872,12,870442,6,2871,516,2872,1121,1
20150106.090619,2871,16,870458,-10,2871,507,2872,1121,0
20150106.09062,2871,16,870474,12,2871,506,2872,1209,0
20150106.09062,2871,14,870488,2,2871,505,2872,1195,0
20150106.09062,2871,18,870506,-6,2871,496,2872,1196,0
20150106.090621,2871,146,870652,-138,2871,425,2872,1201,0
20150106.090622,2871,20,870672,-4,2871,422,2872,1206,0
20150106.090622,2871,36,870708,4,2871,414,2872,1215,0
20150106.090623,2871,392,871100,-128,2871,22,2872,1022,0
20150106.090623,2871,60,871160,-28,2870,1057,2871,5,0
20150106.090624,2871,280,871440,34,2871,215,2872,492,0
20150106.090624,2871,54,871494,54,2871,296,2872,483,0
20150106.090625,2872,26,871520,20,2871,213,2872,498,1
20150106.090625,2872,328,871848,244,2871,60,2872,492,1
20150106.090626,2871,122,871970,-2,2871,11,2872,503,0
20150106.090626,2871,28,871998,-18,2870,1107,2872,554,0
20150106.090627,2871,2036,874034,1012,2870,198,2871,103,0
20150106.090627,2871,840,874874,-212,2869,329,2871,185,0
20150106.090628,2871,114,874988,102,2869,329,2871,203,0
20150106.090628,2869,204,875192,132,2869,234,2871,362,0
20150106.090629,2870,30,875222,-16,2869,260,2870,8,1
20150106.090629,2870,56,875278,38,2869,232,2870,36,1
20150106.09063,2870,46,875324,38,2869,224,2870,93,1
20150106.09063,2870,8,875332,2,2869,234,2870,94,1
20150106.090631,2870,188,875520,-168,2870,408,2871,1020,1
20150106.090631,2870,4,875524,-2,2870,521,2871,921,1
20150106.090632,2870,2,875526,-2,2870,521,2871,925,1
20150106.090632,2870,12,875538,0,2870,523,2871,933,1
20150106.090633,2870,10,875548,-4,2870,523,2871,933,1
20150106.090633,2871,1892,877440,-1362,2871,203,2872,712,1
20150106.090634,2871,24,877464,0,2871,279,2872,713,1
20150106.090634,2871,16,877480,-12,2871,223,2872,912,1
20150106.090635,2871,12,877492,-8,2871,217,2872,913,1
20150106.090635,2870,446,877938,114,2870,599,2871,518,0
20150106.090636,2870,46,877984,20,2870,496,2871,509,0
20150106.090636,2870,6,877990,0,2870,494,2871,515,0
20150106.090637,2871,6,877996,4,2870,684,2871,546,1
20150106.090637,2871,20,878016,2,2870,684,2871,571,1
20150106.090638,2870,14,878030,-10,2870,678,2871,594,0
20150106.090638,2870,1364,879394,-624,2869,458,2870,52,0
20150106.090639,2870,8,879402,0,2869,251,2870,60,0
20150106.09064,2869,26,879428,4,2869,244,2870,52,0
20150106.09064,2869,16,879444,0,2869,308,2870,249,0
20150106.090641,2870,266,879710,-150,2869,309,2870,243,1
20150106.090641,2870,6,879716,0,2869,312,2870,263,1
20150106.090641,2870,10,879726,2,2869,291,2870,778,1
20150106.090642,2870,82,879808,-42,2869,252,2870,784,1
20150106.090643,2870,6,879814,4,2869,258,2870,784,1
20150106.090644,2870,8,879822,-4,2869,255,2870,783,1
20150106.090644,2869,1016,880838,-934,2869,249,2870,282,0
20150106.090645,2870,6,880844,0,2869,250,2870,280,1
20150106.090645,2870,96,880940,-80,2870,53,2871,920,1
20150106.090646,2870,102,881042,100,2870,189,2871,770,1
20150106.090646,2870,4,881046,-2,2870,370,2871,637,1
20150106.090647,2870,8,881054,-8,2870,407,2871,635,1
20150106.090647,2870,32,881086,-30,2870,430,2871,635,1
20150106.090648,2870,20,881106,0,2870,453,2871,665,1
20150106.090648,2869,1108,882214,-806,2869,583,2870,126,0
20150106.090649,2870,356,882570,-150,2870,45,2871,601,1
20150106.090649,2870,24,882594,-18,2870,187,2871,553,1
20150106.09065,2870,30,882624,-22,2870,173,2871,553,1
20150106.09065,2870,256,882880,176,2870,178,2871,453,1
20150106.090651,2870,34,882914,-4,2870,182,2871,453,1
20150106.090651,2870,414,883328,36,2870,92,2871,495,1
20150106.090652,2870,384,883712,-22,2869,572,2870,337,1
20150106.090653,2870,716,884428,-656,2870,256,2871,862,1
20150106.090653,2871,16,884444,-12,2870,250,2871,755,1
20150106.090654,2870,4,884448,0,2870,263,2871,696,0
20150106.090654,2871,342,884790,-14,2870,268,2871,526,1
20150106.090655,2871,210,885000,22,2870,314,2871,624,1
20150106.090655,2871,2,885002,-2,2870,322,2871,1686,1
20150106.090656,2870,834,885836,350,2869,434,2871,1608,0
20150106.090656,2870,206,886042,2,2869,618,2870,101,0
20150106.090657,2870,222,886264,-92,2870,58,2871,1564,0
20150106.090657,2870,44,886308,40,2870,187,2871,1578,0
20150106.090658,2870,616,886924,-98,2869,615,2870,750,0
20150106.090659,2870,184,887108,80,2870,60,2871,1711,0
20150106.090659,2870,236,887344,0,2870,43,2871,1570,0
20150106.0907,2871,14,887358,-14,2870,43,2871,1564,1
20150106.0907,2871,1522,888880,-146,2870,75,2871,795,1
20150106.090701,2871,220,889100,208,2870,67,2871,727,1
20150106.090701,2870,142,889242,126,2870,91,2871,738,0
20150106.090702,2871,4,889246,4,2870,175,2871,749,1
20150106.090702,2870,104,889350,-90,2870,124,2871,850,0
20150106.090703,2870,374,889724,-192,2869,557,2870,419,0
20150106.090703,2870,24,889748,-24,2869,557,2870,468,0
20150106.090704,2870,6,889754,-2,2869,557,2870,468,0
20150106.090704,2870,142,889896,-140,2869,490,2870,349,0
20150106.090705,2870,14,889910,-14,2869,486,2870,359,0
20150106.090705,2870,212,890122,-110,2869,485,2870,259,0
20150106.090706,2870,24,890146,0,2869,485,2870,249,0
20150106.090706,2869,2,890148,0,2869,485,2870,250,0
20150106.090707,2870,4,890152,0,2869,485,2870,255,1
20150106.090708,2869,12,890164,0,2869,514,2870,251,0
20150106.090708,2869,2,890166,0,2869,513,2870,254,0
20150106.090709,2869,10,890176,-8,2869,508,2870,254,0
20150106.090709,2869,6,890182,-6,2869,502,2870,259,0
20150106.09071,2870,234,890416,-106,2869,659,2870,147,1
20150106.09071,2869,2,890418,0,2869,682,2870,168,0
20150106.090711,2870,40,890458,0,2869,682,2870,167,1
20150106.090711,2869,4,890462,-2,2869,685,2870,166,0
20150106.090712,2870,22,890484,-22,2869,681,2870,159,1
20150106.090713,2870,8,890492,0,2869,670,2870,155,1
20150106.090714,2870,22,890514,-18,2869,645,2870,661,1
20150106.090714,2869,16,890530,-4,2869,398,2870,663,0
20150106.090715,2869,12,890542,-6,2869,324,2870,760,0
20150106.090715,2869,12,890554,8,2869,314,2870,772,0
20150106.090716,2869,4,890558,2,2869,318,2870,784,0
20150106.090716,2870,424,890982,-192,2869,110,2870,784,1
20150106.090717,2869,346,891328,50,2869,64,2870,884,0
20150106.090717,2869,158,891486,8,2868,1036,2870,832,0
20150106.090718,2869,34,891520,18,2868,1036,2870,839,0
20150106.090718,2869,2,891522,0,2868,1037,2870,850,0
20150106.090719,2869,6,891528,0,2868,1038,2870,900,0
20150106.090719,2869,118,891646,98,2868,228,2870,901,0
20150106.090719,2869,2,891648,0,2869,179,2870,900,0
20150106.09072,2868,312,891960,42,2868,813,2869,99,0
20150106.09072,2868,40,892000,0,2868,800,2869,201,0
20150106.090721,2868,52,892052,2,2868,786,2869,280,0
20150106.090722,2869,20,892072,0,2868,762,2869,276,1
20150106.090722,2868,6,892078,4,2868,759,2869,277,0
20150106.090723,2869,310,892388,72,2868,765,2869,172,1
20150106.090723,2868,6,892394,4,2868,814,2869,184,0
20150106.090724,2868,8,892402,6,2868,811,2869,190,0
20150106.090724,2868,8,892410,-8,2868,903,2869,141,0
20150106.090725,2868,4,892414,0,2868,902,2869,141,0
20150106.090725,2869,10,892424,-2,2868,904,2869,147,1
20150106.090726,2868,14,892438,-2,2868,899,2869,134,0
20150106.090726,2868,1008,893446,256,2868,505,2869,134,0
20150106.090727,2868,24,893470,0,2868,503,2869,152,0
20150106.090727,2868,4,893474,4,2868,502,2869,245,0
20150106.090728,2868,26,893500,-12,2867,329,2869,277,0
20150106.090728,2869,8,893508,0,2867,330,2869,365,1
20150106.090729,2868,18,893526,-8,2867,361,2869,366,0
20150106.09073,2869,124,893650,-122,2867,361,2869,410,1
20150106.09073,2868,12,893662,-2,2867,371,2869,421,0
20150106.090731,2868,2,893664,-2,2867,372,2869,434,0
20150106.090731,2868,2,893666,-2,2868,421,2869,433,0
20150106.090732,2869,106,893772,-100,2868,372,2869,432,1
20150106.090732,2868,10,893782,-2,2868,368,2869,436,0
20150106.090733,2868,16,893798,4,2868,11,2869,582,0
20150106.090733,2868,102,893900,-84,2867,680,2868,2,0
20150106.090734,2868,16,893916,-6,2868,2,2869,584,0
20150106.090734,2868,42,893958,-8,2868,9,2869,588,0
20150106.090735,2869,2,893960,-2,2868,9,2869,587,1
20150106.090735,2868,42,894002,2,2868,2,2869,681,0
20150106.090736,2868,106,894108,-100,2867,692,2868,21,0
20150106.090736,2868,286,894394,-108,2868,21,2869,594,0
20150106.090737,2868,50,894444,0,2867,644,2869,607,0
20150106.090737,2868,16,894460,0,2867,681,2868,20,0
20150106.090738,2868,4,894464,0,2867,681,2868,21,0
20150106.090738,2868,164,894628,-126,2868,73,2869,506,0
20150106.090739,2868,14,894642,-10,2868,67,2869,521,0
20150106.090739,2868,116,894758,-20,2868,7,2869,441,0
20150106.09074,2868,28,894786,0,2868,34,2869,416,0
20150106.09074,2868,74,894860,66,2867,648,2868,1208,0
20150106.090741,2868,108,894968,-52,2867,597,2868,1204,0
20150106.090741,2868,100,895068,0,2867,597,2868,1166,0
20150106.090742,2868,10,895078,0,2867,594,2868,1173,0
20150106.090742,2867,8,895086,6,2867,595,2868,1178,0
20150106.090743,2867,26,895112,24,2867,596,2868,1172,0
20150106.090744,2867,2,895114,0,2867,597,2868,1174,0
20150106.090744,2868,2,895116,2,2867,599,2868,1174,1
20150106.090745,2867,16,895132,10,2867,597,2868,1171,0
20150106.090745,2867,162,895294,0,2867,522,2868,1171,0
20150106.090746,2867,216,895510,-70,2867,414,2868,1173,0
20150106.090747,2867,4,895514,-2,2867,625,2868,1177,0
20150106.090747,2868,10,895524,0,2867,630,2868,1172,1
20150106.090747,2867,16,895540,-16,2867,694,2868,1179,0
20150106.090748,2867,34,895574,-32,2867,673,2868,1179,0
20150106.090748,2867,24,895598,-20,2867,682,2868,1190,0
20150106.090749,2867,2,895600,-2,2867,676,2868,1198,0
20150106.09075,2867,56,895656,-32,2867,561,2868,1199,0
20150106.090751,2867,92,895748,-78,2867,501,2868,1204,0
20150106.090751,2867,36,895784,-34,2867,483,2868,1205,0
20150106.090752,2867,12,895796,0,2867,472,2868,1205,0
20150106.090752,2867,24,895820,-22,2867,464,2868,1202,0
20150106.090753,2868,4,895824,2,2867,408,2868,1214,1
20150106.090753,2867,26,895850,-20,2867,252,2868,1215,0
20150106.090754,2867,124,895974,12,2867,191,2868,1272,0
20150106.090754,2867,582,896556,-142,2867,2,2868,1381,0
20150106.090755,2867,186,896742,-4,2866,784,2867,3,0
20150106.090755,2867,74,896816,-24,2867,63,2868,1279,0
20150106.090756,2867,72,896888,-72,2867,341,2868,1281,0
20150106.090756,2867,20,896908,-12,2867,429,2868,1303,0
20150106.090756,2867,10,896918,0,2867,451,2868,1318,0
20150106.090757,2867,48,896966,-44,2867,442,2868,1320,0
20150106.090758,2868,1028,897994,-182,2867,314,2868,920,1
20150106.090758,2867,20,898014,0,2867,323,2868,944,0
20150106.090759,2867,4,898018,0,2867,458,2868,944,0
20150106.090759,2867,2,898020,0,2867,557,2868,944,0
20150106.0908,2867,2,898022,-2,2867,557,2868,944,0
20150106.0908,2867,2,898024,-2,2867,572,2868,944,0
20150106.090801,2867,4,898028,0,2867,468,2868,1354,0
20150106.090801,2868,32,898060,-18,2867,458,2868,1389,1
20150106.090802,2867,6,898066,-4,2867,455,2868,1397,0
20150106.090803,2867,10,898076,-6,2867,438,2868,1431,0
20150106.090804,2867,104,898180,-90,2867,390,2868,1434,0
20150106.090804,2867,118,898298,-2,2867,329,2868,1554,0
20150106.090805,2867,6,898304,-6,2867,327,2868,1564,0
20150106.090806,2867,674,898978,-560,2866,634,2867,170,0
20150106.090806,2867,4,898982,0,2866,506,2867,271,0
20150106.090807,2867,2,898984,0,2866,395,2867,277,0
20150106.090807,2867,10,898994,-6,2866,323,2867,393,0
20150106.090808,2867,142,899136,-140,2866,324,2867,397,0
20150106.090808,2867,20,899156,-2,2866,335,2867,389,0
20150106.090809,2867,2,899158,0,2866,335,2867,408,0
20150106.090809,2866,6,899164,0,2866,333,2867,415,0
20150106.09081,2866,8,899172,0,2866,343,2867,416,0
20150106.090811,2866,204,899376,-44,2866,254,2867,332,0
20150106.090811,2867,8,899384,0,2866,255,2867,346,1
20150106.090812,2866,2,899386,-2,2866,257,2867,348,0
20150106.090812,2866,118,899504,0,2866,203,2867,333,0
20150106.090813,2867,2062,901566,-1368,2867,382,2868,999,1
20150106.090814,2867,2328,903894,-1538,2868,1,2869,406,1
20150106.090814,2868,106,904000,0,2867,369,2868,68,1
20150106.090815,2867,100,904100,0,2867,316,2868,69,0
20150106.090815,2869,1330,905430,-490,2869,343,2870,841,1
20150106.090815,2869,850,906280,-344,2868,138,2869,38,1
20150106.090816,2869,12,906292,0,2868,152,2869,115,1
20150106.090817,2869,2,906294,0,2868,241,2869,171,1
20150106.090817,2869,10,906304,0,2868,286,2869,170,1
20150106.090817,2868,2,906306,2,2868,285,2869,191,0
20150106.090818,2868,22,906328,18,2868,237,2869,178,0
20150106.090819,2868,6,906334,0,2868,234,2869,208,0
20150106.090819,2869,10,906344,-8,2868,236,2869,228,1
20150106.090819,2868,4,906348,0,2868,291,2869,228,0
20150106.090821,2868,14,906362,4,2868,291,2869,240,0
20150106.090821,2869,4,906366,-4,2868,294,2869,238,1
20150106.090822,2868,22,906388,20,2868,367,2869,237,0
20150106.090822,2869,16,906404,-10,2868,362,2869,235,1
20150106.090823,2868,2,906406,2,2868,362,2869,235,0
20150106.090823,2868,2,906408,2,2868,361,2869,236,0
20150106.090823,2868,752,907160,-346,2867,411,2868,139,0
20150106.090824,2869,364,907524,-294,2868,307,2869,252,1
20150106.090825,2869,16,907540,2,2868,309,2869,223,1
20150106.090826,2868,650,908190,-540,2867,289,2868,239,0
20150106.090826,2868,6,908196,-6,2867,265,2868,261,0
20150106.090827,2868,18,908214,-12,2867,345,2868,254,0
20150106.090827,2868,10,908224,0,2867,345,2868,254,0
20150106.090828,2869,1672,909896,-932,2869,217,2870,889,1
20150106.090829,2868,436,910332,-204,2868,177,2869,31,0
20150106.09083,2868,4,910336,0,2868,281,2869,127,0
20150106.090831,2868,10,910346,-8,2868,284,2869,173,0
20150106.090832,2868,6,910352,-4,2868,286,2869,186,0
20150106.090833,2869,50,910402,40,2868,291,2869,171,1
20150106.090834,2868,4,910406,-2,2868,289,2869,172,0
20150106.090835,2868,580,910986,-126,2867,559,2868,225,0
20150106.090836,2868,2,910988,0,2867,347,2868,253,0
20150106.090837,2868,42,911030,-2,2867,347,2868,292,0
20150106.090837,2868,4,911034,-4,2867,349,2868,320,0
20150106.090838,2869,1826,912860,-1112,2869,89,2870,992,1
20150106.090838,2868,222,913082,12,2868,115,2869,106,0
20150106.090839,2869,6,913088,-4,2868,147,2869,162,1
20150106.090839,2869,4,913092,2,2868,132,2869,244,1
20150106.09084,2868,370,913462,-98,2867,553,2868,317,0
20150106.090841,2868,2,913464,-2,2867,416,2868,329,0
20150106.090841,2868,4,913468,-4,2867,420,2868,327,0
20150106.090842,2868,30,913498,-6,2867,917,2868,318,0
20150106.090842,2868,76,913574,-14,2867,918,2868,281,0
20150106.090843,2868,160,913734,-68,2867,915,2868,214,0
20150106.090843,2868,428,914162,-348,2868,113,2869,473,0
20150106.090844,2868,248,914410,-106,2867,924,2868,131,0
20150106.090845,2868,4,914414,0,2867,930,2868,159,0
20150106.090846,2868,6,914420,-6,2867,930,2868,161,0
20150106.090846,2868,2,914422,-2,2867,930,2868,675,0
20150106.090847,2867,6,914428,-2,2867,892,2868,674,0
20150106.090847,2867,2,914430,0,2867,1101,2868,676,0
20150106.090848,2868,420,914850,-362,2867,362,2868,742,1
20150106.090849,2869,2000,916850,-1474,2868,1,2869,376,1
20150106.09085,2868,8,916858,2,2868,101,2869,264,0
20150106.09085,2868,2,916860,0,2868,161,2869,234,0
20150106.090851,2868,12,916872,12,2868,158,2869,234,0
20150106.090851,2868,4,916876,0,2868,161,2869,242,0
20150106.090852,2868,30,916906,0,2868,151,2869,242,0
20150106.090852,2868,134,917040,-36,2868,168,2869,181,0
20150106.090853,2868,2,917042,0,2868,201,2869,205,0
20150106.090854,2868,28,917070,22,2868,188,2869,207,0
20150106.090855,2868,396,917466,-124,2868,199,2869,17,0
20150106.090855,2868,46,917512,-26,2868,304,2869,7,0
20150106.090856,2869,182,917694,-170,2868,321,2869,3,1
20150106.090856,2869,12,917706,-2,2869,2,2870,1399,1
20150106.090857,2869,4,917710,0,2868,336,2869,102,1
20150106.090857,2869,4,917714,0,2868,339,2869,109,1
20150106.090858,2869,24,917738,-10,2868,335,2869,102,1
20150106.090858,2869,206,917944,-94,2868,335,2869,8,1
20150106.090859,2869,16,917960,-14,2868,315,2869,20,1
20150106.090859,2868,680,918640,-452,2867,601,2868,179,0
20150106.0909,2868,18,918658,-12,2867,406,2868,171,0
20150106.0909,2868,202,918860,-2,2867,403,2868,70,0
20150106.090901,2868,8,918868,-2,2867,406,2868,67,0
20150106.090901,2868,6,918874,-2,2867,405,2868,70,0
20150106.090902,2868,336,919210,-304,2868,148,2869,242,0
20150106.090902,2869,168,919378,82,2868,68,2869,245,1
20150106.090903,2868,246,919624,-66,2868,132,2869,247,0
20150106.090903,2869,8,919632,-2,2868,124,2869,247,1
20150106.090904,2868,8,919640,0,2868,122,2869,242,0
20150106.090904,2869,10,919650,-8,2868,121,2869,244,1
20150106.090905,2868,108,919758,-10,2868,73,2869,255,0
20150106.090906,2868,158,919916,-10,2867,667,2868,54,0
20150106.090907,2868,122,920038,-18,2868,106,2869,260,0
20150106.090907,2869,42,920080,28,2868,106,2869,240,1
20150106.090908,2868,278,920358,-138,2867,587,2868,407,0
20150106.090908,2868,28,920386,0,2867,449,2868,394,0
20150106.090909,2868,4,920390,0,2867,449,2868,392,0
20150106.090909,2868,24,920414,-10,2867,444,2868,393,0
20150106.09091,2868,20,920434,-20,2867,444,2868,386,0
20150106.09091,2868,4,920438,2,2867,443,2868,386,0
20150106.090911,2867,8,920446,-2,2867,447,2868,386,0
20150106.090913,2868,8,920454,-2,2867,462,2868,385,1
20150106.090913,2868,2,920456,0,2867,462,2868,384,1
20150106.090915,2867,100,920556,-98,2867,418,2868,389,0
20150106.090916,2867,14,920570,-2,2867,411,2868,389,0
20150106.090917,2868,40,920610,0,2867,411,2868,370,1
20150106.090917,2867,4,920614,0,2867,409,2868,372,0
20150106.090918,2868,4,920618,0,2867,406,2868,370,1
20150106.090918,2868,6,920624,0,2867,405,2868,368,1
20150106.090918,2867,2,920626,-2,2867,404,2868,384,0
20150106.090919,2868,2,920628,-2,2867,425,2868,374,1
20150106.09092,2868,4,920632,-2,2867,423,2868,376,1
20150106.090921,2867,404,921036,-360,2867,223,2868,373,0
20150106.090921,2868,20,921056,-2,2867,242,2868,374,1
20150106.090922,2868,26,921082,-2,2867,231,2868,380,1
20150106.090922,2867,2,921084,0,2867,229,2868,380,0
20150106.090923,2867,2,921086,-2,2867,229,2868,415,0
20150106.090923,2867,42,921128,-2,2867,229,2868,406,0
20150106.090924,2867,88,921216,0,2867,186,2868,405,0
20150106.090924,2867,54,921270,22,2867,161,2868,406,0
20150106.090925,2867,6,921276,-4,2867,158,2868,405,0
20150106.090925,2867,6,921282,0,2867,155,2868,407,0
20150106.090926,2867,14,921296,0,2867,155,2868,411,0
20150106.090927,2867,52,921348,4,2867,228,2868,429,0
20150106.090927,2867,48,921396,8,2867,206,2868,444,0
20150106.090928,2868,14,921410,6,2867,206,2868,446,1
20150106.090928,2868,38,921448,6,2867,190,2868,444,1
20150106.090929,2867,2,921450,-2,2867,192,2868,445,0
20150106.09093,2868,40,921490,0,2867,209,2868,427,1
20150106.09093,2867,6,921496,2,2867,206,2868,429,0
20150106.090931,2867,4,921500,2,2867,207,2868,428,0
20150106.090932,2867,40,921540,-30,2867,187,2868,428,0
20150106.090932,2868,6,921546,2,2867,190,2868,429,1
20150106.090933,2867,26,921572,-20,2867,184,2868,422,0
20150106.090933,2867,14,921586,-12,2867,182,2868,419,0
20150106.090934,2868,4,921590,0,2867,182,2868,417,1
20150106.090934,2867,374,921964,42,2866,793,2867,361,0
20150106.090935,2867,6,921970,6,2866,670,2867,414,0
20150106.090936,2867,8,921978,0,2866,444,2867,424,0
20150106.090936,2867,40,922018,40,2866,444,2867,414,0
20150106.090938,2866,10,922028,0,2866,440,2867,438,0
20150106.090939,2867,8,922036,0,2866,441,2867,538,1
20150106.090939,2866,2,922038,-2,2866,441,2867,538,0
20150106.09094,2867,2,922040,0,2866,443,2867,547,1
20150106.090941,2866,6,922046,2,2866,442,2867,528,0
20150106.090941,2867,4,922050,0,2866,441,2867,526,1
20150106.090942,2866,14,922064,-2,2866,434,2867,536,0
20150106.090942,2867,2,922066,2,2866,439,2867,548,1
20150106.090943,2867,6,922072,0,2866,439,2867,545,1
20150106.090943,2866,20,922092,-20,2866,430,2867,547,0
20150106.090944,2867,40,922132,40,2866,430,2867,528,1
20150106.090945,2866,40,922172,0,2866,411,2867,529,0
20150106.090945,2866,14,922186,-6,2866,407,2867,528,0
20150106.090945,2867,2,922188,2,2866,407,2867,528,1
20150106.090946,2866,8,922196,-4,2866,402,2867,530,0
20150106.090947,2867,32,922228,0,2866,401,2867,517,1
20150106.090948,2866,26,922254,-16,2866,394,2867,517,0
20150106.090948,2866,16,922270,2,2866,388,2867,516,0
20150106.090948,2866,2,922272,2,2866,387,2867,517,0
20150106.090949,2866,22,922294,2,2866,376,2867,517,0
20150106.09095,2866,12,922306,-4,2866,375,2867,517,0
20150106.09095,2866,8,922314,-2,2866,875,2867,506,0
20150106.090951,2867,60,922374,56,2866,874,2867,477,1
20150106.090951,2866,42,922416,38,2866,877,2867,454,0
20150106.090952,2866,32,922448,8,2866,867,2867,449,0
20150106.090952,2867,2,922450,0,2866,867,2867,448,1
20150106.090953,2866,1002,923452,-768,2866,367,2867,449,0
20150106.090953,2867,24,923476,8,2866,364,2867,456,1
20150106.090953,2866,10,923486,-10,2866,360,2867,456,0
20150106.090954,2866,6,923492,-2,2866,357,2867,457,0
20150106.090955,2866,28,923520,-26,2866,344,2867,457,0
20150106.090956,2866,16,923536,-16,2866,341,2867,458,0
20150106.090957,2866,684,924220,-656,2865,928,2866,279,0
20150106.090957,2866,8,924228,0,2865,919,2866,305,0
20150106.090957,2866,40,924268,0,2865,921,2866,290,0
20150106.090958,2866,796,925064,-592,2866,155,2867,464,0
20150106.090959,2866,26,925090,-24,2866,193,2867,486,0
20150106.091,2867,414,925504,-14,2866,196,2867,291,1
20150106.091001,2867,96,925600,16,2866,195,2867,253,1
20150106.091001,2867,274,925874,-82,2866,192,2867,131,1
20150106.091002,2866,2,925876,-2,2866,257,2867,96,0
20150106.091002,2866,294,926170,80,2866,338,2868,1051,0
20150106.091003,2866,14,926184,-8,2866,360,2868,1049,0
20150106.091003,2866,462,926646,-366,2866,170,2867,80,0
20150106.091004,2866,12,926658,-10,2866,189,2867,83,0
20150106.091004,2866,6,926664,-6,2866,158,2867,105,0
20150106.091005,2867,38,926702,-6,2866,100,2867,130,1
20150106.091005,2867,4,926706,-4,2866,131,2867,274,1
20150106.091006,2866,4,926710,0,2866,637,2867,483,0
20150106.091007,2866,12,926722,-12,2866,631,2867,588,0
20150106.091008,2866,22,926744,0,2866,621,2867,587,0
20150106.091008,2866,22,926766,-4,2866,618,2867,587,0
20150106.091009,2867,10,926776,-4,2866,624,2867,587,1
20150106.09101,2866,12,926788,-2,2866,624,2867,590,0
20150106.09101,2866,12,926800,-10,2866,624,2867,1084,0
20150106.091011,2866,40,926840,-22,2866,608,2867,1137,0
20150106.091012,2866,6,926846,6,2866,607,2867,1137,0
20150106.091012,2866,2,926848,0,2866,606,2867,1142,0
20150106.091013,2867,20,926868,12,2866,607,2867,1133,1
20150106.091013,2867,10,926878,8,2866,605,2867,1132,1
20150106.091014,2866,66,926944,-66,2866,584,2867,1132,0
20150106.091014,2866,12,926956,6,2866,582,2867,1132,0
20150106.091015,2866,836,927792,-816,2866,166,2867,1132,0
20150106.091015,2866,332,928124,-52,2865,522,2866,207,0
20150106.091016,2866,188,928312,30,2865,522,2866,119,0
20150106.091016,2865,12,928324,8,2865,521,2866,125,0
20150106.091017,2866,20,928344,4,2865,532,2866,117,1
20150106.091018,2866,18,928362,2,2865,527,2866,128,1
20150106.091018,2865,46,928408,8,2865,1024,2866,166,0
20150106.091019,2866,6,928414,6,2865,1025,2866,173,1
20150106.091019,2866,4,928418,2,2865,1035,2866,172,1
20150106.09102,2866,354,928772,-152,2866,369,2867,1299,1
20150106.091021,2866,108,928880,-100,2866,375,2867,1276,1
20150106.091021,2866,766,929646,-738,2865,1035,2866,187,1
20150106.091022,2865,6,929652,4,2865,1036,2866,199,0
20150106.091022,2866,2,929654,0,2865,1036,2866,202,1
20150106.091023,2866,4,929658,-2,2865,1035,2866,235,1
20150106.091024,2865,120,929778,-8,2865,981,2866,266,0
20150106.091024,2865,14,929792,0,2865,980,2866,318,0
20150106.091025,2865,8,929800,-4,2865,976,2866,376,0
20150106.091025,2865,18,929818,-10,2865,972,2866,390,0
20150106.091026,2866,42,929860,-20,2865,964,2866,380,1
20150106.091026,2865,46,929906,42,2865,945,2866,388,0
20150106.091026,2865,10,929916,0,2865,941,2866,388,0
20150106.091027,2865,122,930038,-70,2865,881,2866,390,0
20150106.091028,2866,16,930054,4,2865,875,2866,394,1
20150106.091028,2865,2,930056,-2,2865,872,2866,396,0
20150106.091029,2865,6,930062,0,2865,870,2866,408,0
20150106.091029,2865,6,930068,-2,2865,870,2866,407,0
20150106.09103,2865,10,930078,-10,2865,866,2866,436,0
20150106.091031,2865,4,930082,0,2865,867,2866,440,0
20150106.091031,2866,6,930088,0,2865,867,2866,438,1
20150106.091032,2865,102,930190,0,2865,816,2866,458,0
20150106.091033,2865,2,930192,-2,2865,806,2866,483,0
20150106.091033,2865,104,930296,-98,2865,755,2866,436,0
20150106.091034,2866,94,930390,-56,2865,724,2866,414,1
20150106.091035,2865,138,930528,126,2865,660,2866,458,0
20150106.091036,2865,30,930558,-12,2865,646,2866,460,0
20150106.091036,2865,8,930566,-4,2865,637,2866,477,0
20150106.091037,2866,38,930604,6,2865,2622,2866,475,1
20150106.091037,2865,20,930624,-6,2865,5621,2866,466,0
20150106.091038,2866,122,930746,-108,2865,615,2866,412,1
20150106.091038,2865,20,930766,4,2865,605,2866,503,0
20150106.091039,2865,8,930774,2,2865,603,2866,526,0
20150106.091039,2866,22,930796,-22,2865,603,2866,515,1
20150106.09104,2865,12,930808,4,2865,597,2866,517,0
20150106.09104,2865,2,930810,-2,2865,597,2866,527,0
20150106.091042,2866,6,930816,-4,2865,597,2866,528,1
20150106.091043,2865,8,930824,6,2865,611,2866,449,0
20150106.091043,2865,10,930834,0,2865,607,2866,449,0
20150106.091044,2865,212,931046,54,2865,502,2866,449,0
20150106.091044,2865,12,931058,-2,2865,499,2866,454,0
20150106.091045,2865,100,931158,0,2865,449,2866,454,0
20150106.091045,2865,26,931184,-2,2865,445,2866,470,0
20150106.091046,2865,8,931192,-8,2865,478,2866,470,0
20150106.091047,2865,1120,932312,38,2864,389,2865,43,0
20150106.091047,2866,98,932410,10,2865,609,2866,462,1
20150106.091048,2865,12,932422,6,2865,716,2866,463,0
20150106.091048,2865,24,932446,16,2865,706,2866,465,0
20150106.091049,2865,2,932448,0,2865,709,2866,469,0
20150106.09105,2866,1006,933454,-974,2865,239,2866,520,1
20150106.09105,2866,4,933458,0,2865,241,2866,519,1
20150106.091051,2865,102,933560,0,2865,190,2866,523,0
20150106.091051,2865,2,933562,0,2865,689,2866,588,0
20150106.091052,2865,126,933688,-110,2865,627,2866,595,0
20150106.091052,2865,624,934312,-554,2865,316,2866,613,0
20150106.091052,2865,2,934314,0,2865,322,2866,614,0
20150106.091053,2865,44,934358,-32,2865,306,2866,616,0
20150106.091054,2865,2,934360,0,2865,309,2866,616,0
20150106.091054,2865,36,934396,-4,2865,293,2866,613,0
20150106.091055,2865,14,934410,-12,2865,306,2866,612,0
20150106.091056,2865,14,934424,-2,2865,306,2866,613,0
20150106.091057,2865,6,934430,0,2865,306,2866,612,0
20150106.091057,2865,4,934434,-2,2865,304,2866,612,0
20150106.091058,2865,20,934454,-10,2865,336,2866,613,0
20150106.091058,2866,204,934658,132,2865,335,2866,524,1
20150106.091059,2866,10,934668,-4,2865,353,2866,523,1
20150106.091059,2865,6,934674,0,2865,424,2866,522,0
20150106.0911,2865,44,934718,0,2865,403,2866,523,0
20150106.0911,2865,12,934730,2,2865,399,2866,519,0
20150106.091101,2865,6,934736,0,2865,397,2866,522,0
20150106.091101,2865,8,934744,-2,2865,393,2866,524,0
20150106.091103,2865,4,934748,0,2865,471,2866,567,0
20150106.091104,2865,32,934780,-2,2865,459,2866,575,0
20150106.091104,2866,2,934782,2,2865,466,2866,574,1
20150106.091105,2866,16,934798,0,2865,474,2866,574,1
20150106.091105,2865,6,934804,0,2865,472,2866,574,0
20150106.091106,2865,12,934816,-8,2865,472,2866,573,0
20150106.091106,2865,2,934818,-2,2865,471,2866,573,0
20150106.091107,2866,18,934836,10,2865,479,2866,576,1
20150106.091107,2866,8,934844,0,2865,477,2866,578,1
20150106.091108,2866,2,934846,0,2865,479,2866,582,1
20150106.091109,2866,20,934866,0,2865,480,2866,571,1
20150106.09111,2865,2,934868,0,2865,489,2866,593,0
20150106.091111,2866,28,934896,-14,2865,489,2866,584,1
20150106.091111,2865,2,934898,-2,2865,490,2866,584,0
20150106.091112,2865,34,934932,-34,2865,480,2866,585,0
20150106.091113,2865,1002,935934,418,2864,518,2865,155,0
20150106.091113,2865,310,936244,-2,2865,392,2866,637,0
20150106.091114,2866,2,936246,-2,2865,392,2866,646,1
20150106.091114,2865,2,936248,0,2865,391,2866,646,0
20150106.091115,2865,12,936260,-8,2865,385,2866,656,0
20150106.091116,2865,4,936264,-2,2865,387,2866,669,0
20150106.091117,2865,20,936284,-18,2865,377,2866,676,0
20150106.091117,2865,214,936498,-4,2865,270,2866,676,0
20150106.091118,2865,564,937062,34,2864,490,2865,185,0
20150106.091118,2865,14,937076,4,2864,448,2865,183,0
20150106.091119,2865,30,937106,-10,2864,403,2865,237,0
20150106.091119,2865,40,937146,0,2864,383,2865,239,0
20150106.09112,2865,600,937746,-306,2865,255,2866,624,0
20150106.09112,2865,2,937748,0,2865,265,2866,624,0
20150106.091121,2865,26,937774,-24,2865,303,2866,620,0
20150106.091121,2865,28,937802,0,2865,289,2866,620,0
20150106.091122,2865,14,937816,-4,2865,292,2866,622,0
20150106.091122,2865,20,937836,-20,2865,283,2866,622,0
20150106.091123,2865,14,937850,-10,2865,268,2866,622,0
20150106.091123,2865,18,937868,-18,2865,259,2866,622,0
20150106.091124,2865,22,937890,-4,2865,261,2866,619,0
20150106.091124,2865,6,937896,0,2865,259,2866,669,0
20150106.091125,2865,10,937906,-4,2865,254,2866,668,0
20150106.091125,2865,4,937910,-4,2865,257,2866,670,0
20150106.091126,2865,100,938010,0,2865,257,2866,630,0
20150106.091126,2865,72,938082,-2,2865,222,2866,646,0
20150106.091127,2865,644,938726,-462,2864,986,2865,14,0
20150106.091127,2865,32,938758,-26,2864,996,2865,28,0
20150106.091128,2864,20,938778,-6,2864,988,2865,75,0
20150106.091128,2865,112,938890,60,2864,982,2865,24,1
20150106.091129,2864,4,938894,-2,2864,951,2865,79,0
20150106.091129,2864,20,938914,-8,2864,940,2865,82,0
20150106.09113,2864,22,938936,-2,2864,915,2865,82,0
20150106.09113,2864,12,938948,-2,2864,910,2865,86,0
20150106.091131,2865,12,938960,2,2864,975,2865,106,1
20150106.091132,2864,8,938968,-2,2864,973,2865,168,0
20150106.091133,2865,48,939016,-12,2864,981,2865,168,1
20150106.091133,2864,30,939046,0,2864,829,2865,327,0
20150106.091134,2864,4,939050,4,2864,828,2865,327,0
20150106.091134,2865,2,939052,0,2864,888,2865,327,1
20150106.091135,2864,20,939072,20,2864,878,2865,333,0
20150106.091135,2865,6,939078,6,2864,876,2865,332,1
20150106.091136,2865,2,939080,0,2864,876,2865,331,1
20150106.091136,2864,14,939094,2,2864,871,2865,331,0
20150106.091137,2864,6,939100,6,2864,867,2865,332,0
20150106.091137,2864,24,939124,-20,2864,855,2865,335,0
20150106.091138,2864,6,939130,-2,2864,853,2865,347,0
20150106.091138,2864,6,939136,-2,2864,850,2865,350,0
20150106.091139,2864,2,939138,0,2864,848,2865,350,0
20150106.091139,2864,20,939158,-16,2864,839,2865,347,0
20150106.091141,2864,2,939160,-2,2864,839,2865,355,0
20150106.091141,2865,8,939168,0,2864,839,2865,351,1
20150106.091142,2864,4,939172,2,2864,838,2865,350,0
20150106.091143,2864,2,939174,0,2864,838,2865,353,0
20150106.091144,2864,4,939178,-2,2864,826,2865,356,0
20150106.091145,2865,8,939186,6,2864,825,2865,354,1
20150106.091146,2864,10,939196,0,2864,820,2865,589,0
20150106.091146,2865,2,939198,2,2864,820,2865,589,1
20150106.091147,2865,2,939200,0,2864,820,2865,598,1
20150106.091147,2864,20,939220,-4,2864,812,2865,629,0
20150106.091149,2864,22,939242,-12,2864,801,2865,634,0
20150106.091149,2864,22,939264,12,2864,790,2865,645,0
20150106.09115,2864,16,939280,12,2864,784,2865,649,0
20150106.09115,2864,40,939320,6,2864,764,2865,649,0
20150106.09115,2864,2,939322,-2,2864,764,2865,649,0
20150106.091151,2864,6,939328,-2,2864,763,2865,668,0
20150106.091151,2864,2,939330,0,2864,762,2865,668,0
20150106.091152,2864,40,939370,-2,2864,742,2865,668,0
20150106.091153,2865,8,939378,4,2864,2743,2865,685,1
20150106.091153,2864,6,939384,-2,2864,5744,2865,677,0
20150106.091154,2865,1092,940476,-268,2864,737,2865,398,1
20150106.091154,2865,8,940484,0,2864,733,2865,387,1
20150106.091155,2864,6,940490,2,2864,737,2865,409,0
20150106.091155,2864,1000,941490,-834,2864,392,2865,62,0
20150106.091156,2864,16,941506,-14,2864,500,2865,91,0
20150106.091157,2864,6,941512,-4,2864,528,2865,146,0
20150106.091157,2864,12,941524,-10,2864,522,2865,146,0
20150106.091158,2865,496,942020,-430,2864,390,2865,390,1
20150106.091158,2865,200,942220,-114,2864,392,2865,293,1
20150106.091159,2864,4,942224,-4,2864,391,2865,295,0
20150106.0912,2864,2,942226,0,2864,391,2865,313,0
20150106.0912,2865,4,942230,-4,2864,390,2865,413,1
20150106.091201,2865,16,942246,-14,2864,390,2865,408,1
20150106.091201,2864,2,942248,-2,2864,389,2865,408,0
20150106.091202,2864,24,942272,-24,2864,377,2865,410,0
20150106.091202,2864,148,942420,-130,2864,305,2865,355,0
20150106.091203,2864,2,942422,-2,2864,307,2865,369,0
20150106.091204,2864,618,943040,-328,2863,801,2864,561,0
20150106.091204,2864,8,943048,2,2863,802,2864,222,0
20150106.091205,2863,2,943050,0,2863,804,2864,267,0
20150106.091205,2864,8,943058,2,2863,815,2864,266,1
20150106.091206,2863,26,943084,-18,2863,806,2864,228,0
20150106.091206,2864,6,943090,-4,2863,794,2864,224,1
20150106.091207,2864,14,943104,0,2863,1294,2864,220,1
20150106.091208,2864,340,943444,-268,2864,2,2865,405,1
20150106.091208,2864,12,943456,-10,2864,48,2865,406,1
20150106.091209,2864,98,943554,-96,2863,1291,2864,72,1
20150106.091209,2864,150,943704,100,2864,21,2865,392,1
20150106.09121,2864,148,943852,-124,2864,93,2865,310,1
20150106.09121,2864,16,943868,-2,2864,105,2865,311,1
20150106.091211,2864,10,943878,-4,2864,166,2865,310,1
20150106.091211,2864,8,943886,-4,2864,170,2865,310,1
20150106.091212,2864,2,943888,0,2864,169,2865,314,1
20150106.091212,2864,26,943914,-10,2864,185,2865,321,1
20150106.091213,2864,2,943916,2,2864,213,2865,341,1
20150106.091213,2864,122,944038,6,2864,123,2865,342,1
20150106.091214,2864,164,944202,28,2863,1572,2864,33,1
20150106.091214,2863,38,944240,38,2863,1507,2864,116,0
20150106.091216,2864,2,944242,0,2863,1505,2864,117,1
20150106.091216,2863,38,944280,20,2863,1495,2864,118,0
20150106.091217,2864,10,944290,-4,2863,1510,2864,114,1
20150106.091217,2864,120,944410,-14,2863,1510,2864,61,1
20150106.091218,2863,6,944416,-6,2863,1523,2864,60,0
20150106.091218,2864,4,944420,0,2863,1526,2864,59,1
20150106.091219,2863,10,944430,-8,2863,1525,2864,55,0
20150106.091219,2864,30,944460,0,2863,1523,2864,41,1
20150106.09122,2863,20,944480,0,2863,1511,2864,63,0
20150106.091221,2863,12,944492,-6,2863,1512,2864,118,0
20150106.091221,2863,4,944496,-2,2863,1509,2864,121,0
20150106.091222,2864,10,944506,-6,2863,1507,2864,128,1
20150106.091222,2864,8,944514,0,2863,1507,2864,124,1
20150106.091223,2864,2,944516,-2,2863,1507,2864,123,1
20150106.091223,2863,62,944578,-56,2863,1476,2864,124,0
20150106.091224,2864,6,944584,0,2863,1476,2864,151,1
20150106.091224,2863,4,944588,-2,2863,1361,2864,165,0
20150106.091226,2863,2,944590,0,2863,1316,2864,222,0
20150106.091226,2863,4,944594,-2,2863,1314,2864,230,0
20150106.091227,2863,26,944620,-20,2863,1301,2864,269,0
20150106.091228,2863,10,944630,-2,2863,1297,2864,271,0
20150106.091228,2863,406,945036,-400,2863,1095,2864,291,0
20150106.091229,2864,750,945786,-600,2863,725,2864,293,1
20150106.09123,2863,1510,947296,302,2862,650,2863,303,0
20150106.09123,2863,112,947408,104,2862,646,2863,270,0
20150106.091231,2863,24,947432,18,2862,655,2863,266,0
20150106.091231,2863,6,947438,2,2862,664,2863,263,0
20150106.091232,2863,18,947456,14,2862,671,2863,262,0
20150106.091232,2863,18,947474,18,2862,662,2863,274,0
20150106.091233,2863,8,947482,-2,2862,659,2863,274,0
20150106.091233,2863,2,947484,2,2862,659,2863,273,0
20150106.091234,2862,52,947536,-4,2862,538,2863,281,0
20150106.091234,2862,12,947548,4,2862,395,2863,319,0
20150106.091235,2863,28,947576,28,2862,392,2863,386,1
20150106.091235,2862,12,947588,2,2862,397,2863,412,0
20150106.091236,2861,896,948484,-392,2861,735,2862,173,0
20150106.091236,2862,2,948486,0,2861,729,2862,172,1
20150106.091237,2861,8,948494,0,2861,739,2862,180,0
20150106.091237,2862,132,948626,-112,2861,691,2862,204,1
20150106.091238,2862,6,948632,-4,2861,693,2862,302,1
20150106.091238,2861,166,948798,40,2861,595,2862,304,0
20150106.091239,2861,30,948828,10,2861,585,2862,306,0
20150106.091239,2861,12,948840,-2,2861,579,2862,309,0
20150106.09124,2861,202,949042,-114,2861,482,2862,308,0
20150106.09124,2861,4,949046,0,2861,522,2862,310,0
20150106.091241,2862,32,949078,10,2861,1035,2862,300,1
20150106.091241,2861,34,949112,8,2861,891,2862,286,0
20150106.091242,2861,28,949140,-8,2861,906,2862,287,0
20150106.091242,2861,38,949178,-34,2861,970,2862,284,0
20150106.091243,2861,28,949206,-6,2861,962,2862,293,0
20150106.091243,2861,118,949324,-4,2861,865,2862,299,0
20150106.091244,2861,2,949326,0,2861,866,2862,304,0
20150106.091244,2861,36,949362,36,2861,848,2862,313,0
20150106.091245,2862,40,949402,-2,2861,835,2862,307,1
20150106.091245,2861,20,949422,-12,2861,828,2862,313,0
20150106.091246,2862,22,949444,20,2861,828,2862,322,1
20150106.091246,2861,26,949470,0,2861,819,2862,352,0
20150106.091247,2862,30,949500,-30,2861,824,2862,339,1
20150106.091247,2861,88,949588,-62,2861,818,2862,305,0
20150106.091248,2862,10,949598,0,2861,848,2862,300,1
20150106.091249,2862,870,950468,-548,2862,461,2863,943,1
20150106.09125,2861,926,951394,-218,2861,878,2862,583,0
20150106.09125,2861,140,951534,-52,2861,885,2862,531,0
20150106.091251,2862,22,951556,18,2861,890,2862,586,1
20150106.091251,2862,4,951560,2,2861,889,2862,590,1
20150106.091252,2862,18,951578,-2,2861,874,2862,404,1
20150106.091252,2862,16,951594,6,2861,765,2862,409,1
20150106.091253,2861,12,951606,8,2861,760,2862,414,0
20150106.091253,2862,20,951626,-4,2861,757,2862,426,1
20150106.091254,2861,14,951640,-4,2861,767,2862,302,0
20150106.091254,2861,676,952316,14,2861,551,2863,758,0
20150106.091255,2863,8,952324,-6,2862,91,2863,713,1
20150106.091255,2863,2,952326,-2,2862,95,2863,800,1
20150106.091256,2862,16,952342,-4,2862,193,2863,797,0
20150106.091256,2862,56,952398,8,2862,165,2863,870,0
20150106.091257,2862,10,952408,4,2862,175,2863,872,0
20150106.091257,2862,20,952428,4,2862,196,2863,872,0
20150106.091258,2862,4,952432,4,2862,147,2863,876,0
20150106.091258,2862,240,952672,176,2861,577,2862,3,0
20150106.091259,2862,6,952678,-6,2861,577,2862,131,0
20150106.091259,2862,2,952680,2,2861,577,2862,341,0
20150106.0913,2862,46,952726,18,2861,575,2862,327,0
20150106.0913,2862,354,953080,-348,2861,400,2862,332,0
20150106.091301,2862,22,953102,0,2861,398,2862,424,0
20150106.091301,2862,2,953104,2,2861,401,2862,423,0
20150106.091302,2861,8,953112,0,2861,402,2862,424,0
20150106.091302,2862,56,953168,18,2861,399,2862,404,1
20150106.091303,2861,842,954010,162,2860,3586,2861,37,0
20150106.091303,2861,14,954024,-4,2860,3579,2861,128,0
20150106.091304,2860,32,954056,-2,2860,3602,2861,113,0
20150106.091304,2861,280,954336,-270,2860,3463,2861,213,1
20150106.091305,2861,16,954352,-10,2860,3462,2861,245,1
20150106.091305,2861,36,954388,12,2860,3453,2861,299,1
20150106.091306,2860,42,954430,-42,2860,3433,2861,304,0
20150106.091306,2860,42,954472,-2,2860,3422,2861,307,0
20150106.091307,2860,46,954518,-14,2860,3410,2861,300,0
20150106.091307,2860,2,954520,-2,2860,3410,2861,301,0
20150106.091308,2860,68,954588,-12,2860,3387,2861,293,0
20150106.091308,2860,50,954638,16,2860,3376,2861,282,0
20150106.091309,2860,58,954696,-44,2860,3355,2861,280,0
20150106.091309,2860,26,954722,-14,2860,3343,2861,303,0
20150106.09131,2860,120,954842,2,2860,3305,2861,340,0
20150106.09131,2861,42,954884,-12,2860,3299,2861,326,1
20150106.091311,2861,16,954900,-6,2860,3291,2861,340,1
20150106.091311,2861,16,954916,-10,2860,3287,2861,339,1
20150106.091312,2861,34,954950,-24,2860,3277,2861,353,1
20150106.091312,2860,12,954962,2,2860,3277,2861,354,0
20150106.091313,2860,2,954964,0,2860,3282,2861,355,0
20150106.091313,2861,6,954970,0,2860,3274,2861,383,1
20150106.091314,2861,778,955748,398,2861,269,2862,529,1
20150106.091314,2861,10,955758,10,2861,350,2862,476,1
20150106.091315,2861,22,955780,12,2861,443,2862,473,1
20150106.091315,2861,46,955826,34,2861,460,2862,447,1
20150106.091316,2862,8,955834,4,2861,474,2862,449,1
20150106.091316,2861,82,955916,2,2861,435,2862,1447,0
20150106.091317,2861,174,956090,166,2861,377,2862,3547,0
20150106.091318,2861,108,956198,108,2861,404,2862,3564,0
20150106.091318,2861,24,956222,-16,2861,417,2862,545,0
20150106.091319,2861,32,956254,-6,2861,442,2862,541,0
20150106.09132,2862,20,956274,-18,2861,442,2862,583,1
20150106.09132,2861,8,956282,0,2861,444,2862,632,0
20150106.091321,2861,94,956376,-86,2861,405,2862,634,0
20150106.091321,2861,2,956378,-2,2861,420,2862,636,0
20150106.091322,2862,2,956380,0,2861,1073,2862,636,1
20150106.091322,2861,4,956384,0,2861,1073,2862,638,0
20150106.091323,2861,14,956398,-8,2861,1071,2862,606,0
20150106.091324,2861,72,956470,10,2861,1019,2862,621,0
20150106.091324,2861,2,956472,2,2861,1022,2862,639,0
20150106.091325,2862,4,956476,-2,2861,1025,2862,668,1
20150106.091325,2861,24,956500,18,2861,1216,2862,565,0
20150106.091326,2861,14,956514,-4,2861,1260,2862,516,0
20150106.091326,2861,4,956518,-2,2861,1223,2862,518,0
20150106.091327,2862,76,956594,24,2861,1231,2862,482,1
20150106.091327,2862,28,956622,-18,2861,1222,2862,468,1
20150106.091328,2862,960,957582,-378,2862,48,2863,1091,1
20150106.091328,2862,32,957614,-24,2862,140,2863,1090,1
20150106.091329,2862,56,957670,-22,2862,194,2863,1074,1
20150106.091329,2863,2,957672,2,2862,194,2863,1073,1
20150106.09133,2862,10,957682,2,2862,197,2863,1071,0
20150106.09133,2862,6,957688,0,2862,237,2863,969,0
20150106.091331,2862,4,957692,-2,2862,238,2863,968,0
20150106.091331,2862,64,957756,-14,2862,210,2863,984,0
20150106.091331,2862,2,957758,0,2862,209,2863,985,0
20150106.091332,2862,34,957792,18,2862,196,2863,983,0
20150106.091333,2863,22,957814,22,2862,187,2863,972,1
20150106.091333,2863,32,957846,6,2862,174,2863,976,1
20150106.091334,2862,22,957868,20,2862,238,2863,975,0
20150106.091334,2863,4,957872,4,2862,263,2863,974,1
20150106.091335,2862,8,957880,0,2862,268,2863,978,0
20150106.091335,2862,34,957914,2,2862,252,2863,977,0
20150106.091336,2862,2,957916,2,2862,256,2863,977,0
20150106.091336,2862,28,957944,20,2862,244,2863,977,0
20150106.091337,2863,10,957954,-4,2862,254,2863,975,1
20150106.091337,2863,34,957988,20,2862,243,2863,970,1
20150106.091338,2863,24,958012,20,2862,239,2863,974,1
20150106.091339,2862,2,958014,2,2862,237,2863,979,0
20150106.09134,2863,20,958034,12,2862,244,2863,1478,1
20150106.09134,2862,24,958058,20,2862,234,2863,1476,0
20150106.091341,2862,228,958286,-76,2862,121,2863,1714,0
20150106.091341,2862,246,958532,112,2861,1432,2862,35,0
20150106.091342,2862,2,958534,-2,2861,1432,2862,34,0
20150106.091342,2862,54,958588,-14,2861,1436,2862,10,0
20150106.091343,2862,34,958622,-10,2861,1426,2862,4,0
20150106.091343,2862,38,958660,10,2862,2,2863,1804,0
20150106.091344,2862,34,958694,-32,2861,1402,2862,107,0
20150106.091344,2862,8,958702,-4,2861,1399,2862,169,0
20150106.091345,2862,12,958714,-6,2861,1399,2862,184,0
20150106.091345,2862,4,958718,0,2861,1459,2862,184,0
20150106.091346,2861,30,958748,-30,2861,1450,2862,240,0
20150106.091346,2861,112,958860,-82,2861,1399,2862,237,0
20150106.091347,2862,56,958916,6,2861,1400,2862,236,1
20150106.091347,2862,118,959034,110,2861,1349,2862,229,1
20150106.091348,2862,22,959056,22,2861,1353,2862,220,1
20150106.091349,2862,12,959068,12,2861,1353,2862,244,1
20150106.091349,2861,34,959102,-20,2861,1336,2862,251,0
20150106.09135,2862,562,959664,-462,2862,22,2863,1863,1
20150106.091351,2862,154,959818,-36,2861,1336,2862,44,1
20150106.091351,2862,6,959824,0,2861,1346,2862,92,1
20150106.091352,2862,4,959828,2,2861,1348,2862,108,1
20150106.091352,2862,1002,960830,962,2861,849,2862,340,1
20150106.091353,2862,2,960832,0,2861,848,2862,351,1
20150106.091353,2861,1702,962534,1266,2860,3561,2861,423,0
20150106.091354,2861,8,962542,0,2860,3330,2861,512,0
20150106.091354,2861,1002,963544,190,2860,2830,2861,614,0
20150106.091355,2861,16,963560,0,2860,2819,2861,533,0
20150106.091355,2861,30,963590,0,2860,2849,2861,518,0
20150106.091356,2860,36,963626,-2,2860,2833,2861,517,0
20150106.091356,2861,2,963628,0,2860,2833,2861,516,1
20150106.091357,2861,24,963652,18,2860,2831,2861,511,1
20150106.091357,2861,2,963654,0,2860,2881,2861,507,1
20150106.091358,2861,22,963676,2,2860,3072,2861,504,1
20150106.091359,2861,1406,965082,12,2860,2452,2861,188,1
20150106.091359,2861,2,965084,0,2860,2452,2861,188,1
20150106.091359,2860,6,965090,0,2860,2455,2861,191,0
20150106.0914,2860,12,965102,-4,2860,2451,2861,268,0
20150106.091401,2861,30,965132,-10,2860,2442,2861,266,1
20150106.091401,2861,22,965154,0,2860,2443,2861,255,1
20150106.091402,2860,228,965382,-4,2860,2336,2861,255,0
20150106.091402,2860,40,965422,-40,2860,2318,2861,257,0
20150106.091403,2861,2,965424,0,2860,2318,2861,284,1
20150106.091403,2860,10,965434,-4,2860,2330,2861,283,0
20150106.091404,2861,6,965440,-6,2860,2330,2861,281,1
20150106.091404,2861,26,965466,-2,2860,2330,2861,269,1
20150106.091405,2860,4,965470,-2,2860,2329,2861,268,0
20150106.091405,2860,2,965472,0,2860,2328,2861,282,0
20150106.091406,2860,32,965504,-12,2860,2327,2861,257,0
20150106.091406,2860,50,965554,0,2860,2303,2861,251,0
20150106.091407,2860,2,965556,-2,2860,2302,2861,261,0
20150106.091407,2860,18,965574,-8,2860,2289,2861,261,0
20150106.091408,2860,88,965662,-54,2860,2282,2861,225,0
20150106.091409,2860,2,965664,0,2860,2278,2861,226,0
20150106.091409,2861,26,965690,-22,2860,2276,2861,237,1
20150106.09141,2861,2,965692,-2,2860,2281,2861,243,1
20150106.09141,2861,2,965694,-2,2860,2281,2861,241,1
20150106.091411,2861,484,966178,-238,2860,2282,2862,478,1
20150106.091411,2862,4,966182,0,2860,2344,2862,465,1
20150106.091412,2861,10,966192,0,2861,7,2862,564,0
20150106.091412,2861,2,966194,2,2861,55,2862,417,0
20150106.091413,2861,18,966212,12,2861,48,2862,406,0
20150106.091413,2861,22,966234,2,2861,73,2862,406,0
20150106.091414,2861,6,966240,4,2861,97,2862,406,0
20150106.091415,2861,6,966246,2,2861,235,2862,433,0
20150106.091416,2861,4,966250,2,2861,309,2862,431,0
20150106.091417,2861,106,966356,70,2861,265,2862,436,0
20150106.091417,2861,2,966358,0,2861,265,2862,441,0
20150106.091418,2861,24,966382,0,2861,265,2862,441,0
20150106.091419,2861,22,966404,-2,2861,261,2862,2453,0
20150106.091419,2862,46,966450,-6,2861,245,2862,2511,1
20150106.09142,2861,38,966488,-4,2861,281,2862,503,0
20150106.09142,2862,10,966498,2,2861,408,2862,500,1
20150106.091421,2861,36,966534,36,2861,445,2862,500,0
20150106.091421,2861,40,966574,40,2861,446,2862,505,0
20150106.091421,2862,12,966586,0,2861,447,2862,499,1
20150106.091422,2861,26,966612,6,2861,448,2862,509,0
20150106.091423,2862,2,966614,0,2861,453,2862,510,1
20150106.091424,2861,32,966646,20,2861,444,2862,519,0
20150106.091424,2862,20,966666,-20,2861,446,2862,509,1
20150106.091425,2861,400,967066,186,2861,307,2862,508,0
20150106.091426,2861,406,967472,198,2861,131,2862,511,0
20150106.091426,2861,244,967716,-236,2861,135,2862,429,0
20150106.091427,2861,64,967780,48,2861,112,2862,511,0
20150106.091427,2861,204,967984,16,2861,696,2862,561,0
20150106.091427,2862,2,967986,0,2861,708,2862,560,1
20150106.091428,2861,20,968006,18,2861,706,2862,719,0
20150106.091429,2861,38,968044,-2,2861,717,2862,673,0
20150106.091429,2862,80,968124,0,2861,718,2862,633,1
20150106.09143,2861,22,968146,-20,2861,719,2862,623,0
20150106.091431,2862,2,968148,-2,2861,732,2862,623,1
20150106.091431,2861,10,968158,-4,2861,731,2862,619,0
20150106.091432,2861,228,968386,-26,2861,646,2862,607,0
20150106.091432,2861,10,968396,0,2861,83,2862,614,0
20150106.091433,2862,22,968418,-20,2861,84,2862,603,1
20150106.091433,2862,26,968444,-20,2861,83,2862,606,1
20150106.091434,2861,2,968446,0,2861,83,2862,613,0
20150106.091435,2862,2,968448,-2,2861,98,2862,612,1
20150106.091435,2861,14,968462,0,2861,93,2862,624,0
20150106.091436,2861,16,968478,4,2861,680,2862,623,0
20150106.091436,2861,2,968480,0,2861,707,2862,624,0
20150106.091437,2862,22,968502,20,2861,745,2862,613,1
20150106.091438,2862,20,968522,20,2861,728,2862,605,1
20150106.091438,2861,10,968532,10,2861,726,2862,607,0
20150106.091439,2861,1000,969532,114,2861,232,2862,607,0
20150106.091439,2862,18,969550,18,2861,234,2862,604,1
20150106.09144,2861,2,969552,-2,2861,235,2862,615,0
20150106.09144,2862,10,969562,8,2861,263,2862,610,1
20150106.091441,2861,82,969644,-2,2861,222,2862,611,0
20150106.091441,2861,80,969724,0,2861,186,2862,611,0
20150106.091442,2861,80,969804,0,2861,248,2862,616,0
20150106.091442,2861,16,969820,12,2861,256,2862,610,0
20150106.091443,2862,8,969828,0,2861,269,2862,622,1
20150106.091443,2861,4,969832,0,2861,271,2862,620,0
20150106.091444,2862,204,970036,108,2861,170,2862,619,1
20150106.091444,2862,10,970046,10,2861,173,2862,671,1
20150106.091445,2861,22,970068,4,2861,181,2862,656,0
20150106.091446,2862,14,970082,14,2861,181,2862,653,1
20150106.091446,2861,4,970086,0,2861,180,2862,651,0
20150106.091447,2861,4,970090,4,2861,179,2862,650,0
20150106.091447,2862,2,970092,0,2861,181,2862,649,1
20150106.091448,2862,10,970102,8,2861,181,2862,646,1
20150106.091448,2861,384,970486,-278,2860,2926,2861,53,0
20150106.091449,2861,106,970592,-34,2861,5,2862,638,0
20150106.091449,2861,116,970708,-2,2861,1,2862,637,0
20150106.09145,2861,4,970712,2,2860,2937,2861,102,0
20150106.09145,2861,56,970768,-2,2860,2912,2861,104,0
20150106.091451,2861,14,970782,-10,2860,2887,2861,129,0
20150106.091452,2861,6,970788,-2,2860,2887,2861,127,0
20150106.091452,2861,4,970792,-4,2860,2888,2861,125,0
20150106.091453,2861,12,970804,0,2860,2889,2861,119,0
20150106.091453,2861,12,970816,-8,2860,2889,2861,113,0
20150106.091453,2861,32,970848,-32,2860,2824,2861,97,0
20150106.091454,2860,30,970878,0,2860,2814,2861,106,0
20150106.091454,2861,122,971000,-16,2860,2814,2861,46,1
20150106.091455,2861,98,971098,-42,2861,22,2862,659,1
20150106.091456,2862,2,971100,2,2861,73,2862,657,1
20150106.091456,2861,14,971114,-10,2861,74,2862,656,0
20150106.091457,2861,28,971142,0,2861,109,2862,652,0
20150106.091457,2861,102,971244,-12,2861,71,2862,652,0
20150106.091458,2861,16,971260,10,2861,77,2862,642,0
20150106.091459,2862,2,971262,2,2861,79,2862,641,1
20150106.091459,2861,24,971286,-2,2861,72,2862,642,0
20150106.0915,2862,26,971312,0,2861,162,2862,673,1
20150106.091501,2861,112,971424,-30,2861,147,2862,673,0
20150106.091501,2862,56,971480,46,2861,178,2862,678,1
20150106.091502,2861,8,971488,6,2861,174,2862,688,0
20150106.091503,2861,2,971490,2,2861,175,2862,711,0
20150106.091503,2861,6,971496,6,2861,173,2862,711,0
20150106.091504,2861,444,971940,210,2860,2955,2862,712,0
20150106.091504,2862,2,971942,0,2861,13,2862,711,1
20150106.091505,2861,6,971948,4,2861,12,2862,711,0
20150106.091506,2861,46,971994,40,2860,2920,2861,489,0
20150106.091506,2860,2,971996,-2,2860,2920,2861,492,0
20150106.091507,2861,28,972024,26,2860,2920,2861,529,1
20150106.091508,2861,2,972026,0,2860,2920,2861,533,1
20150106.091508,2860,8,972034,2,2860,2915,2861,539,0
20150106.091509,2861,8,972042,0,2860,2895,2861,550,1
20150106.091509,2861,20,972062,20,2860,2895,2861,540,1
20150106.09151,2861,822,972884,258,2860,2945,2861,142,1
20150106.09151,2862,290,973174,188,2861,111,2862,733,1
20150106.091511,2861,2,973176,0,2861,110,2862,734,0
20150106.091512,2862,56,973232,-24,2861,104,2862,711,1
20150106.091512,2861,518,973750,-86,2860,2792,2861,52,0
20150106.091513,2861,164,973914,102,2861,51,2862,725,0
20150106.091513,2861,8,973922,4,2861,48,2862,735,0
20150106.091514,2861,28,973950,0,2861,36,2862,736,0
20150106.091514,2861,136,974086,-68,2860,2814,2861,3,0
20150106.091515,2861,2,974088,0,2860,2766,2861,65,0
20150106.091516,2861,14,974102,-4,2860,2767,2861,90,0
20150106.091517,2861,12,974114,-12,2860,2759,2861,167,0
20150106.091517,2861,62,974176,-4,2860,2759,2861,136,0
20150106.091518,2861,30,974206,4,2860,2760,2861,121,0
20150106.091518,2860,476,974682,6,2860,2526,2861,117,0
20150106.091519,2861,24,974706,0,2860,2526,2861,105,1
20150106.091519,2861,222,974928,118,2861,424,2862,741,1
20150106.091519,2861,38,974966,2,2861,406,2862,748,1
20150106.09152,2861,22,974988,2,2861,414,2862,750,1
20150106.091521,2861,86,975074,6,2861,382,2862,750,1
20150106.091521,2861,2,975076,0,2861,386,2862,752,1
20150106.091522,2861,4,975080,0,2861,385,2862,753,1
20150106.091522,2861,2,975082,2,2861,385,2862,753,1
20150106.091524,2861,28,975110,8,2861,386,2862,773,1
20150106.091525,2861,26,975136,20,2861,373,2862,775,1
20150106.091525,2861,20,975156,0,2861,363,2862,775,1
20150106.091526,2861,62,975218,0,2861,335,2862,775,1
20150106.091527,2861,272,975490,2,2861,228,2862,763,1
20150106.091527,2861,40,975530,0,2861,209,2862,763,1
20150106.091528,2861,10,975540,10,2861,206,2862,773,1
20150106.091528,2861,2,975542,2,2861,207,2862,773,1
20150106.091529,2861,8,975550,0,2861,193,2862,781,1
20150106.091529,2861,6,975556,0,2861,190,2862,781,1
20150106.091531,2861,22,975578,18,2861,187,2862,781,1
20150106.091531,2861,36,975614,0,2861,174,2862,781,1
20150106.091532,2861,60,975674,0,2861,168,2862,781,1
20150106.091533,2861,4,975678,4,2861,169,2862,791,1
20150106.091533,2861,8,975686,4,2861,165,2862,791,1
20150106.091534,2861,8,975694,6,2861,161,2862,792,1
20150106.091534,2861,6,975700,2,2861,163,2862,792,1
20150106.091535,2861,46,975746,-8,2861,140,2862,792,1
20150106.091536,2861,6,975752,-4,2861,137,2862,795,1
20150106.091536,2861,8,975760,-4,2861,135,2862,798,1
20150106.091537,2861,210,975970,94,2861,30,2862,798,1
20150106.091537,2861,22,975992,16,2861,18,2862,799,1
20150106.091538,2861,34,976026,22,2861,2,2862,799,1
20150106.091538,2861,2,976028,0,2861,1,2862,800,1
20150106.091539,2861,6,976034,4,2860,2874,2861,42,1
20150106.091539,2861,10,976044,2,2860,2872,2861,61,1
20150106.09154,2861,4,976048,2,2860,2878,2861,61,1
20150106.09154,2861,22,976070,-4,2860,2869,2861,57,1
20150106.091541,2861,50,976120,10,2860,2870,2861,32,1
20150106.091542,2861,30,976150,-8,2860,2863,2861,36,1
20150106.091542,2860,2,976152,-2,2860,2859,2861,36,0
20150106.091543,2861,16,976168,-6,2860,2857,2861,30,1
20150106.091543,2861,84,976252,12,2861,52,2862,814,1
20150106.091544,2861,24,976276,10,2861,42,2862,810,1
20150106.091544,2861,6,976282,4,2861,40,2862,810,1
20150106.091545,2861,64,976346,0,2861,32,2862,820,1
20150106.091545,2861,10,976356,4,2861,31,2862,818,1
20150106.091546,2861,36,976392,6,2861,30,2862,802,1
20150106.091547,2862,10,976402,-8,2861,30,2862,897,1
20150106.091547,2861,2,976404,2,2861,29,2862,897,0
20150106.091548,2862,2,976406,2,2861,39,2862,898,1
20150106.091548,2861,2,976408,0,2861,39,2862,898,0
20150106.091548,2861,16,976424,-2,2861,51,2862,895,0
20150106.091549,2861,20,976444,0,2861,47,2862,891,0
20150106.09155,2861,30,976474,-4,2861,32,2862,890,0
20150106.09155,2861,10,976484,0,2861,26,2862,890,0
20150106.091551,2862,10,976494,-10,2861,32,2862,895,1
20150106.091552,2862,2,976496,0,2861,33,2862,894,1
20150106.091552,2861,22,976518,-4,2861,26,2862,894,0
20150106.091554,2861,58,976576,-34,2861,5,2862,894,0
20150106.091555,2861,30,976606,-26,2860,2873,2861,57,0
20150106.091555,2860,2,976608,0,2860,2872,2861,62,0
20150106.091556,2861,2,976610,0,2860,2873,2861,152,1
20150106.091556,2861,32,976642,-8,2860,2871,2861,139,1
20150106.091557,2861,2,976644,0,2860,2871,2861,177,1
20150106.091557,2860,2,976646,0,2860,2870,2861,182,0
20150106.091558,2861,26,976672,-4,2860,2866,2861,179,1
20150106.091558,2861,30,976702,-24,2860,2868,2861,169,1
20150106.091559,2861,36,976738,-34,2860,2863,2861,176,1
20150106.0916,2860,34,976772,-12,2860,2854,2861,170,0
20150106.091601,2861,14,976786,0,2860,2856,2861,164,1
20150106.091601,2861,2,976788,0,2860,2861,2861,163,1
20150106.091602,2861,2,976790,0,2860,2860,2861,169,1
20150106.091603,2861,38,976828,-16,2860,2845,2861,84,1
20150106.091603,2861,2,976830,2,2860,2848,2861,83,1
20150106.091604,2860,2,976832,-2,2860,2848,2861,83,0
20150106.091605,2861,10,976842,6,2860,2849,2861,85,1
20150106.091605,2861,306,977148,160,2860,2900,2861,4,1
20150106.091606,2861,114,977262,110,2861,2,2862,891,1
20150106.091606,2861,4,977266,-2,2861,18,2862,893,1
20150106.091607,2861,172,977438,0,2860,2870,2861,56,1
20150106.091607,2861,124,977562,-90,2861,31,2862,893,1
20150106.091608,2861,36,977598,-28,2861,110,2862,894,1
20150106.091609,2861,2,977600,0,2861,151,2862,888,1
20150106.09161,2861,8,977608,-6,2861,160,2862,895,1
20150106.091611,2861,2,977610,0,2861,162,2862,899,1
20150106.091612,2861,2,977612,0,2861,163,2862,916,1
20150106.091613,2861,6,977618,-2,2861,163,2862,913,1
20150106.091614,2861,52,977670,4,2861,136,2862,915,1
20150106.091614,2861,46,977716,-44,2861,191,2862,915,1
20150106.091614,2862,10,977726,0,2861,191,2862,910,1
20150106.091615,2862,4,977730,-4,2861,192,2862,908,1
20150106.091616,2861,104,977834,12,2861,206,2862,859,0
20150106.091617,2861,8,977842,-8,2861,228,2862,858,0
20150106.091617,2861,6,977848,0,2861,336,2862,848,0
20150106.091618,2861,404,978252,-340,2861,337,2862,647,0
20150106.09162,2862,22,978274,-12,2861,453,2862,641,1
20150106.091621,2862,2,978276,-2,2861,459,2862,638,1
20150106.091621,2861,2,978278,-2,2861,458,2862,638,0
20150106.091622,2862,8,978286,-6,2861,462,2862,636,1
20150106.091623,2861,8,978294,0,2861,463,2862,635,0
20150106.091624,2861,110,978404,-30,2861,410,2862,635,0
20150106.091625,2862,36,978440,-20,2861,484,2862,621,1
20150106.091625,2861,6,978446,2,2861,481,2862,622,0
20150106.091626,2861,62,978508,-12,2861,450,2862,622,0
20150106.091627,2862,416,978924,174,2861,442,2862,424,1
20150106.091628,2861,2,978926,0,2861,454,2862,425,0
20150106.091628,2862,428,979354,130,2861,452,2862,214,1
20150106.09163,2862,4,979358,-2,2861,467,2862,211,1
20150106.09163,2862,20,979378,0,2861,503,2862,205,1
20150106.091631,2862,24,979402,0,2861,507,2862,193,1
20150106.091632,2862,4,979406,2,2861,557,2862,193,1
20150106.091632,2862,10,979416,-4,2861,557,2862,188,1
20150106.091633,2862,10,979426,0,2861,557,2862,183,1
20150106.091633,2862,20,979446,0,2861,577,2862,173,1
20150106.091634,2862,6,979452,0,2861,584,2862,171,1
20150106.091635,2862,12,979464,0,2861,621,2862,165,1
20150106.091636,2862,18,979482,0,2861,624,2862,178,1
20150106.091636,2861,4,979486,4,2861,627,2862,180,0
20150106.091637,2861,10,979496,0,2861,634,2862,176,0
20150106.091637,2861,72,979568,0,2861,619,2862,141,0
20150106.091638,2861,132,979700,-18,2861,632,2862,92,0
20150106.091638,2862,16,979716,-12,2861,632,2862,86,1
20150106.091639,2862,78,979794,8,2861,633,2862,75,1
20150106.091639,2862,4,979798,-2,2861,643,2862,77,1
20150106.09164,2861,12,979810,10,2861,642,2862,72,0
20150106.091641,2862,4,979814,-2,2861,653,2862,70,1
20150106.091642,2862,10,979824,6,2861,653,2862,66,1
20150106.091642,2862,2,979826,2,2861,653,2862,65,1
20150106.091642,2861,600,980426,492,2861,353,2862,67,0
20150106.091643,2862,2,980428,2,2861,354,2862,69,1
20150106.091644,2861,36,980464,24,2861,373,2862,176,0
20150106.091645,2861,2,980466,2,2861,372,2862,194,0
20150106.091645,2861,18,980484,18,2861,364,2862,200,0
20150106.091646,2862,22,980506,8,2861,363,2862,190,1
20150106.091647,2862,2,980508,0,2861,366,2862,190,1
20150106.091649,2862,2,980510,0,2861,368,2862,200,1
20150106.09165,2861,2,980512,0,2861,368,2862,201,0
20150106.091652,2862,2,980514,-2,2861,377,2862,406,1
20150106.091653,2861,6,980520,0,2861,374,2862,409,0
20150106.091654,2861,184,980704,10,2861,284,2862,411,0
20150106.091654,2861,6,980710,0,2861,283,2862,430,0
20150106.091655,2862,4,980714,0,2861,284,2862,429,1
20150106.091655,2861,4,980718,0,2861,282,2862,429,0
20150106.091656,2862,6,980724,0,2861,283,2862,426,1
20150106.091658,2862,2,980726,0,2861,297,2862,425,1
20150106.091658,2862,2,980728,0,2861,300,2862,424,1
20150106.0917,2861,62,980790,58,2861,269,2862,438,0
20150106.0917,2861,4,980794,0,2861,268,2862,437,0
20150106.091701,2861,10,980804,0,2861,272,2862,450,0
20150106.091703,2861,16,980820,16,2861,267,2862,456,0
20150106.091704,2861,2,980822,2,2861,266,2862,463,0
20150106.091704,2861,6,980828,0,2861,265,2862,464,0
20150106.091705,2861,2,980830,0,2861,269,2862,464,0
20150106.091706,2861,4,980834,4,2861,267,2862,465,0
20150106.091706,2861,4,980838,2,2861,271,2862,491,0
20150106.091707,2861,2,980840,2,2861,270,2862,492,0
20150106.091708,2861,10,980850,-4,2861,269,2862,488,0
20150106.091708,2862,2,980852,0,2861,270,2862,487,1
20150106.091709,2861,100,980952,-96,2861,229,2862,488,0
20150106.09171,2862,2,980954,0,2861,229,2862,493,1
20150106.091711,2861,284,981238,-66,2861,108,2862,489,0
20150106.091712,2861,6,981244,-2,2861,122,2862,489,0
20150106.091712,2861,34,981278,6,2861,106,2862,490,0
20150106.091713,2861,204,981482,-190,2861,108,2862,389,0
20150106.091713,2861,170,981652,-126,2861,103,2862,309,0
20150106.091714,2861,16,981668,8,2861,127,2862,313,0
20150106.091714,2861,4,981672,0,2861,127,2862,316,0
20150106.091715,2861,10,981682,4,2861,165,2862,317,0
20150106.091715,2861,2,981684,-2,2861,164,2862,317,0
20150106.091717,2861,160,981844,-30,2861,126,2862,320,0
20150106.091718,2861,2,981846,2,2861,267,2862,322,0
20150106.091718,2862,10,981856,-6,2861,281,2862,320,1
20150106.09172,2861,120,981976,106,2861,232,2862,325,0
20150106.09172,2862,20,981996,0,2861,232,2862,337,1
20150106.091721,2861,4,982000,0,2861,230,2862,337,0
20150106.091722,2862,40,982040,22,2861,232,2862,318,1
20150106.091723,2861,18,982058,10,2861,223,2862,319,0
20150106.091724,2861,4,982062,0,2861,222,2862,317,0
20150106.091725,2862,2,982064,0,2861,242,2862,317,1
20150106.091726,2861,4,982068,4,2861,240,2862,329,0
20150106.091727,2861,4,982072,4,2861,238,2862,335,0
20150106.091728,2861,2,982074,2,2861,253,2862,335,0
20150106.09173,2861,2,982076,2,2861,260,2862,337,0
20150106.091731,2861,12,982088,6,2861,256,2862,339,0
20150106.091731,2862,92,982180,-72,2861,278,2862,294,1
20150106.091732,2862,28,982208,-12,2861,277,2862,302,1
20150106.091732,2862,12,982220,0,2861,277,2862,296,1
20150106.091733,2862,10,982230,0,2861,277,2862,306,1
20150106.091733,2862,50,982280,18,2861,279,2862,487,1
20150106.091734,2862,10,982290,-10,2861,383,2862,499,1
20150106.091735,2862,2,982292,-2,2861,384,2862,495,1
20150106.091735,2862,12,982304,-12,2861,384,2862,489,1
20150106.091736,2862,38,982342,-22,2861,383,2862,471,1
20150106.091737,2861,2,982344,2,2861,399,2862,475,0
20150106.091737,2861,60,982404,-24,2861,441,2862,484,0
20150106.091739,2861,2,982406,0,2861,467,2862,503,0
20150106.09174,2862,112,982518,-82,2861,469,2862,448,1
20150106.091741,2861,2,982520,-2,2861,468,2862,450,0
20150106.091742,2862,48,982568,16,2861,483,2862,428,1
20150106.091743,2862,12,982580,12,2861,483,2862,436,1
20150106.091743,2862,200,982780,0,2861,483,2862,336,1
20150106.091744,2862,22,982802,10,2861,485,2862,326,1
20150106.091744,2862,2,982804,0,2861,484,2862,331,1
20150106.091745,2862,220,983024,-88,2861,485,2862,248,1
20150106.091745,2861,206,983230,-74,2861,483,2863,1188,0
20150106.091746,2861,26,983256,0,2862,1,2863,1335,0
20150106.091746,2863,16,983272,4,2862,47,2863,1286,1
20150106.091747,2863,60,983332,56,2862,226,2863,1321,1
20150106.091747,2862,12,983344,12,2862,229,2863,1322,0
20150106.091747,2862,14,983358,0,2862,219,2863,1322,0
20150106.091748,2863,16,983374,0,2862,215,2863,1318,1
20150106.091749,2862,4,983378,4,2862,218,2863,1319,0
20150106.091751,2863,20,983398,0,2862,218,2863,1309,1
20150106.091751,2862,2,983400,2,2862,217,2863,1309,0
20150106.091752,2863,2,983402,-2,2862,217,2863,1308,1
20150106.091753,2863,2,983404,0,2862,229,2863,1352,1
20150106.091754,2863,2,983406,-2,2862,230,2863,1352,1
20150106.091754,2863,2,983408,0,2862,231,2863,1351,1
20150106.091755,2862,464,983872,-308,2861,621,2862,821,0
20150106.091756,2862,60,983932,-56,2861,821,2862,992,0
20150106.091756,2862,16,983948,0,2861,822,2862,985,0
20150106.091756,2862,8,983956,-8,2861,822,2862,984,0
20150106.091757,2862,6,983962,-2,2861,819,2862,1007,0
20150106.091757,2861,2,983964,0,2861,818,2862,1047,0
20150106.091758,2862,6,983970,-6,2861,800,2862,1080,1
20150106.0918,2862,4,983974,0,2861,796,2862,1141,1
20150106.091801,2861,4,983978,0,2861,793,2862,1154,0
20150106.091802,2861,2,983980,0,2861,793,2862,1156,0
20150106.091802,2862,8,983988,0,2861,793,2862,1152,1
20150106.091803,2861,2,983990,0,2861,803,2862,1642,0
20150106.091804,2862,2,983992,-2,2861,807,2862,1641,1
20150106.091805,2862,10,984002,0,2861,808,2862,1684,1
20150106.091806,2861,6,984008,0,2861,804,2862,1684,0
20150106.091808,2861,2,984010,0,2861,803,2862,1684,0
20150106.091808,2861,12,984022,0,2861,799,2862,1682,0
20150106.091809,2862,1014,985036,-12,2861,798,2862,1152,1
20150106.09181,2861,100,985136,0,2861,750,2862,1157,0
20150106.091811,2862,4,985140,-4,2861,1248,2862,1150,1
20150106.091812,2862,34,985174,-34,2861,1250,2862,1135,1
20150106.091812,2862,20,985194,-12,2861,1250,2862,1130,1
20150106.091813,2862,6,985200,-4,2861,1250,2862,1156,1
20150106.091814,2862,2,985202,0,2861,1252,2862,1155,1
20150106.091815,2861,2,985204,0,2861,1254,2862,1155,0
20150106.091816,2862,10,985214,0,2861,1318,2862,1150,1
20150106.091817,2862,10,985224,-10,2861,1319,2862,1156,1
20150106.091818,2861,2,985226,0,2861,1318,2862,1157,0
20150106.091818,2861,16,985242,0,2861,1310,2862,1177,0
20150106.09182,2862,6,985248,-2,2861,1309,2862,1175,1
20150106.091822,2862,100,985348,0,2861,1311,2862,1125,1
20150106.091822,2861,22,985370,-14,2861,1309,2862,1144,0
20150106.091823,2862,6,985376,-6,2861,1311,2862,1141,1
20150106.091824,2861,6,985382,0,2861,1320,2862,1141,0
20150106.091825,2862,2,985384,0,2861,1322,2862,1141,1
20150106.091826,2862,28,985412,-26,2861,1313,2862,1129,1
20150106.091826,2862,6,985418,-6,2861,1313,2862,1127,1
20150106.091827,2862,8,985426,0,2861,1311,2862,1126,1
20150106.091827,2862,20,985446,-20,2861,1326,2862,1116,1
20150106.091828,2862,32,985478,-32,2861,1326,2862,1100,1
20150106.091828,2861,12,985490,0,2861,1320,2862,1100,0
20150106.091831,2861,54,985544,-14,2861,1310,2862,1200,0
20150106.091832,2861,62,985606,-10,2861,1279,2862,1205,0
20150106.091832,2861,50,985656,-24,2861,1259,2862,1201,0
20150106.091833,2861,32,985688,-2,2861,1243,2862,1255,0
20150106.091835,2861,2,985690,2,2861,1241,2862,1295,0
20150106.091835,2861,4,985694,0,2861,1240,2862,1305,0
20150106.091836,2861,4,985698,2,2861,1238,2862,1301,0
20150106.091836,2861,2,985700,2,2861,1237,2862,1297,0
20150106.091837,2861,16,985716,-4,2861,1260,2862,1296,0
20150106.091838,2861,82,985798,-80,2861,1259,2862,1256,0
20150106.091838,2862,14,985812,-14,2861,1260,2862,1259,1
20150106.091839,2861,10,985822,-2,2861,1255,2862,1260,0
20150106.09184,2861,30,985852,8,2861,1280,2862,1261,0
20150106.091841,2861,2,985854,2,2861,1279,2862,1263,0
20150106.091844,2861,2,985856,0,2861,1280,2862,1273,0
20150106.091845,2861,4,985860,4,2861,1278,2862,1273,0
20150106.091846,2862,120,985980,-120,2861,1278,2862,1204,1
20150106.091846,2861,32,986012,20,2861,1269,2862,1199,0
20150106.091847,2861,2,986014,2,2861,1268,2862,1199,0
20150106.091847,2861,6,986020,-4,2861,1266,2862,1195,0
20150106.091848,2861,14,986034,0,2861,1259,2862,1196,0
20150106.091849,2861,10,986044,0,2861,1264,2862,1197,0
20150106.09185,2861,4,986048,4,2861,1263,2862,1174,0
20150106.091852,2861,2,986050,2,2861,1232,2862,1183,0
20150106.091852,2861,6,986056,0,2861,1229,2862,1184,0
20150106.091853,2861,2,986058,0,2861,1228,2862,1236,0
20150106.091854,2861,6,986064,0,2861,1226,2862,1236,0
20150106.091855,2861,2,986066,0,2861,1224,2862,1237,0
20150106.091856,2862,32,986098,-20,2861,1224,2862,1221,1
20150106.091857,2861,2,986100,0,2861,1223,2862,1222,0
20150106.091857,2861,20,986120,20,2861,1213,2862,1223,0
20150106.091858,2862,2,986122,0,2861,1220,2862,1226,1
20150106.0919,2861,10,986132,2,2861,1217,2862,1225,0
20150106.091901,2861,6,986138,6,2861,1219,2862,1225,0
20150106.091901,2861,400,986538,-170,2861,1021,2862,1225,0
20150106.091902,2861,2,986540,0,2861,1030,2862,1230,0
20150106.091902,2861,40,986580,0,2861,1010,2862,1230,0
20150106.091903,2861,2,986582,2,2861,1010,2862,1231,0
20150106.091903,2861,2,986584,2,2861,1009,2862,1231,0
20150106.091904,2861,2,986586,0,2861,1008,2862,1231,0
20150106.091904,2861,2,986588,0,2861,1007,2862,1231,0
20150106.091905,2861,24,986612,-18,2861,1003,2862,1224,0
20150106.091905,2861,4,986616,0,2861,1001,2862,1224,0
20150106.091907,2861,2,986618,0,2861,1011,2862,1259,0
20150106.091907,2861,2,986620,0,2861,1010,2862,1269,0
20150106.091909,2861,2,986622,0,2861,1008,2862,1281,0
20150106.091909,2861,6,986628,-6,2861,1005,2862,1281,0
20150106.09191,2861,8,986636,-4,2861,1013,2862,1281,0
20150106.09191,2861,208,986844,194,2861,1018,2862,1294,0
20150106.091911,2861,4,986848,0,2861,1016,2862,1294,0
20150106.091911,2861,10,986858,0,2861,1011,2862,1317,0
20150106.091912,2861,12,986870,2,2861,1005,2862,1317,0
20150106.091912,2861,24,986894,20,2861,992,2862,1317,0
20150106.091913,2861,12,986906,0,2861,1048,2862,1317,0
20150106.091914,2861,14,986920,2,2861,1041,2862,1368,0
20150106.091914,2861,18,986938,6,2861,1032,2862,1598,0
20150106.091915,2861,4,986942,0,2861,1030,2862,1598,0
20150106.091915,2862,12,986954,0,2861,1025,2862,1600,1
20150106.091915,2861,14,986968,0,2861,1018,2862,1600,0
20150106.091916,2861,204,987172,2,2861,914,2862,1538,0
20150106.091916,2861,130,987302,-2,2861,849,2862,1539,0
20150106.091917,2861,14,987316,-4,2861,842,2862,1546,0
20150106.091917,2861,14,987330,-6,2861,835,2862,915,0
20150106.091918,2861,12,987342,4,2861,872,2862,905,0
20150106.091918,2861,86,987428,12,2861,829,2862,905,0
20150106.091919,2861,4,987432,0,2861,827,2862,905,0
20150106.091919,2861,6,987438,2,2861,825,2862,905,0
20150106.09192,2861,2,987440,2,2861,824,2862,904,0
20150106.09192,2861,10,987450,2,2861,819,2862,904,0
20150106.091921,2861,18,987468,-2,2861,814,2862,904,0
20150106.091922,2862,10,987478,-2,2861,929,2862,902,1
20150106.091922,2861,10,987488,0,2861,924,2862,902,0
20150106.091923,2862,10,987498,0,2861,921,2862,900,1
20150106.091923,2861,108,987606,-100,2861,917,2862,849,0
20150106.091924,2861,18,987624,14,2861,910,2862,856,0
20150106.091925,2861,12,987636,0,2861,904,2862,873,0
20150106.091925,2861,4,987640,0,2861,905,2862,863,0
20150106.091925,2861,10,987650,2,2861,900,2862,864,0
20150106.091926,2862,34,987684,0,2861,899,2862,849,1
20150106.091928,2861,10,987694,2,2861,895,2862,853,0
20150106.091928,2861,14,987708,2,2861,888,2862,868,0
20150106.091929,2862,1004,988712,72,2861,887,2862,378,1
20150106.091929,2862,50,988762,2,2861,882,2862,371,1
20150106.09193,2861,26,988788,0,2861,873,2862,374,0
20150106.09193,2861,10,988798,2,2861,869,2862,372,0
20150106.091931,2862,6,988804,-2,2861,868,2862,372,1
20150106.091931,2861,10,988814,0,2861,866,2862,371,0
20150106.091932,2862,10,988824,0,2861,862,2862,376,1
20150106.091932,2862,204,989028,-94,2861,860,2862,277,1
20150106.091933,2861,8,989036,0,2861,858,2862,277,0
20150106.091933,2861,8,989044,0,2861,854,2862,277,0
20150106.091933,2861,204,989248,-124,2861,851,2862,175,0
20150106.091934,2861,14,989262,2,2861,847,2862,178,0
20150106.091935,2861,210,989472,-160,2861,844,2862,80,0
20150106.091935,2861,10,989482,0,2861,850,2862,79,0
20150106.091936,2862,262,989744,-16,2861,897,2862,3,1
20150106.091936,2862,10,989754,-4,2861,895,2862,51,1
20150106.091937,2861,38,989792,-8,2861,882,2862,47,0
20150106.091937,2862,212,990004,-98,2861,881,2862,2,1
20150106.091938,2861,12,990016,0,2861,878,2862,51,0
20150106.091938,2862,34,990050,26,2861,867,2862,88,1
20150106.091939,2861,4,990054,0,2861,891,2862,520,0
20150106.091939,2861,8,990062,0,2861,887,2862,530,0
20150106.09194,2861,10,990072,2,2861,882,2862,532,0
20150106.09194,2861,28,990100,0,2861,868,2862,542,0
20150106.091941,2862,10,990110,0,2861,867,2862,546,1
20150106.091941,2861,26,990136,2,2861,860,2862,541,0
20150106.091942,2861,8,990144,0,2861,857,2862,541,0
20150106.091942,2861,116,990260,100,2861,848,2862,534,0
20150106.091943,2861,16,990276,0,2861,841,2862,565,0
20150106.091944,2861,24,990300,0,2861,830,2862,569,0
20150106.091944,2861,18,990318,2,2861,821,2862,569,0
20150106.091945,2861,44,990362,28,2861,805,2862,568,0
20150106.091945,2861,22,990384,2,2861,813,2862,566,0
20150106.091945,2861,8,990392,0,2861,811,2862,567,0
20150106.091946,2861,18,990410,2,2861,802,2862,570,0
20150106.091946,2861,18,990428,2,2861,793,2862,570,0
20150106.091947,2861,8,990436,0,2861,789,2862,571,0
20150106.091947,2861,24,990460,0,2861,777,2862,571,0
20150106.091948,2862,20,990480,0,2861,771,2862,577,1
20150106.091948,2861,10,990490,0,2861,766,2862,577,0
20150106.091949,2861,24,990514,0,2861,754,2862,582,0
20150106.09195,2861,26,990540,0,2861,747,2862,577,0
20150106.09195,2861,16,990556,0,2861,739,2862,578,0
20150106.091951,2861,16,990572,0,2861,733,2862,580,0
20150106.091951,2862,52,990624,0,2861,728,2862,561,1
20150106.091952,2861,12,990636,0,2861,722,2862,563,0
20150106.091952,2861,8,990644,0,2861,718,2862,588,0
20150106.091953,2861,4,990648,0,2861,716,2862,684,0
20150106.091953,2861,4,990652,0,2861,714,2862,684,0
20150106.091954,2861,12,990664,0,2861,718,2862,689,0
20150106.091954,2861,8,990672,0,2861,714,2862,733,0
20150106.091955,2861,12,990684,2,2861,709,2862,772,0
20150106.091955,2861,8,990692,0,2861,719,2862,772,0
20150106.091956,2861,4,990696,0,2861,717,2862,782,0
20150106.091956,2861,6,990702,4,2861,715,2862,783,0
20150106.091957,2861,6,990708,0,2861,712,2862,883,0
20150106.091958,2862,2,990710,0,2861,712,2862,884,1
20150106.091959,2862,2,990712,2,2861,712,2862,882,1
20150106.091959,2861,12,990724,0,2861,1207,2862,883,0
20150106.091959,2861,4,990728,0,2861,1205,2862,803,0
20150106.092,2862,24,990752,0,2861,1205,2862,752,1
20150106.092001,2861,136,990888,-84,2861,1205,2862,690,0
20150106.092001,2862,114,991002,-102,2861,1204,2862,633,1
20150106.092003,2862,10,991012,0,2861,1199,2862,632,1
20150106.092004,2861,10,991022,0,2861,1196,2862,632,0
20150106.092005,2861,32,991054,6,2861,1211,2862,624,0
20150106.092006,2862,58,991112,-56,2861,1211,2862,605,1
20150106.092006,2861,204,991316,-196,2861,1209,2862,505,0
20150106.092006,2862,202,991518,-200,2861,1209,2862,414,1
20150106.092007,2862,212,991730,-152,2861,1212,2862,326,1
20150106.092008,2862,22,991752,2,2861,1211,2862,316,1
20150106.092008,2862,206,991958,-128,2861,1210,2862,216,1
20150106.092009,2862,98,992056,18,2861,1180,2862,232,1
20150106.092009,2862,466,992522,-180,2862,231,2863,2332,1
20150106.092009,2862,10,992532,-8,2862,243,2863,2283,1
20150106.09201,2862,208,992740,-208,2862,145,2863,2283,1
20150106.092011,2862,14,992754,-14,2862,140,2863,2283,1
20150106.092011,2862,2,992756,-2,2862,143,2863,2283,1
20150106.092012,2862,6,992762,-4,2862,140,2863,2283,1
20150106.092012,2862,16,992778,-16,2862,132,2863,2284,1
20150106.092013,2862,8,992786,-8,2862,190,2863,2284,1
20150106.092013,2862,8,992794,-8,2862,187,2863,2284,1
20150106.092014,2862,8,992802,-8,2862,193,2863,2284,1
20150106.092014,2862,14,992816,-14,2862,187,2863,2284,1
20150106.092014,2863,30,992846,30,2862,209,2863,2271,1
20150106.092015,2862,24,992870,-4,2862,315,2863,2271,0
20150106.092016,2862,2,992872,0,2862,320,2863,2271,0
20150106.092017,2863,4,992876,0,2862,321,2863,2269,1
20150106.092019,2862,2,992878,-2,2862,330,2863,2269,0
20150106.09202,2863,2,992880,2,2862,330,2863,2271,1
20150106.09202,2862,10,992890,-10,2862,340,2863,2271,0
20150106.092021,2863,2,992892,2,2862,342,2863,2269,1
20150106.092021,2862,2,992894,-2,2862,341,2863,2269,0
20150106.092022,2863,2,992896,2,2862,355,2863,2268,1
20150106.092022,2862,14,992910,0,2862,349,2863,2263,0
20150106.092023,2863,6,992916,6,2862,355,2863,2260,1
20150106.092023,2863,2,992918,2,2862,361,2863,2244,1
20150106.092024,2863,2,992920,0,2862,366,2863,2245,1
20150106.092024,2862,2,992922,0,2862,365,2863,2245,0
20150106.092025,2863,4,992926,2,2862,365,2863,2253,1
20150106.092026,2863,2,992928,2,2862,366,2863,2253,1
20150106.092026,2863,10,992938,10,2862,399,2863,2248,1
20150106.092027,2862,12,992950,2,2862,366,2863,2249,0
20150106.092029,2863,10,992960,0,2862,366,2863,2243,1
20150106.09203,2863,92,993052,0,2862,357,2863,2207,1
20150106.09203,2863,32,993084,30,2862,382,2863,2191,1
20150106.092032,2863,44,993128,14,2862,410,2863,2174,1
20150106.092033,2862,10,993138,0,2862,405,2863,2174,0
20150106.092034,2863,4,993142,-4,2862,455,2863,2173,1
20150106.092035,2862,20,993162,-20,2862,446,2863,2175,0
20150106.092036,2863,4,993166,0,2862,446,2863,2173,1
20150106.092037,2862,8,993174,-6,2862,463,2863,2173,0
20150106.092037,2863,102,993276,-14,2862,460,2863,2126,1
20150106.092038,2863,2334,995610,1056,2862,467,2864,346,1
20150106.092038,2863,52,995662,-50,2862,467,2864,330,1
20150106.092039,2863,360,996022,266,2862,468,2864,330,1
20150106.092039,2863,88,996110,48,2862,470,2863,365,1
20150106.092039,2863,252,996362,252,2862,471,2864,353,1
20150106.09204,2863,146,996508,144,2862,473,2864,348,1
20150106.09204,2863,2,996510,2,2862,473,2863,152,1
20150106.092041,2863,2,996512,2,2862,473,2863,114,1
20150106.092042,2863,6,996518,0,2862,496,2864,419,1
20150106.092042,2863,20,996538,8,2862,497,2864,418,1
20150106.092043,2864,2,996540,-2,2863,1,2864,956,1
20150106.092044,2863,82,996622,38,2863,3,2864,918,0
20150106.092044,2863,112,996734,-44,2863,1,2864,919,0
20150106.092045,2863,4,996738,-2,2863,63,2864,903,0
20150106.092045,2864,2,996740,2,2863,64,2864,903,1
20150106.092046,2864,12,996752,4,2863,60,2864,905,1
20150106.092046,2864,4,996756,-2,2863,60,2864,903,1
20150106.092047,2864,4,996760,-2,2863,77,2864,901,1
20150106.092047,2864,6,996766,-4,2863,79,2864,850,1
20150106.092048,2864,2,996768,-2,2863,79,2864,849,1
20150106.092048,2864,2,996770,0,2863,99,2864,848,1
20150106.092049,2864,104,996874,90,2863,150,2864,797,1
20150106.092049,2864,4,996878,-2,2863,152,2864,795,1
20150106.09205,2863,10,996888,0,2863,147,2864,807,0
20150106.09205,2864,30,996918,16,2863,142,2864,799,1
20150106.092051,2863,8,996926,8,2863,139,2864,800,0
20150106.092052,2863,2,996928,2,2863,145,2864,801,0
20150106.092054,2864,70,996998,68,2863,124,2864,790,1
20150106.092054,2864,4,997002,2,2863,135,2864,788,1
20150106.092055,2863,12,997014,0,2863,132,2864,788,0
20150106.092056,2864,4,997018,4,2863,144,2864,786,1
20150106.092056,2864,10,997028,2,2863,140,2864,785,1
20150106.092057,2864,24,997052,2,2863,157,2864,782,1
20150106.092058,2864,20,997072,20,2863,157,2864,772,1
20150106.092058,2864,20,997092,2,2863,156,2864,768,1
20150106.0921,2863,2,997094,2,2863,210,2864,767,0
20150106.092101,2864,2,997096,2,2863,210,2864,767,1
20150106.092101,2863,10,997106,-8,2863,205,2864,767,0
20150106.092103,2864,2,997108,2,2863,269,2864,766,1
20150106.092105,2863,2,997110,0,2863,268,2864,768,0
20150106.092106,2864,30,997140,0,2863,281,2864,758,1
20150106.092106,2863,20,997160,6,2863,277,2864,758,0
20150106.092108,2863,10,997170,10,2863,277,2864,760,0
20150106.092108,2864,12,997182,0,2863,285,2864,757,1
20150106.09211,2864,976,998158,-2,2863,321,2864,283,1
20150106.09211,2863,4,998162,0,2863,345,2864,276,0
20150106.092111,2864,22,998184,4,2863,343,2864,270,1
20150106.092112,2864,2,998186,2,2863,350,2864,290,1
20150106.092113,2863,128,998314,70,2863,354,2864,228,0
20150106.092114,2863,20,998334,-4,2863,517,2864,297,0
20150106.092114,2864,6,998340,-6,2863,518,2864,294,1
20150106.092115,2864,2,998342,-2,2863,491,2864,305,1
20150106.092116,2864,8,998350,-4,2863,466,2864,333,1
20150106.092116,2863,2,998352,2,2863,464,2864,341,0
20150106.092118,2864,8,998360,0,2863,469,2864,338,1
20150106.092118,2864,34,998394,-14,2863,465,2864,332,1
20150106.092119,2864,8,998402,-8,2863,466,2864,329,1
20150106.09212,2863,2,998404,0,2863,465,2864,360,0
20150106.09212,2863,2,998406,2,2863,467,2864,368,0
20150106.092121,2864,2,998408,-2,2863,470,2864,370,1
20150106.092121,2863,10,998418,10,2863,465,2864,374,0
20150106.092122,2863,202,998620,-182,2863,467,2864,275,0
20150106.092122,2863,6,998626,0,2863,466,2864,280,0
20150106.092123,2864,218,998844,-168,2863,461,2864,336,1
20150106.092123,2864,8,998852,0,2863,460,2864,336,1
20150106.092124,2864,220,999072,-188,2863,457,2864,297,1
20150106.092125,2863,4,999076,0,2863,457,2864,395,0
20150106.092125,2863,2,999078,2,2863,457,2864,395,0
20150106.092126,2864,2,999080,-2,2863,466,2864,398,1
20150106.092126,2864,220,999300,-184,2863,457,2864,291,1
20150106.092127,2863,2,999302,2,2863,457,2864,308,0
20150106.092127,2864,12,999314,0,2863,451,2864,301,1
20150106.092128,2864,200,999514,-200,2863,452,2864,256,1
20150106.092129,2864,24,999538,-24,2863,452,2864,276,1
20150106.092129,2864,8,999546,-4,2863,452,2864,278,1
20150106.09213,2863,204,999750,-200,2863,450,2864,173,0
20150106.092131,2863,6,999756,2,2863,448,2864,168,0
20150106.092131,2863,2,999758,2,2863,446,2864,210,0
20150106.092132,2864,304,1000062,-114,2863,430,2864,62,1
20150106.092133,2864,304,1000366,-70,2863,479,2865,1915,1
20150106.092133,2863,8,1000374,-2,2863,428,2864,132,0
20150106.092134,2864,10,1000384,2,2863,427,2864,196,1
20150106.092135,2864,2,1000386,0,2863,428,2864,283,1
20150106.092135,2864,6,1000392,4,2863,428,2864,289,1
20150106.092136,2864,4,1000396,4,2863,423,2864,528,1
20150106.092136,2864,6,1000402,4,2863,424,2864,586,1
20150106.092137,2863,20,1000422,0,2863,416,2864,580,0
20150106.092137,2864,12,1000434,10,2863,415,2864,580,1
20150106.092138,2864,58,1000492,-20,2863,389,2864,709,1
20150106.092138,2863,786,1001278,-162,2862,530,2863,126,0
20150106.092139,2863,14,1001292,0,2862,516,2863,145,0
20150106.09214,2863,70,1001362,30,2862,513,2863,200,0
20150106.092141,2863,6,1001368,6,2862,513,2863,198,0
20150106.092141,2863,44,1001412,20,2862,513,2863,176,0
20150106.092142,2863,2,1001414,0,2862,528,2863,175,0
20150106.092142,2863,2,1001416,2,2862,528,2863,176,0
20150106.092143,2863,2,1001418,0,2862,543,2863,175,0
20150106.092144,2863,4,1001422,4,2862,573,2863,177,0
20150106.092145,2863,224,1001646,-100,2862,573,2863,73,0
20150106.092145,2863,10,1001656,-4,2862,585,2863,68,0
20150106.092146,2863,16,1001672,4,2862,577,2863,105,0
20150106.092147,2863,12,1001684,12,2862,583,2863,99,0
20150106.092147,2863,4,1001688,4,2862,583,2863,96,0
20150106.092148,2863,8,1001696,8,2862,584,2863,96,0
20150106.092148,2863,8,1001704,8,2862,594,2863,96,0
20150106.092149,2863,20,1001724,0,2862,594,2863,91,0
20150106.092149,2863,6,1001730,6,2862,595,2863,87,0
20150106.09215,2863,42,1001772,38,2862,595,2863,69,0
20150106.092151,2863,10,1001782,8,2862,594,2863,62,0
20150106.092152,2862,2,1001784,-2,2862,594,2863,71,0
20150106.092153,2862,4,1001788,0,2862,603,2863,87,0
20150106.092154,2862,2,1001790,0,2862,602,2863,94,0
20150106.092157,2862,2,1001792,0,2862,601,2863,94,0
20150106.092157,2862,4,1001796,-2,2862,599,2863,95,0
20150106.092158,2863,192,1001988,-136,2863,56,2864,984,1
20150106.092158,2863,10,1001998,-4,2863,103,2864,792,1
20150106.092159,2863,4,1002002,0,2863,170,2864,757,1
20150106.0922,2863,24,1002026,-22,2863,158,2864,767,1
20150106.092201,2863,40,1002066,0,2863,139,2864,757,1
20150106.092202,2863,2,1002068,-2,2863,138,2864,758,1
20150106.092202,2863,4,1002072,-2,2863,136,2864,757,1
20150106.092203,2863,14,1002086,-12,2863,131,2864,766,1
20150106.092204,2863,2,1002088,0,2863,130,2864,821,1
20150106.092205,2863,6,1002094,0,2863,131,2864,833,1
20150106.092206,2863,24,1002118,0,2863,119,2864,834,1
20150106.092206,2863,240,1002358,-230,2862,644,2863,51,1
20150106.092207,2863,4,1002362,-2,2862,594,2863,71,1
20150106.092207,2863,24,1002386,20,2862,591,2863,59,1
20150106.092208,2862,4,1002390,0,2862,589,2863,65,0
20150106.092209,2862,20,1002410,0,2862,629,2863,84,0
20150106.092211,2863,192,1002602,-48,2863,174,2864,815,1
20150106.092211,2863,6,1002608,-2,2863,322,2864,814,1
20150106.092212,2863,12,1002620,0,2863,367,2864,838,1
20150106.092214,2863,14,1002634,-12,2863,370,2864,1050,1
20150106.092214,2863,2,1002636,-2,2863,376,2864,1052,1
20150106.092215,2863,2,1002638,0,2863,375,2864,1062,1
20150106.092216,2863,2,1002640,0,2863,374,2864,1062,1
20150106.092216,2863,22,1002662,-10,2863,381,2864,1062,1
20150106.092217,2863,10,1002672,0,2863,376,2864,1016,1
20150106.092217,2864,12,1002684,-6,2863,373,2864,1013,1
20150106.092218,2863,4,1002688,0,2863,372,2864,1018,0
20150106.092218,2863,12,1002700,-12,2863,366,2864,1021,0
20150106.092219,2864,1600,1004300,-702,2863,375,2864,249,1
20150106.09222,2863,20,1004320,-2,2863,369,2864,192,0
20150106.09222,2864,220,1004540,-220,2863,370,2864,83,1
20150106.092221,2863,6,1004546,-6,2863,367,2864,83,0
20150106.092221,2864,168,1004714,-86,2864,96,2865,1867,1
20150106.092222,2863,230,1004944,94,2863,451,2864,4,0
20150106.092222,2864,248,1005192,-86,2864,28,2865,1867,1
20150106.092223,2864,12,1005204,-12,2864,67,2865,1865,1
20150106.092223,2864,8,1005212,-4,2864,63,2865,1865,1
20150106.092224,2864,6,1005218,-4,2864,61,2865,1866,1
20150106.092224,2864,4,1005222,-4,2864,59,2865,1862,1
20150106.092225,2864,4,1005226,-4,2864,57,2865,1861,1
20150106.092225,2864,26,1005252,-18,2864,45,2865,1861,1
20150106.092226,2865,6,1005258,0,2864,66,2865,1860,1
20150106.092226,2864,58,1005316,2,2864,61,2865,1843,0
20150106.092227,2864,122,1005438,68,2863,538,2864,49,0
20150106.092227,2864,20,1005458,-4,2863,489,2864,92,0
20150106.092228,2864,186,1005644,-82,2864,63,2865,1836,0
20150106.092228,2864,46,1005690,-22,2864,91,2865,1834,0
20150106.092229,2864,22,1005712,10,2864,80,2865,1834,0
20150106.092229,2864,4,1005716,0,2864,165,2865,1836,0
20150106.09223,2865,10,1005726,10,2864,167,2865,1831,1
20150106.09223,2865,4,1005730,2,2864,176,2865,1830,1
20150106.092231,2865,14,1005744,0,2864,179,2865,1810,1
20150106.092231,2864,42,1005786,42,2864,162,2865,1814,0
20150106.092232,2864,72,1005858,-2,2864,248,2865,1789,0
20150106.092233,2865,26,1005884,6,2864,240,2865,1783,1
20150106.092233,2864,100,1005984,2,2864,190,2865,1786,0
20150106.092234,2864,2,1005986,0,2864,190,2865,1787,0
20150106.092235,2864,88,1006074,-4,2864,148,2865,1802,0
20150106.092236,2864,12,1006086,0,2864,147,2865,1797,0
20150106.092236,2864,6,1006092,-4,2864,144,2865,1797,0
20150106.092237,2864,10,1006102,-6,2864,229,2865,1797,0
20150106.092237,2865,2,1006104,0,2864,243,2865,1797,1
20150106.092237,2864,4,1006108,-4,2864,242,2865,1788,0
20150106.092238,2864,2,1006110,0,2864,249,2865,1793,0
20150106.092239,2865,4,1006114,2,2864,249,2865,1797,1
20150106.092241,2865,2,1006116,2,2864,269,2865,1816,1
20150106.092242,2864,12,1006128,8,2864,268,2865,1823,0
20150106.092243,2865,2,1006130,2,2864,269,2865,1822,1
20150106.092244,2865,18,1006148,10,2864,267,2865,1815,1
20150106.092244,2864,6,1006154,0,2864,264,2865,1815,0
20150106.092245,2864,12,1006166,0,2864,295,2865,1829,0
20150106.092246,2865,20,1006186,16,2864,344,2865,1819,1
20150106.092246,2865,4,1006190,2,2864,344,2865,1820,1
20150106.092247,2864,20,1006210,-18,2864,365,2865,1820,0
20150106.092248,2864,20,1006230,10,2864,356,2865,1823,0
20150106.092249,2865,40,1006270,40,2864,366,2865,1804,1
20150106.09225,2865,10,1006280,10,2864,366,2865,1778,1
20150106.092251,2865,4,1006284,4,2864,469,2865,1774,1
20150106.092251,2865,10,1006294,10,2864,469,2865,1777,1
20150106.092252,2864,202,1006496,12,2864,372,2865,1778,0
20150106.092253,2865,12,1006508,12,2864,372,2865,1778,1
20150106.092254,2865,4,1006512,0,2864,371,2865,1778,1
20150106.092254,2865,2,1006514,0,2864,368,2865,1779,1
20150106.092255,2864,12,1006526,0,2864,362,2865,1804,0
20150106.092257,2865,18,1006544,-6,2864,362,2865,1809,1
20150106.092257,2864,4,1006548,-4,2864,463,2865,1808,0
20150106.092258,2865,4,1006552,-4,2864,464,2865,1807,1
20150106.092258,2864,2,1006554,0,2864,465,2865,1857,0
20150106.092259,2865,12,1006566,-2,2864,1266,2865,1839,1
20150106.0923,2864,112,1006678,84,2864,1262,2865,1769,0
20150106.092301,2865,6,1006684,0,2864,1246,2865,1766,1
20150106.092302,2864,10,1006694,-6,2864,1242,2865,1763,0
20150106.092302,2865,230,1006924,2,2864,1241,2865,1609,1
20150106.092303,2864,14,1006938,-12,2864,1237,2865,1608,0
20150106.092304,2864,46,1006984,38,2864,1234,2865,1588,0
20150106.092304,2864,2,1006986,0,2864,1233,2865,1587,0
20150106.092305,2864,6,1006992,4,2864,1262,2865,1591,0
20150106.092306,2865,20,1007012,0,2864,1263,2865,1554,1
20150106.092307,2865,2,1007014,2,2864,1263,2865,1554,1
20150106.092308,2865,2,1007016,2,2864,1265,2865,1544,1
20150106.092309,2865,6,1007022,2,2864,1265,2865,1545,1
20150106.092309,2864,10,1007032,-10,2864,1260,2865,1545,0
20150106.09231,2864,12,1007044,-6,2864,1256,2865,1545,0
20150106.092311,2865,1006,1008050,-736,2864,1256,2865,1028,1
20150106.092312,2865,14,1008064,-14,2864,1267,2865,1035,1
20150106.092313,2865,6,1008070,-6,2864,1267,2865,1033,1
20150106.092314,2864,20,1008090,0,2864,1259,2865,1033,0
20150106.092314,2864,6,1008096,0,2864,1256,2865,1035,0
20150106.092315,2865,2,1008098,-2,2864,1256,2865,1034,1
20150106.092316,2865,12,1008110,-6,2864,1258,2865,1033,1
20150106.092318,2865,2,1008112,0,2864,1229,2865,1034,1
20150106.092319,2864,4,1008116,-2,2864,1230,2865,1032,0
20150106.09232,2864,2,1008118,0,2864,1230,2865,1032,0
20150106.09232,2864,8,1008126,-2,2864,1228,2865,1030,0
20150106.092321,2865,2,1008128,0,2864,1228,2865,1032,1
20150106.092321,2864,70,1008198,0,2864,1183,2865,1033,0
20150106.092325,2865,16,1008214,-6,2864,1184,2865,1066,1
20150106.092326,2864,66,1008280,-58,2864,1181,2865,1030,0
20150106.092327,2864,16,1008296,4,2864,1175,2865,1030,0
20150106.092328,2864,16,1008312,0,2864,1168,2865,1059,0
20150106.092329,2865,2,1008314,-2,2864,1168,2865,1063,1
20150106.09233,2864,6,1008320,-6,2864,1167,2865,1062,0
20150106.092331,2865,2,1008322,0,2864,1167,2865,1061,1
20150106.092331,2865,602,1008924,-366,2864,1166,2865,710,1
20150106.092332,2864,14,1008938,-8,2864,1162,2865,711,0
20150106.092333,2864,18,1008956,-12,2864,1157,2865,721,0
20150106.092333,2865,632,1009588,-108,2864,1180,2866,553,1
20150106.092334,2865,52,1009640,24,2864,1178,2866,553,1
20150106.092334,2865,2,1009642,2,2864,1178,2866,554,1
20150106.092335,2865,18,1009660,2,2864,1179,2865,365,1
20150106.092336,2864,12,1009672,0,2864,1171,2865,571,0
20150106.092337,2865,2,1009674,0,2864,1172,2865,662,1
20150106.09234,2865,10,1009684,-6,2864,1202,2865,677,1
20150106.092345,2865,2,1009686,0,2864,1205,2865,774,1
20150106.092345,2864,12,1009698,-4,2864,1199,2865,780,0
20150106.092348,2865,2,1009700,0,2864,1222,2865,842,1
20150106.092349,2865,2,1009702,-2,2864,1224,2865,842,1
20150106.09235,2864,6,1009708,-4,2864,1247,2865,841,0
20150106.09235,2865,200,1009908,-200,2864,1247,2865,741,1
20150106.092351,2865,100,1010008,-100,2864,1247,2865,694,1
20150106.092351,2865,218,1010226,-104,2864,1247,2865,587,1
20150106.092352,2865,204,1010430,-26,2864,1247,2865,486,1
20150106.092353,2864,214,1010644,-202,2864,1246,2865,384,0
20150106.092354,2864,22,1010666,-2,2864,1245,2865,376,0
20150106.092354,2865,2,1010668,0,2864,1245,2865,405,1
20150106.092355,2865,224,1010892,-78,2864,1245,2865,306,1
20150106.092355,2865,204,1011096,2,2864,1245,2866,630,1
20150106.092356,2865,20,1011116,-16,2865,55,2866,1341,1
20150106.092357,2866,16,1011132,-10,2865,236,2866,1340,1
20150106.092357,2865,48,1011180,-14,2865,288,2866,1340,0
20150106.092358,2866,8,1011188,0,2865,347,2866,1339,1
20150106.092358,2865,68,1011256,-46,2865,342,2866,1311,0
20150106.092359,2865,30,1011286,-8,2865,331,2866,1307,0
20150106.092359,2865,48,1011334,32,2865,328,2866,1287,0
20150106.0924,2866,32,1011366,0,2865,370,2866,1280,1
20150106.0924,2866,6,1011372,0,2865,368,2866,1280,1
20150106.092401,2865,12,1011384,-4,2865,365,2866,1281,0
20150106.092401,2865,4,1011388,0,2865,364,2866,1283,0
20150106.092402,2865,6,1011394,-4,2865,362,2866,1283,0
20150106.092402,2865,20,1011414,-14,2865,353,2866,1287,0
20150106.092403,2865,14,1011428,-6,2865,348,2866,1287,0
20150106.092403,2865,14,1011442,-10,2865,341,2866,1288,0
20150106.092404,2865,48,1011490,26,2865,333,2866,1272,0
20150106.092404,2865,22,1011512,2,2865,340,2866,1219,0
20150106.092405,2865,4,1011516,0,2865,359,2866,1219,0
20150106.092405,2865,16,1011532,-10,2865,357,2866,1216,0
20150106.092406,2865,4,1011536,-4,2865,353,2866,1216,0
20150106.092406,2866,70,1011606,-6,2865,319,2866,1215,1
20150106.092407,2865,10,1011616,0,2865,314,2866,1316,0
20150106.092407,2865,110,1011726,0,2865,258,2866,1261,0
20150106.092408,2865,222,1011948,-208,2865,148,2866,1261,0
20150106.092408,2865,300,1012248,208,2864,1209,2865,95,0
20150106.092409,2865,268,1012516,174,2864,1150,2865,31,0
20150106.092409,2865,100,1012616,-4,2865,53,2866,1235,0
20150106.09241,2865,14,1012630,10,2865,51,2866,1211,0
20150106.092411,2865,76,1012706,76,2865,14,2866,1210,0
20150106.092411,2865,46,1012752,18,2865,94,2866,1189,0
20150106.092412,2865,102,1012854,0,2865,48,2866,1144,0
20150106.092412,2865,112,1012966,16,2864,1148,2865,31,0
20150106.092413,2864,8,1012974,2,2864,1147,2865,60,0
20150106.092414,2865,166,1013140,-10,2865,172,2866,1066,1
20150106.092415,2865,204,1013344,-34,2865,85,2866,1266,1
20150106.092415,2865,8,1013352,6,2865,103,2866,1266,1
20150106.092416,2865,212,1013564,-74,2864,1046,2865,51,1
20150106.092416,2866,108,1013672,-92,2865,50,2866,1272,1
20150106.092417,2865,28,1013700,0,2865,36,2866,1272,0
20150106.092418,2865,82,1013782,4,2864,1046,2865,131,0
20150106.092418,2865,6,1013788,2,2864,1046,2865,142,0
20150106.092419,2865,4,1013792,4,2864,1047,2865,201,0
20150106.092419,2865,412,1014204,32,2864,1047,2865,43,0
20150106.09242,2865,100,1014304,26,2865,139,2866,1272,0
20150106.09242,2865,10,1014314,0,2865,97,2866,1272,0
20150106.09242,2865,150,1014464,86,2865,24,2866,1261,0
20150106.092421,2865,8,1014472,-2,2865,20,2866,1262,0
20150106.092421,2865,62,1014534,-18,2864,1047,2865,77,0
20150106.092422,2864,6,1014540,-4,2864,1044,2865,98,0
20150106.092424,2864,4,1014544,4,2864,1042,2865,116,0
20150106.092425,2865,24,1014568,-14,2864,1042,2865,127,1
20150106.092427,2864,2,1014570,0,2864,1045,2865,151,0
20150106.092427,2865,4,1014574,-4,2864,1045,2865,155,1
20150106.092429,2864,4,1014578,0,2864,1043,2865,200,0
20150106.09243,2865,2,1014580,-2,2864,1028,2865,203,1
20150106.09243,2864,12,1014592,6,2864,1022,2865,290,0
20150106.092431,2865,6,1014598,0,2864,1024,2865,289,1
20150106.092433,2864,2,1014600,2,2864,1024,2865,343,0
20150106.092433,2865,20,1014620,6,2864,1024,2865,345,1
20150106.092433,2864,20,1014640,20,2864,1014,2865,345,0
20150106.092435,2864,2,1014642,0,2864,1023,2865,375,0
20150106.092435,2864,4,1014646,0,2864,1021,2865,436,0
20150106.092437,2864,602,1015248,-514,2864,721,2865,434,0
20150106.092437,2865,10,1015258,-2,2864,715,2865,481,1
20150106.092437,2864,1200,1016458,-1110,2864,115,2865,481,0
20150106.092438,2864,232,1016690,-92,2863,704,2864,53,0
20150106.092438,2864,12,1016702,-6,2863,707,2864,111,0
20150106.092439,2864,2,1016704,0,2863,710,2864,118,0
20150106.092442,2864,2,1016706,-2,2863,707,2864,123,0
20150106.092442,2863,20,1016726,20,2863,694,2864,123,0
20150106.092443,2863,2,1016728,2,2863,690,2864,124,0
20150106.092444,2863,12,1016740,-10,2863,689,2864,118,0
20150106.092444,2864,12,1016752,0,2863,689,2864,113,1
20150106.092446,2864,2,1016754,-2,2863,692,2864,113,1
20150106.092449,2863,4,1016758,2,2863,708,2864,126,0
20150106.09245,2863,2,1016760,2,2863,707,2864,129,0
20150106.092451,2863,10,1016770,10,2863,706,2864,137,0
20150106.092452,2864,4,1016774,0,2863,707,2864,136,1
20150106.092452,2863,600,1017374,-4,2863,419,2864,159,0
20150106.092453,2863,46,1017420,30,2863,392,2864,176,0
20150106.092454,2864,44,1017464,-38,2863,386,2864,175,1
20150106.092455,2863,2,1017466,2,2863,385,2864,177,0
20150106.092455,2863,4,1017470,-2,2863,385,2864,182,0
20150106.092457,2863,4,1017474,0,2863,388,2864,265,0
20150106.092458,2863,40,1017514,-38,2863,368,2864,268,0
20150106.092458,2863,8,1017522,-4,2863,367,2864,280,0
20150106.092459,2864,8,1017530,-4,2863,367,2864,279,1
20150106.092459,2864,38,1017568,-26,2863,349,2864,280,1
20150106.0925,2863,4,1017572,-4,2863,347,2864,265,0
20150106.0925,2864,18,1017590,-12,2863,347,2864,264,1
20150106.092501,2863,6,1017596,-4,2863,344,2864,266,0
20150106.092502,2864,2,1017598,0,2863,343,2864,266,1
20150106.092502,2864,4,1017602,2,2863,343,2864,265,1
20150106.092502,2863,602,1018204,-520,2863,44,2864,265,0
20150106.092503,2863,2,1018206,0,2863,100,2864,297,0
20150106.092504,2863,28,1018234,10,2863,105,2864,304,0
20150106.092504,2863,10,1018244,0,2863,102,2864,304,0
20150106.092504,2864,2,1018246,2,2863,102,2864,303,1
20150106.092505,2863,8,1018254,6,2863,109,2864,307,0
20150106.092506,2863,4,1018258,2,2863,122,2864,332,0
20150106.092506,2864,2,1018260,2,2863,132,2864,331,1
20150106.092506,2863,4,1018264,0,2863,132,2864,340,0
20150106.092507,2864,2,1018266,2,2863,132,2864,339,1
20150106.092508,2863,4,1018270,4,2863,134,2864,341,0
20150106.092508,2863,40,1018310,0,2863,115,2864,341,0
20150106.092509,2863,2,1018312,2,2863,119,2864,341,0
20150106.09251,2863,62,1018374,22,2863,90,2864,343,0
20150106.092511,2863,4,1018378,-2,2863,88,2864,344,0
20150106.092512,2863,182,1018560,-82,2862,957,2863,116,0
20150106.092512,2863,2,1018562,-2,2862,652,2863,115,0
20150106.092513,2862,2,1018564,-2,2862,650,2863,139,0
20150106.092514,2863,10,1018574,-4,2862,657,2863,134,1
20150106.092515,2863,6,1018580,-6,2862,658,2863,133,1
20150106.092515,2862,10,1018590,-10,2862,655,2863,133,0
20150106.092517,2862,22,1018612,-20,2862,646,2863,133,0
20150106.092518,2862,6,1018618,-6,2862,643,2863,146,0
20150106.092519,2862,2,1018620,-2,2862,643,2863,150,0
20150106.09252,2863,22,1018642,-20,2862,644,2863,140,1
20150106.09252,2862,20,1018662,-20,2862,634,2863,140,0
20150106.092521,2863,10,1018672,0,2862,634,2863,136,1
20150106.092521,2862,10,1018682,-4,2862,632,2863,133,0
20150106.092522,2862,4,1018686,-4,2862,615,2863,133,0
20150106.092522,2862,204,1018890,28,2862,614,2863,33,0
20150106.092523,2862,26,1018916,-2,2862,608,2863,26,0
20150106.092523,2862,40,1018956,-20,2862,587,2863,26,0
20150106.092524,2862,4,1018960,-4,2862,570,2863,34,0
20150106.092524,2863,2,1018962,0,2862,573,2863,40,1
20150106.092525,2863,2,1018964,-2,2862,574,2863,39,1
20150106.092526,2862,2,1018966,0,2862,573,2863,40,0
20150106.092526,2862,20,1018986,-20,2862,568,2863,42,0
20150106.092527,2862,602,1019588,-136,2862,284,2863,42,0
20150106.092527,2863,4,1019592,-4,2862,287,2863,52,1
20150106.092528,2862,20,1019612,0,2862,287,2863,59,0
20150106.092528,2862,4,1019616,2,2862,285,2863,158,0
20150106.092529,2862,328,1019944,-130,2862,118,2863,176,0
20150106.09253,2862,20,1019964,-16,2862,105,2863,265,0
20150106.09253,2862,2,1019966,-2,2862,104,2863,269,0
20150106.092531,2862,6,1019972,0,2862,134,2863,271,0
20150106.092531,2862,10,1019982,10,2862,135,2863,271,0
20150106.092532,2862,22,1020004,-20,2862,129,2863,271,0
20150106.092533,2862,22,1020026,0,2862,118,2863,272,0
20150106.092534,2862,28,1020054,-20,2862,110,2863,278,0
20150106.092535,2862,4,1020058,0,2862,120,2863,292,0
20150106.092536,2862,26,1020084,6,2862,118,2863,282,0
20150106.092537,2862,4,1020088,-2,2862,116,2863,283,0
20150106.092537,2862,30,1020118,0,2862,101,2863,308,0
20150106.092538,2862,4,1020122,0,2862,99,2863,309,0
20150106.092538,2862,10,1020132,6,2862,106,2863,309,0
20150106.092539,2862,2,1020134,2,2862,105,2863,309,0
20150106.092542,2862,2,1020136,0,2862,118,2863,340,0
20150106.092542,2862,82,1020218,26,2862,78,2863,340,0
20150106.092543,2862,4,1020222,-4,2862,76,2863,351,0
20150106.092543,2862,12,1020234,-10,2862,70,2863,350,0
20150106.092544,2862,2,1020236,0,2862,69,2863,356,0
20150106.092544,2862,6,1020242,0,2862,67,2863,357,0
20150106.092546,2862,104,1020346,58,2862,27,2863,351,0
20150106.092547,2862,34,1020380,-14,2862,19,2863,357,0
20150106.092548,2862,10,1020390,-4,2862,16,2863,360,0
20150106.092549,2862,2,1020392,-2,2862,15,2863,361,0
20150106.092549,2862,2,1020394,0,2862,16,2863,361,0
20150106.09255,2862,2,1020396,0,2862,15,2863,365,0
20150106.092551,2862,38,1020434,16,2862,1,2863,425,0
20150106.092553,2862,36,1020470,36,2862,105,2863,423,0
20150106.092553,2862,2,1020472,2,2862,106,2863,423,0
20150106.092554,2862,134,1020606,132,2862,37,2863,422,0
20150106.092555,2862,16,1020622,16,2862,30,2863,427,0
20150106.092555,2862,10,1020632,8,2862,16,2863,425,0
20150106.092556,2862,142,1020774,26,2861,1058,2862,51,0
20150106.092557,2862,104,1020878,-98,2862,112,2863,378,0
20150106.092557,2862,22,1020900,12,2862,103,2863,369,0
20150106.092558,2862,6,1020906,6,2862,110,2863,372,0
20150106.092558,2863,2,1020908,0,2862,111,2863,371,1
20150106.092559,2862,16,1020924,16,2862,104,2863,373,0
20150106.0926,2862,82,1021006,40,2862,68,2863,373,0
20150106.092602,2862,20,1021026,0,2862,92,2863,370,0
20150106.092602,2862,10,1021036,10,2862,93,2863,370,0
20150106.092603,2863,4,1021040,2,2862,155,2863,368,1
20150106.092604,2862,4,1021044,4,2862,155,2863,370,0
20150106.092605,2862,2,1021046,2,2862,154,2863,370,0
20150106.092606,2863,20,1021066,-18,2862,162,2863,360,1
20150106.092607,2862,4,1021070,4,2862,167,2863,361,0
20150106.092609,2862,4,1021074,4,2862,212,2863,363,0
20150106.09261,2862,2,1021076,0,2862,212,2863,363,0
20150106.09261,2862,2,1021078,0,2862,212,2863,363,0
20150106.092611,2863,600,1021678,-298,2862,269,2863,63,1
20150106.092612,2863,6,1021684,-2,2862,305,2863,60,1
20150106.092614,2863,112,1021796,-42,2862,280,2863,5,1
20150106.092617,2862,332,1022128,284,2862,230,2863,11,0
20150106.092619,2862,2,1022130,0,2862,145,2863,66,0
20150106.092623,2863,14,1022144,8,2862,151,2863,73,1
20150106.092624,2863,10,1022154,10,2862,200,2863,68,1
20150106.092624,2863,2,1022156,0,2862,234,2863,79,1
20150106.092626,2863,14,1022170,0,2862,192,2863,70,1
20150106.092627,2863,8,1022178,-6,2862,206,2863,67,1
20150106.092628,2862,6,1022184,-4,2862,193,2863,71,0
20150106.092629,2863,2,1022186,2,2862,193,2863,70,1
20150106.092629,2863,20,1022206,2,2862,208,2863,61,1
20150106.092632,2863,204,1022410,122,2862,280,2863,58,1
20150106.092633,2863,4,1022414,0,2862,268,2863,106,1
20150106.092633,2862,40,1022454,-24,2862,261,2863,107,0
20150106.092634,2863,6,1022460,0,2862,273,2863,146,1
20150106.092637,2863,8,1022468,-8,2862,276,2863,145,1
20150106.092641,2863,164,1022632,-150,2862,292,2863,68,1
20150106.092642,2863,2,1022634,-2,2862,277,2863,70,1
20150106.092642,2863,8,1022642,-6,2862,286,2863,68,1
20150106.092643,2863,138,1022780,36,2863,52,2864,380,1
20150106.092643,2863,62,1022842,60,2863,21,2864,386,1
20150106.092644,2863,28,1022870,20,2863,7,2864,386,1
20150106.092644,2863,16,1022886,12,2862,297,2863,90,1
20150106.092645,2862,6,1022892,0,2862,295,2863,94,0
20150106.092646,2862,20,1022912,-4,2862,292,2863,89,0
20150106.092648,2862,4,1022916,-4,2862,296,2863,112,0
20150106.092649,2863,2,1022918,2,2862,296,2863,115,1
20150106.09265,2863,2,1022920,0,2862,314,2863,109,1
20150106.092651,2862,2,1022922,0,2862,299,2863,109,0
20150106.092655,2862,2,1022924,0,2862,399,2863,182,0
20150106.092656,2862,2,1022926,-2,2862,403,2863,184,0
20150106.092657,2863,10,1022936,10,2862,406,2863,186,1
20150106.092657,2862,2,1022938,0,2862,405,2863,186,0
20150106.092702,2863,2,1022940,2,2862,414,2863,200,1
20150106.092702,2862,2,1022942,0,2862,413,2863,200,0
20150106.092704,2862,2,1022944,0,2862,418,2863,200,0
20150106.092704,2862,4,1022948,0,2862,433,2863,205,0
20150106.092707,2862,6,1022954,-6,2862,446,2863,254,0
20150106.09271,2862,6,1022960,-2,2862,441,2863,267,0
20150106.092711,2863,2,1022962,2,2862,442,2863,267,1
20150106.092711,2862,40,1023002,-4,2862,424,2863,285,0
20150106.092712,2863,4,1023006,2,2862,423,2863,286,1
20150106.092715,2862,2,1023008,2,2862,381,2863,296,0
20150106.092716,2863,6,1023014,0,2862,388,2863,295,1
20150106.092718,2862,20,1023034,-12,2862,382,2863,295,0
20150106.092722,2863,2,1023036,2,2862,394,2863,317,1
20150106.092723,2862,6,1023042,-6,2862,395,2863,318,0
20150106.092724,2862,22,1023064,18,2862,384,2863,317,0
20150106.092724,2862,2,1023066,0,2862,394,2863,317,0
20150106.092725,2862,26,1023092,-22,2862,381,2863,321,0
20150106.092725,2863,20,1023112,20,2862,384,2863,311,1
20150106.092726,2863,10,1023122,0,2862,394,2863,304,1
20150106.092727,2862,8,1023130,2,2862,390,2863,458,0
20150106.092729,2862,14,1023144,14,2862,390,2863,448,0
20150106.09273,2862,4,1023148,0,2862,388,2863,449,0
20150106.092732,2862,4,1023152,0,2862,392,2863,459,0
20150106.092732,2862,600,1023752,422,2862,92,2863,461,0
20150106.092733,2862,184,1023936,-118,2861,784,2862,17,0
20150106.092733,2862,52,1023988,34,2861,768,2862,14,0
20150106.092734,2861,16,1024004,-6,2861,757,2862,27,0
20150106.092734,2862,6,1024010,-2,2861,757,2862,24,1
20150106.092735,2861,18,1024028,0,2861,759,2862,23,0
20150106.092735,2861,4,1024032,4,2861,757,2862,57,0
20150106.092736,2861,4,1024036,0,2861,755,2862,57,0
20150106.092737,2862,2,1024038,2,2861,746,2862,52,1
20150106.092739,2861,4,1024042,0,2861,748,2862,54,0
20150106.09274,2862,12,1024054,2,2861,747,2862,75,1
20150106.092741,2861,4,1024058,2,2861,752,2862,95,0
20150106.092742,2861,2,1024060,2,2861,751,2862,95,0
20150106.092743,2861,2,1024062,2,2861,750,2862,105,0
20150106.092744,2861,50,1024112,44,2861,725,2862,106,0
20150106.092745,2861,10,1024122,-10,2861,720,2862,106,0
20150106.092745,2861,20,1024142,-14,2861,710,2862,106,0
20150106.092747,2862,100,1024242,48,2861,713,2862,87,1
20150106.092748,2862,8,1024250,0,2861,713,2862,87,1
20150106.092749,2862,6,1024256,2,2861,711,2862,88,1
20150106.092749,2862,10,1024266,0,2861,711,2862,84,1
20150106.092751,2862,6,1024272,0,2861,711,2862,85,1
20150106.092751,2862,8,1024280,0,2861,712,2862,83,1
20150106.092752,2862,2,1024282,2,2861,716,2862,83,1
20150106.092755,2862,4,1024286,-2,2861,721,2862,84,1
20150106.092756,2862,2,1024288,2,2861,721,2862,86,1
20150106.092758,2861,4,1024292,0,2861,719,2862,94,0
20150106.092759,2862,4,1024296,4,2861,727,2862,122,1
20150106.0928,2861,12,1024308,-6,2861,722,2862,122,0
20150106.092801,2862,4,1024312,4,2861,722,2862,120,1
20150106.092805,2861,100,1024412,-88,2861,672,2862,126,0
20150106.092806,2861,6,1024418,0,2861,669,2862,126,0
20150106.092807,2861,400,1024818,296,2861,481,2862,138,0
20150106.092807,2861,12,1024830,-10,2861,467,2862,140,0
20150106.092808,2861,22,1024852,10,2861,469,2862,132,0
20150106.092808,2861,20,1024872,0,2861,450,2862,144,0
20150106.092809,2862,50,1024922,-10,2861,449,2862,120,1
20150106.09281,2861,2,1024924,0,2861,448,2862,119,0
20150106.092811,2861,2,1024926,0,2861,447,2862,120,0
20150106.092812,2862,2,1024928,-2,2861,448,2862,124,1
20150106.092812,2861,40,1024968,0,2861,428,2862,125,0
20150106.092813,2861,2,1024970,0,2861,427,2862,125,0
20150106.092813,2861,4,1024974,-2,2861,435,2862,132,0
20150106.092814,2861,102,1025076,-2,2861,385,2862,129,0
20150106.092815,2861,10,1025086,-10,2861,383,2862,130,0
20150106.092815,2861,6,1025092,-4,2861,380,2862,229,0
20150106.092817,2861,4,1025096,0,2861,380,2862,242,0
20150106.092818,2862,2,1025098,0,2861,397,2862,244,1
20150106.092819,2861,2,1025100,0,2861,396,2862,243,0
20150106.092819,2861,2,1025102,0,2861,395,2862,244,0
20150106.09282,2861,2,1025104,2,2861,394,2862,245,0
20150106.092821,2861,2,1025106,0,2861,405,2862,249,0
20150106.092822,2861,8,1025114,2,2861,402,2862,255,0
20150106.092823,2861,4,1025118,0,2861,401,2862,257,0
20150106.092824,2861,2,1025120,0,2861,401,2862,267,0
20150106.092826,2861,6,1025126,6,2861,400,2862,273,0
20150106.092827,2861,12,1025138,6,2861,405,2862,273,0
20150106.092827,2861,20,1025158,0,2861,400,2862,274,0
20150106.092828,2861,2,1025160,2,2861,399,2862,277,0
20150106.09283,2861,4,1025164,0,2861,399,2862,288,0
20150106.092831,2862,638,1025802,454,2862,283,2863,765,1
20150106.092832,2862,6,1025808,0,2862,342,2863,755,1
20150106.092832,2862,16,1025824,0,2862,355,2863,461,1
20150106.092834,2862,4,1025828,0,2862,362,2863,448,1
20150106.092835,2862,602,1026430,-60,2862,62,2863,448,1
20150106.092836,2862,130,1026560,-102,2861,570,2862,52,1
20150106.092836,2862,108,1026668,-92,2862,3,2863,498,1
20150106.092837,2862,2,1026670,2,2862,52,2863,450,1
20150106.092837,2862,110,1026780,82,2861,492,2862,117,1
20150106.092838,2862,24,1026804,12,2861,488,2862,110,1
20150106.092838,2862,22,1026826,14,2861,488,2862,74,1
20150106.092839,2863,208,1027034,-44,2862,27,2863,404,1
20150106.092839,2861,70,1027104,-44,2861,480,2862,1,0
20150106.09284,2862,12,1027116,-6,2862,39,2863,405,1
20150106.092841,2862,10,1027126,-2,2862,36,2863,448,1
20150106.092842,2862,8,1027134,0,2862,32,2863,448,1
20150106.092842,2862,4,1027138,0,2862,30,2863,448,1
20150106.092843,2861,102,1027240,36,2861,481,2862,94,0
20150106.092843,2862,24,1027264,14,2861,481,2862,84,1
20150106.092843,2862,8,1027272,4,2861,481,2862,90,1
20150106.092844,2862,8,1027280,6,2861,482,2862,86,1
20150106.092844,2861,8,1027288,-8,2861,478,2862,89,0
20150106.092846,2862,2,1027290,2,2861,477,2862,174,1
20150106.092849,2861,604,1027894,152,2861,291,2862,82,0
20150106.092849,2861,2,1027896,0,2861,293,2862,85,0
20150106.092849,2861,2,1027898,2,2861,295,2862,85,0
20150106.09285,2862,2,1027900,0,2861,294,2862,85,1
20150106.092851,2861,10,1027910,-8,2861,289,2862,181,0
20150106.092852,2861,594,1028504,314,2860,2577,2861,706,0
20150106.092852,2861,6,1028510,4,2860,2528,2861,2,0
20150106.092853,2861,114,1028624,104,2861,4,2862,331,0
20150106.092853,2861,8,1028632,4,2860,2442,2861,111,0
20150106.092854,2861,4,1028636,0,2860,2444,2861,108,0
20150106.092855,2861,22,1028658,-18,2860,2437,2861,107,0
20150106.092856,2861,2,1028660,2,2860,2439,2861,116,0
20150106.092857,2861,2,1028662,0,2860,2438,2861,116,0
20150106.092857,2861,4,1028666,0,2860,2478,2861,114,0
20150106.092857,2861,22,1028688,-20,2860,2467,2861,120,0
20150106.092858,2861,20,1028708,20,2860,2467,2861,111,0
20150106.092859,2861,258,1028966,-166,2861,95,2862,364,0
20150106.0929,2861,8,1028974,-8,2861,93,2862,363,0
20150106.0929,2861,20,1028994,-12,2861,85,2862,379,0
20150106.092901,2862,18,1029012,-8,2861,187,2862,378,1
20150106.092902,2861,2,1029014,-2,2861,195,2862,378,0
20150106.092902,2861,24,1029038,4,2861,195,2862,369,0
20150106.092903,2861,14,1029052,-12,2861,192,2862,370,0
20150106.092904,2862,2,1029054,2,2861,504,2862,353,1
20150106.092904,2862,8,1029062,4,2861,521,2862,322,1
20150106.092905,2861,10,1029072,-6,2861,546,2862,327,0
20150106.092905,2862,2,1029074,2,2861,546,2862,526,1
20150106.092906,2861,8,1029082,-4,2861,509,2862,526,0
20150106.092907,2861,2,1029084,-2,2861,510,2862,526,0
20150106.092908,2862,4,1029088,0,2861,554,2862,527,1
20150106.092909,2862,4,1029092,4,2861,554,2862,527,1
20150106.092909,2861,24,1029116,0,2861,589,2862,528,0
20150106.09291,2862,8,1029124,4,2861,589,2862,524,1
20150106.092911,2862,36,1029160,12,2861,575,2862,520,1
20150106.092911,2862,100,1029260,84,2861,577,2862,470,1
20150106.092912,2862,2,1029262,0,2861,577,2862,475,1
20150106.092912,2861,20,1029282,20,2861,568,2862,495,0
20150106.092913,2861,10,1029292,-2,2861,670,2862,491,0
20150106.092915,2861,22,1029314,0,2861,666,2862,504,0
20150106.092915,2861,8,1029322,4,2861,652,2862,504,0
20150106.092916,2861,4,1029326,-2,2861,655,2862,504,0
20150106.092917,2862,2,1029328,-2,2861,668,2862,502,1
20150106.092918,2861,40,1029368,8,2861,648,2862,502,0
20150106.092919,2861,44,1029412,-40,2861,627,2862,522,0
20150106.092919,2861,20,1029432,-20,2861,617,2862,524,0
20150106.09292,2861,2,1029434,0,2861,619,2862,524,0
20150106.092921,2861,6,1029440,0,2861,616,2862,529,0
20150106.092921,2862,4,1029444,0,2861,618,2862,527,1
20150106.092921,2862,20,1029464,-20,2861,618,2862,518,1
20150106.092922,2861,22,1029486,0,2861,305,2862,521,0
20150106.092923,2861,22,1029508,-22,2861,294,2862,521,0
20150106.092924,2861,76,1029584,4,2861,256,2862,522,0
20150106.092925,2861,2,1029586,-2,2861,252,2862,530,0
20150106.092926,2862,342,1029928,58,2861,82,2862,589,1
20150106.092927,2861,166,1030094,28,2860,2487,2861,102,0
20150106.092927,2860,10,1030104,-4,2860,2471,2861,235,0
20150106.092928,2860,28,1030132,-22,2860,2454,2861,235,0
20150106.092928,2861,6,1030138,4,2860,2450,2861,226,1
20150106.092929,2860,6,1030144,0,2860,2448,2861,224,0
20150106.092929,2861,4,1030148,2,2860,2450,2861,229,1
20150106.09293,2861,22,1030170,2,2860,2440,2861,218,1
20150106.09293,2861,8,1030178,-4,2860,2439,2861,217,1
20150106.092931,2860,8,1030186,0,2860,2437,2861,218,0
20150106.092931,2860,2,1030188,-2,2860,2436,2861,233,0
20150106.092933,2860,24,1030212,-22,2860,2421,2861,252,0
20150106.092934,2861,178,1030390,-98,2860,2424,2861,168,1
20150106.092935,2860,2,1030392,-2,2860,2423,2861,197,0
20150106.092936,2860,2,1030394,-2,2860,2422,2861,203,0
20150106.092936,2860,20,1030414,-20,2860,2412,2861,203,0
20150106.092937,2860,2,1030416,-2,2860,2412,2861,205,0
20150106.092937,2860,402,1030818,0,2860,2210,2861,205,0
20150106.092938,2861,14,1030832,-4,2860,2209,2861,199,1
20150106.092938,2860,4,1030836,-2,2860,2206,2861,202,0
20150106.092939,2860,8,1030844,-8,2860,2202,2861,202,0
20150106.092939,2860,2,1030846,0,2860,2201,2861,202,0
20150106.09294,2860,6,1030852,-4,2860,2200,2861,192,0
20150106.09294,2860,26,1030878,14,2860,2200,2861,185,0
20150106.092941,2860,4,1030882,0,2860,2198,2861,200,0
20150106.092942,2860,114,1030996,-114,2860,2142,2861,213,0
20150106.092943,2860,2,1030998,-2,2860,2141,2861,215,0
20150106.092943,2860,82,1031080,0,2860,2099,2861,217,0
20150106.092944,2860,4,1031084,2,2860,2097,2861,224,0
20150106.092944,2860,202,1031286,-142,2860,1996,2861,224,0
20150106.092945,2861,14,1031300,0,2860,1991,2861,222,1
20150106.092945,2861,2058,1033358,350,2860,932,2861,217,1
20150106.092946,2860,138,1033496,98,2860,857,2861,238,0
20150106.092946,2860,214,1033710,50,2860,750,2861,272,0
20150106.092947,2860,14,1033724,-2,2860,737,2861,321,0
20150106.092947,2861,10,1033734,10,2860,728,2861,321,1
20150106.092948,2860,18,1033752,2,2860,720,2861,322,0
20150106.092948,2860,94,1033846,-18,2860,678,2861,367,0
20150106.092949,2860,4,1033850,4,2860,676,2861,367,0
20150106.09295,2860,8,1033858,6,2860,672,2861,371,0
20150106.09295,2860,8,1033866,8,2860,658,2861,372,0
20150106.092951,2860,6,1033872,0,2860,655,2861,389,0
20150106.092951,2860,30,1033902,-4,2860,638,2861,389,0
20150106.092952,2860,20,1033922,12,2860,629,2861,392,0
20150106.092952,2860,34,1033956,2,2860,602,2861,376,0
20150106.092953,2860,16,1033972,14,2860,596,2861,389,0
20150106.092953,2860,16,1033988,6,2860,592,2861,390,0
20150106.092954,2860,8,1033996,2,2860,589,2861,390,0
20150106.092954,2860,2,1033998,0,2860,589,2861,417,0
20150106.092954,2860,6,1034004,4,2860,586,2861,417,0
20150106.092955,2860,10,1034014,-2,2860,587,2861,419,0
20150106.092956,2860,58,1034072,-28,2860,565,2861,419,0
20150106.092956,2860,28,1034100,-18,2860,552,2861,420,0
20150106.092957,2860,2,1034102,2,2860,603,2861,409,0
20150106.092958,2861,2,1034104,2,2860,346,2861,420,1
20150106.093,2860,232,1034336,-222,2859,2520,2860,168,0
20150106.093,2860,410,1034746,-132,2860,49,2861,450,0
20150106.093001,2861,50,1034796,2,2860,144,2861,404,1
20150106.093001,2860,58,1034854,-8,2860,231,2861,382,0
20150106.093001,2860,30,1034884,0,2860,1216,2861,382,0
20150106.093002,2860,20,1034904,0,2860,1229,2861,375,0
20150106.093002,2860,664,1035568,92,2860,1236,2861,45,0
20150106.093003,2861,242,1035810,102,2860,1387,2862,534,1
20150106.093004,2861,44,1035854,16,2861,3,2862,531,1
20150106.093004,2860,50,1035904,-32,2860,1420,2861,64,0
20150106.093005,2861,130,1036034,-128,2861,53,2862,543,1
20150106.093005,2861,90,1036124,-10,2861,11,2862,543,1
20150106.093006,2861,4,1036128,0,2861,59,2862,543,1
20150106.093006,2861,12,1036140,-6,2861,53,2862,551,1
20150106.093007,2861,108,1036248,0,2860,1536,2861,52,1
20150106.093008,2861,4,1036252,2,2860,1497,2861,57,1
20150106.093008,2861,10,1036262,6,2860,1476,2861,53,1
20150106.093009,2861,2,1036264,2,2860,1474,2861,60,1
20150106.09301,2860,34,1036298,-4,2860,1482,2861,53,0
20150106.093011,2861,4,1036302,0,2860,1490,2861,51,1
20150106.093011,2860,10,1036312,0,2860,1485,2861,52,0
20150106.093012,2861,20,1036332,20,2860,1486,2861,42,1
20150106.093012,2860,4,1036336,0,2860,1485,2861,41,0
20150106.093013,2860,54,1036390,20,2860,1467,2861,31,0
20150106.093014,2860,20,1036410,0,2860,1454,2861,54,0
20150106.093014,2860,4,1036414,-4,2860,1453,2861,58,0
20150106.093015,2861,4,1036418,0,2860,1453,2861,62,1
20150106.093015,2861,6,1036424,-2,2860,1452,2861,60,1
20150106.093016,2861,2,1036426,2,2860,1453,2861,70,1
20150106.093016,2861,4,1036430,2,2860,1453,2861,71,1
20150106.093017,2860,6,1036436,-4,2860,1396,2861,77,0
20150106.093018,2860,4,1036440,-4,2860,1394,2861,85,0
20150106.093018,2861,14,1036454,0,2860,1392,2861,80,1
20150106.093019,2860,2,1036456,0,2860,1441,2861,81,0
20150106.09302,2861,2,1036458,2,2860,1441,2861,80,1
20150106.09302,2860,22,1036480,2,2860,1433,2861,81,0
20150106.093021,2860,2,1036482,0,2860,1432,2861,132,0
20150106.093022,2861,2,1036484,-2,2860,1432,2861,137,1
20150106.093025,2861,264,1036748,-88,2861,70,2862,657,1
20150106.093025,2861,4,1036752,-2,2861,74,2862,660,1
20150106.093026,2861,20,1036772,-2,2861,96,2862,660,1
20150106.093027,2861,64,1036836,-32,2861,129,2862,660,1
20150106.093027,2861,6,1036842,-6,2861,156,2862,660,1
20150106.093028,2862,26,1036868,-26,2861,145,2862,649,1
20150106.093028,2861,2,1036870,0,2861,144,2862,649,0
20150106.093029,2861,6,1036876,-6,2861,154,2862,652,0
20150106.09303,2861,14,1036890,-4,2861,211,2862,652,0
20150106.093031,2861,52,1036942,8,2861,199,2862,652,0
20150106.093032,2861,20,1036962,0,2861,199,2862,752,0
20150106.093032,2861,2,1036964,-2,2861,198,2862,752,0
20150106.093034,2862,4,1036968,-4,2861,212,2862,751,1
20150106.093035,2861,2,1036970,-2,2861,216,2862,750,0
20150106.093036,2861,2,1036972,-2,2861,389,2862,751,0
20150106.093037,2862,2,1036974,0,2861,391,2862,750,1
20150106.093039,2861,4,1036978,0,2861,411,2862,755,0
20150106.09304,2861,250,1037228,-216,2861,373,2862,682,0
20150106.093041,2861,4,1037232,-4,2861,366,2862,682,0
20150106.093042,2861,12,1037244,-4,2861,361,2862,4682,0
20150106.093042,2861,722,1037966,4,2860,1632,2861,314,0
20150106.093043,2861,8,1037974,6,2860,1358,2861,322,0
20150106.093045,2860,416,1038390,-16,2860,1151,2861,325,0
20150106.093045,2861,2,1038392,2,2860,1151,2861,324,1
20150106.093046,2860,6,1038398,-4,2860,1150,2861,323,0
20150106.093046,2860,6,1038404,0,2860,1143,2861,328,0
20150106.093048,2860,2,1038406,0,2860,376,2861,339,0
20150106.093048,2861,2,1038408,0,2860,377,2861,339,1
20150106.093049,2861,2,1038410,0,2860,371,2861,344,1
20150106.09305,2860,214,1038624,50,2860,269,2861,275,0
20150106.093051,2861,40,1038664,40,2860,320,2861,270,1
20150106.093052,2860,28,1038692,-8,2860,306,2861,295,0
20150106.093054,2861,20,1038712,20,2860,309,2861,285,1
20150106.093055,2860,18,1038730,-18,2860,302,2861,336,0
20150106.093055,2860,108,1038838,-6,2860,293,2861,336,0
20150106.093056,2860,12,1038850,-6,2860,326,2861,337,0
20150106.093057,2860,2,1038852,0,2860,325,2861,342,0
20150106.093057,2860,10,1038862,0,2860,321,2861,341,0
20150106.093058,2861,4,1038866,4,2860,324,2861,339,1
20150106.093058,2860,42,1038908,40,2860,304,2861,340,0
20150106.093059,2860,76,1038984,-22,2860,266,2861,329,0
20150106.093059,2860,2,1038986,0,2860,265,2861,335,0
20150106.0931,2860,16,1039002,2,2860,257,2861,338,0
20150106.0931,2860,6,1039008,2,2860,255,2861,339,0
20150106.093101,2860,24,1039032,20,2860,244,2861,339,0
20150106.093101,2860,14,1039046,14,2860,237,2861,340,0
20150106.093102,2861,2,1039048,2,2860,237,2861,339,1
20150106.093103,2861,6,1039054,2,2860,487,2861,341,1
20150106.093104,2860,10,1039064,10,2860,484,2861,339,0
20150106.093104,2860,4,1039068,4,2860,987,2861,333,0
20150106.093104,2860,36,1039104,36,2860,972,2861,331,0
20150106.093105,2860,56,1039160,-10,2860,961,2861,332,0
20150106.093106,2860,2,1039162,0,2860,960,2861,333,0
20150106.093107,2860,52,1039214,38,2860,916,2861,336,0
20150106.093108,2860,438,1039652,-128,2860,737,2861,335,0
20150106.093108,2860,6,1039658,-6,2860,815,2861,340,0
20150106.093109,2860,12,1039670,-6,2860,809,2861,339,0
20150106.093109,2861,8,1039678,0,2860,809,2861,335,1
20150106.09311,2860,2,1039680,0,2860,809,2861,335,0
20150106.09311,2860,4,1039684,0,2860,807,2861,335,0
20150106.093112,2861,172,1039856,6,2860,807,2861,206,1
20150106.093113,2860,2,1039858,0,2860,811,2861,214,0
20150106.093113,2861,6,1039864,-4,2860,812,2861,212,1
20150106.093114,2860,10,1039874,-10,2860,809,2861,316,0
20150106.093115,2861,2,1039876,0,2860,809,2861,317,1
20150106.093115,2860,2,1039878,0,2860,809,2861,318,0
20150106.093117,2860,2,1039880,0,2860,808,2861,319,0
20150106.093117,2860,10,1039890,0,2860,803,2861,319,0
20150106.093118,2861,4,1039894,0,2860,803,2861,319,1
20150106.093118,2860,12,1039906,0,2860,799,2861,317,0
20150106.093119,2861,4,1039910,0,2860,798,2861,317,1
20150106.093119,2861,2,1039912,0,2860,809,2861,316,1
20150106.09312,2860,8,1039920,0,2860,807,2861,316,0
20150106.09312,2860,802,1040722,-798,2860,407,2861,316,0
20150106.093121,2860,2,1040724,0,2860,409,2861,337,0
20150106.093122,2860,64,1040788,-64,2860,377,2861,337,0
20150106.093123,2860,2,1040790,0,2860,401,2861,339,0
20150106.093124,2860,802,1041592,-458,2859,2707,2860,52,0
20150106.093125,2860,230,1041822,-170,2860,46,2861,398,0
20150106.093125,2860,16,1041838,-4,2860,39,2861,397,0
20150106.093126,2860,20,1041858,0,2860,29,2861,399,0
20150106.093126,2860,2,1041860,0,2860,33,2861,399,0
20150106.093127,2860,4,1041864,-4,2860,31,2861,399,0
20150106.093128,2861,264,1042128,-2,2860,102,2861,353,1
20150106.093129,2860,16,1042144,-8,2860,98,2861,355,0
20150106.093129,2861,22,1042166,-4,2860,93,2861,350,1
20150106.093131,2860,2,1042168,0,2860,98,2861,368,0
20150106.093131,2860,96,1042264,22,2860,51,2861,369,0
20150106.093133,2861,10,1042274,8,2860,51,2861,366,1
20150106.093134,2860,30,1042304,30,2860,136,2861,366,0
20150106.093134,2860,4,1042308,4,2860,136,2861,364,0
20150106.093135,2861,8,1042316,-4,2860,1151,2861,338,1
20150106.093136,2860,22,1042338,10,2860,1155,2861,5334,0
20150106.093137,2860,2,1042340,0,2860,1197,2861,5336,0
20150106.093137,2861,2,1042342,0,2860,1267,2861,5330,1
20150106.093138,2860,4,1042346,2,2860,1232,2861,5341,0
20150106.093139,2860,4,1042350,4,2860,1238,2861,5350,0
20150106.09314,2860,4,1042354,0,2860,1245,2861,5350,0
20150106.09314,2860,14,1042368,8,2860,1241,2861,5350,0
20150106.093141,2860,10,1042378,-2,2860,1238,2861,5350,0
20150106.093141,2860,2,1042380,2,2860,1237,2861,5350,0
20150106.093142,2860,2,1042382,2,2860,1240,2861,5351,0
20150106.093143,2860,280,1042662,-52,2860,1100,2861,5351,0
20150106.093143,2860,20,1042682,-6,2860,1090,2861,5352,0
20150106.093144,2861,6,1042688,0,2860,1088,2861,5351,1
20150106.093144,2860,30,1042718,-22,2860,1073,2861,5351,0
20150106.093145,2860,2,1042720,-2,2860,1072,2861,5350,0
20150106.093146,2860,2,1042722,0,2860,1071,2861,5355,0
20150106.093147,2860,2,1042724,-2,2860,1070,2861,5355,0
20150106.093147,2860,4,1042728,-2,2860,1074,2861,5359,0
20150106.093148,2860,10,1042738,0,2860,1066,2861,5361,0
20150106.093148,2860,6,1042744,-4,2860,1063,2861,5362,0
20150106.093149,2861,4,1042748,0,2860,1064,2861,5359,1
20150106.093149,2860,8,1042756,-8,2860,1062,2861,5365,0
20150106.09315,2860,18,1042774,8,2860,1059,2861,5356,0
20150106.09315,2860,2,1042776,-2,2860,1058,2861,5356,0
20150106.093152,2860,554,1043330,-542,2860,786,2861,5366,0
20150106.093154,2860,8,1043338,-4,2860,784,2861,5366,0
20150106.093154,2860,14,1043352,0,2860,781,2861,5366,0
20150106.093155,2860,22,1043374,-16,2860,772,2861,5366,0
20150106.093155,2860,30,1043404,0,2860,759,2861,5364,0
20150106.093156,2860,4,1043408,0,2860,763,2861,5366,0
20150106.093157,2860,6,1043414,-2,2860,761,2861,5366,0
20150106.093157,2860,14,1043428,-2,2860,754,2861,5366,0
20150106.093158,2860,6,1043434,0,2860,751,2861,5366,0
20150106.093158,2860,2,1043436,-2,2860,750,2861,5366,0
20150106.093159,2861,2,1043438,0,2860,763,2861,5368,1
20150106.093159,2861,48,1043486,-6,2860,748,2861,5360,1
20150106.0932,2860,2,1043488,0,2860,745,2861,5360,0
20150106.0932,2861,10,1043498,2,2860,741,2861,5358,1
20150106.0932,2860,4,1043502,-4,2860,739,2861,5376,0
20150106.093201,2861,4,1043506,0,2860,741,2861,5373,1
20150106.093202,2860,16,1043522,-12,2860,735,2861,5371,0
20150106.093203,2860,8,1043530,-2,2860,733,2861,5372,0
20150106.093203,2860,10,1043540,0,2860,723,2861,5372,0
20150106.093203,2860,2,1043542,0,2860,722,2861,5372,0
20150106.093204,2860,26,1043568,-2,2860,800,2861,5368,0
20150106.093205,2861,2,1043570,2,2860,800,2861,5370,1
20150106.093205,2860,40,1043610,0,2860,781,2861,5370,0
20150106.093206,2860,14,1043624,0,2860,775,2861,5371,0
20150106.093207,2860,24,1043648,0,2860,768,2861,5369,0
20150106.093208,2860,12,1043660,-8,2860,766,2861,5367,0
20150106.093209,2860,52,1043712,-40,2860,740,2861,5367,0
20150106.09321,2860,10,1043722,0,2860,734,2861,5367,0
20150106.09321,2860,4,1043726,0,2860,735,2861,5367,0
20150106.093213,2860,54,1043780,-2,2860,712,2861,5367,0
20150106.093214,2860,18,1043798,-18,2860,705,2861,5371,0
20150106.093214,2861,52,1043850,-20,2860,695,2861,5362,1
20150106.093215,2860,6,1043856,-2,2860,692,2861,5362,0
20150106.093215,2860,12,1043868,-10,2860,1186,2861,5362,0
20150106.093216,2860,54,1043922,-2,2860,1159,2861,5362,0
20150106.093216,2860,4,1043926,0,2860,1162,2861,5359,0
20150106.093217,2861,2,1043928,-2,2860,1163,2861,5398,1
20150106.093217,2860,24,1043952,-4,2860,1151,2861,5399,0
20150106.093218,2860,94,1044046,-82,2860,1105,2861,5399,0
20150106.093218,2860,12,1044058,0,2860,1102,2861,5404,0
20150106.093219,2860,50,1044108,0,2860,1078,2861,5404,0
20150106.093219,2860,12,1044120,0,2860,1073,2861,5404,0
20150106.09322,2860,26,1044146,0,2860,1062,2861,3406,0
20150106.09322,2860,10,1044156,-6,2860,1061,2861,3403,0
20150106.093221,2860,78,1044234,-4,2860,1061,2861,2365,0
20150106.093221,2861,56,1044290,8,2860,1067,2861,1335,1
20150106.093222,2861,12,1044302,8,2860,1118,2861,328,1
20150106.093222,2861,12,1044314,-2,2860,1171,2861,322,1
20150106.093223,2861,8,1044322,2,2860,1179,2861,319,1
20150106.093223,2861,20,1044342,0,2860,1217,2861,318,1
20150106.093224,2860,30,1044372,-6,2860,1212,2861,314,0
20150106.093224,2860,6,1044378,-6,2860,1209,2861,314,0
20150106.093225,2861,630,1045008,-164,2861,706,2862,354,1
20150106.093225,2861,8,1045016,-6,2861,817,2862,357,1
20150106.093226,2861,4,1045020,-2,2861,816,2862,357,1
20150106.093226,2862,6,1045026,0,2861,819,2862,355,1
20150106.093229,2861,2,1045028,-2,2861,849,2862,373,0
20150106.09323,2861,12,1045040,-2,2861,844,2862,373,0
20150106.093233,2862,8,1045048,4,2861,941,2862,403,1
20150106.093234,2861,2,1045050,-2,2861,944,2862,406,0
20150106.093234,2861,2,1045052,0,2861,943,2862,406,0
20150106.093235,2861,16,1045068,-6,2861,935,2862,406,0
20150106.093235,2862,2,1045070,0,2861,935,2862,405,1
20150106.093236,2862,2,1045072,2,2861,935,2862,404,1
20150106.093237,2861,2,1045074,0,2861,934,2862,409,0
20150106.093237,2862,22,1045096,2,2861,924,2862,409,1
20150106.093238,2861,20,1045116,0,2861,914,2862,409,0
20150106.093238,2861,204,1045320,-56,2861,915,2862,308,0
20150106.093239,2861,42,1045362,-4,2861,917,2862,288,0
20150106.093239,2862,4,1045366,-4,2861,921,2862,287,1
20150106.09324,2862,102,1045468,98,2861,922,2862,233,1
20150106.093241,2862,2,1045470,0,2861,922,2862,229,1
20150106.093241,2861,6,1045476,-4,2861,920,2862,229,0
20150106.093242,2862,4,1045480,-2,2861,920,2862,229,1
20150106.093244,2861,8,1045488,-4,2861,920,2862,902,0
20150106.093244,2861,10,1045498,0,2861,917,2862,902,0
20150106.093245,2861,10,1045508,0,2861,1113,2862,901,0
20150106.093246,2862,4,1045512,-2,2861,1113,2862,902,1
20150106.093247,2862,2,1045514,-2,2861,1109,2862,893,1
20150106.093248,2862,2,1045516,2,2861,1109,2862,893,1
20150106.093248,2861,2,1045518,0,2861,1108,2862,893,0
20150106.093249,2862,1002,1046520,0,2861,608,2862,892,1
20150106.093249,2861,32,1046552,0,2861,592,2862,894,0
20150106.093251,2861,4,1046556,-2,2861,594,2862,907,0
20150106.093252,2862,4,1046560,0,2861,594,2862,915,1
20150106.093253,2862,2,1046562,0,2861,595,2862,914,1
20150106.093255,2861,10,1046572,0,2861,623,2862,916,0
20150106.093259,2861,6,1046578,0,2861,1178,2862,918,0
20150106.0933,2861,18,1046596,0,2861,1169,2862,923,0
20150106.0933,2862,8,1046604,0,2861,1170,2862,919,1
20150106.093301,2862,10,1046614,0,2861,1169,2862,914,1
20150106.093301,2861,10,1046624,-10,2861,1164,2862,909,0
20150106.093302,2861,16,1046640,-16,2861,1156,2862,910,0
20150106.093302,2861,10,1046650,0,2861,1152,2862,910,0
20150106.093303,2861,12,1046662,0,2861,1146,2862,913,0
20150106.093306,2861,2,1046664,-2,2861,1161,2862,918,0
20150106.093307,2862,2,1046666,-2,2861,1174,2862,917,1
20150106.093307,2861,10,1046676,0,2861,1170,2862,917,0
20150106.093309,2862,4,1046680,-2,2861,1174,2862,915,1
20150106.093311,2861,50,1046730,2,2861,1155,2862,910,0
20150106.093312,2861,4,1046734,2,2861,1154,2862,910,0
20150106.093313,2862,2,1046736,0,2861,1154,2862,909,1
20150106.093314,2862,50,1046786,32,2861,1154,2862,886,1
20150106.093314,2862,2,1046788,0,2861,1154,2862,885,1
20150106.093315,2862,4,1046792,0,2861,1154,2862,883,1
20150106.093315,2862,4,1046796,0,2861,1154,2862,882,1
20150106.093316,2862,2,1046798,-2,2861,1154,2862,882,1
20150106.093317,2861,30,1046828,-26,2861,1141,2862,891,0
20150106.093317,2861,42,1046870,-38,2861,1140,2862,872,0
20150106.093318,2862,20,1046890,-20,2861,1130,2862,861,1
20150106.093319,2861,2,1046892,-2,2861,1129,2862,861,0
20150106.09332,2862,2,1046894,-2,2861,1150,2862,861,1
20150106.093321,2861,4,1046898,-4,2861,1148,2862,862,0
20150106.093322,2862,2,1046900,-2,2861,1149,2862,860,1
20150106.093322,2861,4,1046904,-4,2861,1149,2862,861,0
20150106.093323,2862,4,1046908,-2,2861,1149,2862,859,1
20150106.093324,2861,2,1046910,0,2861,1151,2862,859,0
20150106.093326,2862,4,1046914,0,2861,1151,2862,857,1
20150106.093326,2861,4,1046918,0,2861,1149,2862,867,0
20150106.093329,2862,2,1046920,0,2861,1152,2862,868,1
20150106.09333,2861,10,1046930,0,2861,1147,2862,869,0
20150106.09333,2862,40,1046970,20,2861,1147,2862,850,1
20150106.093332,2862,2,1046972,-2,2861,1147,2862,854,1
20150106.093333,2862,2,1046974,2,2861,1147,2862,854,1
20150106.093335,2862,4,1046978,0,2861,1147,2862,865,1
20150106.093335,2862,4,1046982,0,2861,1150,2862,863,1
20150106.093336,2862,18,1047000,-14,2861,1150,2862,855,1
20150106.093337,2862,22,1047022,2,2861,1149,2862,845,1
20150106.093338,2861,72,1047094,-36,2861,1118,2862,839,0
20150106.093339,2862,2,1047096,0,2861,1119,2862,852,1
20150106.09334,2862,36,1047132,24,2861,1118,2862,836,1
20150106.09334,2862,4,1047136,-2,2861,1127,2862,834,1
20150106.093341,2861,4,1047140,0,2861,1125,2862,836,0
20150106.093342,2862,4,1047144,0,2861,1127,2862,844,1
20150106.093343,2862,2,1047146,-2,2861,1127,2862,843,1
20150106.093343,2862,2,1047148,-2,2861,1127,2862,842,1
20150106.093344,2861,6,1047154,6,2861,1123,2862,842,0
20150106.093345,2862,2,1047156,-2,2861,1118,2862,841,1
20150106.093346,2862,12,1047168,-12,2861,1118,2862,837,1
20150106.093346,2862,362,1047530,-328,2861,1118,2862,656,1
20150106.093347,2862,10,1047540,0,2861,1118,2862,649,1
20150106.093348,2862,14,1047554,-14,2861,1089,2862,642,1
20150106.093349,2862,2,1047556,0,2861,1089,2862,641,1
20150106.093349,2862,2,1047558,0,2861,1089,2862,640,1
20150106.09335,2861,60,1047618,-56,2861,1092,2862,618,0
20150106.093351,2862,2,1047620,0,2861,1091,2862,617,1
20150106.093353,2862,6,1047626,0,2861,1091,2862,614,1
20150106.093354,2862,2,1047628,-2,2861,1091,2862,603,1
20150106.093355,2861,8,1047636,-4,2861,1091,2862,602,0
20150106.093356,2861,2,1047638,2,2861,1090,2862,602,0
20150106.093357,2861,2,1047640,2,2861,1089,2862,602,0
20150106.093358,2862,50,1047690,-50,2861,1090,2862,579,1
20150106.0934,2861,26,1047716,0,2861,1078,2862,580,0
20150106.093402,2862,60,1047776,-60,2861,1079,2862,562,1
20150106.093404,2862,312,1048088,-308,2861,1079,2862,410,1
20150106.093404,2862,14,1048102,-14,2861,1078,2862,403,1
20150106.093405,2861,8,1048110,2,2861,1074,2862,403,0
20150106.093405,2861,82,1048192,78,2861,1034,2862,402,0
20150106.093406,2862,10,1048202,2,2861,986,2862,388,1
20150106.093407,2862,10,1048212,-10,2861,987,2862,386,1
20150106.093408,2862,40,1048252,0,2861,994,2862,366,1
20150106.093409,2861,2,1048254,2,2861,994,2862,367,0
20150106.093413,2862,2,1048256,-2,2861,997,2862,372,1
20150106.093416,2861,62,1048318,-60,2861,995,2862,346,0
20150106.093418,2862,2,1048320,-2,2861,999,2862,359,1
20150106.093418,2862,80,1048400,-80,2861,799,2862,319,1
20150106.093419,2861,8,1048408,4,2861,798,2862,319,0
20150106.093419,2862,2,1048410,0,2861,798,2862,318,1
20150106.09342,2861,4,1048414,0,2861,797,2862,317,0
20150106.093423,2861,2,1048416,2,2861,844,2862,317,0
20150106.093423,2861,286,1048702,90,2861,701,2862,329,0
20150106.093424,2861,2,1048704,-2,2861,741,2862,339,0
20150106.093424,2862,4,1048708,-4,2861,754,2862,343,1
20150106.093426,2861,4,1048712,-4,2861,752,2862,444,0
20150106.093427,2861,30,1048742,-30,2861,737,2862,444,0
20150106.093428,2861,2,1048744,0,2861,735,2862,446,0
20150106.093431,2861,4,1048748,0,2861,733,2862,462,0
20150106.093431,2861,2,1048750,0,2861,732,2862,462,0
20150106.093436,2861,58,1048808,-58,2861,700,2862,479,0
20150106.093438,2861,10,1048818,0,2861,695,2862,491,0
20150106.093443,2861,4,1048822,-2,2861,684,2862,510,0
20150106.093447,2861,6,1048828,-2,2861,681,2862,514,0
20150106.093449,2862,38,1048866,0,2861,681,2862,505,1
20150106.093451,2862,2,1048868,0,2861,683,2862,497,1
20150106.093452,2861,2,1048870,-2,2861,682,2862,502,0
20150106.093453,2861,6,1048876,-2,2861,681,2862,501,0
20150106.093454,2862,10,1048886,-8,2861,681,2862,496,1
20150106.093455,2862,10,1048896,0,2861,681,2862,491,1
20150106.093502,2862,42,1048938,0,2861,680,2862,478,1
20150106.093502,2861,10,1048948,0,2861,675,2862,478,0
20150106.093502,2861,4,1048952,0,2861,673,2862,478,0
20150106.093504,2862,42,1048994,-2,2861,677,2862,457,1
20150106.093514,2861,6,1049000,0,2861,689,2862,458,0
20150106.093515,2861,2,1049002,0,2861,688,2862,457,0
20150106.093518,2861,62,1049064,0,2861,659,2862,672,0
20150106.093522,2861,2,1049066,0,2861,660,2862,669,0
20150106.093523,2861,4,1049070,-4,2861,662,2862,672,0
20150106.093524,2861,4,1049074,0,2861,665,2862,675,0
20150106.093525,2861,100,1049174,0,2861,616,2862,675,0
20150106.093526,2861,32,1049206,0,2861,600,2862,677,0
20150106.093527,2861,10,1049216,-10,2861,595,2862,677,0
20150106.093528,2861,4,1049220,-4,2861,593,2862,677,0
20150106.093529,2861,2,1049222,0,2861,592,2862,677,0
20150106.09353,2861,24,1049246,-24,2861,580,2862,683,0
20150106.093531,2862,2,1049248,-2,2861,591,2862,685,1
20150106.093533,2862,12,1049260,0,2861,590,2862,681,1
20150106.093534,2861,6,1049266,-6,2861,587,2862,681,0
20150106.093536,2861,10,1049276,0,2861,584,2862,681,0
20150106.093541,2862,10,1049286,0,2861,592,2862,679,1
20150106.093543,2861,2,1049288,0,2861,602,2862,679,0
20150106.093546,2862,2,1049290,-2,2861,600,2862,678,1
20150106.093547,2862,4,1049294,0,2861,598,2862,676,1
20150106.093548,2862,2,1049296,0,2861,598,2862,675,1
20150106.093549,2861,2,1049298,0,2861,597,2862,701,0
20150106.093552,2861,4,1049302,-4,2861,596,2862,701,0
20150106.093554,2862,14,1049316,-10,2861,613,2862,859,1
20150106.093557,2862,4,1049320,0,2861,628,2862,891,1
20150106.0936,2861,60,1049380,-20,2861,599,2862,885,0
20150106.093606,2861,2,1049382,0,2861,676,2862,861,0
20150106.093606,2861,2,1049384,0,2861,675,2862,861,0
20150106.093607,2861,22,1049406,0,2861,665,2862,862,0
20150106.093607,2861,20,1049426,-20,2861,655,2862,862,0
20150106.093608,2861,4,1049430,-4,2861,653,2862,862,0
20150106.093608,2862,2,1049432,-2,2861,653,2862,861,1
20150106.09361,2862,202,1049634,-144,2861,652,2862,762,1
20150106.09361,2861,4,1049638,-4,2861,650,2862,763,0
20150106.093612,2861,2,1049640,0,2861,648,2862,765,0
20150106.093613,2862,2,1049642,2,2861,649,2862,765,1
20150106.093616,2861,2,1049644,0,2861,792,2862,764,0
20150106.093617,2862,2,1049646,2,2861,792,2862,763,1
20150106.093618,2861,20,1049666,0,2861,782,2862,763,0
20150106.093618,2861,60,1049726,0,2861,768,2862,763,0
20150106.093621,2862,104,1049830,-42,2861,768,2862,712,1
20150106.093621,2862,80,1049910,54,2861,768,2862,672,1
20150106.093624,2861,40,1049950,0,2861,748,2862,674,0
20150106.093625,2861,10,1049960,0,2861,745,2862,674,0
20150106.093627,2862,14,1049974,2,2861,745,2862,677,1
20150106.09363,2862,2,1049976,-2,2861,746,2862,679,1
20150106.093631,2861,2,1049978,-2,2861,745,2862,689,0
20150106.093631,2861,2,1049980,0,2861,744,2862,689,0
20150106.093632,2861,20,1050000,0,2861,736,2862,689,0
20150106.093633,2861,2,1050002,0,2861,735,2862,689,0
20150106.093634,2861,4,1050006,-4,2861,734,2862,692,0
20150106.093634,2861,2,1050008,-2,2861,733,2862,692,0
20150106.093636,2861,2,1050010,0,2861,735,2862,695,0
20150106.093638,2861,1042,1051052,584,2861,214,2862,690,0
20150106.093641,2861,120,1051172,-38,2861,174,2862,747,0
20150106.093641,2861,20,1051192,0,2861,164,2862,747,0
20150106.093642,2861,2,1051194,0,2861,164,2862,747,0
20150106.093642,2861,2,1051196,0,2861,163,2862,748,0
20150106.093644,2861,4,1051200,0,2861,165,2862,749,0
20150106.093644,2862,2,1051202,-2,2861,165,2862,748,1
20150106.093645,2861,22,1051224,-12,2861,154,2862,749,0
20150106.093646,2861,2,1051226,0,2861,153,2862,750,0
20150106.093647,2861,6,1051232,-4,2861,152,2862,748,0
20150106.093647,2862,2,1051234,0,2861,152,2862,747,1
20150106.093648,2861,6,1051240,-6,2861,149,2862,748,0
20150106.093649,2861,18,1051258,-18,2861,140,2862,748,0
20150106.093649,2861,2,1051260,-2,2861,139,2862,748,0
20150106.09365,2861,2,1051262,0,2861,138,2862,748,0
20150106.093652,2861,2,1051264,-2,2861,138,2862,752,0
20150106.093653,2861,8,1051272,0,2861,183,2862,753,0
20150106.093653,2861,6,1051278,-2,2861,180,2862,753,0
20150106.093654,2861,10,1051288,0,2861,175,2862,755,0
20150106.093655,2861,2,1051290,0,2861,174,2862,755,0
20150106.093657,2861,10,1051300,-10,2861,171,2862,755,0
20150106.093657,2862,22,1051322,8,2861,177,2862,756,1
20150106.093658,2861,46,1051368,0,2861,154,2862,755,0
20150106.0937,2861,2,1051370,-2,2861,190,2862,765,0
20150106.093702,2861,2,1051372,0,2861,211,2862,770,0
20150106.093703,2861,2,1051374,0,2861,211,2862,770,0
20150106.093706,2861,14,1051388,-14,2861,192,2862,772,0
20150106.093707,2861,6,1051394,0,2861,189,2862,773,0
20150106.093709,2861,6,1051400,0,2861,186,2862,768,0
20150106.093709,2861,2,1051402,0,2861,138,2862,768,0
20150106.093713,2861,20,1051422,0,2861,128,2862,774,0
20150106.093714,2861,40,1051462,0,2861,118,2862,613,0
20150106.093716,2861,12,1051474,-6,2861,112,2862,615,0
20150106.093716,2861,2,1051476,2,2861,111,2862,622,0
20150106.093717,2861,224,1051700,-180,2860,1510,2861,115,0
20150106.093718,2861,2,1051702,-2,2860,1513,2861,115,0
20150106.093718,2861,238,1051940,-124,2861,56,2862,675,0
20150106.093719,2861,8,1051948,2,2861,101,2862,627,0
20150106.09372,2861,6,1051954,-2,2861,106,2862,627,0
20150106.093721,2861,14,1051968,-2,2861,100,2862,627,0
20150106.093722,2861,4,1051972,-2,2861,98,2862,627,0
20150106.093723,2861,80,1052052,-78,2861,59,2862,627,0
20150106.093724,2861,78,1052130,78,2861,20,2862,627,0
20150106.093724,2862,12,1052142,4,2861,16,2862,625,1
20150106.093725,2861,10,1052152,10,2861,11,2862,641,0
20150106.093725,2861,10,1052162,0,2861,8,2862,640,0
20150106.093726,2861,20,1052182,4,2860,1501,2861,2,0
20150106.093727,2861,30,1052212,24,2860,1403,2861,110,0
20150106.093727,2861,6,1052218,2,2860,1410,2861,107,0
20150106.093729,2860,2,1052220,0,2860,1409,2861,118,0
20150106.093729,2861,82,1052302,-10,2860,1413,2861,83,1
20150106.09373,2860,2,1052304,-2,2860,1412,2861,83,0
20150106.09373,2861,6,1052310,-6,2860,1412,2861,87,1
20150106.093731,2861,22,1052332,-20,2860,1411,2861,239,1
20150106.093731,2861,16,1052348,0,2860,1411,2861,236,1
20150106.093732,2861,40,1052388,0,2860,1411,2861,216,1
20150106.093733,2861,4,1052392,0,2860,1387,2861,219,1
20150106.093733,2861,438,1052830,84,2861,133,2862,685,1
20150106.093734,2861,36,1052866,8,2861,115,2862,635,1
20150106.093734,2861,232,1053098,32,2860,1433,2861,75,1
20150106.093735,2861,150,1053248,126,2861,26,2862,635,1
20150106.093735,2861,52,1053300,-4,2860,1433,2861,2,1
20150106.093736,2861,6,1053306,-2,2861,2,2862,685,1
20150106.093736,2861,4,1053310,2,2861,1,2862,634,1
20150106.093737,2861,4,1053314,-2,2860,1433,2861,1,1
20150106.093737,2861,4,1053318,0,2860,1383,2861,6,1
20150106.093738,2861,18,1053336,-2,2861,3,2862,689,1
20150106.093739,2861,4,1053340,2,2861,23,2862,649,1
20150106.093739,2861,56,1053396,-56,2860,1383,2861,34,1
20150106.09374,2861,6,1053402,-2,2860,1383,2861,64,1
20150106.093741,2861,28,1053430,0,2860,1383,2861,51,1
20150106.093741,2861,106,1053536,-28,2861,102,2862,668,1
20150106.093742,2861,6,1053542,-4,2861,99,2862,668,1
20150106.093742,2861,8,1053550,-2,2861,96,2862,840,1
20150106.093743,2861,8,1053558,0,2861,95,2862,840,1
20150106.093743,2861,26,1053584,0,2861,83,2862,840,1
20150106.093744,2861,22,1053606,-22,2861,79,2862,840,1
20150106.093744,2861,14,1053620,-6,2861,72,2862,840,1
20150106.093745,2861,48,1053668,2,2860,1383,2861,51,1
20150106.093745,2861,2,1053670,2,2860,1383,2861,50,1
20150106.093746,2861,4,1053674,2,2860,1398,2861,147,1
20150106.093747,2861,4,1053678,0,2860,1398,2861,179,1
20150106.093747,2861,2,1053680,2,2860,1403,2861,231,1
20150106.093748,2861,6,1053686,6,2860,1403,2861,230,1
20150106.093749,2861,22,1053708,22,2860,1403,2861,244,1
20150106.093751,2860,4,1053712,-2,2860,1401,2861,298,0
20150106.093752,2861,22,1053734,22,2860,1401,2861,288,1
20150106.093755,2860,2,1053736,0,2860,1400,2861,300,0
20150106.093756,2861,42,1053778,-2,2860,1401,2861,285,1
20150106.093758,2861,10,1053788,0,2860,1402,2861,296,1
20150106.093759,2860,64,1053852,0,2860,1371,2861,327,0
20150106.0938,2861,12,1053864,-12,2860,1370,2861,322,1
20150106.093801,2861,2,1053866,-2,2860,1370,2861,321,1
20150106.093803,2860,4,1053870,-4,2860,1368,2861,323,0
20150106.093805,2860,114,1053984,-110,2860,1315,2861,325,0
20150106.093805,2860,8,1053992,-4,2860,1311,2861,325,0
20150106.093806,2861,4,1053996,0,2860,1311,2861,346,1
20150106.093806,2860,8,1054004,-8,2860,1307,2861,350,0
20150106.093807,2860,4,1054008,-4,2860,1305,2861,347,0
20150106.093807,2860,4,1054012,-4,2860,1303,2861,345,0
20150106.093808,2861,102,1054114,-100,2860,1303,2861,295,1
20150106.093808,2861,2,1054116,0,2860,1303,2861,294,1
20150106.093809,2860,2,1054118,-2,2860,1302,2861,296,0
20150106.09381,2861,22,1054140,-22,2860,1293,2861,294,1
20150106.093811,2861,8,1054148,-4,2860,1423,2861,292,1
20150106.093811,2860,22,1054170,-20,2860,1402,2861,292,0
20150106.093812,2860,2,1054172,0,2860,1401,2861,302,0
20150106.093813,2860,8,1054180,-4,2860,909,2861,305,0
20150106.093814,2860,2,1054182,0,2860,907,2861,309,0
20150106.093816,2860,2,1054184,0,2860,895,2861,310,0
20150106.093816,2861,16,1054200,-16,2860,894,2861,302,1
20150106.093817,2861,16,1054216,0,2860,894,2861,295,1
20150106.093817,2860,2,1054218,-2,2860,896,2861,301,0
20150106.093818,2860,26,1054244,0,2860,883,2861,301,0
20150106.093822,2860,200,1054444,-200,2860,745,2861,276,0
20150106.093823,2861,2,1054446,-2,2860,745,2861,276,1
20150106.093823,2861,4,1054450,0,2860,745,2861,275,1
20150106.093824,2861,2,1054452,0,2860,746,2861,284,1
20150106.093825,2860,20,1054472,0,2860,736,2861,284,0
20150106.093826,2860,42,1054514,2,2860,1242,2861,266,0
20150106.093827,2860,4,1054518,-4,2860,1240,2861,266,0
20150106.093828,2861,2,1054520,0,2860,1240,2861,272,1
20150106.093828,2860,2,1054522,-2,2860,1239,2861,269,0
20150106.09383,2860,8,1054530,-8,2860,1235,2861,271,0
20150106.09383,2860,10,1054540,-4,2860,1231,2861,271,0
20150106.093831,2860,38,1054578,4,2860,1219,2861,264,0
20150106.093831,2861,16,1054594,0,2860,1221,2861,256,1
20150106.093835,2860,8,1054602,0,2860,1214,2861,795,0
20150106.093836,2860,12,1054614,0,2860,1208,2861,798,0
20150106.093836,2860,2,1054616,2,2860,1207,2861,798,0
20150106.093837,2861,8,1054624,0,2860,1208,2861,794,1
20150106.093839,2860,2,1054626,0,2860,1207,2861,803,0
20150106.09384,2860,2,1054628,0,2860,1206,2861,806,0
20150106.093841,2860,2,1054630,0,2860,1203,2861,821,0
20150106.093842,2861,40,1054670,-34,2860,1203,2861,822,1
20150106.093844,2860,4,1054674,0,2860,1201,2861,808,0
20150106.093845,2861,2,1054676,0,2860,1204,2861,809,1
20150106.093847,2860,20,1054696,0,2860,1196,2861,830,0
20150106.093849,2860,2,1054698,2,2860,1205,2861,831,0
20150106.093849,2860,2,1054700,2,2860,1203,2861,831,0
20150106.093853,2860,104,1054804,90,2860,1149,2861,838,0
20150106.093853,2861,4,1054808,4,2860,1156,2861,838,1
20150106.093854,2861,16,1054824,0,2860,1161,2861,830,1
20150106.093855,2860,2,1054826,-2,2860,1144,2861,836,0
20150106.093857,2860,16,1054842,-2,2860,1144,2861,835,0
20150106.093857,2861,4,1054846,0,2860,1144,2861,833,1
20150106.0939,2860,4,1054850,0,2860,1142,2861,858,0
20150106.093901,2860,2,1054852,0,2860,1141,2861,858,0
20150106.093902,2860,14,1054866,2,2860,1139,2861,852,0
20150106.093907,2861,26,1054892,-26,2860,1154,2861,839,1
20150106.093907,2860,40,1054932,-16,2860,1134,2861,839,0
20150106.093909,2860,22,1054954,-4,2860,1117,2861,840,0
20150106.093911,2860,4,1054958,4,2860,1115,2861,840,0
20150106.093911,2861,4,1054962,2,2860,1114,2861,839,1
20150106.093913,2860,4,1054966,4,2860,1108,2861,839,0
20150106.093913,2860,4,1054970,4,2860,1105,2861,839,0
20150106.093914,2860,242,1055212,126,2860,1005,2861,819,0
20150106.093914,2861,2,1055214,0,2860,1005,2861,818,1
20150106.093915,2860,2,1055216,0,2860,1005,2861,818,0
20150106.093915,2860,8,1055224,0,2860,989,2861,818,0
20150106.093916,2860,2,1055226,0,2860,988,2861,818,0
20150106.093918,2860,16,1055242,-6,2860,976,2861,821,0
20150106.093919,2860,2,1055244,0,2860,976,2861,823,0
20150106.093919,2860,2,1055246,-2,2860,976,2861,824,0
20150106.09392,2860,4,1055250,-4,2860,976,2861,824,0
20150106.09392,2861,10,1055260,-10,2860,976,2861,819,1
20150106.093922,2860,4,1055264,0,2860,974,2861,822,0
20150106.093922,2860,4,1055268,0,2860,972,2861,823,0
20150106.093923,2861,2,1055270,0,2860,972,2861,824,1
20150106.093924,2860,100,1055370,20,2860,926,2861,826,0
20150106.093924,2860,8,1055378,-6,2860,922,2861,826,0
20150106.093925,2860,2,1055380,0,2860,921,2861,826,0
20150106.093926,2861,10,1055390,-2,2860,920,2861,823,1
20150106.093927,2860,40,1055430,-32,2860,900,2861,823,0
20150106.093928,2860,4,1055434,-4,2860,898,2861,823,0
20150106.093928,2860,2,1055436,0,2860,897,2861,823,0
20150106.09393,2860,2,1055438,0,2860,900,2861,826,0
20150106.09393,2860,24,1055462,-8,2860,890,2861,824,0
20150106.093931,2861,2,1055464,0,2860,891,2861,824,1
20150106.093932,2860,4,1055468,-4,2860,889,2861,824,0
20150106.093933,2860,2,1055470,-2,2860,888,2861,824,0
20150106.093933,2860,10,1055480,0,2860,883,2861,825,0
20150106.093934,2860,10,1055490,-2,2860,880,2861,823,0
20150106.093934,2860,2,1055492,0,2860,879,2861,823,0
20150106.093936,2860,2,1055494,0,2860,884,2861,824,0
20150106.093937,2860,4,1055498,-2,2860,882,2861,822,0
20150106.093937,2860,2,1055500,-2,2860,891,2861,822,0
20150106.093938,2861,2,1055502,2,2860,881,2861,821,1
20150106.093939,2860,4,1055506,0,2860,879,2861,821,0
20150106.09394,2861,10,1055516,4,2860,871,2861,836,1
20150106.093941,2861,2,1055518,-2,2860,870,2861,839,1
20150106.093942,2860,140,1055658,-60,2860,800,2861,839,0
20150106.093943,2860,192,1055850,-32,2860,704,2861,841,0
20150106.093943,2860,400,1056250,48,2860,504,2861,841,0
20150106.093944,2860,2,1056252,0,2860,503,2861,843,0
20150106.093944,2860,468,1056720,-2,2860,274,2861,843,0
20150106.093945,2861,550,1057270,-188,2859,2340,2860,62,1
20150106.093946,2859,2,1057272,0,2859,2339,2860,87,0
20150106.093946,2859,2070,1059342,-1844,2859,1299,2860,211,0
20150106.093947,2859,88,1059430,-78,2859,1254,2860,213,0
20150106.093948,2859,26,1059456,16,2859,1241,2860,229,0
20150106.093949,2859,2,1059458,2,2859,1240,2860,239,0
20150106.093951,2859,8,1059466,4,2859,1237,2860,479,0
20150106.093951,2859,12,1059478,12,2859,1231,2860,480,0
20150106.093952,2859,32,1059510,6,2859,1215,2860,480,0
20150106.093952,2859,20,1059530,20,2859,1205,2860,535,0
20150106.093953,2859,2,1059532,2,2859,1204,2860,537,0
20150106.093954,2859,10,1059542,2,2859,1202,2860,642,0
20150106.093955,2859,2,1059544,2,2859,1201,2860,643,0
20150106.093956,2859,6,1059550,6,2859,1198,2860,645,0
20150106.093956,2859,2,1059552,0,2859,1198,2860,645,0
20150106.093957,2859,6,1059558,4,2859,1195,2860,646,0
20150106.093957,2859,2,1059560,2,2859,1188,2860,647,0
20150106.093958,2860,28,1059588,26,2859,1180,2860,647,1
20150106.093959,2859,54,1059642,14,2859,1155,2860,648,0
20150106.093959,2859,6,1059648,2,2859,1152,2860,680,0
20150106.094,2859,2,1059650,2,2859,1151,2860,723,0
20150106.094,2860,20,1059670,20,2859,1150,2860,715,1
20150106.094001,2859,2,1059672,2,2859,1149,2860,723,0
20150106.094001,2859,2,1059674,2,2859,1148,2860,723,0
20150106.094003,2859,2,1059676,2,2859,1147,2860,724,0
20150106.094003,2859,12,1059688,4,2859,1143,2860,725,0
20150106.094004,2859,2,1059690,0,2859,1142,2860,761,0
20150106.094005,2859,52,1059742,12,2859,1116,2860,729,0
20150106.094006,2859,2,1059744,2,2859,1115,2860,731,0
20150106.094007,2860,2,1059746,0,2859,1116,2860,731,1
20150106.094008,2859,2,1059748,2,2859,1116,2860,736,0
20150106.094008,2859,46,1059794,28,2859,1093,2860,732,0
20150106.094009,2859,4,1059798,0,2859,1091,2860,733,0
20150106.094009,2859,2,1059800,2,2859,1092,2860,742,0
20150106.09401,2859,2,1059802,2,2859,1092,2860,799,0
20150106.09401,2859,2,1059804,0,2859,1091,2860,741,0
20150106.094011,2859,4,1059808,0,2859,1089,2860,800,0
20150106.094012,2859,14,1059822,0,2859,1082,2860,583,0
20150106.094012,2859,18,1059840,16,2859,1078,2860,632,0
20150106.094013,2860,2,1059842,0,2859,1087,2860,631,1
20150106.094013,2860,8,1059850,0,2859,1087,2860,630,1
20150106.094014,2859,2,1059852,0,2859,1085,2860,663,0
20150106.094015,2859,2,1059854,0,2859,1072,2860,783,0
20150106.094017,2859,4,1059858,4,2859,1071,2860,696,0
20150106.094017,2860,6,1059864,6,2859,1073,2860,690,1
20150106.094018,2859,16,1059880,4,2859,1066,2860,697,0
20150106.094018,2860,6,1059886,6,2859,1064,2860,699,1
20150106.094019,2859,2,1059888,0,2859,1063,2860,699,0
20150106.094019,2859,54,1059942,52,2859,1036,2860,699,0
20150106.09402,2859,52,1059994,12,2859,1010,2860,700,0
20150106.094021,2859,28,1060022,16,2859,996,2860,698,0
20150106.094021,2860,4,1060026,2,2859,996,2860,701,1
20150106.094021,2859,12,1060038,12,2859,990,2860,703,0
20150106.094022,2859,2,1060040,2,2859,989,2860,706,0
20150106.094023,2859,8,1060048,6,2859,985,2860,707,0
20150106.094023,2859,90,1060138,36,2859,940,2860,694,0
20150106.094023,2859,2,1060140,0,2859,939,2860,1194,0
20150106.094024,2859,6,1060146,-4,2859,934,2860,1197,0
20150106.094025,2859,6,1060152,0,2859,932,2860,1196,0
20150106.094025,2859,20,1060172,-16,2859,921,2860,1196,0
20150106.094026,2859,114,1060286,-100,2859,864,2860,1202,0
20150106.094026,2860,2,1060288,0,2859,873,2860,1202,1
20150106.094027,2859,218,1060506,0,2859,776,2860,1202,0
20150106.094027,2859,2,1060508,-2,2859,775,2860,1202,0
20150106.094028,2859,1754,1062262,-1248,2858,1056,2859,134,0
20150106.094028,2859,6,1062268,-2,2858,1042,2859,134,0
20150106.094029,2858,32,1062300,-22,2858,1028,2859,260,0
20150106.09403,2858,2078,1064378,-1152,2857,766,2858,159,0
20150106.09403,2857,684,1065062,-46,2857,593,2858,8,0
20150106.094031,2857,176,1065238,10,2857,518,2858,38,0
20150106.094031,2857,326,1065564,8,2857,299,2858,43,0
20150106.094032,2857,20,1065584,-2,2857,321,2858,67,0
20150106.094033,2858,14,1065598,2,2857,315,2858,66,1
20150106.094033,2857,10,1065608,-4,2857,310,2858,67,0
20150106.094034,2857,168,1065776,-86,2857,258,2858,37,0
20150106.094034,2858,14,1065790,-6,2857,245,2858,37,1
20150106.094035,2857,26,1065816,-2,2857,259,2858,38,0
20150106.094035,2857,52,1065868,4,2857,235,2858,43,0
20150106.094036,2857,6,1065874,2,2857,235,2858,43,0
20150106.094036,2858,22,1065896,2,2857,326,2858,41,1
20150106.094037,2858,2,1065898,0,2857,326,2858,38,1
20150106.094037,2857,32,1065930,2,2857,311,2858,146,0
20150106.094038,2858,20,1065950,0,2857,308,2858,178,1
20150106.094038,2857,28,1065978,4,2857,294,2858,180,0
20150106.094039,2857,4,1065982,2,2857,291,2858,182,0
20150106.094039,2857,8,1065990,-6,2857,173,2858,189,0
20150106.09404,2858,4,1065994,-4,2857,171,2858,257,1
20150106.09404,2857,410,1066404,-298,2856,1736,2857,130,0
20150106.094041,2857,94,1066498,-20,2856,1687,2857,125,0
20150106.094042,2857,8,1066506,-2,2856,1688,2857,126,0
20150106.094042,2856,16,1066522,-4,2856,1682,2857,123,0
20150106.094043,2857,166,1066688,-90,2856,1615,2857,116,1
20150106.094043,2856,46,1066734,-32,2856,1503,2857,118,0
20150106.094044,2857,30,1066764,-24,2856,1494,2857,126,1
20150106.094045,2856,60,1066824,-46,2856,1468,2857,119,0
20150106.094045,2857,56,1066880,-52,2856,1412,2857,124,1
20150106.094046,2857,88,1066968,-52,2856,1379,2857,105,1
20150106.094046,2857,146,1067114,-80,2856,1410,2857,65,1
20150106.094047,2857,28,1067142,4,2856,1414,2857,60,1
20150106.094047,2856,10,1067152,0,2856,1411,2857,60,0
20150106.094048,2857,150,1067302,-90,2857,48,2858,371,1
20150106.094048,2858,234,1067536,-96,2857,34,2858,376,1
20150106.094049,2857,166,1067702,-110,2857,46,2858,327,0
20150106.094049,2857,102,1067804,2,2857,4,2858,339,0
20150106.09405,2857,166,1067970,-24,2857,149,2858,389,0
20150106.09405,2857,2,1067972,-2,2857,153,2858,397,0
20150106.094051,2857,86,1068058,-42,2857,115,2858,397,0
20150106.094051,2857,66,1068124,-32,2857,170,2858,408,0
20150106.094052,2857,204,1068328,194,2857,103,2858,411,0
20150106.094052,2857,82,1068410,0,2857,101,2858,435,0
20150106.094053,2857,54,1068464,40,2857,82,2858,437,0
20150106.094053,2857,10,1068474,-10,2857,81,2858,449,0
20150106.094054,2857,4,1068478,-4,2857,80,2858,451,0
20150106.094054,2857,188,1068666,-60,2856,1575,2857,74,0
20150106.094055,2858,158,1068824,94,2857,54,2858,455,1
20150106.094056,2858,46,1068870,-36,2857,68,2858,485,1
20150106.094056,2857,90,1068960,12,2857,24,2858,488,0
20150106.094057,2857,26,1068986,24,2857,13,2858,488,0
20150106.094057,2858,2,1068988,0,2857,70,2858,512,1
20150106.094058,2857,36,1069024,0,2857,60,2858,516,0
20150106.094058,2857,42,1069066,2,2857,46,2858,515,0
20150106.094059,2857,180,1069246,-78,2856,1487,2857,132,0
20150106.0941,2857,4,1069250,0,2856,1530,2857,289,0
20150106.0941,2857,2,1069252,0,2856,1532,2857,291,0
20150106.094101,2856,4,1069256,-4,2856,1524,2857,319,0
20150106.094101,2856,4,1069260,0,2856,1517,2857,318,0
20150106.094102,2857,42,1069302,-34,2856,1500,2857,321,1
20150106.094102,2856,8,1069310,-6,2856,1497,2857,423,0
20150106.094103,2857,22,1069332,0,2856,1497,2857,418,1
20150106.094103,2856,44,1069376,-24,2856,1488,2857,416,0
20150106.094104,2856,24,1069400,-24,2856,1477,2857,416,0
20150106.094104,2856,26,1069426,-2,2856,1487,2857,418,0
20150106.094105,2857,10,1069436,0,2856,1491,2857,417,1
20150106.094105,2857,258,1069694,-46,2856,1462,2857,316,1
20150106.094106,2856,8,1069702,-2,2856,1499,2857,310,0
20150106.094106,2856,10,1069712,0,2856,1504,2857,311,0
20150106.094107,2856,8,1069720,0,2856,1521,2857,312,0
20150106.094107,2857,82,1069802,-82,2856,1473,2857,314,1
20150106.094108,2856,18,1069820,6,2856,1467,2857,312,0
20150106.094108,2856,4,1069824,-2,2856,1465,2857,315,0
20150106.094109,2857,4,1069828,0,2856,1460,2857,304,1
20150106.094109,2856,14,1069842,-10,2856,1485,2857,301,0
20150106.09411,2856,8,1069850,-6,2856,1487,2857,305,0
20150106.09411,2856,14,1069864,-12,2856,1500,2857,309,0
20150106.094111,2856,120,1069984,-116,2856,1442,2857,314,0
20150106.094111,2856,44,1070028,38,2856,1425,2857,354,0
20150106.094112,2856,10,1070038,2,2856,1420,2857,374,0
20150106.094113,2856,28,1070066,0,2856,1369,2857,375,0
20150106.094113,2856,44,1070110,-36,2856,1349,2857,375,0
20150106.094114,2857,54,1070164,12,2856,1580,2857,371,1
20150106.094115,2857,14,1070178,8,2856,1583,2857,412,1
20150106.094116,2857,4,1070182,0,2856,1589,2857,429,1
20150106.094116,2856,4,1070186,-4,2856,1588,2857,434,0
20150106.094117,2856,2,1070188,0,2856,1559,2857,436,0
20150106.094117,2857,4,1070192,2,2856,1563,2857,447,1
20150106.094118,2857,2,1070194,0,2856,1513,2857,472,1
20150106.094118,2856,2,1070196,0,2856,1512,2857,471,0
20150106.094119,2857,8,1070204,0,2856,1512,2857,468,1
20150106.094119,2856,80,1070284,-70,2856,1474,2857,468,0
20150106.09412,2856,10,1070294,-4,2856,1482,2857,465,0
20150106.094121,2856,104,1070398,-8,2856,1432,2857,470,0
20150106.094122,2856,12,1070410,-10,2856,1425,2857,476,0
20150106.094122,2856,2,1070412,0,2856,1424,2857,504,0
20150106.094123,2856,46,1070458,0,2856,1402,2857,505,0
20150106.094123,2856,8,1070466,-4,2856,1401,2857,505,0
20150106.094124,2856,22,1070488,-12,2856,1391,2857,510,0
20150106.094124,2857,8,1070496,0,2856,1382,2857,550,1
20150106.094125,2856,2,1070498,-2,2856,1380,2857,550,0
20150106.094125,2856,28,1070526,-26,2856,1368,2857,552,0
20150106.094126,2857,14,1070540,0,2856,1338,2857,562,1
20150106.094127,2856,20,1070560,-20,2856,1331,2857,613,0
20150106.094127,2856,14,1070574,-12,2856,1329,2857,613,0
20150106.094128,2857,2,1070576,0,2856,1329,2857,613,1
20150106.094128,2857,4,1070580,0,2856,1338,2857,612,1
20150106.094129,2856,142,1070722,-2,2856,1267,2857,583,0
20150106.094129,2856,2,1070724,0,2856,1267,2857,593,0
20150106.09413,2857,8,1070732,0,2856,1281,2857,589,1
20150106.094131,2857,602,1071334,446,2856,1281,2857,289,1
20150106.094132,2858,714,1072048,-36,2857,41,2858,489,1
20150106.094132,2857,196,1072244,94,2857,68,2858,539,0
20150106.094133,2857,246,1072490,130,2856,1409,2857,51,0
20150106.094133,2857,196,1072686,-4,2856,1363,2857,119,0
20150106.094134,2856,12,1072698,-10,2856,1374,2857,207,0
20150106.094134,2857,406,1073104,-332,2856,1358,2857,46,1
20150106.094135,2857,2,1073106,0,2856,1402,2857,49,1
20150106.094135,2857,210,1073316,-20,2857,52,2858,555,1
20150106.094136,2857,102,1073418,58,2856,1438,2858,555,1
20150106.094136,2857,12,1073430,-4,2856,1387,2857,99,1
20150106.094137,2857,10,1073440,-10,2856,1379,2857,192,1
20150106.094138,2857,10,1073450,-6,2856,1378,2857,199,1
20150106.094138,2857,38,1073488,-32,2856,1363,2857,196,1
20150106.094139,2857,1036,1074524,558,2856,823,2857,179,1
20150106.094139,2857,6,1074530,-6,2856,821,2857,191,1
20150106.09414,2856,4,1074534,0,2856,804,2857,259,0
20150106.09414,2857,82,1074616,-26,2856,781,2857,221,1
20150106.094141,2856,224,1074840,92,2856,681,2857,215,0
20150106.094141,2857,10,1074850,6,2856,680,2857,212,1
20150106.094142,2856,20,1074870,-14,2856,670,2857,220,0
20150106.094142,2857,2,1074872,0,2856,671,2857,219,1
20150106.094143,2856,2,1074874,0,2856,671,2857,220,0
20150106.094143,2856,4,1074878,0,2856,670,2857,230,0
20150106.094143,2857,2,1074880,2,2856,670,2857,229,1
20150106.094144,2857,64,1074944,-24,2856,671,2857,199,1
20150106.094145,2857,2,1074946,0,2856,683,2857,204,1
20150106.094146,2856,254,1075200,-180,2856,556,2857,313,0
20150106.094147,2857,104,1075304,-18,2856,552,2857,265,1
20150106.094147,2857,10,1075314,0,2856,554,2857,265,1
20150106.094148,2857,12,1075326,-4,2856,555,2857,264,1
20150106.094148,2856,8,1075334,-8,2856,560,2857,266,0
20150106.094149,2857,10,1075344,0,2856,516,2857,261,1
20150106.094149,2856,2,1075346,0,2856,516,2857,278,0
20150106.09415,2856,10,1075356,-8,2856,615,2857,279,0
20150106.094151,2857,202,1075558,84,2856,700,2857,258,1
20150106.094152,2856,2,1075560,0,2856,711,2857,261,0
20150106.094153,2856,2626,1078186,-798,2855,1131,2856,400,0
20150106.094153,2856,208,1078394,-2,2855,1136,2856,299,0
20150106.094154,2856,2,1078396,0,2855,1115,2856,313,0
20150106.094154,2855,4,1078400,0,2855,1114,2856,312,0
20150106.094155,2856,214,1078614,-202,2855,1116,2856,215,1
20150106.094155,2855,220,1078834,-210,2855,1009,2856,259,0
20150106.094156,2855,36,1078870,2,2855,994,2856,344,0
20150106.094156,2855,92,1078962,14,2855,949,2856,344,0
20150106.094157,2855,26,1078988,4,2855,942,2856,338,0
20150106.094157,2856,4,1078992,2,2855,941,2856,337,1
20150106.094158,2855,118,1079110,96,2855,885,2856,338,0
20150106.094159,2855,2,1079112,2,2855,891,2856,362,0
20150106.0942,2856,170,1079282,30,2855,819,2856,354,1
20150106.0942,2855,8,1079290,4,2855,818,2856,275,0
20150106.094201,2855,32,1079322,32,2855,804,2856,283,0
20150106.094201,2855,2,1079324,2,2855,798,2856,280,0
20150106.094202,2856,30,1079354,20,2855,864,2856,275,1
20150106.094202,2855,58,1079412,30,2855,836,2856,321,0
20150106.094203,2855,46,1079458,0,2855,817,2856,424,0
20150106.094204,2855,18,1079476,12,2855,810,2856,423,0
20150106.094204,2855,70,1079546,6,2855,808,2856,482,0
20150106.094205,2855,4,1079550,0,2855,810,2856,483,0
20150106.094205,2855,112,1079662,0,2855,749,2856,480,0
20150106.094206,2855,8,1079670,4,2855,800,2856,481,0
20150106.094206,2855,30,1079700,6,2855,791,2856,477,0
20150106.094207,2855,24,1079724,-14,2855,779,2856,478,0
20150106.094207,2856,22,1079746,-10,2855,769,2856,537,1
20150106.094208,2856,2,1079748,0,2855,826,2856,537,1
20150106.094209,2855,14,1079762,-4,2855,820,2856,540,0
20150106.094209,2855,42,1079804,-36,2855,793,2856,539,0
20150106.09421,2856,10,1079814,-6,2855,751,2856,637,1
20150106.09421,2855,4,1079818,-2,2855,755,2856,638,0
20150106.094211,2855,2,1079820,0,2855,798,2856,669,0
20150106.094211,2855,22,1079842,-14,2855,823,2856,669,0
20150106.094212,2855,4,1079846,-2,2855,826,2856,659,0
20150106.094212,2856,2,1079848,-2,2855,826,2856,658,1
20150106.094213,2856,16,1079864,-12,2855,815,2856,652,1
20150106.094213,2855,2,1079866,0,2855,813,2856,654,0
20150106.094214,2855,36,1079902,-36,2855,787,2856,703,0
20150106.094215,2855,24,1079926,0,2855,783,2856,647,0
20150106.094215,2855,46,1079972,-42,2855,781,2856,626,0
20150106.094215,2856,2,1079974,-2,2855,793,2856,625,1
20150106.094216,2855,34,1080008,-12,2855,1058,2856,614,0
20150106.094217,2856,4,1080012,0,2855,1065,2856,617,1
20150106.094217,2856,60,1080072,-38,2855,1057,2856,606,1
20150106.094218,2855,974,1081046,-458,2855,1054,2856,136,0
20150106.094218,2856,284,1081330,-234,2856,156,2857,421,1
20150106.094218,2856,2,1081332,0,2856,411,2857,419,1
20150106.094219,2856,12,1081344,2,2856,519,2857,389,1
20150106.094219,2856,64,1081408,-4,2856,504,2857,388,1
20150106.09422,2856,4,1081412,0,2856,513,2857,388,1
20150106.094221,2856,2,1081414,0,2856,513,2857,392,1
20150106.094221,2856,2,1081416,0,2856,512,2857,393,1
20150106.094222,2856,4,1081420,-4,2856,511,2857,394,1
20150106.094223,2856,12,1081432,-12,2856,508,2857,515,1
20150106.094223,2856,8,1081440,-8,2856,507,2857,515,1
20150106.094224,2857,2,1081442,2,2856,614,2857,515,1
20150106.094224,2856,4,1081446,0,2856,618,2857,520,0
20150106.094224,2856,12,1081458,-12,2856,624,2857,511,0
20150106.094225,2857,20,1081478,-6,2856,628,2857,514,1
20150106.094225,2856,22,1081500,12,2856,624,2857,508,0
20150106.094226,2856,10,1081510,8,2856,624,2857,604,0
20150106.094227,2856,46,1081556,-2,2856,616,2857,599,0
20150106.094227,2857,10,1081566,8,2856,616,2857,599,1
20150106.094228,2857,8,1081574,0,2856,615,2857,596,1
20150106.094228,2857,6,1081580,6,2856,625,2857,502,1
20150106.094229,2857,64,1081644,4,2856,644,2857,506,1
20150106.094229,2857,4,1081648,4,2856,645,2857,503,1
20150106.09423,2857,1024,1082672,764,2857,12,2858,893,1
20150106.094231,2857,8,1082680,4,2857,84,2858,895,1
20150106.094231,2856,188,1082868,176,2856,711,2857,52,0
20150106.094232,2857,44,1082912,-10,2856,815,2857,32,1
20150106.094232,2857,86,1082998,-62,2857,222,2858,946,1
20150106.094233,2857,22,1083020,0,2857,261,2858,891,1
20150106.094233,2857,8,1083028,2,2857,268,2858,890,1
20150106.094234,2857,10,1083038,10,2857,276,2858,889,1
20150106.094235,2858,32,1083070,28,2857,269,2858,886,1
20150106.094236,2857,8,1083078,4,2857,266,2858,1386,0
20150106.094237,2857,2,1083080,2,2857,265,2858,1388,0
20150106.094237,2858,36,1083116,-2,2857,271,2858,1370,1
20150106.094238,2858,2,1083118,2,2857,272,2858,1369,1
20150106.094239,2857,2,1083120,2,2857,277,2858,1369,0
20150106.094239,2857,4,1083124,0,2857,275,2858,1370,0
20150106.09424,2857,2,1083126,0,2857,304,2858,1371,0
20150106.094241,2858,14,1083140,12,2857,302,2858,1371,1
20150106.094241,2858,20,1083160,0,2857,302,2858,1371,1
20150106.094241,2857,242,1083402,26,2857,284,2858,1271,0
20150106.094242,2857,74,1083476,74,2857,252,2858,1239,0
20150106.094243,2857,2,1083478,0,2857,256,2858,1239,0
20150106.094244,2857,42,1083520,20,2857,254,2858,1242,0
20150106.094245,2857,8,1083528,6,2857,170,2858,1259,0
20150106.094245,2857,242,1083770,-122,2857,12,2858,1259,0
20150106.094246,2857,130,1083900,-22,2856,692,2857,16,0
20150106.094246,2857,2,1083902,2,2856,703,2857,27,0
20150106.094246,2857,46,1083948,-12,2856,703,2857,9,0
20150106.094247,2857,22,1083970,8,2857,52,2858,1309,0
20150106.094248,2857,2,1083972,-2,2857,52,2858,1361,0
20150106.094248,2857,14,1083986,-4,2857,47,2858,1361,0
20150106.094249,2857,20,1084006,-20,2857,42,2858,1361,0
20150106.094249,2857,84,1084090,-16,2856,762,2857,81,0
20150106.09425,2857,2,1084092,0,2856,711,2857,166,0
20150106.094251,2857,2,1084094,2,2856,626,2857,186,0
20150106.094251,2857,20,1084114,8,2856,622,2857,176,0
20150106.094252,2857,10,1084124,6,2856,597,2857,253,0
20150106.094253,2857,6,1084130,6,2856,592,2857,253,0
20150106.094253,2857,2,1084132,2,2856,607,2857,255,0
20150106.094254,2857,2,1084134,2,2856,607,2857,255,0
20150106.094254,2856,4,1084138,2,2856,609,2857,254,0
20150106.094255,2856,20,1084158,20,2856,600,2857,254,0
20150106.094255,2857,508,1084666,-74,2857,767,2858,1411,1
20150106.094256,2857,4,1084670,-4,2857,815,2858,1360,1
20150106.094257,2857,10,1084680,-4,2857,811,2858,1360,1
20150106.094257,2857,424,1085104,-90,2857,813,2858,1206,1
20150106.094258,2857,2,1085106,0,2857,815,2858,1205,1
20150106.094259,2857,422,1085528,-20,2857,644,2858,1207,1
20150106.094259,2857,12,1085540,-10,2857,643,2858,1207,1
20150106.0943,2858,12,1085552,-4,2857,641,2858,1206,1
20150106.094301,2858,40,1085592,-20,2857,656,2858,1185,1
20150106.094302,2857,26,1085618,-2,2857,658,2858,1173,0
20150106.094303,2857,4,1085622,0,2857,660,2858,1173,0
20150106.094305,2857,812,1086434,-808,2857,385,2858,1176,0
20150106.094305,2857,320,1086754,-2,2857,226,2858,1175,0
20150106.094306,2857,402,1087156,84,2857,26,2858,1175,0
20150106.094306,2857,6,1087162,-2,2857,28,2858,1183,0
20150106.094307,2857,60,1087222,-40,2856,705,2857,185,0
20150106.094308,2856,4,1087226,2,2856,687,2857,185,0
20150106.094308,2857,10,1087236,-8,2856,687,2857,181,1
20150106.094308,2857,10,1087246,-4,2856,690,2857,184,1
20150106.094309,2857,2,1087248,-2,2856,689,2857,185,1
20150106.09431,2857,18,1087266,-6,2856,689,2857,177,1
20150106.09431,2857,364,1087630,-134,2857,53,2858,1248,1
20150106.094311,2858,208,1087838,-202,2857,101,2858,1104,1
20150106.094311,2857,14,1087852,-8,2857,95,2858,1105,0
20150106.094312,2857,4,1087856,0,2857,94,2858,1107,0
20150106.094313,2857,20,1087876,0,2857,85,2858,1109,0
20150106.094314,2857,22,1087898,-20,2857,75,2858,1110,0
20150106.094314,2858,20,1087918,0,2857,75,2858,1101,1
20150106.094315,2857,4,1087922,0,2857,74,2858,1100,0
20150106.094316,2857,10,1087932,-10,2857,71,2858,1102,0
20150106.094316,2857,12,1087944,-6,2857,65,2858,1103,0
20150106.094317,2857,2,1087946,0,2857,64,2858,1103,0
20150106.094317,2858,6,1087952,-2,2857,63,2858,1104,1
20150106.094318,2857,2,1087954,0,2857,69,2858,1114,0
20150106.094318,2857,104,1088058,-2,2857,17,2858,1114,0
20150106.09432,2857,22,1088080,6,2857,46,2858,1114,0
20150106.094321,2857,2,1088082,0,2857,45,2858,1126,0
20150106.094322,2857,2,1088084,2,2857,59,2858,1128,0
20150106.094323,2857,24,1088108,-20,2857,57,2858,1118,0
20150106.094324,2858,4,1088112,-4,2857,62,2858,1116,1
20150106.094326,2857,62,1088174,0,2857,33,2858,1127,0
20150106.094327,2857,6,1088180,2,2857,30,2858,1127,0
20150106.094327,2857,2,1088182,0,2857,29,2858,1127,0
20150106.094328,2857,2,1088184,0,2857,28,2858,1127,0
20150106.09433,2857,2,1088186,-2,2857,89,2858,1127,0
20150106.09433,2857,4,1088190,-4,2857,88,2858,1130,0
20150106.094331,2858,4,1088194,-4,2857,119,2858,1129,1
20150106.094331,2857,2,1088196,2,2857,118,2858,1129,0
20150106.094332,2857,2,1088198,0,2857,133,2858,1129,0
20150106.094333,2857,8,1088206,-2,2857,230,2858,1129,0
20150106.094334,2857,4,1088210,-2,2857,292,2858,1130,0
20150106.094334,2857,4,1088214,0,2857,291,2858,1130,0
20150106.094337,2857,40,1088254,20,2857,260,2858,1132,0
20150106.09434,2858,10,1088264,-10,2857,269,2858,1126,1
20150106.09434,2857,2,1088266,0,2857,271,2858,1126,0
20150106.094341,2858,2,1088268,-2,2857,271,2858,1125,1
20150106.094342,2857,2,1088270,2,2857,272,2858,1128,0
20150106.094345,2858,2,1088272,-2,2857,275,2858,1128,1
20150106.094345,2857,4,1088276,-4,2857,288,2858,1128,0
20150106.094346,2858,40,1088316,-40,2857,288,2858,1109,1
20150106.094347,2858,2,1088318,-2,2857,287,2858,1108,1
20150106.094348,2858,2,1088320,0,2857,287,2858,1107,1
20150106.094349,2857,10,1088330,-8,2857,301,2858,1102,0
20150106.094349,2857,402,1088732,-358,2857,102,2858,1101,0
20150106.094351,2858,8,1088740,0,2857,100,2858,1096,1
20150106.094352,2858,2258,1090998,-304,2858,76,2859,543,1
20150106.094353,2858,22,1091020,2,2858,64,2859,396,1
20150106.094353,2859,6,1091026,-6,2858,63,2859,393,1
20150106.094354,2859,2,1091028,-2,2858,63,2859,392,1
20150106.094355,2858,6,1091034,2,2858,62,2859,394,0
20150106.094355,2858,4,1091038,4,2858,62,2859,394,0
20150106.094356,2858,2,1091040,0,2858,66,2859,394,0
20150106.094357,2858,4,1091044,-4,2858,65,2859,399,0
20150106.094358,2858,4,1091048,2,2858,64,2859,400,0
20150106.094359,2858,4,1091052,2,2858,62,2859,400,0
20150106.094359,2859,2,1091054,-2,2858,62,2859,399,1
20150106.0944,2858,4,1091058,0,2858,61,2859,409,0
20150106.0944,2858,2,1091060,0,2858,60,2859,420,0
20150106.094401,2858,10,1091070,0,2858,54,2859,420,0
20150106.094401,2858,10,1091080,0,2858,49,2859,422,0
20150106.094403,2859,20,1091100,-20,2858,48,2859,438,1
20150106.094406,2858,10,1091110,10,2858,65,2859,462,0
20150106.094407,2858,132,1091242,-40,2857,273,2858,106,0
20150106.094407,2858,10,1091252,-4,2857,275,2858,97,0
20150106.094408,2858,2,1091254,-2,2857,276,2858,127,0
20150106.094409,2858,2,1091256,0,2857,273,2858,126,0
20150106.09441,2858,2,1091258,0,2857,273,2858,155,0
20150106.094411,2858,2,1091260,0,2857,274,2858,157,0
20150106.094411,2858,2,1091262,0,2857,274,2858,157,0
20150106.094412,2857,2,1091264,2,2857,273,2858,172,0
20150106.094413,2857,46,1091310,-14,2857,273,2858,150,0
20150106.094414,2858,166,1091476,-60,2857,1274,2858,71,1
20150106.094415,2859,156,1091632,-46,2858,2101,2859,485,1
20150106.094416,2858,20,1091652,10,2858,148,2859,487,0
20150106.094416,2858,8,1091660,0,2858,162,2859,468,0
20150106.094418,2858,2,1091662,2,2858,194,2859,469,0
20150106.094419,2858,2,1091664,2,2858,194,2859,470,0
20150106.09442,2859,2,1091666,-2,2858,194,2859,469,1
20150106.09442,2858,12,1091678,0,2858,191,2859,466,0
20150106.094421,2858,6,1091684,6,2858,189,2859,466,0
20150106.094421,2858,102,1091786,58,2858,239,2859,480,0
20150106.094422,2858,2,1091788,0,2858,239,2859,481,0
20150106.094425,2858,6,1091794,-6,2858,238,2859,689,0
20150106.094427,2858,4,1091798,-2,2858,241,2859,693,0
20150106.094428,2859,6,1091804,0,2858,241,2859,690,1
20150106.094429,2858,2,1091806,0,2858,242,2859,691,0
20150106.09443,2859,2,1091808,-2,2858,245,2859,695,1
20150106.094431,2859,102,1091910,-98,2858,214,2859,676,1
20150106.094431,2858,48,1091958,2,2858,190,2859,678,0
20150106.094432,2859,2,1091960,-2,2858,190,2859,615,1
20150106.094434,2858,2,1091962,2,2858,190,2859,621,0
20150106.094437,2859,2,1091964,0,2858,199,2859,600,1
20150106.094437,2858,4,1091968,2,2858,197,2859,600,0
20150106.094438,2859,2,1091970,-2,2858,197,2859,600,1
20150106.094442,2858,2,1091972,0,2858,226,2859,607,0
20150106.094443,2859,8,1091980,2,2858,425,2859,621,1
20150106.094444,2858,24,1092004,16,2858,416,2859,620,0
20150106.094444,2859,10,1092014,-10,2858,416,2859,615,1
20150106.094445,2858,4,1092018,4,2858,414,2859,615,0
20150106.094445,2858,2,1092020,0,2858,413,2859,617,0
20150106.094446,2858,50,1092070,-6,2858,404,2859,612,0
20150106.094447,2859,2,1092072,0,2858,405,2859,621,1
20150106.09445,2858,2,1092074,2,2858,407,2859,623,0
20150106.094451,2858,12,1092086,2,2858,401,2859,623,0
20150106.094451,2858,10,1092096,0,2858,396,2859,599,0
20150106.094453,2858,804,1092900,-528,2857,448,2858,100,0
20150106.094454,2859,222,1093122,-96,2858,101,2859,633,1
20150106.094455,2858,6,1093128,-2,2858,150,2859,621,0
20150106.094457,2858,42,1093170,40,2858,131,2859,623,0
20150106.094458,2858,2,1093172,0,2858,139,2859,623,0
20150106.094458,2859,10,1093182,10,2858,139,2859,625,1
20150106.094459,2858,6,1093188,2,2858,138,2859,623,0
20150106.094459,2858,2,1093190,2,2858,138,2859,623,0
20150106.0945,2858,2,1093192,2,2858,148,2859,629,0
20150106.0945,2858,244,1093436,-56,2858,36,2859,629,0
20150106.094501,2858,8,1093444,-2,2858,33,2859,651,0
20150106.094502,2858,10,1093454,-2,2858,30,2859,716,0
20150106.094503,2858,2,1093456,0,2858,29,2859,713,0
20150106.094503,2858,2,1093458,2,2858,28,2859,713,0
20150106.094504,2858,2,1093460,2,2858,27,2859,719,0
20150106.094504,2859,20,1093480,12,2858,27,2859,710,1
20150106.094506,2858,2,1093482,0,2858,53,2859,708,0
20150106.094506,2858,2,1093484,0,2858,64,2859,708,0
20150106.094507,2858,4,1093488,0,2858,64,2859,686,0
20150106.094507,2859,2,1093490,2,2858,64,2859,685,1
20150106.094508,2859,6,1093496,2,2858,63,2859,684,1
20150106.09451,2859,2,1093498,0,2858,61,2859,673,1
20150106.094511,2858,2,1093500,2,2858,231,2859,678,0
20150106.094516,2858,4,1093504,4,2858,284,2859,520,0
20150106.094517,2858,20,1093524,16,2858,274,2859,514,0
20150106.094519,2858,2,1093526,0,2858,276,2859,551,0
20150106.09452,2858,4,1093530,4,2858,279,2859,551,0
20150106.09452,2859,2,1093532,2,2858,279,2859,551,1
20150106.094522,2859,4,1093536,0,2858,286,2859,556,1
20150106.094523,2859,4,1093540,0,2858,292,2859,564,1
20150106.094523,2859,26,1093566,-2,2858,292,2859,554,1
20150106.094524,2858,2,1093568,0,2858,292,2859,554,0
20150106.094524,2859,2,1093570,-2,2858,292,2859,644,1
20150106.094525,2858,100,1093670,-44,2858,254,2859,652,0
20150106.094526,2858,4,1093674,4,2858,253,2859,652,0
20150106.094527,2859,2,1093676,-2,2858,253,2859,651,1
20150106.094527,2859,2,1093678,-2,2858,253,2859,650,1
20150106.09453,2859,2,1093680,-2,2858,261,2859,638,1
20150106.094532,2858,52,1093732,-4,2858,237,2859,649,0
20150106.094532,2859,100,1093832,42,2858,237,2859,601,1
20150106.094533,2858,2,1093834,0,2858,236,2859,595,0
20150106.094535,2858,2,1093836,0,2858,241,2859,624,0
20150106.094535,2858,490,1094326,348,2857,550,2858,296,0
20150106.094536,2858,1004,1095330,780,2858,47,2859,594,0
20150106.094537,2858,4,1095334,4,2858,96,2859,489,0
20150106.094538,2858,2,1095336,2,2858,97,2859,490,0
20150106.094538,2858,10,1095346,0,2858,92,2859,496,0
20150106.094539,2859,6,1095352,-6,2858,292,2859,493,1
20150106.094539,2858,6,1095358,6,2858,290,2859,489,0
20150106.09454,2858,80,1095438,-6,2858,259,2859,505,0
20150106.09454,2859,10,1095448,0,2858,216,2859,500,1
20150106.094541,2859,2,1095450,-2,2858,221,2859,499,1
20150106.094542,2858,2,1095452,0,2858,230,2859,500,0
20150106.094545,2858,2,1095454,-2,2858,1236,2859,500,0
20150106.094545,2859,12,1095466,-6,2858,2237,2859,494,1
20150106.094546,2859,460,1095926,170,2858,6278,2859,244,1
20150106.094546,2858,496,1096422,72,2858,342,2859,10,0
20150106.094547,2859,30,1096452,-4,2859,9,2860,1465,1
20150106.094547,2859,22,1096474,-18,2858,394,2860,1934,1
20150106.094548,2859,10,1096484,-8,2858,392,2859,504,1
20150106.094549,2859,12,1096496,-4,2858,251,2859,561,1
20150106.09455,2859,14,1096510,-8,2858,3260,2859,575,1
20150106.094551,2859,10,1096520,-4,2858,6263,2859,655,1
20150106.094552,2859,2,1096522,-2,2858,6267,2859,657,1
20150106.094553,2859,2,1096524,-2,2858,6267,2859,666,1
20150106.094554,2859,2,1096526,-2,2858,6267,2859,665,1
20150106.094554,2859,4,1096530,-4,2858,5287,2859,669,1
20150106.094555,2858,24,1096554,-8,2858,4306,2859,679,0
20150106.094556,2858,12,1096566,-6,2858,2301,2859,680,0
20150106.094557,2859,12,1096578,-12,2858,2301,2859,692,1
20150106.094557,2858,2,1096580,0,2858,1300,2859,792,0
20150106.094558,2859,4,1096584,-4,2858,1302,2859,805,1
20150106.094559,2858,38,1096622,-38,2858,1301,2859,788,0
20150106.094601,2859,8,1096630,0,2858,1302,2859,790,1
20150106.094601,2858,12,1096642,-12,2858,1296,2859,799,0
20150106.094602,2858,10,1096652,-10,2858,1291,2859,807,0
20150106.094603,2859,4,1096656,-4,2858,1295,2859,728,1
20150106.094605,2859,2,1096658,0,2858,1297,2859,708,1
20150106.094606,2859,4,1096662,0,2858,1297,2859,707,1
20150106.094606,2859,200,1096862,0,2858,1297,2859,608,1
20150106.094609,2859,10,1096872,-10,2858,1294,2859,595,1
20150106.094611,2859,6,1096878,-6,2858,1294,2859,632,1
20150106.094611,2858,60,1096938,-60,2858,1264,2859,631,0
20150106.094612,2858,1402,1098340,-324,2858,563,2859,632,0
20150106.094612,2859,2282,1100622,-926,2859,114,2860,1327,1
20150106.094613,2858,250,1100872,-120,2858,85,2859,268,0
20150106.094615,2859,226,1101098,32,2859,54,2860,1351,1
20150106.094616,2859,112,1101210,-4,2858,5236,2859,668,1
20150106.094617,2858,30,1101240,-26,2858,5222,2859,668,0
20150106.094617,2859,4,1101244,0,2858,5223,2859,667,1
20150106.094618,2859,132,1101376,-32,2858,5223,2859,601,1
20150106.094618,2859,12,1101388,-12,2858,5224,2859,595,1
20150106.094619,2859,52,1101440,-52,2858,5223,2859,573,1
20150106.09462,2859,4,1101444,-4,2858,5223,2859,7,1
20150106.09462,2859,14,1101458,-6,2859,16,2860,1326,1
20150106.094622,2859,84,1101542,-32,2858,5226,2859,536,1
20150106.094623,2859,4,1101546,-4,2858,5226,2859,540,1
20150106.094624,2859,2,1101548,-2,2858,5226,2859,541,1
20150106.094624,2859,50,1101598,-32,2859,6,2860,1365,1
20150106.094624,2859,14,1101612,8,2858,5225,2859,17,1
20150106.094625,2859,44,1101656,-2,2858,5225,2859,13,1
20150106.094626,2860,46,1101702,-22,2859,990,2860,1309,1
20150106.094626,2860,6,1101708,0,2859,989,2860,1307,1
20150106.094627,2859,1058,1102766,-1044,2859,475,2860,1305,0
20150106.094627,2859,12,1102778,-10,2859,475,2860,1302,0
20150106.094627,2859,22,1102800,-12,2859,464,2860,1302,0
20150106.094632,2860,20,1102820,0,2859,509,2860,1298,1
20150106.094634,2860,2,1102822,-2,2859,534,2860,1297,1
20150106.094635,2860,10,1102832,2,2859,534,2860,1292,1
20150106.094637,2859,20,1102852,0,2859,535,2860,1295,0
20150106.094637,2860,4,1102856,-2,2859,535,2860,1293,1
20150106.094639,2859,2,1102858,-2,2859,547,2860,1293,0
20150106.094641,2860,2,1102860,-2,2859,548,2860,1293,1
20150106.094643,2860,2,1102862,-2,2859,1057,2860,1293,1
20150106.094643,2860,2,1102864,0,2859,1058,2860,1293,1
20150106.094644,2860,400,1103264,282,2859,1058,2860,1093,1
20150106.094644,2860,22,1103286,20,2859,1057,2860,1082,1
20150106.094645,2860,2,1103288,0,2859,1157,2860,1081,1
20150106.094645,2860,10,1103298,6,2859,1157,2860,1076,1
20150106.094646,2860,20,1103318,6,2859,1157,2860,1068,1
20150106.094646,2860,2,1103320,0,2859,1160,2860,1067,1
20150106.094647,2860,2,1103322,0,2859,1160,2860,1066,1
20150106.094647,2860,100,1103422,0,2859,1160,2860,1018,1
20150106.094648,2860,4,1103426,-2,2859,1160,2860,1017,1
20150106.094649,2860,204,1103630,-2,2859,1172,2860,917,1
20150106.09465,2860,14,1103644,-14,2859,1172,2860,910,1
20150106.094651,2860,8,1103652,-6,2859,1173,2860,907,1
20150106.094651,2860,4,1103656,-4,2859,1193,2860,908,1
20150106.094652,2860,18,1103674,-18,2859,1193,2860,899,1
20150106.094653,2860,22,1103696,-20,2859,1196,2860,889,1
20150106.094654,2860,2,1103698,-2,2859,1196,2860,900,1
20150106.094654,2860,4,1103702,-2,2859,1196,2860,898,1
20150106.094655,2860,2,1103704,-2,2859,1198,2860,897,1
20150106.094656,2860,6,1103710,-4,2859,1199,2860,894,1
20150106.094656,2860,8,1103718,-4,2859,1199,2860,891,1
20150106.094657,2860,44,1103762,-4,2859,1199,2860,869,1
20150106.094658,2860,2,1103764,-2,2859,1199,2860,869,1
20150106.094659,2860,20,1103784,0,2859,1198,2860,860,1
20150106.0947,2860,6,1103790,-2,2859,1198,2860,857,1
20150106.0947,2860,6,1103796,-6,2859,1198,2860,854,1
20150106.094701,2860,402,1104198,-402,2859,1198,2860,661,1
20150106.094702,2860,402,1104600,-130,2859,1198,2860,462,1
20150106.094702,2860,34,1104634,32,2859,1200,2860,447,1
20150106.094703,2860,468,1105102,-266,2859,1200,2860,213,1
20150106.094703,2861,504,1105606,94,2860,125,2861,257,1
20150106.094704,2861,68,1105674,-12,2860,199,2861,249,1
20150106.094704,2861,12,1105686,-12,2860,202,2861,243,1
20150106.094705,2860,4,1105690,2,2860,201,2861,268,0
20150106.094706,2861,10,1105700,0,2860,204,2861,286,1
20150106.094707,2861,14,1105714,0,2860,205,2861,282,1
20150106.094708,2860,410,1106124,-98,2859,1272,2860,297,0
20150106.094708,2860,6,1106130,-6,2859,1210,2860,345,0
20150106.094709,2860,58,1106188,-46,2859,1200,2860,316,0
20150106.094709,2860,20,1106208,-10,2859,1200,2860,256,0
20150106.09471,2860,20,1106228,-10,2859,1201,2860,246,0
20150106.094711,2860,60,1106288,-60,2859,1213,2860,216,0
20150106.094711,2860,316,1106604,-122,2859,1213,2860,60,0
20150106.094712,2860,122,1106726,0,2860,53,2861,458,0
20150106.094712,2860,4,1106730,0,2860,62,2861,452,0
20150106.094713,2860,12,1106742,6,2860,120,2861,456,0
20150106.094713,2860,6,1106748,2,2860,259,2861,455,0
20150106.094714,2860,548,1107296,-254,2859,1206,2860,331,0
20150106.094715,2860,34,1107330,-8,2859,1206,2860,314,0
20150106.094715,2860,4,1107334,-4,2859,1205,2860,313,0
20150106.094716,2860,10,1107344,-2,2859,1205,2860,448,0
20150106.094716,2860,4,1107348,-2,2859,1205,2860,396,0
20150106.094717,2860,804,1108152,-604,2860,651,2861,423,0
20150106.09472,2861,1038,1109190,-1008,2860,150,2861,295,1
20150106.09472,2861,6,1109196,4,2860,151,2861,319,1
20150106.094721,2861,10,1109206,0,2860,156,2861,329,1
20150106.094722,2860,6,1109212,0,2860,262,2861,325,0
20150106.094722,2860,528,1109740,-382,2859,1197,2860,346,0
20150106.094723,2860,20,1109760,0,2859,1196,2860,338,0
20150106.094723,2860,4,1109764,-2,2859,1196,2860,336,0
20150106.094725,2860,36,1109800,-6,2859,1196,2860,332,0
20150106.094725,2860,12,1109812,-6,2859,1196,2860,329,0
20150106.094727,2860,2,1109814,0,2859,1197,2860,344,0
20150106.094727,2860,2,1109816,-2,2859,1197,2860,336,0
20150106.094728,2860,22,1109838,0,2859,1199,2860,341,0
20150106.094729,2860,14,1109852,-2,2859,1199,2860,338,0
20150106.09473,2860,4,1109856,0,2859,1201,2860,336,0
20150106.094732,2860,6,1109862,0,2859,1202,2860,352,0
20150106.094733,2860,4,1109866,-4,2859,1203,2860,354,0
20150106.094733,2860,4,1109870,0,2859,1203,2860,353,0
20150106.094734,2860,8,1109878,-8,2859,1203,2860,349,0
20150106.094735,2860,222,1110100,0,2859,1203,2860,240,0
20150106.094736,2860,8,1110108,-6,2859,1204,2860,237,0
20150106.094737,2860,2,1110110,-2,2859,1204,2860,236,0
20150106.094738,2860,40,1110150,-40,2859,1204,2860,216,0
20150106.094739,2860,2,1110152,-2,2859,1204,2860,215,0
20150106.094739,2860,6,1110158,-6,2859,1208,2860,212,0
20150106.09474,2860,2,1110160,0,2859,1208,2860,211,0
20150106.094741,2860,2,1110162,-2,2859,1208,2860,212,0
20150106.094742,2860,4,1110166,-2,2859,1208,2860,210,0
20150106.094743,2860,2,1110168,0,2859,1212,2860,210,0
20150106.094744,2860,262,1110430,-260,2859,1212,2860,78,0
20150106.094744,2860,178,1110608,70,2860,98,2861,647,0
20150106.094745,2860,14,1110622,6,2860,91,2861,645,0
20150106.094746,2861,2,1110624,0,2860,212,2861,580,1
20150106.094747,2860,46,1110670,46,2860,192,2861,377,0
20150106.094748,2860,4,1110674,2,2860,190,2861,367,0
20150106.094748,2860,4,1110678,4,2860,188,2861,367,0
20150106.094749,2861,2,1110680,2,2860,188,2861,366,1
20150106.09475,2860,34,1110714,32,2860,178,2861,366,0
20150106.09475,2860,2,1110716,2,2860,178,2861,369,0
20150106.094752,2861,2,1110718,0,2860,181,2861,384,1
20150106.094755,2861,2,1110720,0,2860,188,2861,382,1
20150106.094755,2860,4,1110724,2,2860,192,2861,381,0
20150106.094756,2861,24,1110748,0,2860,204,2861,424,1
20150106.094756,2861,4,1110752,0,2860,203,2861,423,1
20150106.094758,2861,30,1110782,30,2860,207,2861,410,1
20150106.0948,2861,4,1110786,4,2860,210,2861,419,1
20150106.0948,2861,2,1110788,2,2860,210,2861,418,1
20150106.094802,2861,96,1110884,-16,2860,211,2861,370,1
20150106.094804,2860,2,1110886,2,2860,281,2861,385,0
20150106.094805,2861,4,1110890,4,2860,283,2861,384,1
20150106.094807,2860,6,1110896,6,2860,292,2861,387,0
20150106.094808,2861,12,1110908,12,2860,291,2861,383,1
20150106.094809,2861,18,1110926,0,2860,288,2861,374,1
20150106.094815,2861,10,1110936,0,2860,311,2861,885,1
20150106.094816,2860,4,1110940,0,2860,310,2861,885,0
20150106.094817,2860,4,1110944,4,2860,309,2861,885,0
20150106.094817,2861,2,1110946,0,2860,310,2861,885,1
20150106.094818,2861,2,1110948,0,2860,320,2861,886,1
20150106.094821,2861,6,1110954,4,2860,318,2861,888,1
20150106.094821,2860,64,1111018,60,2860,287,2861,886,0
20150106.094822,2860,102,1111120,6,2860,238,2861,886,0
20150106.094824,2860,14,1111134,-12,2860,221,2861,876,0
20150106.094825,2860,2,1111136,0,2860,220,2861,878,0
20150106.094825,2861,2,1111138,0,2860,220,2861,877,1
20150106.094827,2861,8,1111146,0,2860,218,2861,878,1
20150106.094828,2861,4,1111150,-2,2860,218,2861,979,1
20150106.094829,2860,12,1111162,-10,2860,212,2861,986,0
20150106.09483,2860,14,1111176,-14,2860,215,2861,988,0
20150106.094831,2860,2,1111178,0,2860,214,2861,989,0
20150106.094831,2860,12,1111190,-2,2860,208,2861,989,0
20150106.094833,2861,6,1111196,6,2860,260,2861,990,1
20150106.094835,2860,2,1111198,0,2860,262,2861,990,0
20150106.094836,2860,4,1111202,0,2860,254,2861,991,0
20150106.094838,2861,4,1111206,0,2860,363,2861,1003,1
20150106.094839,2860,4,1111210,2,2860,363,2861,979,0
20150106.09484,2860,2,1111212,0,2860,362,2861,979,0
20150106.094842,2860,2,1111214,0,2860,363,2861,1089,0
20150106.094842,2860,4,1111218,0,2860,360,2861,1089,0
20150106.094843,2861,2,1111220,0,2860,360,2861,1088,1
20150106.094843,2860,8,1111228,-2,2860,356,2861,1090,0
20150106.094845,2861,100,1111328,-18,2860,407,2861,1042,1
20150106.094847,2860,2,1111330,0,2860,403,2861,1041,0
20150106.094852,2860,22,1111352,0,2860,410,2861,1107,0
20150106.094853,2861,4,1111356,0,2860,409,2861,1110,1
20150106.094854,2861,400,1111756,256,2860,411,2861,904,1
20150106.094858,2861,4,1111760,4,2860,430,2861,1007,1
20150106.094859,2861,4,1111764,4,2860,430,2861,1006,1
20150106.094859,2860,2,1111766,-2,2860,428,2861,1006,0
20150106.0949,2860,4,1111770,4,2860,427,2861,1005,0
20150106.0949,2861,36,1111806,0,2860,428,2861,988,1
20150106.094901,2861,6,1111812,6,2860,428,2861,985,1
20150106.094902,2861,6,1111818,6,2860,428,2861,982,1
20150106.094904,2860,2,1111820,0,2860,437,2861,982,0
20150106.094904,2861,8,1111828,2,2860,437,2861,978,1
20150106.094906,2861,2,1111830,0,2860,438,2861,978,1
20150106.094906,2860,10,1111840,0,2860,433,2861,978,0
20150106.094907,2860,2,1111842,2,2860,433,2861,980,0
20150106.094909,2860,2,1111844,2,2860,432,2861,980,0
20150106.094912,2861,4,1111848,0,2860,442,2861,982,1
20150106.094916,2860,202,1112050,-40,2860,342,2861,998,0
20150106.094917,2861,8,1112058,8,2860,344,2861,996,1
20150106.094917,2860,80,1112138,52,2860,307,2861,996,0
20150106.094918,2860,202,1112340,130,2860,207,2861,995,0
20150106.094919,2860,12,1112352,-12,2860,201,2861,995,0
20150106.094919,2860,30,1112382,0,2860,186,2861,995,0
20150106.09492,2860,24,1112406,0,2860,188,2861,995,0
20150106.094921,2860,2,1112408,-2,2860,187,2861,999,0
20150106.094922,2860,44,1112452,-20,2860,168,2861,999,0
20150106.094922,2860,4,1112456,0,2860,167,2861,999,0
20150106.094923,2860,2,1112458,0,2860,166,2861,999,0
20150106.094924,2860,10,1112468,0,2860,161,2861,999,0
20150106.094927,2861,200,1112668,38,2860,187,2861,899,1
20150106.094929,2860,162,1112830,-160,2860,219,2861,825,0
20150106.09493,2860,322,1113152,-216,2860,58,2861,825,0
20150106.09493,2860,4,1113156,-2,2860,57,2861,825,0
20150106.094931,2860,8,1113164,-2,2860,53,2861,869,0
20150106.094932,2860,4,1113168,-2,2860,52,2861,873,0
20150106.094932,2860,2,1113170,0,2860,51,2861,873,0
20150106.094933,2860,104,1113274,-84,2859,1265,2860,15,0
20150106.094934,2860,2,1113276,-2,2859,1217,2860,67,0
20150106.094935,2860,158,1113434,-128,2860,361,2861,891,0
20150106.094935,2861,10,1113444,-10,2860,361,2861,845,1
20150106.094936,2860,2,1113446,0,2860,367,2861,845,0
20150106.094936,2860,2,1113448,0,2860,376,2861,844,0
20150106.094939,2860,2,1113450,0,2860,475,2861,854,0
20150106.094941,2860,4,1113454,0,2860,474,2861,857,0
20150106.094942,2860,20,1113474,-20,2860,465,2861,855,0
20150106.094943,2860,2,1113476,0,2860,465,2861,856,0
20150106.094944,2861,2,1113478,-2,2860,467,2861,856,1
20150106.094946,2860,2,1113480,0,2860,465,2861,860,0
20150106.094946,2860,40,1113520,-40,2860,445,2861,860,0
20150106.094947,2860,2,1113522,0,2860,444,2861,911,0
20150106.094951,2860,4,1113526,0,2860,486,2861,871,0
20150106.094951,2861,10,1113536,-10,2860,486,2861,866,1
20150106.094953,2861,10,1113546,0,2860,486,2861,862,1
20150106.094955,2861,4,1113550,0,2860,488,2861,930,1
20150106.094957,2860,90,1113640,-90,2860,444,2861,931,0
20150106.094959,2860,2,1113642,0,2860,441,2861,1091,0
20150106.095,2861,12,1113654,-12,2860,441,2861,1095,1
20150106.095,2860,76,1113730,-76,2860,403,2861,1095,0
20150106.095001,2860,2,1113732,0,2860,404,2861,1096,0
20150106.095006,2860,4,1113736,-2,2860,404,2861,1098,0
20150106.095006,2860,2,1113738,-2,2860,403,2861,1098,0
20150106.095007,2861,4,1113742,-2,2860,403,2861,1094,1
20150106.095008,2860,2,1113744,0,2860,402,2861,1094,0
20150106.095009,2861,20,1113764,0,2860,454,2861,1084,1
20150106.095015,2860,2,1113766,0,2860,456,2861,1187,0
20150106.095015,2860,4,1113770,-4,2860,454,2861,1188,0
20150106.095016,2861,2,1113772,0,2860,454,2861,1187,1
20150106.095018,2861,40,1113812,-40,2860,456,2861,1172,1
20150106.095021,2861,20,1113832,-20,2860,454,2861,1157,1
20150106.095021,2860,2,1113834,0,2860,453,2861,1157,0
20150106.095022,2861,6,1113840,-6,2860,454,2861,1174,1
20150106.095023,2860,2,1113842,0,2860,454,2861,1172,0
20150106.095028,2860,800,1114642,-680,2860,62,2861,1208,0
20150106.095028,2860,126,1114768,-94,2859,1217,2860,258,0
20150106.095029,2860,4,1114772,-2,2859,1217,2860,251,0
20150106.095031,2860,2,1114774,-2,2859,1217,2860,352,0
20150106.095032,2860,2,1114776,0,2859,1217,2860,351,0
20150106.095033,2859,10,1114786,-10,2859,1218,2860,351,0
20150106.095034,2859,10,1114796,-10,2859,1213,2860,351,0
20150106.095035,2860,2,1114798,0,2859,1214,2860,351,1
20150106.095038,2860,20,1114818,-20,2859,1267,2860,278,1
20150106.095041,2860,4,1114822,-4,2859,1267,2860,268,1
20150106.095041,2859,6,1114828,-4,2859,1265,2860,268,0
20150106.095042,2860,4,1114832,-4,2859,1265,2860,271,1
20150106.095042,2860,4,1114836,-4,2859,1265,2860,269,1
20150106.095043,2860,2,1114838,-2,2859,1266,2860,285,1
20150106.095043,2860,2,1114840,0,2859,1267,2860,284,1
20150106.095044,2859,4,1114844,-4,2859,1265,2860,284,0
20150106.095046,2859,2,1114846,-2,2859,1264,2860,282,0
20150106.095048,2860,10,1114856,0,2859,1264,2860,268,1
20150106.095049,2859,6,1114862,0,2859,1262,2860,283,0
20150106.095051,2859,20,1114882,-20,2859,1250,2860,300,0
20150106.095054,2860,2,1114884,0,2859,1250,2860,358,1
20150106.095055,2859,4,1114888,-4,2859,1248,2860,358,0
20150106.095058,2859,2,1114890,0,2859,1249,2860,376,0
20150106.095102,2859,2,1114892,-2,2859,1250,2860,392,0
20150106.095102,2859,2,1114894,-2,2859,1249,2860,393,0
20150106.095103,2860,82,1114976,-82,2859,1249,2860,353,1
20150106.095105,2859,48,1115024,0,2859,1212,2860,366,0
20150106.095106,2860,4,1115028,0,2859,1209,2860,368,1
20150106.095108,2860,10,1115038,0,2859,1209,2860,357,1
20150106.095109,2860,40,1115078,0,2859,1209,2860,348,1
20150106.09511,2860,4,1115082,-4,2859,1213,2860,347,1
20150106.095111,2860,4,1115086,-4,2859,1213,2860,345,1
20150106.095111,2860,2,1115088,-2,2859,1213,2860,344,1
20150106.095112,2860,2,1115090,-2,2859,1213,2860,343,1
20150106.095113,2860,14,1115104,-4,2859,1214,2860,337,1
20150106.095114,2860,2,1115106,0,2859,1214,2860,335,1
20150106.095115,2860,2,1115108,0,2859,1214,2860,334,1
20150106.095116,2860,10,1115118,0,2859,1215,2860,328,1
20150106.095116,2860,12,1115130,-12,2859,1213,2860,329,1
20150106.095118,2860,2,1115132,0,2859,1224,2860,323,1
20150106.09512,2859,24,1115156,16,2859,1223,2860,324,0
20150106.095121,2860,20,1115176,20,2859,1224,2860,329,1
20150106.095123,2860,26,1115202,0,2859,1223,2860,333,1
20150106.095124,2859,2,1115204,0,2859,1223,2860,330,0
20150106.095125,2859,2,1115206,-2,2859,1222,2860,344,0
20150106.095127,2860,2,1115208,2,2859,1222,2860,356,1
20150106.095128,2860,54,1115262,54,2859,1222,2860,329,1
20150106.09513,2859,10,1115272,-10,2859,1221,2860,330,0
20150106.095131,2859,2,1115274,0,2859,1220,2860,341,0
20150106.095132,2859,246,1115520,0,2859,1097,2860,412,0
20150106.095133,2859,338,1115858,-44,2859,936,2860,419,0
20150106.095133,2859,204,1116062,28,2859,833,2860,421,0
20150106.095134,2859,1106,1117168,-358,2859,330,2860,378,0
20150106.095134,2859,666,1117834,-18,2858,235,2859,160,0
20150106.095137,2858,162,1117996,76,2858,174,2859,208,0
20150106.095137,2858,2,1117998,0,2858,173,2859,232,0
20150106.095138,2858,162,1118160,68,2858,93,2859,231,0
20150106.095139,2858,2,1118162,-2,2858,215,2859,260,0
20150106.09514,2858,2,1118164,-2,2858,277,2859,246,0
20150106.09514,2858,20,1118184,-20,2858,293,2859,220,0
20150106.095141,2858,2,1118186,2,2858,291,2859,229,0
20150106.095142,2858,2,1118188,2,2858,300,2859,229,0
20150106.095143,2858,2,1118190,2,2858,299,2859,230,0
20150106.095144,2858,2,1118192,0,2858,298,2859,261,0
20150106.095145,2858,4,1118196,4,2858,326,2859,261,0
20150106.095145,2858,12,1118208,-4,2858,320,2859,261,0
20150106.095148,2859,6,1118214,-2,2858,322,2859,290,1
20150106.095149,2858,2,1118216,-2,2858,321,2859,290,0
20150106.09515,2858,30,1118246,-12,2858,306,2859,290,0
20150106.095151,2858,2,1118248,0,2858,306,2859,292,0
20150106.095151,2859,2,1118250,0,2858,307,2859,291,1
20150106.095152,2859,6,1118256,-2,2858,307,2859,290,1
20150106.095153,2858,6,1118262,0,2858,305,2859,290,0
20150106.095154,2858,6,1118268,0,2858,306,2859,292,0
20150106.095155,2858,2,1118270,0,2858,305,2859,292,0
20150106.0952,2858,2,1118272,0,2858,313,2859,311,0
20150106.095203,2858,2,1118274,0,2858,278,2859,314,0
20150106.095205,2858,6,1118280,-6,2858,275,2859,329,0
20150106.095207,2858,20,1118300,0,2858,267,2859,329,0
20150106.095208,2858,2,1118302,0,2858,267,2859,329,0
20150106.095211,2858,2,1118304,0,2858,296,2859,331,0
20150106.095212,2858,2,1118306,-2,2858,296,2859,331,0
20150106.095215,2858,10,1118316,0,2858,294,2859,331,0
20150106.095216,2858,2,1118318,-2,2858,294,2859,331,0
20150106.095217,2858,64,1118382,2,2858,263,2859,331,0
20150106.095218,2858,6,1118388,-6,2858,261,2859,331,0
20150106.095219,2858,2,1118390,-2,2858,260,2859,331,0
20150106.095223,2859,22,1118412,-22,2858,251,2859,343,1
20150106.095224,2858,2,1118414,0,2858,250,2859,343,0
20150106.095224,2859,2,1118416,0,2858,250,2859,342,1
20150106.095227,2859,34,1118450,-34,2858,234,2859,361,1
20150106.095229,2858,8,1118458,-4,2858,230,2859,362,0
20150106.09523,2859,20,1118478,-20,2858,232,2859,352,1
20150106.095232,2858,6,1118484,-2,2858,230,2859,352,0
20150106.095235,2859,6,1118490,-6,2858,241,2859,328,1
20150106.095238,2858,4,1118494,-2,2858,240,2859,326,0
20150106.095239,2859,8,1118502,-4,2858,741,2859,299,1
20150106.095241,2859,2,1118504,0,2858,745,2859,297,1
20150106.095242,2858,4,1118508,-2,2858,744,2859,296,0
20150106.095242,2859,434,1118942,50,2858,744,2859,55,1
20150106.095243,2859,110,1119052,-10,2859,272,2860,318,1
20150106.095245,2859,8,1119060,0,2859,420,2860,333,1
20150106.095245,2860,10,1119070,-2,2859,420,2860,328,1
20150106.095248,2860,4,1119074,0,2859,526,2860,325,1
20150106.09525,2859,404,1119478,-182,2859,526,2860,160,0
20150106.095251,2860,18,1119496,-2,2859,540,2860,151,1
20150106.095252,2859,106,1119602,0,2859,489,2860,152,0
20150106.095252,2860,10,1119612,-4,2859,489,2860,146,1
20150106.095253,2860,22,1119634,-2,2859,588,2860,135,1
20150106.095254,2860,92,1119726,-92,2859,588,2860,95,1
20150106.095254,2860,2,1119728,-2,2859,587,2860,94,1
20150106.095255,2860,22,1119750,-22,2859,587,2860,82,1
20150106.095255,2860,2,1119752,0,2859,588,2860,81,1
20150106.095256,2860,42,1119794,-16,2859,591,2860,61,1
20150106.095256,2860,34,1119828,28,2859,588,2860,47,1
20150106.095257,2860,4,1119832,4,2859,588,2860,50,1
20150106.095258,2860,2,1119834,2,2859,578,2860,48,1
20150106.095258,2859,6,1119840,4,2859,576,2860,48,0
20150106.095259,2860,2,1119842,0,2859,577,2860,50,1
20150106.0953,2860,114,1119956,-6,2860,495,2861,1416,1
20150106.0953,2860,200,1120156,0,2860,395,2861,1313,1
20150106.095301,2860,122,1120278,0,2860,335,2861,1358,1
20150106.095301,2861,18,1120296,-18,2860,366,2861,1354,1
20150106.095302,2861,2,1120298,-2,2860,480,2861,1332,1
20150106.095303,2860,2,1120300,0,2860,582,2861,1317,0
20150106.095304,2860,4,1120304,0,2860,581,2861,1313,0
20150106.095306,2861,4,1120308,-2,2860,586,2861,1317,1
20150106.095306,2861,2,1120310,-2,2860,586,2861,1316,1
20150106.095306,2860,4,1120314,-4,2860,584,2861,1317,0
20150106.095307,2860,6,1120320,-6,2860,581,2861,1316,0
20150106.095308,2861,12,1120332,0,2860,576,2861,1335,1
20150106.095309,2860,2,1120334,-2,2860,577,2861,1336,0
20150106.095312,2860,22,1120356,-20,2860,593,2861,1379,0
20150106.095313,2860,2,1120358,-2,2860,592,2861,1379,0
20150106.095313,2860,12,1120370,-12,2860,586,2861,1382,0
20150106.095314,2860,4,1120374,0,2860,584,2861,1378,0
20150106.095315,2861,2,1120376,-2,2860,584,2861,1379,1
20150106.095317,2861,4,1120380,-4,2860,587,2861,1387,1
20150106.095318,2860,8,1120388,-8,2860,583,2861,1388,0
20150106.095318,2861,42,1120430,-14,2860,586,2861,1367,1
20150106.095325,2860,4,1120434,0,2860,595,2861,1317,0
20150106.095326,2860,4,1120438,0,2860,593,2861,1318,0
20150106.095327,2860,2,1120440,-2,2860,592,2861,1314,0
20150106.095328,2860,2,1120442,-2,2860,591,2861,1264,0
20150106.095332,2860,2,1120444,-2,2860,563,2861,1303,0
20150106.095333,2860,2,1120446,0,2860,562,2861,1314,0
20150106.095336,2860,10,1120456,-10,2860,557,2861,1319,0
20150106.095337,2861,2,1120458,0,2860,558,2861,1317,1
20150106.095337,2861,2,1120460,-2,2860,558,2861,1316,1
20150106.095339,2861,10,1120470,-10,2860,558,2861,1312,1
20150106.095339,2860,6,1120476,0,2860,555,2861,1313,0
20150106.095342,2861,12,1120488,-2,2860,549,2861,1293,1
20150106.095343,2861,4,1120492,-4,2860,449,2861,1291,1
20150106.095344,2860,4,1120496,-4,2860,447,2861,1291,0
20150106.095346,2860,20,1120516,-20,2860,936,2861,1251,0
20150106.095347,2860,2,1120518,-2,2860,935,2861,1252,0
20150106.095351,2860,2,1120520,0,2860,944,2861,1253,0
20150106.095352,2860,2,1120522,0,2860,943,2861,1253,0
20150106.095354,2861,2,1120524,-2,2860,942,2861,1182,1
20150106.095356,2860,10,1120534,-10,2860,939,2861,1184,0
20150106.095358,2860,4,1120538,-4,2860,938,2861,1177,0
20150106.095359,2861,4,1120542,-4,2860,938,2861,1174,1
20150106.0954,2861,4,1120546,-4,2860,939,2861,1172,1
20150106.095401,2860,2,1120548,-2,2860,938,2861,1182,0
20150106.095401,2860,12,1120560,-12,2860,933,2861,1181,0
20150106.095405,2861,2,1120562,-2,2860,1026,2861,1177,1
20150106.095405,2861,2,1120564,-2,2860,1025,2861,1176,1
20150106.095407,2861,2,1120566,0,2860,1023,2861,1175,1
20150106.095408,2860,2,1120568,0,2860,1032,2861,1174,0
20150106.09541,2860,6,1120574,-2,2860,1028,2861,1173,0
20150106.095416,2860,40,1120614,-40,2860,1016,2861,1171,0
20150106.095419,2860,2,1120616,0,2860,1015,2861,1220,0
20150106.09542,2861,2,1120618,0,2860,1015,2861,1221,1
20150106.09542,2860,10,1120628,0,2860,1010,2861,1221,0
20150106.095422,2861,2,1120630,-2,2860,1012,2861,1220,1
20150106.095425,2860,2,1120632,0,2860,1011,2861,1220,0
20150106.095425,2861,4,1120636,0,2860,1011,2861,1218,1
20150106.095428,2861,400,1121036,-400,2860,1011,2861,958,1
20150106.095429,2861,10,1121046,-10,2860,1008,2861,767,1
20150106.095429,2861,80,1121126,2,2860,1008,2861,722,1
20150106.09543,2861,1446,1122572,-742,2861,54,2862,1849,1
20150106.09543,2862,2,1122574,2,2861,140,2862,1798,1
20150106.095431,2862,12,1122586,-2,2861,154,2862,1793,1
20150106.095431,2862,18,1122604,2,2861,221,2862,1795,1
20150106.095432,2862,2,1122606,0,2861,228,2862,1796,1
20150106.095432,2862,6,1122612,0,2861,328,2862,1793,1
20150106.095433,2861,2,1122614,2,2861,333,2862,1794,0
20150106.095434,2861,2,1122616,0,2861,333,2862,1796,0
20150106.095435,2861,6,1122622,4,2861,435,2862,1797,0
20150106.095435,2862,4,1122626,0,2861,435,2862,1795,1
20150106.095436,2862,20,1122646,20,2861,440,2862,1785,1
20150106.095437,2861,20,1122666,20,2861,461,2862,1786,0
20150106.095437,2861,4,1122670,2,2861,461,2862,1785,0
20150106.095438,2862,22,1122692,2,2861,460,2862,1775,1
20150106.095438,2861,40,1122732,0,2861,440,2862,1775,0
20150106.09544,2862,6,1122738,0,2861,446,2862,1836,1
20150106.095442,2862,2,1122740,2,2861,479,2862,1837,1
20150106.095443,2862,18,1122758,0,2861,479,2862,1828,1
20150106.095443,2861,4,1122762,4,2861,477,2862,1847,0
20150106.095446,2861,10,1122772,4,2861,485,2862,1845,0
20150106.095446,2861,408,1123180,254,2861,286,2862,1841,0
20150106.095447,2861,2,1123182,2,2861,285,2862,1841,0
20150106.095447,2861,4,1123186,0,2861,283,2862,1841,0
20150106.095448,2861,14,1123200,10,2861,275,2862,1839,0
20150106.095448,2861,562,1123762,-112,2860,955,2861,119,0
20150106.095449,2861,2,1123764,-2,2860,956,2861,194,0
20150106.09545,2861,4,1123768,-4,2860,956,2861,203,0
20150106.095451,2861,12,1123780,-12,2860,956,2861,188,0
20150106.095453,2861,202,1123982,106,2860,956,2861,85,0
20150106.095453,2861,2,1123984,0,2860,956,2861,81,0
20150106.095454,2861,2,1123986,-2,2860,942,2861,57,0
20150106.095455,2861,16,1124002,-6,2860,962,2861,51,0
20150106.095455,2861,2,1124004,2,2860,962,2861,50,0
20150106.095456,2861,84,1124088,-48,2860,965,2861,11,0
20150106.095456,2861,12,1124100,-2,2860,965,2861,6,0
20150106.095457,2861,138,1124238,126,2861,34,2862,1862,0
20150106.095457,2861,74,1124312,54,2860,965,2861,1,0
20150106.095458,2860,4,1124316,0,2860,964,2862,1912,0
20150106.095459,2860,2,1124318,0,2860,965,2861,2,0
20150106.095501,2861,6,1124324,2,2860,965,2861,55,1
20150106.095503,2861,2,1124326,2,2860,966,2861,58,1
20150106.095508,2860,2,1124328,0,2860,969,2861,63,0
20150106.095509,2861,6,1124334,4,2860,969,2861,60,1
20150106.095511,2861,2,1124336,0,2860,974,2861,162,1
20150106.095513,2861,2,1124338,2,2860,974,2861,163,1
20150106.095515,2861,2,1124340,2,2860,977,2861,161,1
20150106.095515,2861,52,1124392,-50,2860,952,2861,161,1
20150106.095517,2861,2,1124394,0,2860,963,2861,225,1
20150106.095517,2861,24,1124418,4,2860,963,2861,213,1
20150106.095519,2861,2,1124420,2,2860,963,2861,216,1
20150106.095523,2861,2,1124422,2,2860,954,2861,218,1
20150106.095524,2860,26,1124448,-2,2860,951,2861,209,0
20150106.095524,2860,2,1124450,-2,2860,950,2861,209,0
20150106.095526,2860,10,1124460,0,2860,946,2861,246,0
20150106.095526,2860,12,1124472,-4,2860,944,2861,243,0
20150106.095527,2861,6,1124478,0,2860,946,2861,239,1
20150106.095527,2861,706,1125184,-60,2860,946,2861,1,1
20150106.095528,2860,14,1125198,2,2860,945,2861,51,0
20150106.095529,2860,2,1125200,0,2860,944,2861,53,0
20150106.095531,2860,2,1125202,0,2860,1061,2861,54,0
20150106.095532,2861,80,1125282,0,2860,1053,2861,14,1
20150106.095532,2861,28,1125310,-2,2861,58,2862,1882,1
20150106.095533,2861,128,1125438,8,2860,1049,2861,16,1
20150106.095534,2861,134,1125572,-30,2861,17,2862,1869,1
20150106.095534,2861,68,1125640,26,2861,34,2862,1813,1
20150106.095535,2861,28,1125668,0,2861,22,2862,1799,1
20150106.095536,2860,60,1125728,4,2860,1038,2861,2,0
20150106.095539,2861,44,1125772,2,2860,1038,2861,606,1
20150106.09554,2861,4,1125776,4,2860,1239,2861,535,1
20150106.095541,2861,2,1125778,2,2860,1249,2861,537,1
20150106.095543,2861,2,1125780,2,2860,1249,2861,537,1
20150106.095543,2860,10,1125790,0,2860,1245,2861,537,0
20150106.095544,2861,2,1125792,0,2860,1245,2861,537,1
20150106.095545,2861,2,1125794,-2,2860,1247,2861,538,1
20150106.095547,2860,2,1125796,-2,2860,1236,2861,522,0
20150106.095548,2860,4,1125800,-2,2860,1235,2861,524,0
20150106.095551,2860,12,1125812,0,2860,1232,2861,522,0
20150106.095557,2861,2,1125814,-2,2860,1233,2861,533,1
20150106.095558,2860,4,1125818,-4,2860,1231,2861,594,0
20150106.095601,2861,1186,1127004,-1148,2861,479,2862,2252,1
20150106.095604,2861,10,1127014,-10,2861,486,2862,2252,1
20150106.095606,2861,4,1127018,0,2861,484,2862,2252,1
20150106.095607,2861,18,1127036,0,2861,480,2862,2248,1
20150106.095608,2861,6,1127042,0,2861,477,2862,2248,1
20150106.095608,2861,2,1127044,0,2861,477,2862,2248,1
20150106.09561,2861,2,1127046,-2,2861,1027,2862,2258,1
20150106.095611,2861,2,1127048,-2,2861,1026,2862,2258,1
20150106.095613,2861,2,1127050,0,2861,1029,2862,2258,1
20150106.095615,2862,60,1127110,-2,2861,1030,2862,2228,1
20150106.095617,2862,2,1127112,0,2861,1038,2862,2226,1
20150106.095618,2861,12,1127124,2,2861,1036,2862,2222,0
20150106.095622,2862,10,1127134,-8,2861,1053,2862,2206,1
20150106.095623,2862,30,1127164,0,2861,1054,2862,2191,1
20150106.095625,2862,2,1127166,-2,2861,554,2862,2208,1
20150106.095625,2862,4,1127170,0,2861,555,2862,2206,1
20150106.095627,2861,2,1127172,0,2861,557,2862,2227,0
20150106.095629,2862,2,1127174,0,2861,557,2862,2226,1
20150106.095629,2862,30,1127204,0,2861,557,2862,2211,1
20150106.09563,2861,6,1127210,-6,2861,554,2862,2211,0
20150106.09563,2861,20,1127230,0,2861,545,2862,2211,0
20150106.095632,2862,20,1127250,4,2861,545,2862,2211,1
20150106.095633,2861,2,1127252,-2,2861,544,2862,2211,0
20150106.095634,2861,4,1127256,0,2861,545,2862,2211,0
20150106.09564,2862,2,1127258,0,2861,555,2862,2221,1
20150106.09564,2861,2,1127260,-2,2861,560,2862,2224,0
20150106.095642,2862,2,1127262,0,2861,565,2862,2223,1
20150106.095647,2862,2,1127264,0,2861,570,2862,2223,1
20150106.095648,2861,2,1127266,0,2861,568,2862,2224,0
20150106.095648,2861,2,1127268,0,2861,567,2862,2223,0
20150106.095649,2862,2,1127270,2,2861,576,2862,2228,1
20150106.095654,2862,2,1127272,2,2861,581,2862,2234,1
20150106.095654,2862,4164,1131436,-2592,2861,591,2863,730,1
20150106.095655,2862,18,1131454,-18,2861,597,2862,147,1
20150106.095656,2862,220,1131674,66,2861,597,2863,730,1
20150106.095656,2862,58,1131732,2,2861,597,2863,730,1
20150106.095657,2862,4,1131736,4,2861,600,2863,729,1
20150106.095657,2862,46,1131782,0,2861,600,2863,729,1
20150106.095658,2861,20,1131802,-20,2861,590,2863,729,0
20150106.095659,2863,36,1131838,0,2862,11,2863,1179,1
20150106.095659,2863,48,1131886,0,2862,59,2863,1155,1
20150106.0957,2863,160,1132046,-28,2862,585,2863,701,1
20150106.095701,2862,2,1132048,0,2862,657,2863,634,0
20150106.095702,2862,4,1132052,2,2862,657,2863,633,0
20150106.095702,2863,18,1132070,0,2862,657,2863,635,1
20150106.095703,2863,6,1132076,-2,2862,656,2863,634,1
20150106.095703,2862,22,1132098,-18,2862,663,2863,624,0
20150106.095704,2863,2,1132100,0,2862,664,2863,631,1
20150106.095705,2863,402,1132502,-284,2862,801,2863,430,1
20150106.095706,2863,868,1133370,566,2863,569,2864,642,1
20150106.095706,2863,12,1133382,-6,2863,125,2864,592,1
20150106.095707,2864,14,1133396,-12,2863,129,2864,592,1
20150106.095708,2863,214,1133610,-88,2863,166,2864,499,0
20150106.095708,2864,36,1133646,-22,2863,166,2864,482,1
20150106.095708,2864,4,1133650,-4,2863,166,2864,480,1
20150106.095709,2864,236,1133886,60,2863,123,2864,473,1
20150106.09571,2864,12,1133898,-4,2863,124,2864,468,1
20150106.09571,2864,4,1133902,-4,2863,124,2864,466,1
20150106.095711,2864,10,1133912,-8,2863,135,2864,463,1
20150106.095711,2863,4,1133916,-2,2863,236,2864,463,0
20150106.095712,2864,4,1133920,-4,2863,236,2864,462,1
20150106.095712,2863,4,1133924,-2,2863,235,2864,471,0
20150106.095713,2864,6,1133930,-4,2863,256,2864,470,1
20150106.095713,2863,50,1133980,-4,2863,258,2864,461,0
20150106.095713,2864,6,1133986,-4,2863,259,2864,458,1
20150106.095714,2864,12,1133998,0,2863,261,2864,456,1
20150106.095715,2864,822,1134820,-334,2863,260,2864,76,1
20150106.095715,2863,34,1134854,-28,2863,275,2864,75,0
20150106.095716,2864,2,1134856,2,2863,281,2864,75,1
20150106.095716,2864,18,1134874,-4,2863,283,2864,78,1
20150106.095717,2864,168,1135042,-80,2864,337,2865,1289,1
20150106.095717,2864,8,1135050,-6,2864,338,2865,1209,1
20150106.095718,2864,14,1135064,-14,2864,331,2865,1245,1
20150106.095718,2864,28,1135092,6,2864,339,2865,1233,1
20150106.095718,2864,4,1135096,0,2864,343,2865,1232,1
20150106.095719,2864,22,1135118,-22,2864,336,2865,1212,1
20150106.09572,2865,18,1135136,-6,2864,331,2865,1203,1
20150106.09572,2864,2,1135138,-2,2864,330,2865,1203,0
20150106.095721,2864,42,1135180,0,2864,327,2865,1184,0
20150106.095721,2865,10,1135190,0,2864,328,2865,1178,1
20150106.095722,2865,4,1135194,-2,2864,328,2865,1178,1
20150106.095722,2865,28,1135222,0,2864,329,2865,1327,1
20150106.095723,2865,82,1135304,6,2864,327,2865,1269,1
20150106.095723,2865,120,1135424,44,2864,329,2865,1210,1
20150106.095724,2865,2,1135426,0,2864,330,2865,1209,1
20150106.095724,2865,1020,1136446,-464,2864,330,2865,701,1
20150106.095725,2865,6,1136452,-2,2864,332,2865,716,1
20150106.095725,2865,66,1136518,-28,2864,333,2865,684,1
20150106.095726,2864,8,1136526,2,2864,331,2865,685,0
20150106.095727,2864,52,1136578,32,2864,327,2865,662,0
20150106.095728,2865,1218,1137796,-804,2864,327,2865,195,1
20150106.095728,2865,2,1137798,-2,2864,351,2865,195,1
20150106.095729,2865,16,1137814,-10,2864,347,2865,242,1
20150106.095729,2865,66,1137880,-6,2864,350,2865,211,1
20150106.09573,2865,50,1137930,0,2864,384,2865,188,1
20150106.09573,2865,4,1137934,-2,2864,385,2865,195,1
20150106.09573,2865,62,1137996,-46,2864,385,2865,165,1
20150106.095731,2865,10,1138006,2,2864,394,2865,619,1
20150106.095732,2865,10,1138016,10,2864,370,2865,625,1
20150106.095732,2865,4,1138020,4,2864,373,2865,627,1
20150106.095733,2864,186,1138206,0,2864,280,2865,638,0
20150106.095733,2865,6,1138212,4,2864,278,2865,640,1
20150106.095734,2865,4,1138216,0,2864,291,2865,645,1
20150106.095734,2864,12,1138228,-2,2864,286,2865,645,0
20150106.095734,2865,50,1138278,-30,2864,290,2865,620,1
20150106.095735,2864,4,1138282,-2,2864,287,2865,623,0
20150106.095736,2865,12,1138294,0,2864,287,2865,626,1
20150106.095737,2865,102,1138396,-2,2864,253,2865,688,1
20150106.095738,2865,12,1138408,-2,2864,253,2865,684,1
20150106.095738,2864,10,1138418,-2,2864,253,2865,499,0
20150106.095739,2865,26,1138444,-20,2864,252,2865,481,1
20150106.095739,2864,2,1138446,0,2864,251,2865,489,0
20150106.09574,2864,10,1138456,0,2864,250,2865,469,0
20150106.095741,2865,38,1138494,-38,2864,293,2865,468,1
20150106.095741,2864,10,1138504,-10,2864,289,2865,468,0
20150106.095742,2864,2,1138506,0,2864,288,2865,478,0
20150106.095743,2864,14,1138520,0,2864,283,2865,480,0
20150106.095743,2864,164,1138684,-14,2864,281,2865,406,0
20150106.095744,2864,6,1138690,0,2864,280,2865,409,0
20150106.095745,2865,48,1138738,-46,2864,282,2865,382,1
20150106.095746,2865,46,1138784,-6,2864,271,2865,393,1
20150106.095747,2864,30,1138814,-28,2864,266,2865,394,0
20150106.095748,2865,4,1138818,0,2864,273,2865,403,1
20150106.09575,2864,4,1138822,-4,2864,271,2865,419,0
20150106.09575,2864,6,1138828,-6,2864,266,2865,439,0
20150106.095751,2864,28,1138856,-4,2864,252,2865,465,0
20150106.095752,2865,42,1138898,-10,2864,246,2865,582,1
20150106.095752,2864,12,1138910,-12,2864,250,2865,604,0
20150106.095752,2864,244,1139154,-170,2864,128,2865,612,0
20150106.095753,2865,268,1139422,-168,2863,671,2864,132,1
20150106.095754,2864,22,1139444,-18,2863,641,2864,139,0
20150106.095755,2864,26,1139470,10,2863,3641,2864,227,0
20150106.095755,2864,236,1139706,-34,2864,127,2865,742,0
20150106.095756,2864,16,1139722,16,2864,140,2865,749,0
20150106.095758,2864,20,1139742,10,2864,157,2865,761,0
20150106.095759,2865,4,1139746,-2,2864,206,2865,761,1
20150106.0958,2864,4,1139750,2,2864,109,2865,763,0
20150106.0958,2864,2,1139752,0,2864,108,2865,876,0
20150106.095801,2864,8,1139760,-4,2864,108,2865,878,0
20150106.095802,2865,6,1139766,-2,2864,107,2865,885,1
20150106.095802,2864,40,1139806,0,2864,87,2865,889,0
20150106.095803,2865,40,1139846,2,2864,95,2865,886,1
20150106.095803,2864,36,1139882,6,2864,77,2865,918,0
20150106.095803,2864,44,1139926,44,2864,55,2865,918,0
20150106.095804,2864,4,1139930,2,2864,53,2865,921,0
20150106.095805,2864,14,1139944,8,2864,47,2865,917,0
20150106.095805,2864,10,1139954,8,2864,43,2865,924,0
20150106.095807,2864,140,1140094,6,2863,656,2864,96,0
20150106.095809,2864,2,1140096,2,2863,657,2864,217,0
20150106.095809,2864,2,1140098,0,2863,657,2864,216,0
20150106.09581,2864,18,1140116,2,2863,655,2864,210,0
20150106.09581,2863,4,1140120,-4,2863,653,2864,210,0
20150106.095811,2863,2,1140122,-2,2863,652,2864,210,0
20150106.095811,2864,2,1140124,2,2863,652,2864,209,1
20150106.095812,2864,202,1140326,-28,2863,653,2864,108,1
20150106.095813,2864,20,1140346,8,2863,653,2864,104,1
20150106.095813,2864,2,1140348,0,2863,653,2864,103,1
20150106.095814,2863,126,1140474,-80,2863,604,2864,101,0
20150106.095815,2864,6,1140480,6,2863,605,2864,101,1
20150106.095816,2864,10,1140490,-2,2863,605,2864,106,1
20150106.095817,2864,4,1140494,-2,2863,604,2864,231,1
20150106.095818,2864,12,1140506,10,2863,601,2864,292,1
20150106.09582,2863,2,1140508,0,2863,601,2864,346,0
20150106.095821,2864,2,1140510,2,2863,712,2864,397,1
20150106.095821,2864,4,1140514,-2,2863,712,2864,406,1
20150106.095822,2863,2,1140516,0,2863,711,2864,406,0
20150106.095822,2863,12,1140528,0,2863,710,2864,401,0
20150106.095823,2863,20,1140548,-20,2863,700,2864,452,0
20150106.095824,2863,2,1140550,-2,2863,699,2864,454,0
20150106.095824,2864,6,1140556,2,2863,698,2864,454,1
20150106.095825,2864,2,1140558,2,2863,697,2864,456,1
20150106.095826,2863,10,1140568,-10,2863,684,2864,457,0
20150106.095828,2864,2,1140570,0,2863,689,2864,465,1
20150106.095829,2864,94,1140664,94,2863,688,2864,423,1
20150106.095829,2864,4,1140668,0,2863,690,2864,433,1
20150106.09583,2863,4,1140672,0,2863,687,2864,448,0
20150106.095831,2864,4,1140676,0,2863,690,2864,446,1
20150106.095831,2863,208,1140884,58,2863,591,2864,443,0
20150106.095832,2863,2,1140886,2,2863,590,2864,445,0
20150106.095833,2863,24,1140910,20,2863,580,2864,444,0
20150106.095834,2863,20,1140930,20,2863,570,2864,444,0
20150106.095834,2864,40,1140970,30,2863,563,2864,444,1
20150106.095835,2864,40,1141010,-28,2863,563,2864,424,1
20150106.095836,2863,2,1141012,0,2863,562,2864,434,0
20150106.095837,2863,2,1141014,0,2863,561,2864,436,0
20150106.095837,2864,12,1141026,-10,2863,561,2864,430,1
20150106.095842,2864,8,1141034,-8,2863,561,2864,450,1
20150106.095843,2863,4,1141038,-2,2863,558,2864,451,0
20150106.095847,2864,4,1141042,-4,2863,550,2864,454,1
20150106.095848,2864,20,1141062,-20,2863,560,2864,454,1
20150106.095848,2864,4,1141066,2,2863,559,2864,454,1
20150106.095849,2864,24,1141090,20,2863,549,2864,453,1
20150106.09585,2863,24,1141114,20,2863,537,2864,453,0
20150106.095852,2864,2,1141116,-2,2863,562,2864,461,1
20150106.095853,2864,14,1141130,-12,2863,557,2864,459,1
20150106.095854,2863,4,1141134,-2,2863,556,2864,460,0
20150106.095856,2863,6,1141140,0,2863,553,2864,466,0
20150106.095857,2864,6,1141146,-4,2863,552,2864,469,1
20150106.095858,2863,48,1141194,-42,2863,536,2864,479,0
20150106.095901,2863,12,1141206,-6,2863,529,2864,1081,0
20150106.095903,2863,8,1141214,-2,2863,526,2864,1216,0
20150106.095904,2863,2,1141216,-2,2863,525,2864,1216,0
20150106.095904,2863,1052,1142268,-948,2862,368,2863,110,0
20150106.095905,2863,2,1142270,0,2862,369,2863,164,0
20150106.095905,2862,4,1142274,0,2862,367,2863,165,0
20150106.095906,2863,2,1142276,2,2862,368,2863,165,1
20150106.095906,2862,26,1142302,6,2862,355,2863,176,0
20150106.095907,2862,4,1142306,4,2862,353,2863,176,0
20150106.095907,2862,6,1142312,0,2862,350,2863,176,0
20150106.095909,2863,18,1142330,16,2862,363,2863,167,1
20150106.095911,2863,10,1142340,8,2862,399,2863,162,1
20150106.095911,2863,4,1142344,0,2862,399,2863,662,1
20150106.095912,2862,2,1142346,0,2862,398,2863,687,0
20150106.095912,2862,2,1142348,2,2862,397,2863,687,0
20150106.095914,2863,44,1142392,2,2862,402,2863,668,1
20150106.095918,2862,10,1142402,10,2862,427,2863,754,0
20150106.095918,2862,4,1142406,0,2862,425,2863,754,0
20150106.095918,2862,4,1142410,4,2862,423,2863,755,0
20150106.095922,2863,10,1142420,10,2862,440,2863,750,1
20150106.095923,2862,2,1142422,2,2862,439,2863,810,0
20150106.095924,2862,4,1142426,4,2862,434,2863,816,0
20150106.095928,2863,26,1142452,0,2862,433,2863,888,1
20150106.095929,2862,2,1142454,2,2862,432,2863,889,0
20150106.095929,2863,52,1142506,-42,2862,432,2863,875,1
20150106.095932,2862,82,1142588,-74,2862,417,2863,888,0
20150106.095935,2862,2,1142590,-2,2862,433,2863,865,0
20150106.095937,2863,14,1142604,-14,2862,432,2863,860,1
20150106.095938,2862,2,1142606,0,2862,432,2863,860,0
20150106.09594,2862,16,1142622,-14,2862,431,2863,854,0
20150106.095941,2863,48,1142670,-30,2862,431,2863,835,1
20150106.095942,2862,2,1142672,-2,2862,431,2863,835,0
20150106.095943,2863,34,1142706,-12,2862,6464,2863,776,1
20150106.095944,2863,14,1142720,-12,2862,6481,2863,771,1
20150106.095944,2863,22,1142742,-14,2862,6456,2863,760,1
20150106.095945,2863,2,1142744,-2,2862,6457,2863,759,1
20150106.095946,2863,2,1142746,0,2862,6458,2863,758,1
20150106.095946,2862,24,1142770,0,2862,6446,2863,760,0
20150106.095948,2862,8,1142778,-4,2862,3440,2863,754,0
20150106.095949,2862,14,1142792,-4,2862,2433,2863,754,0
20150106.095951,2863,200,1142992,0,2862,432,2863,671,1
20150106.095953,2862,2,1142994,0,2862,435,2863,674,0
20150106.095954,2863,20,1143014,0,2862,435,2863,674,1
20150106.095955,2863,48,1143062,-48,2862,435,2863,650,1
20150106.095956,2863,4,1143066,-4,2862,435,2863,650,1
20150106.095957,2862,4,1143070,0,2862,439,2863,656,0
20150106.095957,2862,6,1143076,-6,2862,436,2863,656,0
20150106.095958,2863,6,1143082,0,2862,436,2863,653,1
20150106.095959,2862,6,1143088,0,2862,433,2863,654,0
20150106.100001,2863,462,1143550,-230,2862,435,2863,423,1
20150106.100001,2863,282,1143832,-220,2862,434,2863,285,1
20150106.100002,2862,88,1143920,-2,2862,408,2863,268,0
20150106.100002,2863,2,1143922,0,2862,483,2863,267,1
20150106.100004,2862,34,1143956,30,2862,531,2863,258,0
20150106.100004,2863,2,1143958,0,2862,533,2863,257,1
20150106.100005,2863,2,1143960,0,2862,538,2863,256,1
20150106.100006,2863,288,1144248,226,2862,640,2863,112,1
20150106.100006,2863,6,1144254,4,2862,640,2863,109,1
20150106.100007,2863,2,1144256,2,2862,641,2863,107,1
20150106.100007,2863,2,1144258,0,2862,641,2863,106,1
20150106.100009,2863,2,1144260,0,2862,641,2863,106,1
20150106.10001,2862,2,1144262,0,2862,638,2863,111,0
20150106.100013,2863,2,1144264,0,2862,837,2863,112,1
20150106.100013,2863,2,1144266,2,2862,837,2863,111,1
20150106.100014,2863,2,1144268,2,2862,837,2863,110,1
20150106.100014,2862,22,1144290,2,2862,825,2863,109,0
20150106.100023,2862,2,1144292,-2,2862,909,2863,140,0
20150106.100024,2863,2,1144294,2,2862,909,2863,140,1
20150106.100025,2863,2,1144296,0,2862,909,2863,151,1
20150106.100028,2863,2,1144298,2,2862,909,2863,149,1
20150106.10003,2863,2,1144300,0,2862,909,2863,294,1
20150106.100035,2862,2,1144302,0,2862,899,2863,296,0
20150106.100035,2863,4,1144306,4,2862,894,2863,295,1
20150106.100036,2862,2,1144308,-2,2862,893,2863,310,0
20150106.100037,2863,40,1144348,-14,2862,893,2863,290,1
20150106.100038,2862,2,1144350,0,2862,892,2863,290,0
20150106.100039,2862,2,1144352,-2,2862,892,2863,803,0
20150106.10004,2862,8,1144360,0,2862,886,2863,805,0
20150106.100041,2862,2,1144362,-2,2862,885,2863,805,0
20150106.100042,2862,2,1144364,0,2862,825,2863,805,0
20150106.100044,2862,2,1144366,0,2862,826,2863,807,0
20150106.100045,2863,6,1144372,-6,2862,839,2863,826,1
20150106.100046,2863,6,1144378,2,2862,839,2863,823,1
20150106.100048,2862,2,1144380,0,2862,839,2863,823,0
20150106.10005,2862,2,1144382,-2,2862,825,2863,823,0
20150106.100052,2862,2,1144384,0,2862,824,2863,823,0
20150106.100054,2862,40,1144424,0,2862,804,2863,823,0
20150106.100055,2862,30,1144454,-30,2862,800,2863,823,0
20150106.100055,2862,4,1144458,-4,2862,798,2863,823,0
20150106.100057,2862,2,1144460,-2,2862,799,2863,823,0
20150106.1001,2862,212,1144672,-184,2862,703,2863,827,0
20150106.100101,2863,4,1144676,2,2862,703,2863,828,1
20150106.100103,2862,30,1144706,-30,2862,688,2863,1228,0
20150106.100104,2862,2,1144708,-2,2862,687,2863,1227,0
20150106.100104,2862,2,1144710,0,2862,686,2863,1232,0
20150106.100105,2862,12,1144722,-12,2862,679,2863,1232,0
20150106.100107,2862,4,1144726,-4,2862,677,2863,1232,0
20150106.10011,2863,2,1144728,-2,2862,678,2863,1232,1
20150106.10011,2862,1356,1146084,-700,2861,1336,2862,174,0
20150106.100111,2862,2,1146086,-2,2861,1305,2862,228,0
20150106.100113,2862,14,1146100,-8,2861,4289,2862,234,0
20150106.100114,2862,70,1146170,-70,2861,4256,2862,204,0
20150106.100118,2862,2,1146172,-2,2861,1214,2862,219,0
20150106.100118,2861,2,1146174,-2,2861,1213,2862,233,0
20150106.100119,2861,30,1146204,-30,2861,1204,2862,234,0
20150106.100119,2861,32,1146236,-28,2861,1190,2862,233,0
20150106.100121,2861,2,1146238,0,2861,1191,2862,236,0
20150106.100123,2862,2,1146240,-2,2861,1191,2862,235,1
20150106.100123,2861,2,1146242,-2,2861,1192,2862,236,0
20150106.100124,2861,12,1146254,-6,2861,1169,2862,332,0
20150106.100124,2861,2,1146256,0,2861,1173,2862,332,0
20150106.100125,2862,20,1146276,0,2861,1158,2862,323,1
20150106.100127,2861,30,1146306,-30,2861,1146,2862,324,0
20150106.100127,2862,2,1146308,0,2861,1145,2862,323,1
20150106.100128,2862,16,1146324,-6,2861,1155,2862,322,1
20150106.100131,2861,2,1146326,-2,2861,1149,2862,322,0
20150106.100132,2861,2,1146328,-2,2861,1143,2862,322,0
20150106.100133,2861,2,1146330,0,2861,1142,2862,338,0
20150106.100135,2861,50,1146380,0,2861,1137,2862,319,0
20150106.100136,2861,10,1146390,0,2861,1127,2862,320,0
20150106.100137,2862,2,1146392,-2,2861,1127,2862,319,1
20150106.100138,2861,12,1146404,-2,2861,1121,2862,320,0
20150106.100141,2862,2,1146406,0,2861,1089,2862,334,1
20150106.100143,2862,4,1146410,0,2861,1089,2862,332,1
20150106.100144,2862,46,1146456,-40,2861,1087,2862,309,1
20150106.100145,2861,24,1146480,-24,2861,1075,2862,310,0
20150106.100147,2861,20,1146500,-20,2861,1062,2862,310,0
20150106.10015,2862,6,1146506,-6,2861,1064,2862,361,1
20150106.100152,2862,764,1147270,-462,2862,679,2863,1195,1
20150106.100155,2862,4,1147274,0,2862,677,2863,1195,1
20150106.100156,2862,2,1147276,-2,2862,676,2863,1195,1
20150106.100158,2862,20,1147296,-20,2862,1168,2863,1195,1
20150106.100159,2862,6,1147302,-6,2862,1177,2863,1195,1
20150106.1002,2863,2,1147304,2,2862,1177,2863,1194,1
20150106.100203,2862,2,1147306,-2,2862,1176,2863,1196,0
20150106.100204,2863,2,1147308,0,2862,1189,2863,1195,1
20150106.100208,2862,4,1147312,-2,2862,1216,2863,1195,0
20150106.100209,2863,20,1147332,2,2862,1216,2863,1194,1
20150106.100209,2862,8,1147340,-6,2862,1214,2863,1193,0
20150106.100213,2862,2,1147342,0,2862,1213,2863,1198,0
20150106.100214,2862,4,1147346,-4,2862,1212,2863,1197,0
20150106.100215,2862,6,1147352,0,2862,1212,2863,1197,0
20150106.100215,2862,4,1147356,0,2862,1210,2863,1197,0
20150106.100217,2862,4,1147360,-2,2862,1209,2863,1196,0
20150106.100218,2862,10,1147370,-10,2862,1204,2863,1196,0
20150106.100221,2862,4,1147374,-4,2862,1213,2863,1196,0
20150106.100221,2862,26,1147400,-26,2862,1200,2863,1196,0
20150106.100225,2863,20,1147420,-12,2862,1210,2863,1186,1
20150106.100227,2862,6,1147426,-2,2862,1208,2863,1187,0
20150106.100229,2862,12,1147438,0,2862,1209,2863,1227,0
20150106.100232,2862,4,1147442,0,2862,1208,2863,1228,0
20150106.100235,2862,26,1147468,-26,2862,1195,2863,1232,0
20150106.100236,2862,2,1147470,0,2862,1194,2863,1232,0
20150106.100238,2863,4,1147474,0,2862,1195,2863,1230,1
20150106.100238,2862,6,1147480,-6,2862,1192,2863,1230,0
20150106.100239,2862,12,1147492,0,2862,1186,2863,1230,0
20150106.100242,2863,4,1147496,-4,2862,1200,2863,1228,1
20150106.100243,2862,14,1147510,-14,2862,1193,2863,1228,0
20150106.100245,2863,20,1147530,10,2862,1184,2863,1219,1
20150106.100248,2863,10,1147540,-10,2862,1185,2863,1221,1
20150106.100249,2862,100,1147640,0,2862,1135,2863,1221,0
20150106.100251,2862,4,1147644,-4,2862,1134,2863,1222,0
20150106.100252,2863,60,1147704,-50,2862,1135,2863,1192,1
20150106.100252,2862,10,1147714,0,2862,1130,2863,1192,0
20150106.100255,2862,10,1147724,0,2862,1127,2863,1216,0
20150106.100256,2863,2,1147726,0,2862,1127,2863,1215,1
20150106.100257,2862,54,1147780,-44,2862,1100,2863,1215,0
20150106.100259,2862,10,1147790,0,2862,1095,2863,1215,0
20150106.100259,2862,2,1147792,0,2862,1095,2863,1316,0
20150106.100301,2862,20,1147812,0,2862,1085,2863,1316,0
20150106.100304,2862,2,1147814,0,2862,1084,2863,1316,0
20150106.100309,2862,2,1147816,0,2862,1085,2863,1316,0
20150106.10031,2862,2,1147818,0,2862,1084,2863,1319,0
20150106.100312,2862,2,1147820,-2,2862,1084,2863,1320,0
20150106.100314,2863,4,1147824,-4,2862,1086,2863,1319,1
20150106.100315,2863,2,1147826,-2,2862,1086,2863,1319,1
20150106.100318,2863,40,1147866,-40,2862,1087,2863,1309,1
20150106.10032,2863,6,1147872,-6,2862,1087,2863,1306,1
20150106.100321,2863,10,1147882,-10,2862,1087,2863,1311,1
20150106.100324,2863,2,1147884,0,2862,1039,2863,1310,1
20150106.100328,2862,2,1147886,-2,2862,1038,2863,1326,0
20150106.100329,2863,2,1147888,0,2862,1038,2863,1345,1
20150106.100332,2863,2,1147890,-2,2862,1038,2863,1344,1
20150106.100335,2862,6,1147896,0,2862,1035,2863,1338,0
20150106.100338,2862,6,1147902,0,2862,1035,2863,1338,0
20150106.100339,2863,4,1147906,-2,2862,1037,2863,1336,1
20150106.100342,2862,6,1147912,-2,2862,1038,2863,1344,0
20150106.100342,2862,26,1147938,-26,2862,1024,2863,1339,0
20150106.100345,2862,8,1147946,0,2862,1020,2863,1296,0
20150106.100345,2862,12,1147958,-12,2862,1014,2863,1296,0
20150106.100346,2863,4,1147962,-4,2862,1012,2863,1294,1
20150106.100346,2863,20,1147982,0,2862,1012,2863,1284,1
20150106.100348,2863,4,1147986,0,2862,1014,2863,1463,1
20150106.100351,2862,70,1148056,0,2862,979,2863,1468,0
20150106.100352,2862,8,1148064,0,2862,975,2863,1469,0
20150106.100353,2862,8,1148072,-8,2862,971,2863,1469,0
20150106.100353,2863,2,1148074,0,2862,971,2863,1468,1
20150106.100354,2863,4,1148078,-4,2862,971,2863,1466,1
20150106.100355,2862,2,1148080,0,2862,970,2863,1567,0
20150106.100356,2862,20,1148100,0,2862,960,2863,1567,0
20150106.100357,2862,4,1148104,-2,2862,958,2863,1592,0
20150106.100358,2862,2,1148106,0,2862,957,2863,1592,0
20150106.100358,2862,4,1148110,-4,2862,956,2863,1591,0
20150106.100359,2863,4,1148114,-4,2862,956,2863,1594,1
20150106.100401,2863,16,1148130,0,2862,953,2863,1586,1
20150106.100402,2863,6,1148136,0,2862,954,2863,1583,1
20150106.100403,2862,10,1148146,0,2862,948,2863,1587,0
20150106.100403,2862,40,1148186,0,2862,928,2863,1587,0
20150106.100404,2862,2,1148188,-2,2862,927,2863,1587,0
20150106.100405,2862,2,1148190,0,2862,927,2863,1587,0
20150106.100407,2862,2,1148192,0,2862,936,2863,1590,0
20150106.100409,2862,4,1148196,-4,2862,934,2863,1590,0
20150106.100409,2862,4,1148200,0,2862,932,2863,1590,0
20150106.100411,2862,10,1148210,0,2862,927,2863,1591,0
20150106.100413,2862,20,1148230,-20,2862,917,2863,1593,0
20150106.100414,2862,2,1148232,0,2862,916,2863,1600,0
20150106.100415,2862,4,1148236,-2,2862,915,2863,1601,0
20150106.100416,2863,16,1148252,0,2862,914,2863,1593,1
20150106.100417,2862,14,1148266,-14,2862,907,2863,1593,0
20150106.100418,2862,2,1148268,0,2862,906,2863,1593,0
20150106.100419,2862,2,1148270,-2,2862,905,2863,1593,0
20150106.100421,2862,6,1148276,-6,2862,902,2863,1593,0
20150106.100423,2862,8,1148284,-8,2862,898,2863,1593,0
20150106.100423,2862,2,1148286,-2,2862,897,2863,1594,0
20150106.100426,2862,4,1148290,-2,2862,892,2863,1594,0
20150106.100429,2862,20,1148310,0,2862,882,2863,1576,0
20150106.100429,2862,10,1148320,0,2862,877,2863,1576,0
20150106.10043,2862,18,1148338,-18,2862,868,2863,1576,0
20150106.100431,2863,20,1148358,0,2862,868,2863,1566,1
20150106.100432,2862,2,1148360,0,2862,867,2863,1566,0
20150106.100433,2862,2,1148362,-2,2862,869,2863,1567,0
20150106.100434,2862,2,1148364,-2,2862,868,2863,1571,0
20150106.100434,2862,2,1148366,0,2862,867,2863,1571,0
20150106.100435,2862,2,1148368,0,2862,866,2863,1571,0
20150106.100437,2862,4,1148372,-4,2862,864,2863,1571,0
20150106.100444,2862,1964,1150336,800,2862,383,2863,1623,0
20150106.100444,2862,766,1151102,-194,2861,924,2862,249,0
20150106.100446,2862,16,1151118,16,2861,906,2862,316,0
20150106.100448,2862,80,1151198,0,2861,906,2862,318,0
20150106.100451,2861,4,1151202,-4,2861,906,2862,326,0
20150106.100451,2861,2,1151204,-2,2861,905,2862,326,0
20150106.100452,2862,2,1151206,2,2861,3905,2862,320,1
20150106.100452,2862,12,1151218,6,2861,4907,2862,223,1
20150106.100453,2862,496,1151714,54,2862,57,2863,1809,1
20150106.100453,2862,214,1151928,-208,2861,5907,2862,395,1
20150106.100454,2862,600,1152528,-600,2861,5907,2862,313,1
20150106.100454,2862,456,1152984,-410,2861,5887,2862,120,1
20150106.100455,2862,252,1153236,14,2862,268,2863,1596,1
20150106.100456,2862,28,1153264,18,2862,134,2863,1596,1
20150106.100456,2862,52,1153316,12,2862,106,2863,1596,1
20150106.100457,2862,42,1153358,38,2862,332,2863,1596,1
20150106.100457,2862,12,1153370,12,2862,329,2863,1596,1
20150106.100458,2862,658,1154028,-608,2861,982,2862,173,1
20150106.1005,2862,402,1154430,-398,2861,899,2862,52,1
20150106.100502,2861,6,1154436,-4,2861,898,2862,59,0
20150106.100503,2861,10,1154446,-10,2861,895,2862,61,0
20150106.100505,2862,2,1154448,0,2861,895,2862,66,1
20150106.100507,2862,148,1154596,78,2862,67,2863,1595,1
20150106.100507,2863,200,1154796,-198,2862,69,2863,1496,1
20150106.100508,2862,8,1154804,-4,2862,67,2863,1499,0
20150106.100509,2862,10,1154814,6,2862,62,2863,1499,0
20150106.10051,2862,124,1154938,-120,2861,891,2862,490,0
20150106.100511,2861,602,1155540,-602,2861,892,2862,203,0
20150106.100513,2862,2,1155542,0,2861,894,2862,239,1
20150106.100516,2862,20,1155562,0,2861,895,2862,242,1
20150106.100518,2861,14,1155576,0,2861,885,2862,247,0
20150106.100518,2862,2,1155578,0,2861,885,2862,246,1
20150106.10052,2862,20,1155598,0,2861,885,2862,236,1
20150106.100521,2862,4,1155602,-4,2861,885,2862,240,1
20150106.100522,2861,6,1155608,0,2861,882,2862,240,0
20150106.100523,2861,34,1155642,-20,2861,873,2862,546,0
20150106.100524,2861,6,1155648,0,2861,872,2862,546,0
20150106.100533,2862,12,1155660,-6,2861,1178,2862,545,1
20150106.100536,2861,20,1155680,-20,2861,1170,2862,546,0
20150106.100537,2861,2,1155682,0,2861,1169,2862,546,0
20150106.10054,2862,1096,1156778,-332,2862,504,2863,1518,1
20150106.100542,2862,2,1156780,0,2862,511,2863,1518,1
20150106.100543,2862,2,1156782,0,2862,510,2863,1518,1
20150106.100543,2862,40,1156822,0,2862,490,2863,1518,1
20150106.100545,2862,10,1156832,0,2862,485,2863,1570,1
20150106.100547,2862,2,1156834,0,2862,486,2863,1578,1
20150106.100548,2862,14,1156848,-14,2862,479,2863,1578,1
20150106.100549,2862,2,1156850,-2,2862,478,2863,1578,1
20150106.10055,2862,4,1156854,0,2862,477,2863,1577,1
20150106.100553,2862,1108,1157962,-998,2861,1167,2862,48,1
20150106.100553,2862,118,1158080,-20,2862,102,2863,2078,1
20150106.100554,2862,28,1158108,-2,2862,153,2863,2079,1
20150106.100555,2862,308,1158416,-72,2861,1167,2862,2,1
20150106.100556,2862,106,1158522,0,2862,51,2863,2082,1
20150106.100557,2862,12,1158534,-10,2862,46,2863,2282,1
20150106.100558,2862,2,1158536,0,2862,48,2863,2282,1
20150106.100559,2862,68,1158604,0,2862,16,2863,2278,1
20150106.1006,2862,6,1158610,-6,2862,13,2863,2279,1
20150106.1006,2862,144,1158754,98,2861,1167,2862,14,1
20150106.100601,2862,28,1158782,28,2862,54,2863,2355,1
20150106.100603,2862,10,1158792,-2,2862,50,2863,2359,1
20150106.100604,2862,2,1158794,0,2862,50,2863,2365,1
20150106.100605,2862,2,1158796,0,2862,49,2863,2365,1
20150106.100605,2862,2,1158798,-2,2862,54,2863,2367,1
20150106.100606,2863,14,1158812,-2,2862,50,2863,2372,1
20150106.100606,2862,4,1158816,0,2862,48,2863,2374,0
20150106.100607,2862,98,1158914,-94,2861,1176,2862,2,0
20150106.100608,2862,104,1159018,104,2861,1176,2862,1,0
20150106.100608,2862,2,1159020,0,2862,54,2863,2375,0
20150106.100609,2862,42,1159062,-38,2862,33,2863,2375,0
20150106.100609,2863,10,1159072,-10,2862,33,2863,2369,1
20150106.100611,2862,2,1159074,0,2862,366,2863,2281,0
20150106.100612,2862,2,1159076,0,2862,370,2863,2281,0
20150106.100613,2863,2,1159078,0,2862,374,2863,2281,1
20150106.100614,2862,2,1159080,0,2862,383,2863,2281,0
20150106.100615,2863,200,1159280,-200,2862,383,2863,2181,1
20150106.100616,2862,206,1159486,-200,2862,385,2863,2081,0
20150106.100616,2863,200,1159686,-200,2862,385,2863,1981,1
20150106.100617,2863,200,1159886,-200,2862,387,2863,1881,1
20150106.100618,2863,200,1160086,-150,2862,388,2863,1781,1
20150106.100619,2862,20,1160106,-20,2862,379,2863,1782,0
20150106.10062,2862,2,1160108,0,2862,378,2863,1782,0
20150106.10062,2862,12,1160120,-12,2862,372,2863,1782,0
20150106.100621,2862,2,1160122,-2,2862,371,2863,1782,0
20150106.100621,2863,2,1160124,0,2862,371,2863,1781,1
20150106.100622,2862,8,1160132,0,2862,368,2863,1780,0
20150106.100625,2862,4,1160136,-4,2862,376,2863,1784,0
20150106.100626,2862,4,1160140,0,2862,379,2863,1784,0
20150106.100628,2862,6,1160146,0,2862,437,2863,1783,0
20150106.10063,2862,8,1160154,-8,2862,435,2863,1783,0
20150106.100632,2862,2,1160156,0,2862,555,2863,1782,0
20150106.100633,2863,300,1160456,-300,2862,506,2863,1681,1
20150106.100634,2863,200,1160656,-200,2862,501,2863,1585,1
20150106.100635,2862,16,1160672,0,2862,494,2863,1583,0
20150106.100636,2863,200,1160872,-200,2862,494,2863,1483,1
20150106.100637,2863,210,1161082,-112,2862,490,2863,1383,1
20150106.100638,2863,200,1161282,0,2862,489,2863,1283,1
20150106.100639,2863,2,1161284,2,2862,489,2863,1284,1
20150106.10064,2863,2516,1163800,-1062,2862,488,2863,27,1
20150106.100641,2863,54,1163854,32,2863,136,2864,940,1
20150106.100641,2863,2,1163856,0,2863,161,2864,940,1
20150106.100642,2864,6,1163862,0,2863,183,2864,938,1
20150106.100643,2864,2,1163864,0,2863,208,2864,937,1
20150106.100644,2863,2,1163866,2,2863,181,2864,943,0
20150106.100645,2863,6,1163872,6,2863,273,2864,943,0
20150106.100646,2863,2,1163874,0,2863,276,2864,943,0
20150106.100648,2863,12,1163886,0,2863,271,2864,963,0
20150106.100648,2864,2,1163888,0,2863,272,2864,963,1
20150106.100649,2863,2,1163890,2,2863,271,2864,963,0
20150106.10065,2864,2,1163892,0,2863,373,2864,962,1
20150106.100652,2863,4,1163896,2,2863,376,2864,962,0
20150106.100654,2863,406,1164302,214,2863,175,2864,1075,0
20150106.100657,2863,2,1164304,0,2863,174,2864,1084,0
20150106.100701,2863,14,1164318,0,2863,171,2864,1085,0
20150106.100708,2864,6,1164324,-6,2863,171,2864,1083,1
20150106.100709,2863,2,1164326,0,2863,170,2864,1083,0
20150106.100712,2864,4,1164330,-4,2863,294,2864,1027,1
20150106.100713,2864,2,1164332,0,2863,294,2864,1007,1
20150106.100714,2864,2,1164334,2,2863,294,2864,1006,1
20150106.100714,2863,2,1164336,0,2863,293,2864,1007,0
20150106.100723,2863,10,1164346,0,2863,310,2864,1005,0
20150106.100724,2864,1000,1165346,-800,2863,313,2864,505,1
20150106.100726,2864,58,1165404,-56,2863,363,2864,465,1
20150106.100727,2864,2,1165406,-2,2863,363,2864,465,1
20150106.100728,2864,4,1165410,0,2863,363,2864,463,1
20150106.100732,2864,66,1165476,-66,2863,377,2864,427,1
20150106.100734,2863,204,1165680,-194,2863,276,2864,430,0
20150106.100735,2864,4,1165684,0,2863,276,2864,431,1
20150106.100735,2864,10,1165694,0,2863,274,2864,428,1
20150106.100738,2863,2,1165696,0,2863,274,2864,424,0
20150106.100738,2864,2,1165698,0,2863,271,2864,424,1
20150106.100739,2864,2,1165700,0,2863,271,2864,423,1
20150106.100741,2864,2,1165702,-2,2863,280,2864,422,1
20150106.100743,2864,2,1165704,-2,2863,281,2864,421,1
20150106.100743,2864,60,1165764,0,2863,281,2864,391,1
20150106.100744,2863,200,1165964,16,2863,181,2864,431,0
20150106.100744,2864,4,1165968,-2,2863,181,2864,455,1
20150106.100746,2864,22,1165990,-20,2863,173,2864,504,1
20150106.100752,2864,16,1166006,0,2863,189,2864,508,1
20150106.100756,2864,2,1166008,-2,2863,193,2864,504,1
20150106.100758,2863,4,1166012,-2,2863,195,2864,503,0
20150106.100802,2863,40,1166052,0,2863,180,2864,509,0
20150106.100802,2864,20,1166072,-20,2863,180,2864,530,1
20150106.100803,2864,2,1166074,0,2863,180,2864,529,1
20150106.100804,2863,20,1166094,0,2863,170,2864,529,0
20150106.100804,2863,2,1166096,0,2863,169,2864,530,0
20150106.100807,2864,2,1166098,-2,2863,179,2864,534,1
20150106.100807,2863,2,1166100,-2,2863,179,2864,534,0
20150106.100807,2863,212,1166312,126,2863,73,2864,535,0
20150106.100808,2863,54,1166366,14,2863,46,2864,541,0
20150106.100808,2863,2,1166368,2,2863,45,2864,541,0
20150106.100809,2863,2,1166370,0,2863,46,2864,541,0
20150106.10081,2863,8,1166378,4,2863,43,2864,535,0
20150106.100812,2863,2,1166380,0,2863,42,2864,538,0
20150106.100814,2864,2,1166382,0,2863,42,2864,540,1
20150106.100814,2863,2,1166384,0,2863,41,2864,540,0
20150106.100817,2864,20,1166404,-16,2863,1043,2864,477,1
20150106.100818,2864,2,1166406,2,2863,1043,2864,459,1
20150106.100819,2863,2,1166408,0,2863,1042,2864,459,0
20150106.100822,2864,4,1166412,0,2863,1050,2864,469,1
20150106.100822,2864,2,1166414,0,2863,1050,2864,472,1
20150106.100824,2863,2,1166416,0,2863,1049,2864,478,0
20150106.100825,2864,962,1167378,-312,2864,21,2865,1490,1
20150106.100826,2864,42,1167420,-40,2863,1050,2864,102,1
20150106.100827,2864,6,1167426,-2,2863,1054,2864,101,1
20150106.100829,2864,2,1167428,0,2863,1059,2864,157,1
20150106.10083,2864,2,1167430,-2,2863,1061,2864,174,1
20150106.100831,2864,4,1167434,0,2863,1058,2864,177,1
20150106.100832,2864,2,1167436,-2,2863,1058,2864,178,1
20150106.100834,2864,2,1167438,0,2863,1052,2864,187,1
20150106.100835,2864,4,1167442,0,2863,1052,2864,206,1
20150106.100836,2864,204,1167646,0,2863,1050,2864,105,1
20150106.100837,2864,200,1167846,-112,2863,1050,2864,5,1
20150106.100837,2864,20,1167866,-12,2863,1126,2864,16,1
20150106.100837,2864,12,1167878,-12,2863,1070,2864,11,1
20150106.100838,2864,22,1167900,-14,2864,98,2865,1501,1
20150106.100838,2864,198,1168098,-156,2863,1141,2865,1497,1
20150106.100839,2864,6,1168104,6,2863,1090,2864,44,1
20150106.100841,2864,88,1168192,-4,2864,100,2865,1503,1
20150106.100841,2864,202,1168394,2,2863,1091,2864,72,1
20150106.100841,2864,14,1168408,-2,2863,1085,2864,66,1
20150106.100842,2864,132,1168540,-2,2864,74,2865,1564,1
20150106.100842,2864,250,1168790,24,2863,1135,2864,20,1
20150106.100843,2864,142,1168932,0,2864,33,2865,1559,1
20150106.100844,2864,106,1169038,4,2863,1092,2864,12,1
20150106.100845,2864,4,1169042,0,2863,1092,2864,10,1
20150106.100846,2864,4,1169046,0,2863,1092,2864,18,1
20150106.100847,2864,2,1169048,0,2863,1092,2864,49,1
20150106.100849,2864,20,1169068,0,2863,1092,2864,39,1
20150106.100849,2864,12,1169080,0,2863,1092,2864,33,1
20150106.10085,2863,100,1169180,-58,2863,1042,2864,33,0
20150106.100852,2864,6,1169186,-2,2863,1053,2864,37,1
20150106.100853,2863,4,1169190,0,2863,1051,2864,47,0
20150106.100853,2864,4,1169194,0,2863,1053,2864,64,1
20150106.100854,2864,2,1169196,2,2863,1053,2864,64,1
20150106.100854,2864,2,1169198,2,2863,1053,2864,66,1
20150106.100855,2864,2,1169200,2,2863,1053,2864,65,1
20150106.100855,2864,2,1169202,2,2863,1054,2864,66,1
20150106.100856,2864,136,1169338,-74,2864,34,2865,1567,1
20150106.100857,2864,40,1169378,0,2864,68,2865,1547,1
20150106.1009,2865,10,1169388,-6,2864,166,2865,1548,1
20150106.1009,2865,10,1169398,0,2864,166,2865,1584,1
20150106.100901,2865,14,1169412,2,2864,162,2865,1581,1
20150106.100903,2865,2,1169414,0,2864,167,2865,1582,1
20150106.100903,2864,40,1169454,4,2864,153,2865,1583,0
20150106.100906,2865,2,1169456,0,2864,160,2865,1581,1
20150106.100907,2864,2,1169458,-2,2864,159,2865,1581,0
20150106.100908,2864,2,1169460,-2,2864,159,2865,1582,0
20150106.100909,2864,346,1169806,-308,2863,1078,2864,379,0
20150106.10091,2864,4,1169810,-2,2863,1078,2864,377,0
20150106.10091,2864,404,1170214,-402,2863,1078,2864,177,0
20150106.100912,2864,2,1170216,-2,2863,1077,2864,176,0
20150106.100915,2864,2,1170218,-2,2863,1079,2864,179,0
20150106.100916,2864,2,1170220,0,2863,1079,2864,178,0
20150106.100917,2864,2,1170222,0,2863,1078,2864,177,0
20150106.100918,2864,20,1170242,0,2863,1079,2864,170,0
20150106.100918,2864,2,1170244,0,2863,1080,2864,169,0
20150106.100919,2864,36,1170280,-36,2863,1080,2864,151,0
20150106.10092,2864,2,1170282,-2,2863,1083,2864,153,0
20150106.100921,2864,2,1170284,0,2863,1083,2864,152,0
20150106.100921,2864,10,1170294,0,2863,1086,2864,148,0
20150106.100927,2864,2,1170296,-2,2863,1108,2864,170,0
20150106.100929,2864,2,1170298,-2,2863,1108,2864,173,0
20150106.10093,2864,12,1170310,-6,2863,1105,2864,172,0
20150106.100931,2864,6,1170316,0,2863,1102,2864,170,0
20150106.100933,2864,2,1170318,0,2863,1102,2864,171,0
20150106.100937,2864,4,1170322,-4,2863,1117,2864,169,0
20150106.100939,2864,4,1170326,-4,2863,1117,2864,172,0
20150106.10094,2863,2,1170328,-2,2863,1134,2864,174,0
20150106.100941,2864,20,1170348,-20,2863,1134,2864,164,1
20150106.100942,2863,2,1170350,-2,2863,1133,2864,164,0
20150106.100943,2863,2,1170352,0,2863,1132,2864,172,0
20150106.100943,2863,2,1170354,-2,2863,1136,2864,172,0
20150106.100944,2864,2,1170356,0,2863,1136,2864,171,1
20150106.100951,2864,2,1170358,0,2863,1141,2864,174,1
20150106.100954,2863,86,1170444,0,2863,1108,2864,175,0
20150106.100957,2863,2,1170446,-2,2863,1107,2864,176,0
20150106.100958,2863,2,1170448,0,2863,1107,2864,177,0
20150106.100958,2864,6,1170454,-6,2863,1107,2864,174,1
20150106.101001,2863,6,1170460,0,2863,1104,2864,176,0
20150106.101003,2864,6,1170466,-4,2863,1102,2864,177,1
20150106.101004,2863,2,1170468,-2,2863,1101,2864,178,0
20150106.101006,2864,6,1170474,0,2863,1092,2864,196,1
20150106.101008,2863,2,1170476,-2,2863,1092,2864,199,0
20150106.10101,2863,2,1170478,-2,2863,1091,2864,249,0
20150106.101012,2863,2,1170480,0,2863,1089,2864,250,0
20150106.101017,2863,26,1170506,-24,2863,1079,2864,260,0
20150106.101018,2863,2,1170508,0,2863,1078,2864,261,0
20150106.101021,2864,10,1170518,-10,2863,1078,2864,316,1
20150106.101023,2864,2,1170520,-2,2863,1066,2864,295,1
20150106.101024,2863,2,1170522,-2,2863,1065,2864,319,0
20150106.101026,2864,22,1170544,0,2863,1064,2864,309,1
20150106.101027,2864,2,1170546,-2,2863,1064,2864,308,1
20150106.101032,2864,44,1170590,-40,2863,1065,2864,326,1
20150106.101035,2864,402,1170992,-162,2863,1068,2864,153,1
20150106.101036,2864,108,1171100,-40,2863,1015,2864,130,1
20150106.101037,2864,14,1171114,-2,2863,1015,2864,123,1
20150106.101038,2864,246,1171360,-116,2864,85,2865,1243,1
20150106.101039,2864,2,1171362,-2,2864,138,2865,1242,1
20150106.101041,2864,4,1171366,-4,2864,209,2865,1244,1
20150106.101042,2864,2,1171368,0,2864,208,2865,1246,1
20150106.101043,2864,2,1171370,0,2864,207,2865,1246,1
20150106.101043,2864,14,1171384,-14,2864,201,2865,1246,1
20150106.101044,2865,2,1171386,-2,2864,201,2865,1246,1
20150106.101046,2864,2,1171388,0,2864,202,2865,1253,0
20150106.101048,2865,34,1171422,-4,2864,202,2865,1234,1
20150106.10105,2865,8,1171430,0,2864,202,2865,1229,1
20150106.101052,2864,2,1171432,0,2864,209,2865,1230,0
20150106.101053,2865,4,1171436,4,2864,209,2865,1228,1
20150106.101054,2864,20,1171456,0,2864,199,2865,1233,0
20150106.101055,2864,2,1171458,-2,2864,198,2865,1733,0
20150106.101056,2864,2,1171460,0,2864,198,2865,1844,0
20150106.101058,2865,400,1171860,-250,2864,193,2865,1646,1
20150106.101059,2864,2,1171862,0,2864,193,2865,1646,0
20150106.1011,2864,386,1172248,-352,2863,1078,2864,309,0
20150106.101102,2863,4,1172252,-2,2863,1029,2864,308,0
20150106.101103,2864,100,1172352,-100,2863,1028,2864,259,1
20150106.101104,2863,4,1172356,-4,2863,1026,2864,269,0
20150106.101104,2864,2,1172358,0,2863,1026,2864,268,1
20150106.101106,2864,2,1172360,-2,2863,1026,2864,269,1
20150106.101107,2864,2,1172362,0,2863,1026,2864,269,1
20150106.101111,2864,20,1172382,0,2863,1048,2864,294,1
20150106.101117,2863,2,1172384,-2,2863,1053,2864,305,0
20150106.101118,2863,2,1172386,-2,2863,1052,2864,305,0
20150106.101121,2864,2,1172388,0,2863,1052,2864,305,1
20150106.101123,2864,4,1172392,0,2863,1051,2864,303,1
20150106.101124,2864,40,1172432,0,2863,1051,2864,284,1
20150106.101126,2864,2,1172434,-2,2863,1101,2864,283,1
20150106.101128,2863,10,1172444,-10,2863,1096,2864,288,0
20150106.10113,2863,2,1172446,-2,2863,1095,2864,288,0
20150106.10113,2864,2,1172448,0,2863,1095,2864,288,1
20150106.101131,2863,20,1172468,0,2863,1085,2864,331,0
20150106.101131,2864,20,1172488,0,2863,1085,2864,321,1
20150106.101132,2864,262,1172750,0,2863,1084,2864,191,1
20150106.101133,2864,16,1172766,-16,2863,1082,2864,189,1
20150106.101134,2864,206,1172972,30,2863,1079,2864,89,1
20150106.101135,2864,2,1172974,2,2863,1089,2864,88,1
20150106.101136,2863,8,1172982,-4,2863,1086,2864,87,0
20150106.101136,2864,2,1172984,2,2863,1086,2864,86,1
20150106.101138,2863,6,1172990,2,2863,1036,2864,85,0
20150106.101141,2863,2,1172992,-2,2863,1035,2864,98,0
20150106.101143,2864,2,1172994,2,2863,1020,2864,99,1
20150106.101144,2863,4,1172998,2,2863,1019,2864,99,0
20150106.101146,2864,2,1173000,2,2863,1019,2864,99,1
20150106.101147,2864,24,1173024,14,2863,1018,2864,93,1
20150106.101149,2863,8,1173032,-8,2863,1345,2864,192,0
20150106.101149,2863,144,1173176,-144,2863,1272,2864,192,0
20150106.10115,2863,224,1173400,-224,2863,1041,2864,194,0
20150106.10115,2863,362,1173762,-362,2863,662,2864,196,0
20150106.101151,2864,2,1173764,0,2863,662,2864,199,1
20150106.101152,2863,2,1173766,-2,2863,661,2864,198,0
20150106.101153,2863,2,1173768,0,2863,660,2864,198,0
20150106.101153,2863,42,1173810,-2,2863,639,2864,198,0
20150106.101155,2864,182,1173992,60,2863,639,2864,122,1
20150106.101156,2863,2,1173994,0,2863,638,2864,124,0
20150106.1012,2863,2,1173996,0,2863,639,2864,153,0
20150106.101201,2864,16,1174012,0,2863,639,2864,145,1
20150106.101202,2863,2,1174014,0,2863,639,2864,147,0
20150106.101202,2863,10,1174024,0,2863,634,2864,147,0
20150106.101205,2864,104,1174128,0,2863,632,2864,123,1
20150106.101206,2863,2,1174130,0,2863,632,2864,126,0
20150106.101209,2863,6,1174136,-4,2863,629,2864,146,0
20150106.101211,2863,8,1174144,0,2863,625,2864,189,0
20150106.101213,2864,40,1174184,0,2863,625,2864,174,1
20150106.101214,2863,2,1174186,-2,2863,624,2864,235,0
20150106.101217,2863,2,1174188,-2,2863,625,2864,242,0
20150106.10122,2864,22,1174210,0,2863,625,2864,236,1
20150106.101221,2863,2,1174212,0,2863,624,2864,236,0
20150106.101223,2863,2,1174214,0,2863,623,2864,239,0
20150106.101224,2863,4,1174218,-4,2863,621,2864,239,0
20150106.101227,2863,6,1174224,0,2863,618,2864,249,0
20150106.101228,2864,2,1174226,-2,2863,619,2864,249,1
20150106.10123,2864,12,1174238,0,2863,616,2864,249,1
20150106.101231,2863,2,1174240,0,2863,615,2864,249,0
20150106.101234,2864,2,1174242,0,2863,615,2864,253,1
20150106.101238,2864,16,1174258,8,2863,615,2864,255,1
20150106.10124,2863,8,1174266,-8,2863,611,2864,265,0
20150106.101241,2863,4,1174270,-2,2863,609,2864,290,0
20150106.101242,2864,2,1174272,0,2863,609,2864,289,1
20150106.101243,2864,2,1174274,2,2863,609,2864,324,1
20150106.101246,2864,18,1174292,8,2863,606,2864,320,1
20150106.101251,2864,6,1174298,-2,2863,604,2864,338,1
20150106.101252,2864,8,1174306,-4,2863,604,2864,335,1
20150106.101253,2864,4,1174310,0,2863,604,2864,333,1
20150106.101254,2863,20,1174330,-20,2863,591,2864,335,0
20150106.101255,2863,100,1174430,0,2863,538,2864,335,0
20150106.101256,2863,20,1174450,-20,2863,528,2864,336,0
20150106.101258,2863,2,1174452,-2,2863,527,2864,336,0
20150106.101258,2864,20,1174472,14,2863,527,2864,336,1
20150106.101301,2864,22,1174494,-22,2863,527,2864,326,1
20150106.101304,2864,2,1174496,0,2863,528,2864,327,1
20150106.101305,2863,4,1174500,0,2863,526,2864,327,0
20150106.101307,2864,2,1174502,0,2863,525,2864,331,1
20150106.101309,2864,6,1174508,0,2863,526,2864,328,1
20150106.10131,2864,4,1174512,-4,2863,526,2864,337,1
20150106.101311,2863,2,1174514,-2,2863,525,2864,337,0
20150106.101314,2864,2,1174516,0,2863,525,2864,336,1
20150106.101319,2863,2,1174518,0,2863,526,2864,345,0
20150106.101323,2864,20,1174538,2,2863,527,2864,342,1
20150106.101329,2864,2,1174540,-2,2863,538,2864,346,1
20150106.10133,2864,4,1174544,0,2863,538,2864,344,1
20150106.10133,2864,22,1174566,-20,2863,538,2864,334,1
20150106.101338,2863,122,1174688,-120,2863,493,2864,334,0
20150106.101341,2864,4,1174692,-2,2863,492,2864,334,1
20150106.101344,2863,6,1174698,0,2863,491,2864,334,0
20150106.101345,2863,6,1174704,-6,2863,490,2864,337,0
20150106.101346,2864,122,1174826,74,2863,489,2864,277,1
20150106.101351,2863,2,1174828,0,2863,498,2864,277,0
20150106.101359,2863,120,1174948,-120,2863,438,2864,289,0
20150106.101359,2863,6,1174954,-6,2863,435,2864,289,0
20150106.1014,2863,2,1174956,0,2863,434,2864,289,0
20150106.1014,2863,2,1174958,-2,2863,433,2864,287,0
20150106.101401,2863,238,1175196,-238,2863,364,2864,287,0
20150106.101402,2864,2,1175198,0,2863,364,2864,290,1
20150106.101402,2864,2,1175200,-2,2863,364,2864,289,1
20150106.101402,2863,24,1175224,-20,2863,352,2864,329,0
20150106.101404,2863,6,1175230,0,2863,349,2864,352,0
20150106.101404,2863,2,1175232,0,2863,348,2864,352,0
20150106.101406,2863,60,1175292,0,2863,318,2864,352,0
20150106.101407,2863,2,1175294,0,2863,317,2864,364,0
20150106.101408,2863,2,1175296,0,2863,316,2864,364,0
20150106.10141,2864,82,1175378,-74,2863,276,2864,376,1
20150106.101411,2864,16,1175394,-14,2863,276,2864,364,1
20150106.101414,2863,2,1175396,2,2863,272,2864,370,0
20150106.101415,2863,20,1175416,-6,2863,262,2864,370,0
20150106.101415,2863,20,1175436,20,2863,252,2864,370,0
20150106.101416,2863,2,1175438,2,2863,271,2864,382,0
20150106.101417,2863,26,1175464,-12,2863,258,2864,384,0
20150106.101418,2863,2,1175466,0,2863,257,2864,384,0
20150106.101419,2864,4,1175470,-4,2863,256,2864,398,1
20150106.10142,2863,2,1175472,-2,2863,255,2864,398,0
20150106.101421,2863,2,1175474,-2,2863,254,2864,409,0
20150106.101423,2863,4,1175478,0,2863,253,2864,413,0
20150106.101424,2863,62,1175540,38,2863,223,2864,415,0
20150106.101424,2863,2,1175542,0,2863,222,2864,415,0
20150106.101425,2863,10,1175552,10,2863,217,2864,415,0
20150106.101426,2863,20,1175572,20,2863,195,2864,415,0
20150106.101426,2863,2,1175574,0,2863,194,2864,417,0
20150106.101427,2863,4,1175578,0,2863,196,2864,416,0
20150106.101428,2863,4,1175582,2,2863,194,2864,420,0
20150106.101428,2863,2,1175584,0,2863,193,2864,420,0
20150106.101429,2864,2,1175586,0,2863,193,2864,419,1
20150106.10143,2863,2,1175588,2,2863,192,2864,419,0
20150106.101431,2863,2,1175590,2,2863,191,2864,419,0
20150106.101431,2863,120,1175710,-38,2863,131,2864,420,0
20150106.101433,2864,4,1175714,0,2863,274,2864,416,1
20150106.101434,2863,4,1175718,0,2863,272,2864,415,0
20150106.101435,2863,2,1175720,2,2863,271,2864,415,0
20150106.101436,2863,24,1175744,20,2863,259,2864,412,0
20150106.101437,2863,52,1175796,46,2863,233,2864,413,0
20150106.10144,2863,14,1175810,12,2863,227,2864,413,0
20150106.101447,2863,8,1175818,8,2863,226,2864,423,0
20150106.10145,2864,800,1176618,-322,2863,235,2864,28,1
20150106.101455,2864,10,1176628,-6,2863,263,2864,24,1
20150106.101456,2864,10,1176638,-6,2863,263,2864,17,1
20150106.101458,2864,2,1176640,-2,2863,263,2864,16,1
20150106.101459,2864,50,1176690,44,2863,239,2864,15,1
20150106.101459,2864,18,1176708,-14,2863,238,2865,2304,1
20150106.103,2863,478,1177186,408,2862,511,2863,168,0
20150106.103001,2861,3972,1181158,850,2860,1190,2861,125,0
20150106.103001,2860,238,1181396,-28,2860,1202,2861,313,0
20150106.103002,2861,240,1181636,-132,2860,1085,2861,216,1
20150106.103002,2860,300,1181936,-124,2860,1025,2861,131,0
20150106.103003,2860,304,1182240,-42,2860,1043,2861,12,0
20150106.103003,2860,108,1182348,-104,2861,180,2862,1967,0
20150106.103004,2861,8,1182356,-4,2861,287,2862,1968,1
20150106.103004,2861,2,1182358,-2,2861,404,2862,1968,1
20150106.103005,2861,12,1182370,0,2861,409,2862,2069,1
20150106.103005,2861,42,1182412,-12,2861,492,2862,2005,1
20150106.103006,2861,2,1182414,-2,2861,491,2862,2005,1
20150106.103006,2861,34,1182448,-30,2861,475,2862,2004,1
20150106.103007,2861,40,1182488,0,2861,455,2862,1914,1
20150106.103007,2861,26,1182514,0,2861,442,2862,1915,1
20150106.103008,2861,2,1182516,-2,2861,474,2862,1653,1
20150106.103008,2861,12,1182528,0,2861,468,2862,1638,1
20150106.103009,2861,24,1182552,-20,2861,459,2862,1637,1
20150106.10301,2861,56,1182608,4,2861,433,2862,1635,1
20150106.103011,2861,4,1182612,0,2861,431,2862,1641,1
20150106.103012,2861,10,1182622,-2,2861,426,2862,1638,1
20150106.103013,2861,6,1182628,-4,2861,494,2862,1563,1
20150106.103013,2861,2,1182630,0,2861,493,2862,1563,1
20150106.103014,2861,40,1182670,-36,2861,477,2862,1566,1
20150106.103015,2861,244,1182914,-32,2861,356,2862,1568,1
20150106.103016,2861,6,1182920,-6,2861,355,2862,1660,1
20150106.103017,2861,36,1182956,2,2861,338,2862,1662,1
20150106.103018,2861,24,1182980,-24,2861,327,2862,1662,1
20150106.103018,2861,6,1182986,0,2861,324,2862,1662,1
20150106.103018,2861,160,1183146,-160,2861,244,2862,1663,1
20150106.103019,2861,488,1183634,28,2860,850,2861,25,1
20150106.10302,2860,12,1183646,-12,2860,846,2861,130,0
20150106.10302,2860,2,1183648,0,2860,884,2861,142,0
20150106.103021,2861,2,1183650,0,2860,884,2861,150,1
20150106.103021,2861,24,1183674,0,2860,884,2861,238,1
20150106.103022,2861,28,1183702,-4,2860,870,2861,224,1
20150106.103023,2860,54,1183756,0,2860,843,2861,225,0
20150106.103023,2860,32,1183788,-30,2860,827,2861,231,0
20150106.103024,2860,12,1183800,0,2860,824,2861,285,0
20150106.103025,2861,2,1183802,0,2860,825,2861,289,1
20150106.103025,2860,12,1183814,-10,2860,819,2861,329,0
20150106.103026,2860,24,1183838,0,2860,807,2861,340,0
20150106.103027,2860,10,1183848,-10,2860,802,2861,367,0
20150106.103027,2860,20,1183868,-20,2860,792,2861,369,0
20150106.103028,2860,62,1183930,-44,2860,761,2861,371,0
20150106.103028,2860,70,1184000,-70,2860,726,2861,372,0
20150106.103029,2860,4,1184004,-2,2860,724,2861,372,0
20150106.103029,2860,4,1184008,-4,2860,724,2861,374,0
20150106.103032,2861,2,1184010,-2,2860,701,2861,481,1
20150106.103032,2860,2,1184012,-2,2860,700,2861,481,0
20150106.103033,2860,2,1184014,-2,2860,760,2861,481,0
20150106.103033,2860,1522,1185536,386,2859,312,2861,499,0
20150106.103034,2860,2,1185538,2,2859,254,2860,9,0
20150106.103035,2859,18,1185556,-10,2859,237,2860,39,0
20150106.103036,2860,6,1185562,0,2859,246,2860,154,1
20150106.103037,2859,200,1185762,-108,2859,144,2860,154,0
20150106.103037,2859,290,1186052,-60,2858,592,2859,359,0
20150106.103038,2859,782,1186834,-322,2858,583,2860,184,0
20150106.103039,2859,12,1186846,-8,2859,216,2860,185,0
20150106.103039,2859,4,1186850,0,2859,214,2860,190,0
20150106.103039,2859,42,1186892,-2,2859,199,2860,196,0
20150106.10304,2859,400,1187292,-398,2858,637,2859,304,0
20150106.10304,2858,12,1187304,2,2858,580,2859,308,0
20150106.103041,2858,62,1187366,-36,2858,511,2859,368,0
20150106.103042,2858,96,1187462,-92,2858,509,2859,348,0
20150106.103042,2858,12,1187474,-4,2858,474,2859,351,0
20150106.103043,2858,50,1187524,-12,2858,464,2859,343,0
20150106.103043,2858,8,1187532,0,2858,460,2859,343,0
20150106.103043,2858,22,1187554,-8,2858,458,2859,444,0
20150106.103044,2858,22,1187576,-14,2858,446,2859,451,0
20150106.103044,2858,12,1187588,-10,2858,476,2859,460,0
20150106.103045,2858,42,1187630,6,2858,455,2859,472,0
20150106.103046,2859,68,1187698,-68,2858,454,2859,440,1
20150106.103046,2859,980,1188678,-558,2859,81,2860,214,1
20150106.103047,2859,22,1188700,0,2859,70,2860,219,1
20150106.103047,2859,14,1188714,-2,2859,65,2860,219,1
20150106.103048,2859,22,1188736,-20,2859,75,2860,223,1
20150106.103048,2859,2,1188738,0,2859,74,2860,234,1
20150106.103049,2859,158,1188896,-154,2858,555,2859,422,1
20150106.103049,2859,2,1188898,0,2858,550,2859,428,1
20150106.10305,2859,30,1188928,-4,2858,651,2859,414,1
20150106.10305,2858,24,1188952,-12,2858,639,2859,406,0
20150106.103051,2858,6,1188958,6,2858,640,2859,406,0
20150106.103052,2859,6,1188964,-6,2858,650,2859,413,1
20150106.103052,2858,14,1188978,12,2858,649,2859,413,0
20150106.103053,2858,202,1189180,172,2858,572,2859,415,0
20150106.103054,2858,40,1189220,0,2858,561,2859,418,0
20150106.103054,2858,1010,1190230,-658,2857,188,2859,418,0
20150106.103055,2858,8,1190238,-2,2857,573,2859,421,0
20150106.103056,2858,36,1190274,-2,2857,570,2859,453,0
20150106.103056,2858,50,1190324,-10,2857,580,2859,454,0
20150106.103057,2858,8,1190332,0,2858,22,2859,458,0
20150106.103058,2858,6,1190338,0,2858,19,2859,458,0
20150106.103058,2858,24,1190362,0,2858,7,2859,458,0
20150106.103059,2858,124,1190486,-18,2857,595,2858,847,0
20150106.103059,2858,104,1190590,-2,2857,552,2858,809,0
20150106.1031,2857,4,1190594,0,2857,591,2858,808,0
20150106.1031,2858,272,1190866,-226,2857,561,2858,728,1
20150106.1031,2857,510,1191376,-2,2857,571,2858,476,0
20150106.103101,2858,12,1191388,-10,2857,587,2858,476,1
20150106.103102,2858,6,1191394,-2,2857,587,2858,473,1
20150106.103102,2858,4,1191398,2,2857,688,2858,471,1
20150106.103103,2858,944,1192342,-90,2858,601,2859,650,1
20150106.103103,2859,18,1192360,-12,2858,599,2859,587,1
20150106.103104,2858,14,1192374,-2,2858,603,2859,592,0
20150106.103104,2858,4,1192378,-4,2858,608,2859,586,0
20150106.103104,2858,2,1192380,-2,2858,608,2859,586,0
20150106.103105,2858,1072,1193452,-1048,2858,79,2859,586,0
20150106.103106,2858,2,1193454,0,2858,105,2859,597,0
20150106.103106,2858,140,1193594,-72,2858,51,2859,593,0
20150106.103107,2858,4,1193598,-2,2858,51,2859,592,0
20150106.103107,2858,20,1193618,8,2858,49,2859,593,0
20150106.103107,2858,12,1193630,10,2858,47,2859,599,0
20150106.103108,2858,32,1193662,28,2858,33,2859,599,0
20150106.103109,2858,4,1193666,-2,2858,40,2859,599,0
20150106.103109,2858,78,1193744,4,2857,981,2858,66,0
20150106.10311,2858,6,1193750,-4,2857,933,2858,66,0
20150106.10311,2858,8,1193758,-2,2857,934,2858,73,0
20150106.103111,2858,160,1193918,-42,2858,974,2859,692,0
20150106.103111,2859,256,1194174,-54,2858,868,2859,623,1
20150106.103112,2858,214,1194388,-214,2858,807,2859,623,0
20150106.103112,2858,402,1194790,0,2858,629,2859,623,0
20150106.103113,2858,10,1194800,-10,2858,625,2859,623,0
20150106.103113,2858,6,1194806,0,2858,626,2859,624,0
20150106.103114,2858,2,1194808,0,2858,622,2859,629,0
20150106.103114,2858,12,1194820,0,2858,623,2859,737,0
20150106.103116,2858,1010,1195830,-1006,2858,109,2859,746,0
20150106.103116,2858,20,1195850,-4,2858,101,2859,746,0
20150106.103117,2858,202,1196052,122,2857,1066,2859,756,0
20150106.103117,2858,2,1196054,0,2858,24,2859,756,0
20150106.103118,2858,118,1196172,44,2857,1016,2858,19,0
20150106.103118,2858,44,1196216,32,2858,2,2859,813,0
20150106.103119,2858,28,1196244,-8,2857,1006,2858,489,0
20150106.10312,2858,2,1196246,0,2857,1006,2858,498,0
20150106.10312,2858,4,1196250,0,2857,1011,2858,497,0
20150106.103121,2858,108,1196358,-108,2857,1011,2858,443,0
20150106.103122,2857,4,1196362,0,2857,1005,2858,563,0
20150106.103122,2858,76,1196438,-72,2857,1001,2858,547,1
20150106.103123,2858,2,1196440,-2,2857,1009,2858,555,1
20150106.103124,2858,10,1196450,-4,2857,1015,2858,588,1
20150106.103125,2857,42,1196492,6,2857,994,2858,597,0
20150106.103125,2858,12,1196504,-2,2857,898,2858,591,1
20150106.103126,2858,8,1196512,-6,2857,897,2858,589,1
20150106.103126,2858,2,1196514,-2,2857,918,2858,650,1
20150106.103128,2858,100,1196614,-100,2857,920,2858,600,1
20150106.103128,2858,40,1196654,-40,2857,920,2858,591,1
20150106.103129,2857,2,1196656,0,2857,919,2858,640,0
20150106.103129,2858,20,1196676,-20,2857,919,2858,630,1
20150106.103129,2858,2,1196678,-2,2857,919,2858,730,1
20150106.103131,2858,2,1196680,-2,2857,932,2858,729,1
20150106.103131,2858,14,1196694,0,2857,927,2858,719,1
20150106.103132,2858,4,1196698,-2,2857,956,2858,718,1
20150106.103132,2857,18,1196716,-18,2857,948,2858,719,0
20150106.103133,2858,10,1196726,-10,2857,955,2858,714,1
20150106.103134,2857,24,1196750,-16,2857,944,2858,718,0
20150106.103135,2858,1006,1197756,-764,2857,941,2858,224,1
20150106.103135,2858,456,1198212,40,2858,97,2859,705,1
20150106.103136,2859,2,1198214,0,2858,79,2859,659,1
20150106.103136,2857,248,1198462,-134,2857,1000,2858,429,0
20150106.103138,2858,6,1198468,0,2857,952,2858,432,1
20150106.103139,2858,918,1199386,-748,2858,98,2859,705,1
20150106.103139,2858,4,1199390,0,2858,97,2859,657,1
20150106.10314,2858,38,1199428,0,2858,102,2859,640,1
20150106.10314,2859,4,1199432,-4,2858,123,2859,639,1
20150106.103142,2858,6,1199438,-6,2858,221,2859,646,0
20150106.103142,2858,6,1199444,0,2858,221,2859,646,0
20150106.103143,2858,518,1199962,-186,2857,891,2858,293,0
20150106.103144,2858,28,1199990,-18,2857,842,2858,280,0
20150106.103144,2858,4,1199994,0,2857,844,2858,351,0
20150106.103145,2858,32,1200026,0,2857,834,2858,346,0
20150106.103145,2857,8,1200034,0,2857,833,2858,345,0
20150106.103146,2858,6,1200040,-2,2857,832,2858,373,1
20150106.103146,2858,4,1200044,-4,2857,835,2858,372,1
20150106.103147,2857,14,1200058,-12,2857,839,2858,400,0
20150106.103147,2857,2,1200060,0,2857,838,2858,409,0
20150106.103148,2857,216,1200276,-48,2857,731,2858,408,0
20150106.103148,2857,402,1200678,-278,2857,532,2858,413,0
20150106.103149,2858,890,1201568,-660,2858,57,2859,755,1
20150106.10315,2858,12,1201580,-4,2858,61,2859,752,1
20150106.10315,2858,32,1201612,0,2858,47,2859,752,1
20150106.103151,2858,32,1201644,-22,2858,34,2859,752,1
20150106.103151,2858,70,1201714,-46,2857,647,2858,2,1
20150106.103151,2858,2,1201716,0,2857,601,2858,227,1
20150106.103152,2857,2,1201718,-2,2857,605,2858,278,0
20150106.103153,2857,1674,1203392,-1304,2857,335,2858,2,0
20150106.103154,2857,44,1203436,-20,2857,279,2858,4,0
20150106.103155,2858,216,1203652,164,2857,204,2858,129,1
20150106.103156,2858,12,1203664,-4,2857,205,2858,178,1
20150106.103157,2857,428,1204092,-136,2856,475,2857,292,0
20150106.103157,2857,10,1204102,-8,2856,476,2857,287,0
20150106.103158,2857,12,1204114,-12,2856,488,2857,282,0
20150106.103159,2857,8,1204122,-4,2856,489,2857,278,0
20150106.103159,2856,4,1204126,4,2856,488,2857,280,0
20150106.1032,2857,1002,1205128,-754,2857,52,2858,197,1
20150106.103201,2858,76,1205204,-26,2857,178,2858,193,1
20150106.103202,2858,1438,1206642,-876,2857,136,2858,72,1
20150106.103203,2857,16,1206658,2,2857,151,2858,125,0
20150106.103204,2857,8,1206666,8,2857,151,2858,139,0
20150106.103204,2857,20,1206686,20,2857,191,2858,139,0
20150106.103205,2858,304,1206990,-116,2858,381,2859,760,1
20150106.103205,2857,764,1207754,-758,2857,354,2858,171,0
20150106.103207,2858,6,1207760,-4,2857,659,2858,195,1
20150106.103207,2858,8,1207768,-8,2857,711,2858,192,1
20150106.103208,2858,4,1207772,0,2857,718,2858,190,1
20150106.103209,2857,4,1207776,2,2857,776,2858,396,0
20150106.10321,2857,2,1207778,0,2857,737,2858,408,0
20150106.103212,2857,1614,1209392,-532,2856,651,2857,50,0
20150106.103212,2857,6,1209398,2,2856,665,2857,48,0
20150106.103213,2857,1210,1210608,-354,2857,32,2858,159,0
20150106.103213,2857,10,1210618,-4,2857,28,2858,181,0
20150106.103214,2858,4,1210622,4,2857,28,2858,199,1
20150106.103214,2857,12,1210634,0,2857,136,2858,287,0
20150106.103215,2858,1030,1211664,-302,2857,192,2858,5,1
20150106.103215,2857,4,1211668,0,2857,274,2858,4,0
20150106.103216,2858,8,1211676,0,2857,596,2858,4,1
20150106.103217,2858,8,1211684,-2,2857,634,2858,12,1
20150106.103217,2857,14,1211698,6,2857,671,2858,11,0
20150106.103218,2858,22,1211720,0,2858,550,2859,797,1
20150106.103218,2858,24,1211744,-2,2858,542,2859,847,1
20150106.103219,2859,410,1212154,-400,2858,343,2859,841,1
20150106.103219,2858,704,1212858,-676,2857,770,2858,151,0
20150106.10322,2858,4,1212862,-2,2857,759,2858,200,0
20150106.103221,2857,208,1213070,178,2857,678,2858,212,0
20150106.103221,2858,102,1213172,-70,2857,678,2858,167,1
20150106.103222,2857,2,1213174,2,2857,678,2858,220,0
20150106.103223,2858,14,1213188,-8,2857,679,2858,236,1
20150106.103224,2858,526,1213714,-212,2858,290,2859,983,1
20150106.103225,2858,602,1214316,-600,2857,697,2858,36,1
20150106.103226,2858,20,1214336,0,2857,697,2858,78,1
20150106.103226,2858,12,1214348,-10,2857,703,2858,72,1
20150106.103227,2858,90,1214438,46,2857,712,2858,31,1
20150106.103228,2858,94,1214532,-16,2858,506,2859,507,1
20150106.103228,2858,12,1214544,0,2858,803,2859,507,1
20150106.103229,2859,36,1214580,12,2858,804,2859,501,1
20150106.10323,2858,2,1214582,0,2858,804,2859,502,0
20150106.10323,2859,2,1214584,0,2858,812,2859,503,1
20150106.103231,2858,2,1214586,0,2858,815,2859,503,0
20150106.103232,2858,2,1214588,0,2858,818,2859,503,0
20150106.103233,2858,20,1214608,-20,2858,808,2859,503,0
20150106.103234,2859,2,1214610,2,2858,819,2859,526,1
20150106.103235,2859,6,1214616,2,2858,820,2859,521,1
20150106.103237,2859,100,1214716,0,2858,823,2859,519,1
20150106.103238,2858,12,1214728,-6,2858,819,2859,525,0
20150106.103238,2859,2,1214730,0,2858,835,2859,525,1
20150106.103239,2859,2,1214732,2,2858,836,2859,530,1
20150106.103239,2859,2,1214734,0,2858,838,2859,532,1
20150106.10324,2859,20,1214754,0,2858,842,2859,533,1
20150106.103241,2858,2,1214756,-2,2858,842,2859,549,0
20150106.103242,2858,2,1214758,0,2858,842,2859,551,0
20150106.103243,2858,606,1215364,-128,2858,842,2859,243,0
20150106.103244,2859,6,1215370,2,2858,843,2859,241,1
20150106.103244,2859,40,1215410,12,2858,837,2859,226,1
20150106.103245,2859,30,1215440,28,2858,837,2859,211,1
20150106.103246,2859,34,1215474,34,2858,839,2859,187,1
20150106.103246,2859,40,1215514,0,2858,840,2859,174,1
20150106.103247,2859,366,1215880,-148,2859,179,2860,311,1
20150106.103247,2859,4,1215884,-2,2859,179,2860,311,1
20150106.103248,2859,4,1215888,0,2859,182,2860,314,1
20150106.103249,2859,2,1215890,0,2859,181,2860,315,1
20150106.103249,2859,6,1215896,-4,2859,182,2860,314,1
20150106.10325,2860,4,1215900,4,2859,184,2860,313,1
20150106.10325,2860,4,1215904,2,2859,188,2860,312,1
20150106.103252,2859,2,1215906,0,2859,188,2860,381,0
20150106.103253,2860,68,1215974,12,2859,175,2860,377,1
20150106.103253,2859,4,1215978,-2,2859,173,2860,389,0
20150106.103254,2859,2,1215980,0,2859,172,2860,391,0
20150106.103254,2860,2,1215982,0,2859,172,2860,390,1
20150106.103255,2859,12,1215994,0,2859,167,2860,389,0
20150106.103256,2859,4,1215998,-4,2859,168,2860,393,0
20150106.103258,2860,34,1216032,-30,2859,153,2860,456,1
20150106.103258,2860,4,1216036,2,2859,153,2860,457,1
20150106.1033,2859,14,1216050,0,2859,149,2860,458,0
20150106.103301,2860,22,1216072,2,2859,139,2860,486,1
20150106.103302,2860,2,1216074,2,2859,142,2860,486,1
20150106.103302,2860,2,1216076,2,2859,143,2860,490,1
20150106.103306,2859,2,1216078,-2,2859,153,2860,513,0
20150106.103306,2860,2,1216080,0,2859,153,2860,572,1
20150106.103307,2859,4,1216084,-2,2859,151,2860,567,0
20150106.103308,2859,2,1216086,0,2859,151,2860,578,0
20150106.103309,2860,1172,1217258,-236,2860,470,2861,257,1
20150106.103309,2860,2,1217260,0,2860,471,2861,136,1
20150106.103311,2860,4,1217264,0,2860,482,2861,137,1
20150106.103312,2861,40,1217304,2,2860,483,2861,115,1
20150106.103313,2861,34,1217338,-16,2860,478,2861,102,1
20150106.103313,2860,646,1217984,0,2860,158,2861,99,0
20150106.103314,2861,2,1217986,2,2860,160,2861,236,1
20150106.103314,2860,14,1218000,-6,2860,141,2861,301,0
20150106.103315,2861,2,1218002,0,2860,139,2861,312,1
20150106.103315,2860,10,1218012,-8,2860,134,2861,311,0
20150106.103316,2860,268,1218280,-164,2859,213,2860,51,0
20150106.103316,2859,52,1218332,-6,2859,277,2860,29,0
20150106.103317,2860,2,1218334,0,2859,378,2860,71,1
20150106.103318,2859,2,1218336,-2,2859,381,2860,81,0
20150106.103319,2859,2,1218338,-2,2859,382,2860,83,0
20150106.103319,2860,4,1218342,0,2859,380,2860,87,1
20150106.10332,2859,2,1218344,-2,2859,379,2860,94,0
20150106.103322,2859,2,1218346,-2,2859,374,2860,299,0
20150106.103322,2859,20,1218366,0,2859,366,2860,310,0
20150106.103324,2859,6,1218372,-2,2859,363,2860,310,0
20150106.103324,2860,2,1218374,0,2859,363,2860,311,1
20150106.103324,2860,6,1218380,0,2859,363,2860,309,1
20150106.103325,2860,2,1218382,0,2859,364,2860,313,1
20150106.103326,2859,2,1218384,-2,2859,362,2860,314,0
20150106.103327,2859,4,1218388,-2,2859,362,2860,321,0
20150106.103328,2859,2,1218390,-2,2859,469,2860,322,0
20150106.103328,2859,6,1218396,-6,2859,467,2860,325,0
20150106.10333,2859,4,1218400,-4,2859,448,2860,361,0
20150106.103332,2859,2,1218402,0,2859,458,2860,395,0
20150106.103333,2860,22,1218424,0,2859,458,2860,414,1
20150106.103334,2859,30,1218454,-30,2859,443,2860,413,0
20150106.103336,2860,202,1218656,-44,2859,447,2860,320,1
20150106.103337,2859,2,1218658,0,2859,452,2860,320,0
20150106.103342,2859,100,1218758,0,2859,417,2860,341,0
20150106.103344,2859,30,1218788,-2,2859,402,2860,349,0
20150106.103344,2859,2,1218790,0,2859,401,2860,366,0
20150106.103345,2859,2,1218792,0,2859,400,2860,365,0
20150106.103349,2859,4,1218796,0,2859,399,2860,367,0
20150106.10335,2859,2,1218798,2,2859,398,2860,366,0
20150106.10335,2859,6,1218804,2,2859,397,2860,369,0
20150106.103351,2859,22,1218826,10,2859,392,2860,368,0
20150106.103352,2860,16,1218842,16,2859,390,2860,362,1
20150106.103352,2859,2,1218844,2,2859,389,2860,362,0
20150106.103353,2859,22,1218866,-2,2859,378,2860,366,0
20150106.103354,2859,2,1218868,2,2859,377,2860,337,0
20150106.103357,2860,16,1218884,0,2859,380,2860,334,1
20150106.103359,2860,600,1219484,496,2859,381,2860,35,1
20150106.103359,2860,2,1219486,0,2859,381,2860,46,1
20150106.103403,2860,218,1219704,160,2859,386,2860,13,1
20150106.103404,2860,2,1219706,0,2859,398,2860,16,1
20150106.103405,2860,2,1219708,2,2859,398,2860,35,1
20150106.103406,2860,8,1219716,-4,2859,399,2860,36,1
20150106.103409,2860,4,1219720,0,2859,499,2860,41,1
20150106.10341,2860,2,1219722,-2,2859,500,2860,42,1
20150106.10341,2860,2,1219724,-2,2859,499,2860,40,1
20150106.10341,2859,2,1219726,0,2859,499,2860,40,0
20150106.103412,2860,2,1219728,0,2859,514,2860,46,1
20150106.103413,2860,6,1219734,2,2859,514,2860,44,1
20150106.103416,2859,2,1219736,2,2859,515,2860,75,0
20150106.103418,2860,2,1219738,0,2859,516,2860,91,1
20150106.10342,2859,12,1219750,10,2859,513,2860,94,0
20150106.103424,2860,2,1219752,0,2859,812,2860,91,1
20150106.103426,2859,10,1219762,8,2859,807,2860,91,0
20150106.103428,2860,190,1219952,164,2860,157,2861,420,1
20150106.103428,2860,10,1219962,6,2860,182,2861,410,1
20150106.103429,2860,2,1219964,2,2860,181,2861,404,1
20150106.103432,2860,2,1219966,2,2860,191,2861,314,1
20150106.103433,2860,2,1219968,2,2860,193,2861,319,1
20150106.103435,2860,2,1219970,2,2860,203,2861,334,1
20150106.103436,2860,40,1220010,40,2860,183,2861,334,1
20150106.103437,2860,4,1220014,4,2860,181,2861,334,1
20150106.103437,2860,20,1220034,20,2860,171,2861,334,1
20150106.103439,2860,2,1220036,2,2860,286,2861,364,1
20150106.10344,2860,4,1220040,4,2860,284,2861,364,1
20150106.103441,2860,2,1220042,2,2860,283,2861,364,1
20150106.103441,2860,100,1220142,0,2860,233,2861,364,1
20150106.103442,2861,2,1220144,2,2860,232,2861,363,1
20150106.103444,2861,2,1220146,2,2860,233,2861,362,1
20150106.103444,2860,2,1220148,2,2860,232,2861,366,0
20150106.103448,2860,6,1220154,6,2860,279,2861,386,0
20150106.103449,2860,50,1220204,48,2860,254,2861,387,0
20150106.103451,2860,2,1220206,2,2860,315,2861,415,0
20150106.103452,2860,2,1220208,2,2860,314,2861,416,0
20150106.103452,2860,530,1220738,240,2860,50,2861,417,0
20150106.103453,2860,100,1220838,-94,2859,809,2860,65,0
20150106.103453,2860,2,1220840,0,2859,805,2860,165,0
20150106.103454,2860,32,1220872,-28,2859,804,2860,153,0
20150106.103458,2860,4,1220876,-4,2859,808,2860,167,0
20150106.103458,2859,48,1220924,-26,2859,791,2860,167,0
20150106.1035,2859,586,1221510,252,2859,503,2860,180,0
20150106.103502,2860,20,1221530,0,2859,503,2860,174,1
20150106.103502,2860,22,1221552,0,2859,493,2860,175,1
20150106.103504,2859,4,1221556,0,2859,492,2860,178,0
20150106.103506,2860,4,1221560,-4,2859,492,2860,193,1
20150106.103507,2860,48,1221608,-18,2859,546,2860,214,1
20150106.103507,2860,4,1221612,2,2859,492,2860,213,1
20150106.103511,2860,2,1221614,2,2859,492,2860,192,1
20150106.103511,2859,40,1221654,0,2859,473,2860,194,0
20150106.103514,2860,10,1221664,2,2859,476,2860,201,1
20150106.103515,2860,8,1221672,-2,2859,477,2860,197,1
20150106.103515,2859,2,1221674,0,2859,475,2860,197,0
20150106.103517,2860,2,1221676,0,2859,475,2860,198,1
20150106.10352,2859,2,1221678,-2,2859,473,2860,237,0
20150106.10352,2860,2,1221680,0,2859,473,2860,237,1
20150106.103521,2859,4,1221684,0,2859,471,2860,240,0
20150106.103523,2860,2,1221686,0,2859,471,2860,243,1
20150106.103524,2860,2,1221688,0,2859,471,2860,242,1
20150106.103524,2859,2,1221690,-2,2859,471,2860,242,0
20150106.103529,2859,10,1221700,0,2859,466,2860,251,0
20150106.103537,2859,30,1221730,-30,2859,460,2860,261,0
20150106.10354,2859,2,1221732,-2,2859,460,2860,271,0
20150106.10354,2859,6,1221738,0,2859,457,2860,773,0
20150106.103541,2859,2,1221740,0,2859,456,2860,773,0
20150106.103542,2859,8,1221748,0,2859,455,2860,775,0
20150106.103544,2859,6,1221754,-6,2859,453,2860,775,0
20150106.103545,2860,42,1221796,-40,2859,433,2860,773,1
20150106.103549,2859,2,1221798,0,2859,432,2860,797,0
20150106.103549,2859,140,1221938,4,2859,362,2860,799,0
20150106.103551,2859,2,1221940,0,2859,361,2860,801,0
20150106.103551,2859,2,1221942,0,2859,360,2860,801,0
20150106.103552,2859,2,1221944,0,2859,359,2860,801,0
20150106.103554,2859,718,1222662,-60,2858,1049,2859,173,0
20150106.103555,2858,2,1222664,-2,2858,900,2859,176,0
20150106.103556,2858,2,1222666,0,2858,899,2859,178,0
20150106.103556,2859,10,1222676,-4,2858,913,2859,174,1
20150106.103556,2858,4,1222680,-2,2858,911,2859,174,0
20150106.103557,2858,4,1222684,0,2858,909,2859,174,0
20150106.103558,2858,2,1222686,-2,2858,909,2859,174,0
20150106.103558,2858,100,1222786,0,2858,860,2859,174,0
20150106.103559,2858,10,1222796,0,2858,855,2859,177,0
20150106.103559,2858,2,1222798,0,2858,855,2859,177,0
20150106.103601,2858,2,1222800,-2,2858,853,2859,178,0
20150106.103603,2858,4,1222804,-2,2858,851,2859,393,0
20150106.103604,2858,2,1222806,-2,2858,851,2859,395,0
20150106.103604,2859,798,1223604,-704,2859,656,2860,806,1
20150106.103606,2859,2,1223606,0,2859,658,2860,809,1
20150106.103608,2859,8,1223614,0,2859,656,2860,812,1
20150106.10361,2859,2,1223616,0,2859,655,2860,813,1
20150106.10361,2860,28,1223644,-28,2859,654,2860,801,1
20150106.103611,2860,12,1223656,-12,2859,654,2860,795,1
20150106.103611,2859,100,1223756,0,2859,634,2860,798,0
20150106.103612,2859,4,1223760,0,2859,632,2860,958,0
20150106.103612,2859,2,1223762,0,2859,632,2860,955,0
20150106.103614,2859,2,1223764,0,2859,636,2860,956,0
20150106.103615,2859,8,1223772,-2,2859,632,2860,948,0
20150106.103616,2859,10,1223782,0,2859,638,2860,936,0
20150106.103617,2859,2,1223784,0,2859,638,2860,946,0
20150106.103618,2859,2,1223786,-2,2859,637,2860,946,0
20150106.103619,2859,20,1223806,0,2859,630,2860,947,0
20150106.103624,2860,2,1223808,0,2859,632,2860,946,1
20150106.103625,2860,4,1223812,-4,2859,638,2860,949,1
20150106.103629,2859,2,1223814,0,2859,651,2860,967,0
20150106.10363,2859,2,1223816,-2,2859,650,2860,967,0
20150106.103637,2860,10,1223826,0,2859,662,2860,959,1
20150106.103641,2860,2,1223828,0,2859,678,2860,979,1
20150106.103644,2860,14,1223842,0,2859,684,2860,982,1
20150106.103645,2859,10,1223852,0,2859,679,2860,982,0
20150106.103646,2860,2,1223854,0,2859,691,2860,982,1
20150106.103647,2859,2,1223856,0,2859,690,2860,982,0
20150106.103648,2859,2,1223858,0,2859,689,2860,983,0
20150106.103652,2860,4,1223862,0,2859,690,2860,986,1
20150106.103652,2860,2,1223864,0,2859,690,2860,985,1
20150106.103653,2859,4,1223868,-2,2859,688,2860,985,0
20150106.103654,2859,12,1223880,0,2859,692,2860,988,0
20150106.103655,2859,2,1223882,0,2859,692,2860,988,0
20150106.103658,2859,10,1223892,0,2859,693,2860,988,0
20150106.103659,2859,4,1223896,-2,2859,682,2860,987,0
20150106.1037,2859,4,1223900,0,2859,680,2860,987,0
20150106.103702,2859,200,1224100,-200,2859,580,2860,986,0
20150106.103703,2859,2,1224102,0,2859,579,2860,989,0
20150106.103703,2859,8,1224110,-8,2859,575,2860,989,0
20150106.103706,2859,402,1224512,0,2859,374,2860,989,0
20150106.103708,2859,2,1224514,0,2859,373,2860,989,0
20150106.103708,2859,6,1224520,-2,2859,370,2860,986,0
20150106.103709,2859,2,1224522,0,2859,369,2860,986,0
20150106.10371,2859,2,1224524,-2,2859,368,2860,986,0
20150106.103711,2859,10,1224534,0,2859,364,2860,986,0
20150106.103712,2859,8,1224542,-6,2859,363,2860,983,0
20150106.103713,2860,10,1224552,-10,2859,353,2860,975,1
20150106.103713,2859,2,1224554,-2,2859,352,2860,975,0
20150106.103715,2859,2,1224556,0,2859,351,2860,965,0
20150106.103715,2859,4,1224560,-4,2859,349,2860,965,0
20150106.103717,2859,26,1224586,-26,2859,336,2860,965,0
20150106.103719,2859,6,1224592,-4,2859,353,2860,963,0
20150106.103721,2859,6,1224598,0,2859,352,2860,955,0
20150106.103722,2859,2,1224600,-2,2859,351,2860,955,0
20150106.103723,2859,4,1224604,-4,2859,349,2860,955,0
20150106.103728,2859,20,1224624,-2,2859,350,2860,982,0
20150106.103729,2859,22,1224646,-20,2859,350,2860,973,0
20150106.103729,2859,2,1224648,-2,2859,349,2860,979,0
20150106.10373,2859,6,1224654,-2,2859,346,2860,979,0
20150106.10373,2859,2,1224656,-2,2859,345,2860,979,0
20150106.103732,2859,4,1224660,-4,2859,345,2860,976,0
20150106.103733,2859,4,1224664,-4,2859,344,2860,976,0
20150106.103733,2859,6,1224670,-4,2859,341,2860,974,0
20150106.103734,2859,4,1224674,0,2859,339,2860,974,0
20150106.103734,2859,20,1224694,-20,2859,329,2860,974,0
20150106.103735,2860,4,1224698,0,2859,336,2860,974,1
20150106.103736,2859,2,1224700,0,2859,334,2860,974,0
20150106.103737,2859,20,1224720,-20,2859,324,2860,974,0
20150106.103738,2859,2,1224722,-2,2859,323,2860,974,0
20150106.103739,2859,10,1224732,-6,2859,323,2860,1000,0
20150106.103742,2859,2,1224734,-2,2859,324,2860,1001,0
20150106.103742,2859,2,1224736,0,2859,323,2860,1001,0
20150106.103744,2859,14,1224750,0,2859,313,2860,1001,0
20150106.103746,2859,2,1224752,-2,2859,312,2860,1000,0
20150106.103749,2860,2,1224754,-2,2859,311,2860,1026,1
20150106.103749,2859,2,1224756,0,2859,310,2860,1028,0
20150106.103752,2860,2,1224758,0,2859,311,2860,1030,1
20150106.103752,2859,2,1224760,0,2859,313,2860,1029,0
20150106.103758,2859,10,1224770,0,2859,323,2860,1014,0
20150106.103801,2860,6,1224776,-6,2859,324,2860,1010,1
20150106.103807,2859,2,1224778,0,2859,376,2860,1020,0
20150106.103809,2859,6,1224784,-4,2859,434,2860,1020,0
20150106.103811,2859,26,1224810,0,2859,421,2860,1036,0
20150106.103812,2859,2,1224812,0,2859,420,2860,1037,0
20150106.103814,2859,2,1224814,0,2859,419,2860,1043,0
20150106.103814,2859,2,1224816,-2,2859,418,2860,1038,0
20150106.103817,2860,200,1225016,-112,2859,421,2860,948,1
20150106.103817,2860,8,1225024,4,2859,425,2860,945,1
20150106.103819,2859,2,1225026,-2,2859,425,2860,945,0
20150106.103821,2859,10,1225036,0,2859,430,2860,945,0
20150106.103822,2859,20,1225056,0,2859,420,2860,946,0
20150106.103829,2859,16,1225072,0,2859,419,2860,952,0
20150106.10383,2859,600,1225672,74,2859,123,2860,952,0
20150106.10383,2859,244,1225916,-58,2858,912,2859,182,0
20150106.103831,2859,24,1225940,0,2858,899,2859,177,0
20150106.103833,2859,10,1225950,6,2858,899,2859,180,0
20150106.103837,2858,2,1225952,-2,2858,894,2859,287,0
20150106.103838,2859,2,1225954,2,2858,894,2859,288,1
20150106.103844,2858,2,1225956,-2,2858,894,2859,303,0
20150106.103846,2858,10,1225966,0,2858,893,2859,302,0
20150106.10385,2858,2,1225968,-2,2858,890,2859,322,0
20150106.103851,2858,20,1225988,0,2858,890,2859,325,0
20150106.103852,2858,2,1225990,-2,2858,891,2859,324,0
20150106.103855,2859,2,1225992,2,2858,1091,2859,327,1
20150106.103857,2859,656,1226648,-154,2859,366,2860,1000,1
20150106.103857,2859,124,1226772,-124,2859,354,2860,953,1
20150106.103858,2859,6,1226778,-4,2859,351,2860,953,1
20150106.103858,2859,24,1226802,14,2859,351,2860,936,1
20150106.1039,2859,2,1226804,0,2859,375,2860,936,1
20150106.103901,2859,10,1226814,0,2859,370,2860,936,1
20150106.103901,2859,2,1226816,0,2859,369,2860,938,1
20150106.103904,2859,2,1226818,-2,2859,370,2860,932,1
20150106.103907,2860,2,1226820,0,2859,370,2860,931,1
20150106.103908,2859,2,1226822,0,2859,369,2860,932,0
20150106.103909,2859,4,1226826,-4,2859,370,2860,933,0
20150106.103913,2859,4,1226830,2,2859,371,2860,932,0
20150106.103914,2859,10,1226840,0,2859,368,2860,932,0
20150106.103917,2859,208,1227048,-4,2859,264,2860,952,0
20150106.103918,2859,30,1227078,0,2859,249,2860,961,0
20150106.10392,2859,8,1227086,0,2859,257,2860,967,0
20150106.103921,2859,18,1227104,-16,2859,248,2860,968,0
20150106.103922,2859,4,1227108,-4,2859,246,2860,968,0
20150106.103923,2859,26,1227134,-26,2859,233,2860,968,0
20150106.103924,2859,244,1227378,72,2859,114,2860,968,0
20150106.103924,2859,14,1227392,12,2859,114,2860,963,0
20150106.103925,2859,12,1227404,12,2859,108,2860,963,0
20150106.103925,2860,4,1227408,0,2859,108,2860,961,1
20150106.103926,2859,2,1227410,2,2859,107,2860,961,0
20150106.103927,2859,10,1227420,10,2859,104,2860,961,0
20150106.103927,2859,20,1227440,0,2859,94,2860,961,0
20150106.103927,2859,2,1227442,0,2859,94,2860,961,0
20150106.103928,2859,2,1227444,0,2859,95,2860,961,0
20150106.103929,2859,190,1227634,94,2858,980,2859,77,0
20150106.103929,2859,2,1227636,0,2858,981,2859,77,0
20150106.10393,2859,14,1227650,2,2858,981,2859,77,0
20150106.103932,2858,2,1227652,0,2858,945,2859,88,0
20150106.103936,2858,100,1227752,0,2858,855,2859,159,0
20150106.103937,2859,10,1227762,0,2858,859,2859,164,1
20150106.103937,2858,40,1227802,0,2858,839,2859,144,0
20150106.103938,2859,10,1227812,0,2858,839,2859,139,1
20150106.103939,2858,2,1227814,0,2858,838,2859,139,0
20150106.103939,2858,2,1227816,0,2858,837,2859,141,0
20150106.103941,2858,2,1227818,0,2858,839,2859,103,0
20150106.103942,2859,2,1227820,0,2858,839,2859,103,1
20150106.103942,2858,2,1227822,0,2858,844,2859,103,0
20150106.103943,2858,80,1227902,0,2858,799,2859,165,0
20150106.103944,2858,2,1227904,0,2858,798,2859,170,0
20150106.103946,2858,2,1227906,0,2858,797,2859,170,0
20150106.103946,2858,20,1227926,0,2858,787,2859,171,0
20150106.103947,2858,2,1227928,-2,2858,786,2859,172,0
20150106.103948,2858,2,1227930,0,2858,785,2859,176,0
20150106.10395,2859,2,1227932,0,2858,784,2859,180,1
20150106.103954,2859,2,1227934,-2,2858,839,2859,196,1
20150106.103955,2859,4,1227938,-4,2858,839,2859,215,1
20150106.103955,2858,12,1227950,-2,2858,835,2859,216,0
20150106.103958,2858,30,1227980,-30,2858,820,2859,218,0
20150106.104,2858,12,1227992,-4,2858,816,2859,304,0
20150106.104007,2858,2,1227994,0,2858,818,2859,344,0
20150106.104007,2858,2,1227996,-2,2858,817,2859,337,0
20150106.104009,2858,2,1227998,0,2858,816,2859,339,0
20150106.104012,2858,2,1228000,0,2858,819,2859,358,0
20150106.104013,2858,10,1228010,0,2858,814,2859,380,0
20150106.104014,2858,4,1228014,0,2858,813,2859,380,0
20150106.104017,2859,2,1228016,-2,2858,815,2859,380,1
20150106.104017,2858,6,1228022,-2,2858,832,2859,381,0
20150106.104019,2859,2,1228024,0,2858,835,2859,382,1
20150106.10402,2859,2,1228026,0,2858,835,2859,381,1
20150106.10402,2858,4,1228030,-4,2858,833,2859,381,0
20150106.104021,2859,4,1228034,0,2858,832,2859,380,1
20150106.104022,2858,22,1228056,-2,2858,821,2859,380,0
20150106.104023,2859,2,1228058,0,2858,821,2859,379,1
20150106.104026,2859,2,1228060,0,2858,822,2859,385,1
20150106.104028,2859,8,1228068,0,2858,823,2859,381,1
20150106.104028,2859,2,1228070,0,2858,824,2859,380,1
20150106.104031,2858,4,1228074,-2,2858,824,2859,379,0
20150106.104031,2858,102,1228176,0,2858,773,2859,379,0
20150106.104033,2858,6,1228182,0,2858,770,2859,380,0
20150106.104036,2859,12,1228194,-10,2858,766,2859,391,1
20150106.104038,2858,2,1228196,0,2858,765,2859,415,0
20150106.104039,2859,2,1228198,0,2858,765,2859,414,1
20150106.10404,2859,16,1228214,-8,2858,759,2859,415,1
20150106.104041,2858,6,1228220,0,2858,756,2859,425,0
20150106.104042,2859,2,1228222,0,2858,756,2859,424,1
20150106.104043,2858,4,1228226,0,2858,764,2859,424,0
20150106.104044,2858,6,1228232,0,2858,764,2859,422,0
20150106.104045,2859,2,1228234,2,2858,764,2859,421,1
20150106.104046,2858,2,1228236,0,2858,763,2859,418,0
20150106.104047,2859,2,1228238,0,2858,763,2859,420,1
20150106.10405,2859,2,1228240,0,2858,767,2859,419,1
20150106.104052,2859,12,1228252,-6,2858,765,2859,417,1
20150106.104052,2859,4,1228256,2,2858,764,2859,417,1
20150106.104053,2858,30,1228286,0,2858,749,2859,417,0
20150106.104054,2859,200,1228486,98,2858,751,2859,318,1
20150106.104055,2858,2,1228488,-2,2858,753,2859,319,0
20150106.104056,2858,2,1228490,0,2858,752,2859,319,0
20150106.104058,2859,2,1228492,-2,2858,749,2859,329,1
20150106.104059,2859,4,1228496,-4,2858,749,2859,322,1
20150106.1041,2859,402,1228898,-140,2858,749,2860,933,1
20150106.104101,2858,2,1228900,0,2858,748,2860,933,0
20150106.104101,2859,246,1229146,-80,2859,80,2860,883,1
20150106.104102,2859,16,1229162,-4,2859,72,2860,883,1
20150106.104102,2859,4,1229166,0,2859,82,2860,881,1
20150106.104103,2859,2,1229168,-2,2859,81,2860,882,1
20150106.104104,2859,20,1229188,0,2859,145,2860,882,1
20150106.104107,2860,6,1229194,0,2859,149,2860,879,1
20150106.104107,2859,2,1229196,-2,2859,148,2860,879,0
20150106.104108,2859,2,1229198,0,2859,147,2860,879,0
20150106.104108,2859,10,1229208,0,2859,144,2860,879,0
20150106.104109,2859,20,1229228,0,2859,125,2860,879,0
20150106.104112,2859,6,1229234,-4,2859,140,2860,929,0
20150106.104113,2859,2,1229236,0,2859,139,2860,929,0
20150106.104114,2859,2,1229238,0,2859,144,2860,939,0
20150106.104115,2859,200,1229438,0,2859,44,2860,941,0
20150106.104117,2859,36,1229474,0,2859,57,2860,1093,0
20150106.104118,2859,6,1229480,0,2859,56,2860,1095,0
20150106.104119,2859,2,1229482,0,2859,56,2860,1095,0
20150106.10412,2859,2,1229484,-2,2859,59,2860,1095,0
20150106.104121,2859,2,1229486,0,2859,59,2860,1094,0
20150106.104122,2860,8,1229494,0,2859,60,2860,1090,1
20150106.104123,2860,10,1229504,0,2859,60,2860,1085,1
20150106.104124,2860,2,1229506,0,2859,60,2860,1104,1
20150106.104124,2859,2,1229508,0,2859,60,2860,1104,0
20150106.104125,2859,4,1229512,0,2859,58,2860,1104,0
20150106.104125,2859,4,1229516,-2,2859,57,2860,1103,0
20150106.104126,2859,2,1229518,0,2859,57,2860,1103,0
20150106.104126,2859,2,1229520,0,2859,71,2860,1104,0
20150106.104127,2860,4,1229524,-2,2859,70,2860,1102,1
20150106.104127,2859,2,1229526,0,2859,69,2860,1104,0
20150106.104128,2860,4,1229530,0,2859,69,2860,1102,1
20150106.10413,2860,4,1229534,2,2859,81,2860,1098,1
20150106.104131,2860,6,1229540,0,2859,79,2860,1099,1
20150106.104132,2859,2,1229542,-2,2859,79,2860,1104,0
20150106.104133,2859,4,1229546,-2,2859,78,2860,1104,0
20150106.104134,2860,14,1229560,0,2859,72,2860,1103,1
20150106.104135,2860,2,1229562,0,2859,75,2860,1092,1
20150106.104137,2860,2,1229564,0,2859,80,2860,1099,1
20150106.104138,2860,204,1229768,56,2858,725,2859,25,1
20150106.104138,2859,2,1229770,0,2858,724,2859,24,0
20150106.104139,2859,4,1229774,-2,2858,724,2859,53,0
20150106.104139,2859,20,1229794,-12,2858,724,2859,45,0
20150106.10414,2858,2,1229796,-2,2858,723,2859,52,0
20150106.104141,2858,8,1229804,-6,2858,721,2859,51,0
20150106.104141,2859,2,1229806,0,2858,725,2859,50,1
20150106.104142,2859,6,1229812,0,2858,723,2859,47,1
20150106.104143,2859,4,1229816,0,2858,723,2859,45,1
20150106.104145,2859,100,1229916,-20,2859,1027,2860,1537,1
20150106.104145,2859,4,1229920,-2,2859,1025,2860,1533,1
20150106.104147,2859,2,1229922,0,2859,1024,2860,1517,1
20150106.104147,2859,68,1229990,0,2859,990,2860,1517,1
20150106.104147,2859,22,1230012,0,2859,979,2860,1508,1
20150106.10415,2859,120,1230132,0,2859,927,2860,1304,1
20150106.10415,2859,40,1230172,-40,2859,907,2860,1105,1
20150106.104154,2859,2,1230174,0,2859,916,2860,1106,1
20150106.104155,2859,14,1230188,-14,2859,909,2860,1106,1
20150106.104155,2859,2,1230190,0,2859,919,2860,1116,1
20150106.104156,2860,2,1230192,0,2859,919,2860,1115,1
20150106.104156,2859,2,1230194,0,2859,918,2860,1115,0
20150106.104157,2859,4,1230198,-4,2859,916,2860,1115,0
20150106.104158,2859,10,1230208,0,2859,925,2860,1115,0
20150106.104159,2859,4,1230212,0,2859,923,2860,1115,0
20150106.104159,2859,4,1230216,0,2859,922,2860,1114,0
20150106.104201,2860,2,1230218,0,2859,922,2860,1118,1
20150106.104202,2860,42,1230260,40,2859,930,2860,1198,1
20150106.104202,2860,2,1230262,-2,2859,930,2860,1197,1
20150106.104203,2860,4,1230266,-2,2859,933,2860,1197,1
20150106.104205,2859,2,1230268,0,2859,934,2860,1198,0
20150106.104206,2860,2,1230270,-2,2859,935,2860,1197,1
20150106.104206,2859,2,1230272,0,2859,934,2860,1196,0
20150106.104207,2860,2,1230274,-2,2859,935,2860,1195,1
20150106.104209,2859,200,1230474,-200,2859,835,2860,1196,0
20150106.104211,2859,2,1230476,0,2859,836,2860,1196,0
20150106.104213,2859,6,1230482,0,2859,834,2860,1196,0
20150106.104214,2860,2,1230484,-2,2859,834,2860,1195,1
20150106.104214,2860,12,1230496,0,2859,834,2860,1189,1
20150106.104216,2860,200,1230696,-200,2859,844,2860,1094,1
20150106.104217,2860,12,1230708,0,2859,846,2860,1106,1
20150106.104218,2860,2,1230710,-2,2859,847,2860,1105,1
20150106.10422,2860,2,1230712,0,2859,850,2860,1105,1
20150106.10422,2860,4,1230716,-2,2859,1351,2860,1103,1
20150106.104222,2860,4,1230720,0,2859,1351,2860,1100,1
20150106.104222,2860,2,1230722,-2,2859,1351,2860,1100,1
20150106.104225,2859,72,1230794,0,2859,1330,2860,1143,0
20150106.104225,2860,2,1230796,0,2859,1331,2860,1142,1
20150106.104226,2860,14,1230810,6,2859,1326,2860,1141,1
20150106.104226,2859,4,1230814,0,2859,1327,2860,1141,0
20150106.104228,2860,2,1230816,0,2859,1327,2860,1130,1
20150106.104228,2859,4,1230820,-2,2859,1327,2860,1130,0
20150106.104232,2860,24,1230844,-24,2859,1348,2860,947,1
20150106.104232,2860,2,1230846,0,2859,1348,2860,946,1
20150106.104233,2860,330,1231176,0,2859,1348,2860,781,1
20150106.104234,2860,10,1231186,-10,2859,1347,2860,776,1
20150106.104234,2860,12,1231198,-12,2859,1347,2860,771,1
20150106.104236,2859,4,1231202,0,2859,1345,2860,771,0
20150106.104237,2860,4,1231206,-2,2859,1345,2860,770,1
20150106.104237,2860,22,1231228,0,2859,1335,2860,768,1
20150106.104238,2860,6,1231234,0,2859,1334,2860,767,1
20150106.104238,2860,2,1231236,0,2859,1334,2860,766,1
20150106.10424,2860,10,1231246,-10,2859,1335,2860,760,1
20150106.104241,2860,2,1231248,-2,2859,1335,2860,759,1
20150106.104243,2860,2,1231250,0,2859,1330,2860,757,1
20150106.104244,2860,6,1231256,0,2859,1330,2860,759,1
20150106.104248,2860,22,1231278,-20,2859,1334,2860,751,1
20150106.104249,2860,2,1231280,0,2859,1336,2860,751,1
20150106.104251,2859,2,1231282,0,2859,1335,2860,752,0
20150106.104257,2859,4,1231286,0,2859,1340,2860,783,0
20150106.1043,2859,8,1231294,0,2859,1341,2860,795,0
20150106.104307,2859,2,1231296,0,2859,1340,2860,861,0
20150106.104309,2860,2,1231298,-2,2859,1345,2860,798,1
20150106.10431,2859,12,1231310,-2,2859,1339,2860,799,0
20150106.104315,2860,20,1231330,-20,2859,1345,2860,795,1
20150106.104317,2859,226,1231556,-226,2859,1243,2860,785,0
20150106.104318,2860,2,1231558,-2,2859,1243,2860,784,1
20150106.104319,2860,4,1231562,-4,2859,1247,2860,786,1
20150106.10432,2860,2,1231564,0,2859,1247,2860,785,1
20150106.104324,2860,2,1231566,-2,2859,1257,2860,783,1
20150106.104326,2859,6,1231572,0,2859,1259,2860,933,0
20150106.104328,2860,2,1231574,0,2859,1262,2860,933,1
20150106.104329,2859,2,1231576,0,2859,1261,2860,935,0
20150106.10433,2860,2,1231578,-2,2859,1262,2860,934,1
20150106.10433,2859,2,1231580,-2,2859,1261,2860,932,0
20150106.104331,2860,6,1231586,0,2859,1261,2860,929,1
20150106.104332,2859,8,1231594,-4,2859,1257,2860,929,0
20150106.104333,2860,40,1231634,0,2859,1258,2860,918,1
20150106.104333,2860,2,1231636,0,2859,1258,2860,917,1
20150106.104336,2860,60,1231696,-60,2859,1258,2860,892,1
20150106.104341,2860,4,1231700,-4,2859,1259,2860,891,1
20150106.104345,2860,6,1231706,0,2859,1263,2860,890,1
20150106.104347,2860,2,1231708,-2,2859,1262,2860,888,1
20150106.104351,2860,40,1231748,0,2859,1268,2860,881,1
20150106.104355,2860,2,1231750,0,2859,1271,2860,880,1
20150106.104355,2860,2,1231752,-2,2859,1271,2860,879,1
20150106.104357,2860,8,1231760,-8,2859,1271,2860,875,1
20150106.104359,2859,176,1231936,0,2859,1184,2860,885,0
20150106.104404,2859,2,1231938,-2,2859,1183,2860,879,0
20150106.104406,2859,24,1231962,-24,2859,1171,2860,882,0
20150106.104407,2859,2,1231964,0,2859,1170,2860,882,0
20150106.104408,2859,2,1231966,0,2859,1169,2860,884,0
20150106.104411,2860,2,1231968,0,2859,1169,2860,883,1
20150106.104417,2860,2,1231970,0,2859,1168,2860,884,1
20150106.10442,2860,10,1231980,-10,2859,1170,2860,874,1
20150106.104421,2859,4,1231984,0,2859,1168,2860,874,0
20150106.104422,2859,10,1231994,-10,2859,1158,2860,874,0
20150106.104422,2859,2,1231996,-2,2859,1157,2860,874,0
20150106.104427,2859,2,1231998,0,2859,1161,2860,914,0
20150106.104429,2859,2,1232000,0,2859,1160,2860,915,0
20150106.104429,2860,4,1232004,0,2859,1160,2860,913,1
20150106.104433,2859,2,1232006,-2,2859,1160,2860,934,0
20150106.104436,2859,4,1232010,0,2859,1158,2860,935,0
20150106.104437,2859,4,1232014,0,2859,1156,2860,935,0
20150106.104445,2860,2,1232016,-2,2859,1157,2860,978,1
20150106.104446,2859,10,1232026,-8,2859,1100,2860,973,0
20150106.10445,2859,2,1232028,-2,2859,1089,2860,972,0
20150106.104453,2859,10,1232038,0,2859,1086,2860,973,0
20150106.104454,2859,2,1232040,-2,2859,1086,2860,974,0
20150106.104455,2859,2,1232042,0,2859,1086,2860,976,0
20150106.104456,2859,10,1232052,0,2859,1081,2860,977,0
20150106.104456,2859,2,1232054,0,2859,1080,2860,979,0
20150106.104457,2859,10,1232064,-10,2859,1076,2860,979,0
20150106.104459,2859,2,1232066,-2,2859,1075,2860,983,0
20150106.1045,2859,62,1232128,0,2859,1044,2860,982,0
20150106.104502,2859,6,1232134,-6,2859,1051,2860,1037,0
20150106.104502,2859,2,1232136,0,2859,1050,2860,1037,0
20150106.104504,2859,2,1232138,0,2859,1049,2860,1037,0
20150106.104505,2860,40,1232178,-40,2859,1050,2860,1342,1
20150106.104506,2859,8,1232186,0,2859,1046,2860,1341,0
20150106.10451,2859,4,1232190,-4,2859,1054,2860,999,0
20150106.104514,2859,4,1232194,-4,2859,1051,2860,987,0
20150106.104515,2859,2,1232196,-2,2859,1048,2860,963,0
20150106.104516,2859,2,1232198,-2,2859,1047,2860,964,0
20150106.104519,2859,10,1232208,0,2859,1043,2860,993,0
20150106.104522,2859,6,1232214,-6,2859,1040,2860,994,0
20150106.104523,2859,16,1232230,0,2859,1032,2860,994,0
20150106.104524,2860,2,1232232,0,2859,1032,2860,993,1
20150106.104526,2859,4,1232236,0,2859,1030,2860,994,0
20150106.104527,2860,36,1232272,-30,2859,1015,2860,992,1
20150106.104527,2860,2,1232274,0,2859,1015,2860,991,1
20150106.10453,2859,2,1232276,0,2859,1013,2860,993,0
20150106.104532,2860,14,1232290,-14,2859,1013,2860,997,1
20150106.104533,2860,2,1232292,0,2859,1017,2860,996,1
20150106.104534,2860,2,1232294,2,2859,1002,2860,995,1
20150106.104537,2860,16,1232310,0,2859,1001,2860,989,1
20150106.10454,2859,2,1232312,0,2859,997,2860,990,0
20150106.104543,2860,2,1232314,0,2859,997,2860,989,1
20150106.104544,2860,2,1232316,0,2859,997,2860,987,1
20150106.104546,2859,4,1232320,-4,2859,995,2860,994,0
20150106.104548,2859,2,1232322,-2,2859,994,2860,994,0
20150106.104552,2860,10,1232332,0,2859,998,2860,1001,1
20150106.104553,2859,10,1232342,0,2859,993,2860,1001,0
20150106.104557,2859,4,1232346,-2,2859,990,2860,1032,0
20150106.104557,2859,12,1232358,-12,2859,985,2860,1032,0
20150106.104601,2859,2,1232360,0,2859,984,2860,1037,0
20150106.104607,2860,4,1232364,2,2859,984,2860,1039,1
20150106.104608,2859,2,1232366,0,2859,983,2860,1040,0
20150106.104612,2859,4,1232370,-4,2859,982,2860,1044,0
20150106.104614,2859,2,1232372,0,2859,981,2860,1045,0
20150106.104615,2859,4,1232376,-2,2859,979,2860,1045,0
20150106.104615,2859,2,1232378,-2,2859,978,2860,1045,0
20150106.104616,2859,2,1232380,0,2859,977,2860,1044,0
20150106.104616,2859,2,1232382,0,2859,976,2860,1043,0
20150106.104617,2859,4,1232386,0,2859,974,2860,1043,0
20150106.104618,2860,4,1232390,0,2859,973,2860,1042,1
20150106.104619,2859,2,1232392,0,2859,972,2860,1042,0
20150106.10462,2859,12,1232404,-12,2859,966,2860,1040,0
20150106.104627,2859,8,1232412,0,2859,974,2860,1057,0
20150106.104629,2859,4,1232416,-4,2859,972,2860,1056,0
20150106.10463,2859,4,1232420,0,2859,970,2860,1065,0
20150106.104631,2859,12,1232432,-4,2859,969,2860,1061,0
20150106.104638,2859,6,1232438,0,2859,967,2860,1088,0
20150106.104639,2859,20,1232458,-20,2859,957,2860,1088,0
20150106.10464,2859,200,1232658,-200,2859,857,2860,1089,0
20150106.10464,2860,38,1232696,-6,2859,859,2860,1070,1
20150106.104641,2859,2,1232698,-2,2859,858,2860,1070,0
20150106.104642,2859,2,1232700,0,2859,857,2860,1070,0
20150106.104643,2859,2,1232702,-2,2859,856,2860,1069,0
20150106.104644,2859,2,1232704,0,2859,855,2860,1069,0
20150106.104645,2859,2,1232706,0,2859,854,2860,1069,0
20150106.104645,2859,10,1232716,-10,2859,849,2860,1070,0
20150106.104646,2859,2,1232718,-2,2859,848,2860,1070,0
20150106.104647,2859,2,1232720,0,2859,847,2860,1070,0
20150106.104649,2859,2,1232722,-2,2859,846,2860,1054,0
20150106.104652,2859,8,1232730,-2,2859,843,2860,1055,0
20150106.104653,2859,12,1232742,-2,2859,836,2860,1055,0
20150106.104657,2859,2,1232744,0,2859,830,2860,1044,0
20150106.104658,2859,2,1232746,0,2859,829,2860,1044,0
20150106.104659,2859,10,1232756,-6,2859,825,2860,1044,0
20150106.1047,2860,4,1232760,0,2859,825,2860,1031,1
20150106.1047,2860,2,1232762,0,2859,825,2860,1030,1
20150106.104701,2859,4,1232766,-4,2859,823,2860,1030,0
20150106.104704,2860,2,1232768,-2,2859,825,2860,1024,1
20150106.104706,2860,2056,1234824,1002,2860,411,2861,863,1
20150106.104707,2860,8,1234832,2,2860,1475,2861,702,1
20150106.104709,2860,10,1234842,0,2860,1471,2861,521,1
20150106.104709,2860,10,1234852,0,2860,1466,2861,521,1
20150106.10471,2861,4,1234856,0,2860,1466,2861,520,1
20150106.104711,2861,10,1234866,2,2860,1342,2861,519,1
20150106.104712,2861,12,1234878,-2,2860,1342,2861,513,1
20150106.104713,2861,26,1234904,-18,2860,1332,2861,510,1
20150106.104713,2861,100,1235004,36,2860,1332,2861,496,1
20150106.104714,2861,30,1235034,0,2860,1332,2861,481,1
20150106.104715,2861,2,1235036,0,2860,1332,2861,480,1
20150106.104716,2860,4,1235040,-4,2860,1330,2861,479,0
20150106.104717,2861,14,1235054,-8,2860,1328,2861,474,1
20150106.104717,2861,2,1235056,-2,2860,1335,2861,489,1
20150106.104718,2861,4,1235060,-4,2860,1336,2861,487,1
20150106.104719,2860,6,1235066,-6,2860,1335,2861,490,0
20150106.104719,2861,2,1235068,-2,2860,1335,2861,489,1
20150106.10472,2861,66,1235134,-34,2860,1335,2861,456,1
20150106.104723,2861,2,1235136,0,2860,1439,2861,482,1
20150106.104723,2861,14,1235150,-4,2860,1432,2861,476,1
20150106.104724,2860,2,1235152,0,2860,1431,2861,476,0
20150106.104724,2861,2,1235154,0,2860,1434,2861,474,1
20150106.104725,2861,110,1235264,64,2860,1434,2861,439,1
20150106.104727,2861,56,1235320,38,2860,1436,2861,411,1
20150106.104728,2861,104,1235424,24,2860,1436,2861,360,1
20150106.104728,2861,720,1236144,-420,2861,641,2862,1042,1
20150106.104729,2862,50,1236194,44,2861,806,2862,996,1
20150106.10473,2861,2,1236196,0,2861,808,2862,985,0
20150106.10473,2862,124,1236320,98,2861,814,2862,919,1
20150106.104731,2861,180,1236500,-64,2861,754,2862,912,0
20150106.104731,2862,2,1236502,2,2861,756,2862,911,1
20150106.104733,2862,6,1236508,6,2861,757,2862,908,1
20150106.104733,2862,22,1236530,0,2861,858,2862,897,1
20150106.104734,2862,4,1236534,0,2861,861,2862,897,1
20150106.104734,2862,20,1236554,0,2861,864,2862,887,1
20150106.104735,2862,14,1236568,2,2861,863,2862,880,1
20150106.104735,2862,2,1236570,2,2861,869,2862,879,1
20150106.104738,2862,50,1236620,50,2861,851,2862,860,1
20150106.104738,2862,2,1236622,0,2861,853,2862,859,1
20150106.104739,2862,4,1236626,2,2861,904,2862,857,1
20150106.10474,2861,30,1236656,-30,2861,890,2862,857,0
20150106.10474,2862,22,1236678,2,2861,889,2862,847,1
20150106.104741,2862,6,1236684,2,2861,888,2862,845,1
20150106.104742,2862,22,1236706,-18,2861,888,2862,835,1
20150106.104742,2862,2,1236708,0,2861,898,2862,835,1
20150106.104743,2861,2,1236710,0,2861,898,2862,835,0
20150106.104744,2862,44,1236754,4,2861,898,2862,818,1
20150106.104745,2862,6,1236760,0,2861,899,2862,817,1
20150106.104745,2862,2,1236762,-2,2861,900,2862,824,1
20150106.104748,2862,40,1236802,0,2861,900,2862,818,1
20150106.104748,2862,36,1236838,-16,2861,893,2862,849,1
20150106.104749,2861,18,1236856,-18,2861,889,2862,849,0
20150106.104749,2862,2,1236858,0,2861,889,2862,848,1
20150106.10475,2861,20,1236878,0,2861,879,2862,848,0
20150106.104752,2862,2,1236880,0,2861,894,2862,853,1
20150106.104753,2862,10,1236890,-6,2861,894,2862,850,1
20150106.104754,2861,10,1236900,0,2861,890,2862,860,0
20150106.104759,2862,6,1236906,-2,2861,898,2862,870,1
20150106.104801,2861,2,1236908,0,2861,901,2862,873,0
20150106.104802,2862,36,1236944,-16,2861,901,2862,875,1
20150106.104804,2861,20,1236964,-10,2861,896,2862,982,0
20150106.104805,2861,2,1236966,0,2861,895,2862,982,0
20150106.104807,2861,2,1236968,0,2861,894,2862,1002,0
20150106.104808,2862,4,1236972,0,2861,894,2862,1004,1
20150106.104809,2862,10,1236982,0,2861,894,2862,999,1
20150106.10481,2861,22,1237004,0,2861,883,2862,999,0
20150106.10481,2861,220,1237224,-188,2861,783,2862,889,0
20150106.104811,2861,160,1237384,-88,2861,698,2862,809,0
20150106.104811,2861,10,1237394,-10,2861,693,2862,809,0
20150106.104812,2861,4,1237398,0,2861,692,2862,810,0
20150106.104812,2861,24,1237422,-2,2861,689,2862,805,0
20150106.104813,2861,22,1237444,0,2861,693,2862,850,0
20150106.104815,2861,2,1237446,-2,2861,692,2862,846,0
20150106.104816,2861,4,1237450,0,2861,690,2862,849,0
20150106.104817,2862,2,1237452,-2,2861,690,2862,850,1
20150106.104817,2861,4,1237456,-4,2861,690,2862,856,0
20150106.104818,2861,218,1237674,0,2861,540,2862,798,0
20150106.104819,2861,20,1237694,-20,2861,530,2862,798,0
20150106.104819,2861,100,1237794,0,2861,480,2862,849,0
20150106.10482,2861,8,1237802,-2,2861,476,2862,851,0
20150106.104821,2861,4,1237806,-4,2861,475,2862,849,0
20150106.104822,2861,16,1237822,-14,2861,467,2862,850,0
20150106.104822,2861,6,1237828,0,2861,465,2862,849,0
20150106.104823,2861,4,1237832,0,2861,463,2862,849,0
20150106.104824,2862,10,1237842,-2,2861,458,2862,850,1
20150106.104827,2861,302,1238144,-128,2861,306,2862,718,0
20150106.104827,2861,28,1238172,-24,2861,290,2862,719,0
20150106.104828,2861,6,1238178,-2,2861,287,2862,718,0
20150106.104828,2861,28,1238206,-14,2861,273,2862,710,0
20150106.104829,2861,24,1238230,4,2861,261,2862,712,0
20150106.10483,2861,16,1238246,16,2861,253,2862,712,0
20150106.104831,2861,208,1238454,196,2861,151,2862,1243,0
20150106.104831,2861,242,1238696,180,2861,30,2862,1244,0
20150106.104831,2861,42,1238738,28,2860,1378,2861,37,0
20150106.104832,2861,82,1238820,-20,2860,1357,2861,137,0
20150106.104832,2861,4,1238824,-4,2860,1357,2861,138,0
20150106.104833,2861,8,1238832,0,2860,1357,2861,190,0
20150106.104834,2861,20,1238852,4,2860,1357,2861,181,0
20150106.104835,2861,6,1238858,0,2860,1357,2861,182,0
20150106.104838,2861,2,1238860,0,2860,1358,2861,229,0
20150106.104841,2861,2,1238862,0,2860,1359,2861,331,0
20150106.104842,2861,6,1238868,-2,2860,1359,2861,329,0
20150106.104842,2861,2,1238870,0,2860,1359,2861,328,0
20150106.104843,2861,62,1238932,-60,2860,1360,2861,300,0
20150106.104844,2860,2,1238934,0,2860,1450,2861,293,0
20150106.104844,2860,4,1238938,-4,2860,1453,2861,293,0
20150106.104846,2861,4,1238942,0,2860,1454,2861,300,1
20150106.104846,2861,64,1239006,-2,2860,1454,2861,268,1
20150106.10485,2861,156,1239162,88,2860,1455,2861,220,1
20150106.10485,2861,2,1239164,2,2860,1455,2861,221,1
20150106.10485,2861,6,1239170,0,2860,1456,2861,218,1
20150106.104851,2861,2,1239172,0,2860,1456,2861,234,1
20150106.104852,2861,2,1239174,2,2860,1462,2861,233,1
20150106.104852,2861,220,1239394,-4,2860,1362,2861,225,1
20150106.104854,2861,4,1239398,2,2860,1362,2861,224,1
20150106.104856,2861,2,1239400,2,2860,1362,2861,279,1
20150106.1049,2860,2,1239402,0,2860,1362,2861,284,0
20150106.1049,2861,12,1239414,12,2860,1363,2861,278,1
20150106.104904,2860,2,1239416,-2,2860,1362,2861,310,0
20150106.104905,2860,10,1239426,6,2860,1357,2861,311,0
20150106.104906,2861,52,1239478,0,2860,1357,2861,297,1
20150106.10491,2861,100,1239578,98,2860,1359,2861,277,1
20150106.104912,2861,602,1240180,-474,2860,1359,2862,1029,1
20150106.104913,2861,2,1240182,0,2860,1359,2861,10,1
20150106.104913,2861,6,1240188,-2,2860,1359,2862,1029,1
20150106.104914,2861,2,1240190,2,2860,1359,2861,16,1
20150106.104915,2861,6,1240196,0,2860,1369,2861,13,1
20150106.104917,2860,42,1240238,42,2860,1349,2861,24,0
20150106.104918,2861,2,1240240,0,2860,1349,2861,23,1
20150106.104919,2861,48,1240288,16,2861,51,2862,1018,1
20150106.104919,2861,8,1240296,4,2861,47,2862,1068,1
20150106.104919,2861,6,1240302,0,2861,50,2862,1068,1
20150106.10492,2861,4,1240306,0,2861,54,2862,1070,1
20150106.104921,2861,30,1240336,30,2861,39,2862,1070,1
20150106.104921,2861,2,1240338,2,2861,38,2862,1070,1
20150106.104922,2861,6,1240344,4,2861,36,2862,1069,1
20150106.104922,2861,2,1240346,0,2861,35,2862,1069,1
20150106.104923,2861,8,1240354,8,2861,32,2862,1069,1
20150106.104924,2861,16,1240370,16,2861,24,2862,1069,1
20150106.104924,2861,16,1240386,12,2861,17,2862,1068,1
20150106.104925,2861,6,1240392,6,2861,14,2862,1066,1
20150106.104925,2861,2,1240394,0,2861,13,2862,1066,1
20150106.104926,2861,32,1240426,16,2860,1351,2861,6,1
20150106.104926,2861,18,1240444,12,2861,3,2862,1132,1
20150106.104927,2861,6,1240450,0,2861,3,2862,1083,1
20150106.104927,2861,6,1240456,2,2860,1348,2861,1,1
20150106.104929,2861,10,1240466,4,2860,1346,2861,2,1
20150106.104929,2861,4,1240470,-2,2861,55,2862,1083,1
20150106.10493,2861,30,1240500,-12,2861,40,2862,1082,1
20150106.104933,2861,36,1240536,-32,2861,25,2862,1083,1
20150106.104933,2861,2,1240538,0,2861,24,2862,1083,1
20150106.104934,2861,4,1240542,-4,2861,23,2862,1083,1
20150106.104934,2861,8,1240550,0,2861,19,2862,1081,1
20150106.104935,2862,10,1240560,0,2861,16,2862,1069,1
20150106.104935,2861,2,1240562,0,2861,15,2862,1069,0
20150106.104936,2861,32,1240594,12,2860,1343,2861,7,0
20150106.104936,2861,14,1240608,-4,2860,1344,2862,1119,0
20150106.104937,2861,4,1240612,-2,2860,1345,2862,1119,0
20150106.104939,2860,20,1240632,20,2860,1344,2862,1118,0
20150106.10494,2861,2,1240634,2,2861,52,2862,1074,1
20150106.104941,2861,68,1240702,8,2861,21,2862,1074,1
20150106.104941,2861,4,1240706,2,2861,19,2862,1074,1
20150106.104942,2861,2,1240708,2,2861,119,2862,1074,1
20150106.104944,2861,2,1240710,2,2861,173,2862,1076,1
20150106.104946,2861,32,1240742,32,2861,138,2862,1063,1
20150106.104947,2861,2,1240744,2,2861,137,2862,1063,1
20150106.104948,2861,48,1240792,-2,2861,158,2862,1039,1
20150106.10495,2862,10,1240802,-10,2861,164,2862,1044,1
20150106.10495,2861,4,1240806,0,2861,152,2862,1044,0
20150106.104953,2861,4,1240810,0,2861,155,2862,1038,0
20150106.104954,2861,6,1240816,-6,2861,152,2862,1042,0
20150106.104957,2861,10,1240826,0,2861,148,2862,1045,0
20150106.104958,2861,2,1240828,0,2861,147,2862,1048,0
20150106.104959,2861,2,1240830,-2,2861,146,2862,1048,0
20150106.104959,2861,2,1240832,-2,2861,145,2862,1048,0
20150106.105,2861,2,1240834,-2,2861,144,2862,1048,0
20150106.105002,2861,2,1240836,-2,2861,177,2862,1066,0
20150106.105003,2861,2,1240838,0,2861,265,2862,1068,0
20150106.105004,2861,2,1240840,0,2861,276,2862,1067,0
20150106.105005,2861,4,1240844,0,2861,278,2862,1067,0
20150106.105006,2861,10,1240854,0,2861,273,2862,1069,0
20150106.105007,2861,2,1240856,-2,2861,272,2862,1069,0
20150106.105008,2861,2,1240858,0,2861,271,2862,1069,0
20150106.105009,2861,556,1241414,-350,2860,1580,2861,274,0
20150106.10501,2860,4,1241418,2,2860,1580,2861,275,0
20150106.105011,2861,14,1241432,-8,2860,1580,2861,268,1
20150106.105011,2860,2,1241434,2,2860,1579,2861,267,0
20150106.105011,2861,2,1241436,-2,2860,1579,2861,266,1
20150106.105013,2861,4,1241440,0,2860,1479,2861,286,1
20150106.105014,2861,10,1241450,-10,2860,1479,2861,281,1
20150106.105015,2861,566,1242016,44,2861,119,2862,1085,1
20150106.105016,2861,6,1242022,4,2861,116,2862,1126,1
20150106.105016,2861,2,1242024,2,2861,115,2862,1126,1
20150106.105017,2861,82,1242106,80,2861,74,2862,1086,1
20150106.105017,2861,16,1242122,14,2861,67,2862,1086,1
20150106.105018,2861,10,1242132,0,2861,62,2862,1086,1
20150106.105019,2861,8,1242140,6,2861,58,2862,1096,1
20150106.10502,2861,10,1242150,10,2861,54,2862,1097,1
20150106.105021,2861,2,1242152,2,2861,53,2862,1098,1
20150106.105022,2861,4,1242156,4,2861,51,2862,1098,1
20150106.105022,2861,18,1242174,4,2861,43,2862,1098,1
20150106.105023,2861,4,1242178,2,2861,41,2862,1101,1
20150106.105024,2861,4,1242182,2,2861,40,2862,1102,1
20150106.105025,2861,2,1242184,2,2861,39,2862,1109,1
20150106.105025,2861,6,1242190,0,2861,36,2862,1106,1
20150106.105026,2861,76,1242266,-4,2860,1515,2861,269,1
20150106.105027,2861,2,1242268,0,2860,1516,2861,290,1
20150106.105028,2861,14,1242282,0,2860,1516,2861,285,1
20150106.105035,2860,12,1242294,0,2860,1534,2861,300,0
20150106.105036,2861,16,1242310,-2,2860,1544,2861,292,1
20150106.10504,2860,2,1242312,2,2860,1544,2861,392,0
20150106.105043,2860,4,1242316,4,2860,1552,2861,407,0
20150106.105043,2860,2,1242318,2,2860,1551,2861,407,0
20150106.105045,2861,2,1242320,0,2860,1551,2861,408,1
20150106.105046,2860,2,1242322,0,2860,1549,2861,408,0
20150106.105047,2860,10,1242332,10,2860,1544,2861,403,0
20150106.105049,2860,8,1242340,4,2860,1530,2861,509,0
20150106.105051,2860,2,1242342,-2,2860,1514,2861,509,0
20150106.105051,2861,62,1242404,2,2860,1514,2861,482,1
20150106.105053,2860,40,1242444,40,2860,1494,2861,496,0
20150106.105054,2860,2,1242446,2,2860,1494,2861,495,0
20150106.105059,2861,8,1242454,-2,2860,1496,2861,501,1
20150106.105102,2860,2,1242456,0,2860,1495,2861,507,0
20150106.105102,2860,4,1242460,2,2860,1495,2861,516,0
20150106.105103,2860,2,1242462,2,2860,1494,2861,516,0
20150106.105103,2860,4,1242466,4,2860,1492,2861,516,0
20150106.105104,2861,6,1242472,-6,2860,1492,2861,560,1
20150106.105106,2860,2,1242474,0,2860,1500,2861,564,0
20150106.105106,2861,2,1242476,-2,2860,1500,2861,564,1
20150106.105107,2860,2,1242478,2,2860,1499,2861,566,0
20150106.105108,2861,46,1242524,-46,2860,1499,2861,543,1
20150106.105109,2860,10,1242534,10,2860,1494,2861,548,0
20150106.10511,2860,72,1242606,0,2860,1458,2861,520,0
20150106.105111,2860,2,1242608,2,2860,1458,2861,512,0
20150106.105113,2860,120,1242728,120,2860,1398,2861,512,0
20150106.105115,2860,2,1242730,2,2860,1397,2861,514,0
20150106.105116,2860,4,1242734,0,2860,1395,2861,515,0
20150106.105117,2860,2,1242736,2,2860,1395,2861,516,0
20150106.105117,2860,4,1242740,4,2860,1393,2861,516,0
20150106.105118,2860,10,1242750,10,2860,1388,2861,517,0
20150106.10512,2860,2,1242752,2,2860,1387,2861,544,0
20150106.10512,2860,2,1242754,2,2860,1386,2861,595,0
20150106.105123,2860,42,1242796,40,2860,1365,2861,626,0
20150106.105124,2860,4,1242800,4,2860,1363,2861,627,0
20150106.105124,2860,2,1242802,2,2860,1362,2861,625,0
20150106.105126,2860,120,1242922,120,2860,1302,2861,625,0
20150106.105127,2861,14,1242936,-14,2860,1302,2861,618,1
20150106.105128,2860,54,1242990,54,2860,1275,2861,662,0
20150106.105129,2861,2,1242992,-2,2860,1275,2861,666,1
20150106.10513,2860,42,1243034,2,2860,1254,2861,667,0
20150106.10513,2860,100,1243134,0,2860,1204,2861,667,0
20150106.105132,2860,22,1243156,2,2860,1193,2861,683,0
20150106.105133,2860,6,1243162,6,2860,1190,2861,709,0
20150106.105134,2860,122,1243284,120,2860,1131,2861,738,0
20150106.105135,2860,70,1243354,4,2860,1100,2861,730,0
20150106.105135,2860,28,1243382,28,2860,1084,2861,711,0
20150106.105136,2860,2,1243384,2,2860,1083,2861,716,0
20150106.105136,2860,26,1243410,22,2860,1072,2861,715,0
20150106.105137,2860,2,1243412,2,2860,1071,2861,725,0
20150106.105139,2860,2,1243414,2,2860,1090,2861,714,0
20150106.105139,2860,6,1243420,6,2860,1087,2861,714,0
20150106.10514,2860,2,1243422,2,2860,1076,2861,715,0
20150106.105141,2860,2,1243424,2,2860,1075,2861,716,0
20150106.105141,2860,100,1243524,100,2860,1025,2861,716,0
20150106.105142,2860,20,1243544,-16,2860,1024,2861,709,0
20150106.105143,2860,262,1243806,2,2860,893,2861,729,0
20150106.105144,2860,42,1243848,2,2860,872,2861,731,0
20150106.105145,2860,24,1243872,22,2860,860,2861,731,0
20150106.105145,2861,2,1243874,-2,2860,860,2861,736,1
20150106.105146,2860,48,1243922,48,2860,836,2861,730,0
20150106.105147,2860,40,1243962,40,2860,814,2861,731,0
20150106.105147,2860,40,1244002,40,2860,704,2861,732,0
20150106.105148,2860,52,1244054,52,2860,678,2861,685,0
20150106.105149,2860,144,1244198,112,2860,606,2861,688,0
20150106.105149,2860,84,1244282,80,2860,565,2861,687,0
20150106.10515,2860,16,1244298,12,2860,557,2861,688,0
20150106.10515,2860,100,1244398,100,2860,508,2861,702,0
20150106.105151,2860,10,1244408,10,2860,503,2861,702,0
20150106.105152,2860,42,1244450,42,2860,482,2861,699,0
20150106.105152,2860,14,1244464,0,2860,474,2861,699,0
20150106.105152,2860,200,1244664,190,2860,374,2861,704,0
20150106.105153,2860,114,1244778,40,2860,317,2861,711,0
20150106.105153,2860,120,1244898,-6,2860,257,2861,706,0
20150106.105154,2860,12,1244910,0,2860,268,2861,750,0
20150106.105155,2860,10,1244920,-8,2860,264,2861,753,0
20150106.105156,2860,22,1244942,0,2860,253,2861,754,0
20150106.105157,2860,506,1245448,32,2859,959,2860,349,0
20150106.105157,2860,6,1245454,-2,2859,959,2860,377,0
20150106.105158,2859,20,1245474,0,2859,1149,2860,843,0
20150106.105158,2859,2,1245476,-2,2859,1148,2860,845,0
20150106.105159,2859,20,1245496,-20,2859,1138,2860,889,0
20150106.1052,2859,6,1245502,0,2859,1135,2860,898,0
20150106.105202,2860,2,1245504,2,2859,1135,2860,901,1
20150106.105203,2859,2,1245506,-2,2859,1134,2860,963,0
20150106.105204,2859,2,1245508,-2,2859,1134,2860,963,0
20150106.105204,2859,2,1245510,0,2859,1181,2860,964,0
20150106.105205,2859,2,1245512,-2,2859,1180,2860,963,0
20150106.105206,2859,2,1245514,0,2859,1179,2860,964,0
20150106.105209,2859,100,1245614,0,2859,1129,2860,1012,0
20150106.10521,2859,42,1245656,-40,2859,1107,2860,1015,0
20150106.105211,2859,2,1245658,0,2859,1107,2860,556,0
20150106.105211,2859,6,1245664,2,2859,1107,2860,556,0
20150106.105212,2859,4,1245668,-4,2859,1105,2860,569,0
20150106.105214,2859,4,1245672,-2,2859,1104,2860,666,0
20150106.105215,2859,2,1245674,-2,2859,1103,2860,666,0
20150106.105215,2860,60,1245734,0,2859,1103,2860,659,1
20150106.10522,2859,2,1245736,-2,2859,1105,2860,710,0
20150106.105225,2859,4,1245740,0,2859,1106,2860,764,0
20150106.105227,2860,60,1245800,0,2859,1106,2860,719,1
20150106.105231,2860,2,1245802,0,2859,1155,2860,690,1
20150106.105233,2860,14,1245816,4,2859,1155,2860,683,1
20150106.105238,2860,20,1245836,0,2859,1155,2860,651,1
20150106.105241,2860,2,1245838,2,2859,1153,2860,652,1
20150106.105246,2859,10,1245848,0,2859,1147,2860,653,0
20150106.105251,2859,2,1245850,0,2859,1173,2860,704,0
20150106.105252,2860,14,1245864,0,2859,1168,2860,692,1
20150106.105253,2860,2,1245866,0,2859,1165,2860,693,1
20150106.105254,2860,2,1245868,2,2859,1165,2860,692,1
20150106.105257,2860,20,1245888,0,2859,1165,2860,682,1
20150106.1053,2859,4,1245892,-4,2859,1164,2860,699,0
20150106.105308,2859,2,1245894,-2,2859,1168,2860,710,0
20150106.105313,2860,4,1245898,4,2859,1171,2860,717,1
20150106.105314,2860,2,1245900,2,2859,1171,2860,715,1
20150106.105315,2860,122,1246022,0,2859,1170,2860,605,1
20150106.105319,2859,2,1246024,-2,2859,1169,2860,566,0
20150106.10532,2859,180,1246204,10,2859,1079,2860,566,0
20150106.105321,2859,2002,1248206,-1448,2859,80,2860,568,0
20150106.105322,2859,162,1248368,-80,2858,676,2859,365,0
20150106.105322,2859,100,1248468,-68,2858,676,2859,316,0
20150106.105324,2858,2,1248470,0,2858,675,2859,319,0
20150106.105324,2858,2,1248472,-2,2858,674,2859,274,0
20150106.105325,2858,2,1248474,-2,2858,673,2859,274,0
20150106.105325,2859,20,1248494,-20,2858,673,2859,277,1
20150106.105326,2859,12,1248506,-2,2858,668,2859,276,1
20150106.105326,2858,22,1248528,0,2858,667,2859,270,0
20150106.105327,2858,2,1248530,0,2858,671,2859,273,0
20150106.105328,2859,30,1248560,-10,2858,661,2859,278,1
20150106.105329,2858,2,1248562,-2,2858,660,2859,288,0
20150106.105329,2859,26,1248588,14,2858,659,2859,275,1
20150106.10533,2858,2,1248590,-2,2858,659,2859,276,0
20150106.105333,2858,2,1248592,0,2858,678,2859,292,0
20150106.105336,2858,2,1248594,0,2858,679,2859,326,0
20150106.105336,2858,2,1248596,-2,2858,678,2859,349,0
20150106.105337,2858,2,1248598,0,2858,677,2859,351,0
20150106.105338,2858,4,1248602,-4,2858,675,2859,351,0
20150106.105339,2858,2,1248604,0,2858,669,2859,351,0
20150106.10534,2858,46,1248650,-26,2858,646,2859,354,0
20150106.10534,2858,8,1248658,0,2858,642,2859,354,0
20150106.105341,2858,2,1248660,-2,2858,641,2859,354,0
20150106.105341,2859,2,1248662,0,2858,641,2859,353,1
20150106.105344,2858,422,1249084,-252,2858,445,2859,399,0
20150106.105345,2858,6,1249090,0,2858,444,2859,401,0
20150106.105345,2858,16,1249106,16,2858,436,2859,401,0
20150106.105347,2858,10,1249116,10,2858,431,2859,425,0
20150106.105347,2859,4,1249120,2,2858,430,2859,476,1
20150106.105348,2858,8,1249128,0,2858,426,2859,475,0
20150106.105348,2859,14,1249142,10,2858,420,2859,474,1
20150106.105349,2858,20,1249162,4,2858,420,2859,471,0
20150106.10535,2858,102,1249264,58,2858,549,2859,471,0
20150106.10535,2858,2,1249266,2,2858,547,2859,471,0
20150106.105351,2859,2,1249268,0,2858,548,2859,471,1
20150106.105352,2858,16,1249284,10,2858,540,2859,473,0
20150106.105353,2858,2,1249286,0,2858,569,2859,479,0
20150106.105354,2858,2,1249288,0,2858,569,2859,479,0
20150106.105355,2858,6,1249294,-6,2858,568,2859,484,0
20150106.105357,2858,2,1249296,-2,2858,567,2859,525,0
20150106.105358,2858,10,1249306,-2,2858,568,2859,535,0
20150106.105403,2859,2,1249308,2,2858,614,2859,538,1
20150106.105403,2859,8,1249316,0,2858,617,2859,534,1
20150106.105404,2859,2,1249318,2,2858,632,2859,534,1
20150106.105405,2858,46,1249364,-32,2858,614,2859,525,0
20150106.105406,2858,30,1249394,-30,2858,599,2859,526,0
20150106.105406,2859,4,1249398,0,2858,598,2859,530,1
20150106.105407,2858,2,1249400,0,2858,602,2859,530,0
20150106.105408,2858,2,1249402,0,2858,651,2859,530,0
20150106.105411,2858,118,1249520,-16,2858,600,2859,529,0
20150106.105411,2858,602,1250122,-450,2858,299,2859,533,0
20150106.105412,2858,34,1250156,0,2858,287,2859,532,0
20150106.105413,2858,62,1250218,6,2858,260,2859,538,0
20150106.105413,2858,2,1250220,0,2858,261,2859,548,0
20150106.105414,2858,2,1250222,2,2858,472,2859,550,0
20150106.105414,2858,24,1250246,-6,2858,460,2859,550,0
20150106.105415,2858,4,1250250,0,2858,459,2859,550,0
20150106.105415,2858,18,1250268,16,2858,456,2859,550,0
20150106.105416,2858,4,1250272,0,2858,468,2859,549,0
20150106.105417,2858,6,1250278,2,2858,465,2859,548,0
20150106.105417,2858,2,1250280,2,2858,466,2859,546,0
20150106.105418,2858,2,1250282,0,2858,465,2859,546,0
20150106.105418,2858,2,1250284,2,2858,464,2859,546,0
20150106.105419,2858,4,1250288,0,2858,462,2859,546,0
20150106.10542,2858,4,1250292,0,2858,460,2859,545,0
20150106.105421,2858,8,1250300,0,2858,460,2859,545,0
20150106.105424,2858,2,1250302,0,2858,470,2859,551,0
20150106.105426,2859,2,1250304,0,2858,471,2859,550,1
20150106.105427,2858,2,1250306,0,2858,470,2859,548,0
20150106.105428,2858,2,1250308,0,2858,469,2859,549,0
20150106.105428,2859,18,1250326,-4,2858,467,2859,542,1
20150106.105429,2859,4,1250330,-2,2858,466,2859,541,1
20150106.105432,2858,610,1250940,-512,2858,164,2859,542,0
20150106.105433,2858,14,1250954,6,2858,168,2859,542,0
20150106.105434,2858,6,1250960,6,2858,165,2859,542,0
20150106.105434,2858,16,1250976,14,2858,157,2859,542,0
20150106.105435,2858,34,1251010,12,2858,140,2859,542,0
20150106.105435,2858,10,1251020,8,2858,137,2859,541,0
20150106.105436,2858,12,1251032,4,2858,136,2859,542,0
20150106.105437,2858,2,1251034,0,2858,136,2859,542,0
20150106.105437,2858,2,1251036,2,2858,135,2859,542,0
20150106.105438,2858,4,1251040,4,2858,139,2859,542,0
20150106.105439,2858,2,1251042,2,2858,272,2859,543,0
20150106.10544,2858,2,1251044,2,2858,281,2859,543,0
20150106.10544,2858,2,1251046,2,2858,281,2859,543,0
20150106.105441,2858,2,1251048,0,2858,283,2859,543,0
20150106.105444,2858,12,1251060,4,2858,282,2859,543,0
20150106.105445,2858,4,1251064,-4,2858,276,2859,543,0
20150106.105447,2858,6,1251070,0,2858,279,2859,548,0
20150106.105451,2858,10,1251080,-8,2858,294,2859,548,0
20150106.105452,2859,8,1251088,-2,2858,298,2859,544,1
20150106.105454,2859,2,1251090,-2,2858,397,2859,548,1
20150106.105456,2858,20,1251110,0,2858,388,2859,548,0
20150106.105457,2858,12,1251122,0,2858,382,2859,548,0
20150106.105458,2858,2,1251124,0,2858,382,2859,548,0
20150106.105458,2859,2,1251126,0,2858,381,2859,547,1
20150106.105501,2858,2,1251128,0,2858,429,2859,552,0
20150106.105505,2859,16,1251144,-12,2858,427,2859,549,1
20150106.105505,2858,2,1251146,0,2858,426,2859,549,0
20150106.105506,2859,8,1251154,-6,2858,429,2859,546,1
20150106.105507,2859,6,1251160,-2,2858,427,2859,545,1
20150106.105507,2858,410,1251570,56,2858,223,2859,545,0
20150106.105508,2859,6,1251576,0,2858,246,2859,544,1
20150106.105509,2858,24,1251600,0,2858,234,2859,620,0
20150106.10551,2858,8,1251608,-2,2858,233,2859,623,0
20150106.105511,2858,98,1251706,4,2858,184,2859,579,0
20150106.105511,2858,2,1251708,-2,2858,183,2859,579,0
20150106.105512,2858,2,1251710,0,2858,183,2859,579,0
20150106.105512,2859,8,1251718,-8,2858,184,2859,575,1
20150106.105514,2858,2,1251720,-2,2858,164,2859,573,0
20150106.105515,2858,38,1251758,-22,2858,160,2859,557,0
20150106.105516,2858,22,1251780,0,2858,150,2859,559,0
20150106.105517,2858,4,1251784,2,2858,149,2859,558,0
20150106.105517,2858,8,1251792,-2,2858,146,2859,558,0
20150106.105518,2858,16,1251808,-14,2858,138,2859,558,0
20150106.105519,2858,2,1251810,0,2858,137,2859,558,0
20150106.10552,2858,4,1251814,-4,2858,155,2859,560,0
20150106.10552,2858,42,1251856,-34,2858,135,2859,560,0
20150106.105521,2858,22,1251878,20,2858,124,2859,560,0
20150106.105522,2859,2,1251880,0,2858,125,2859,560,1
20150106.105523,2858,16,1251896,14,2857,795,2859,550,0
20150106.105523,2858,10,1251906,4,2857,795,2859,551,0
20150106.105525,2858,2,1251908,0,2857,796,2859,551,0
20150106.105525,2858,20,1251928,-18,2857,796,2859,551,0
20150106.105526,2858,20,1251948,6,2857,796,2859,551,0
20150106.105526,2858,6,1251954,4,2857,796,2859,551,0
20150106.105527,2858,2,1251956,0,2858,106,2859,573,0
20150106.105528,2858,10,1251966,2,2858,101,2859,573,0
20150106.105528,2858,2,1251968,0,2858,100,2859,573,0
20150106.105529,2858,4,1251972,0,2858,101,2859,573,0
20150106.105531,2858,2,1251974,0,2858,103,2859,575,0
20150106.105532,2858,2,1251976,0,2858,102,2859,574,0
20150106.105534,2858,2,1251978,-2,2858,102,2859,575,0
20150106.105535,2859,2,1251980,-2,2858,102,2859,573,1
20150106.105535,2858,18,1251998,-12,2858,94,2859,572,0
20150106.105536,2858,2,1252000,-2,2858,93,2859,572,0
20150106.105537,2858,2,1252002,2,2858,92,2859,572,0
20150106.105539,2858,4,1252006,2,2858,121,2859,571,0
20150106.10554,2859,18,1252024,-14,2858,114,2859,570,1
20150106.105541,2858,6,1252030,0,2858,111,2859,577,0
20150106.105542,2858,4,1252034,0,2858,110,2859,578,0
20150106.105542,2858,6,1252040,-2,2858,109,2859,577,0
20150106.105543,2858,2,1252042,0,2858,108,2859,577,0
20150106.105545,2859,2,1252044,0,2858,371,2859,577,1
20150106.105548,2859,68,1252112,2,2857,848,2859,579,1
20150106.105549,2858,2,1252114,0,2858,339,2859,575,0
20150106.10555,2859,2,1252116,0,2858,357,2859,578,1
20150106.105552,2858,6,1252122,-2,2858,361,2859,580,0
20150106.105554,2859,2,1252124,0,2858,374,2859,503,1
20150106.105555,2858,2,1252126,0,2858,380,2859,503,0
20150106.105556,2859,22,1252148,-10,2858,379,2859,493,1
20150106.105557,2858,154,1252302,-118,2857,839,2859,487,0
20150106.105559,2859,10,1252312,0,2858,327,2859,484,1
20150106.105559,2859,2,1252314,2,2858,321,2859,483,1
20150106.1056,2858,8,1252322,0,2858,323,2859,484,0
20150106.1056,2858,10,1252332,-4,2858,316,2859,484,0
20150106.105603,2859,2,1252334,2,2858,388,2859,490,1
20150106.105605,2858,1028,1253362,-864,2858,750,2859,487,0
20150106.105606,2858,20,1253382,-12,2858,742,2859,486,0
20150106.105607,2858,840,1254222,-840,2858,283,2859,486,0
20150106.105607,2859,2,1254224,2,2858,283,2859,486,1
20150106.105609,2858,10,1254234,0,2858,285,2859,485,0
20150106.105611,2858,208,1254442,-138,2857,844,2859,482,0
20150106.105611,2858,2,1254444,0,2857,843,2859,482,0
20150106.105613,2858,106,1254550,2,2857,843,2859,483,0
20150106.105614,2858,2,1254552,2,2858,142,2859,488,0
20150106.105615,2858,4,1254556,2,2858,140,2859,488,0
20150106.105616,2858,12,1254568,2,2857,846,2859,485,0
20150106.105617,2858,2,1254570,0,2857,852,2859,489,0
20150106.105619,2858,2,1254572,-2,2858,198,2859,496,0
20150106.10562,2858,14,1254586,0,2857,852,2859,492,0
20150106.105621,2858,4,1254590,0,2857,852,2859,492,0
20150106.105621,2858,2,1254592,0,2857,793,2859,492,0
20150106.105622,2858,2,1254594,-2,2857,793,2859,492,0
20150106.105623,2858,14,1254608,-10,2858,260,2859,492,0
20150106.105624,2858,4,1254612,-2,2858,259,2859,493,0
20150106.105625,2858,10,1254622,-4,2858,254,2859,493,0
20150106.105626,2859,2,1254624,2,2858,284,2859,491,1
20150106.105627,2858,2,1254626,0,2858,284,2859,491,0
20150106.105628,2858,2,1254628,0,2858,316,2859,492,0
20150106.105628,2858,2,1254630,0,2858,285,2859,492,0
20150106.10563,2858,2,1254632,0,2858,294,2859,492,0
20150106.105631,2858,2,1254634,0,2858,296,2859,492,0
20150106.105633,2858,4,1254638,-4,2858,292,2859,442,0
20150106.105634,2858,2,1254640,0,2858,292,2859,442,0
20150106.105635,2858,6,1254646,-4,2858,283,2859,442,0
20150106.105637,2858,896,1255542,-720,2858,3,2859,446,0
20150106.105637,2858,2,1255544,0,2858,7,2859,447,0
20150106.105638,2858,6,1255550,-2,2858,5,2859,446,0
20150106.105638,2858,2,1255552,0,2858,65,2859,446,0
20150106.105639,2858,6,1255558,0,2858,65,2859,445,0
20150106.105641,2858,6,1255564,0,2858,111,2859,446,0
20150106.105642,2858,2,1255566,0,2858,112,2859,446,0
20150106.105642,2858,6,1255572,-6,2858,109,2859,476,0
20150106.105644,2858,2,1255574,-2,2858,109,2859,449,0
20150106.105644,2859,2,1255576,2,2858,109,2859,448,1
20150106.105646,2858,2,1255578,-2,2858,117,2859,443,0
20150106.105646,2858,2,1255580,0,2858,116,2859,443,0
20150106.105647,2859,2,1255582,2,2858,116,2859,442,1
20150106.105648,2858,10,1255592,0,2858,112,2859,442,0
20150106.105649,2858,2,1255594,0,2858,112,2859,442,0
20150106.10565,2858,2,1255596,-2,2858,113,2859,442,0
20150106.10565,2858,22,1255618,0,2858,118,2859,438,0
20150106.105651,2859,2,1255620,2,2858,119,2859,437,1
20150106.105651,2858,6,1255626,0,2858,146,2859,438,0
20150106.105652,2859,2,1255628,2,2858,146,2859,458,1
20150106.105654,2858,2,1255630,-2,2858,162,2859,457,0
20150106.105659,2859,4,1255634,2,2858,208,2859,457,1
20150106.105701,2859,2,1255636,2,2858,209,2859,436,1
20150106.105704,2858,2,1255638,0,2858,209,2859,437,0
20150106.105708,2859,2,1255640,2,2858,212,2859,435,1
20150106.105709,2859,4,1255644,0,2858,212,2859,433,1
20150106.10571,2858,2,1255646,0,2858,269,2859,433,0
20150106.105715,2858,6,1255652,0,2858,231,2859,431,0
20150106.105716,2858,4,1255656,-4,2858,229,2859,431,0
20150106.10572,2859,140,1255796,-2,2858,199,2859,331,1
20150106.105721,2858,20,1255816,-20,2858,206,2859,331,0
20150106.105722,2859,20,1255836,0,2858,207,2859,321,1
20150106.105723,2859,12,1255848,0,2858,208,2859,315,1
20150106.105724,2858,2,1255850,0,2858,207,2859,318,0
20150106.105725,2858,2,1255852,0,2858,193,2859,333,0
20150106.105727,2859,2,1255854,0,2858,194,2859,319,1
20150106.105728,2858,40,1255894,6,2858,174,2859,319,0
20150106.10573,2859,2,1255896,0,2858,179,2859,318,1
20150106.105731,2858,2,1255898,2,2858,178,2859,318,0
20150106.105732,2858,2,1255900,2,2858,187,2859,322,0
20150106.105732,2858,2,1255902,2,2858,186,2859,322,0
20150106.105733,2858,6,1255908,0,2858,184,2859,322,0
20150106.105734,2858,42,1255950,22,2858,164,2859,324,0
20150106.105734,2858,2,1255952,2,2858,163,2859,324,0
20150106.105736,2858,2,1255954,2,2858,201,2859,325,0
20150106.105737,2858,2,1255956,2,2858,249,2859,325,0
20150106.105738,2858,30,1255986,20,2858,235,2859,325,0
20150106.105739,2858,2,1255988,2,2858,244,2859,325,0
20150106.10574,2858,2,1255990,2,2858,243,2859,325,0
20150106.105741,2858,12,1256002,0,2858,237,2859,349,0
20150106.105743,2859,2,1256004,2,2858,238,2859,348,1
20150106.105744,2858,2,1256006,2,2858,238,2859,348,0
20150106.105744,2858,202,1256208,128,2858,137,2859,348,0
20150106.105746,2858,2,1256210,-2,2858,138,2859,354,0
20150106.105747,2858,10,1256220,0,2858,134,2859,358,0
20150106.105748,2858,2,1256222,0,2858,135,2859,358,0
20150106.10575,2858,8,1256230,0,2858,134,2859,465,0
20150106.105751,2858,2,1256232,0,2858,132,2859,465,0
20150106.105753,2858,2,1256234,0,2858,132,2859,467,0
20150106.105755,2858,2,1256236,-2,2858,132,2859,467,0
20150106.105757,2859,6,1256242,-2,2858,133,2859,466,1
20150106.105758,2859,2,1256244,0,2858,133,2859,467,1
20150106.105759,2858,2,1256246,2,2858,135,2859,467,0
20150106.105801,2858,4,1256250,-4,2858,136,2859,464,0
20150106.105801,2858,98,1256348,-82,2858,87,2859,464,0
20150106.105802,2858,10,1256358,6,2858,82,2859,464,0
20150106.105802,2858,2,1256360,2,2858,81,2859,464,0
20150106.105804,2858,2,1256362,0,2858,100,2859,471,0
20150106.105806,2858,10,1256372,0,2858,101,2859,473,0
20150106.105808,2858,2,1256374,0,2858,102,2859,473,0
20150106.10581,2858,4,1256378,-2,2858,123,2859,473,0
20150106.105811,2859,20,1256398,20,2858,130,2859,463,1
20150106.105813,2859,46,1256444,-6,2858,140,2859,439,1
20150106.105813,2858,2,1256446,0,2858,139,2859,464,0
20150106.105814,2858,40,1256486,0,2858,116,2859,459,0
20150106.105817,2858,10,1256496,0,2858,108,2859,486,0
20150106.105818,2859,2,1256498,2,2858,114,2859,504,1
20150106.105818,2858,4,1256502,-2,2858,111,2859,505,0
20150106.105819,2858,2,1256504,0,2858,108,2859,516,0
20150106.105821,2858,4,1256508,0,2858,119,2859,532,0
20150106.105821,2858,2,1256510,0,2858,119,2859,532,0
20150106.105822,2858,2,1256512,0,2858,120,2859,532,0
20150106.105822,2858,244,1256756,100,2857,688,2858,463,0
20150106.105823,2858,14,1256770,10,2857,683,2858,457,0
20150106.105824,2857,16,1256786,4,2857,678,2858,483,0
20150106.105825,2857,10,1256796,-4,2857,675,2858,485,0
20150106.105825,2857,2,1256798,-2,2857,674,2858,515,0
20150106.105826,2857,2,1256800,2,2857,673,2858,515,0
20150106.105827,2857,2,1256802,2,2857,672,2858,516,0
20150106.105828,2857,2,1256804,0,2857,671,2858,566,0
20150106.105828,2858,4,1256808,4,2857,671,2858,525,1
20150106.105829,2857,500,1257308,-212,2857,422,2858,528,0
20150106.10583,2857,4,1257312,-2,2857,414,2858,568,0
20150106.105831,2857,10,1257322,-4,2857,408,2858,586,0
20150106.105832,2857,20,1257342,4,2857,397,2858,586,0
20150106.105832,2857,22,1257364,-2,2857,385,2858,586,0
20150106.105833,2857,26,1257390,0,2857,372,2858,588,0
20150106.105833,2857,2,1257392,0,2857,363,2858,597,0
20150106.105834,2858,2,1257394,0,2857,362,2858,596,1
20150106.105836,2858,2,1257396,0,2857,362,2858,596,1
20150106.105836,2858,2,1257398,0,2857,362,2858,595,1
20150106.105837,2857,2,1257400,0,2857,363,2858,597,0
20150106.105838,2857,24,1257424,-24,2857,352,2858,597,0
20150106.105838,2858,2,1257426,2,2857,353,2858,596,1
20150106.105839,2857,2,1257428,0,2857,352,2858,596,0
20150106.10584,2857,2,1257430,0,2857,361,2858,595,0
20150106.105843,2857,2,1257432,0,2857,362,2858,595,0
20150106.105843,2858,2,1257434,0,2857,362,2858,595,1
20150106.105844,2858,2,1257436,2,2857,363,2858,612,1
20150106.105845,2857,50,1257486,-50,2857,340,2858,617,0
20150106.105847,2858,4,1257490,0,2857,356,2858,623,1
20150106.105847,2857,8,1257498,0,2857,352,2858,624,0
20150106.105848,2858,4,1257502,2,2857,351,2858,623,1
20150106.105848,2858,2,1257504,0,2857,361,2858,622,1
20150106.105849,2857,2,1257506,0,2857,360,2858,622,0
20150106.10585,2858,36,1257542,24,2857,356,2858,615,1
20150106.105851,2857,2,1257544,0,2857,355,2858,618,0
20150106.105852,2857,2,1257546,0,2857,354,2858,618,0
20150106.105853,2857,4,1257550,-2,2857,352,2858,618,0
20150106.105854,2857,6,1257556,-4,2857,351,2858,620,0
20150106.105856,2857,2,1257558,-2,2857,352,2858,629,0
20150106.105856,2857,2,1257560,0,2857,362,2858,630,0
20150106.105857,2857,4,1257564,0,2857,360,2858,628,0
20150106.105858,2857,2,1257566,0,2857,359,2858,628,0
20150106.105858,2857,2,1257568,0,2857,358,2858,638,0
20150106.105859,2857,2,1257570,-2,2857,357,2858,638,0
20150106.1059,2857,8,1257578,-2,2857,356,2858,639,0
20150106.1059,2857,2,1257580,0,2857,356,2858,639,0
20150106.105901,2858,20,1257600,0,2857,347,2858,638,1
20150106.105901,2857,2,1257602,-2,2857,346,2858,639,0
20150106.105902,2857,8,1257610,-8,2857,342,2858,636,0
20150106.105903,2857,8,1257618,-4,2857,340,2858,836,0
20150106.105903,2857,2,1257620,0,2857,339,2858,836,0
20150106.105904,2857,6,1257626,-6,2857,336,2858,836,0
20150106.105904,2857,10,1257636,0,2857,331,2858,831,0
20150106.105905,2857,2,1257638,0,2857,340,2858,832,0
20150106.105909,2857,4,1257642,0,2857,333,2858,879,0
20150106.10591,2857,12,1257654,-2,2857,327,2858,880,0
20150106.105911,2857,4,1257658,0,2857,325,2858,881,0
20150106.105912,2857,22,1257680,2,2857,315,2858,880,0
20150106.105913,2857,4,1257684,-4,2857,313,2858,881,0
20150106.105914,2857,14,1257698,-10,2857,307,2858,881,0
20150106.105914,2857,2,1257700,0,2857,306,2858,896,0
20150106.105915,2858,10,1257710,10,2857,305,2858,890,1
20150106.105915,2857,4,1257714,-2,2857,303,2858,890,0
20150106.105916,2857,52,1257766,-40,2857,278,2858,889,0
20150106.105916,2857,2,1257768,-2,2857,277,2858,890,0
20150106.105917,2857,4,1257772,-4,2857,276,2858,890,0
20150106.105917,2857,2,1257774,0,2857,277,2858,890,0
20150106.105919,2858,32,1257806,0,2857,279,2858,880,1
20150106.10592,2857,4,1257810,-4,2857,277,2858,882,0
20150106.105921,2857,12,1257822,-12,2857,280,2858,882,0
20150106.105921,2857,200,1258022,16,2857,180,2858,882,0
20150106.105922,2857,32,1258054,4,2857,164,2858,882,0
20150106.105923,2857,66,1258120,-60,2857,131,2858,883,0
20150106.105923,2857,12,1258132,0,2857,125,2858,883,0
20150106.105924,2857,14,1258146,0,2857,119,2858,881,0
20150106.105924,2857,38,1258184,16,2857,99,2858,881,0
20150106.105925,2857,4,1258188,-2,2857,97,2858,881,0
20150106.105925,2857,6,1258194,0,2857,94,2858,881,0
20150106.105926,2857,12,1258206,4,2857,89,2858,881,0
20150106.105926,2857,22,1258228,12,2857,79,2858,880,0
20150106.105927,2857,8,1258236,2,2857,75,2858,871,0
20150106.105928,2857,28,1258264,10,2857,67,2858,866,0
20150106.105928,2857,32,1258296,0,2857,55,2858,862,0
20150106.105929,2857,4,1258300,-2,2857,56,2858,862,0
20150106.105929,2857,20,1258320,14,2857,49,2858,862,0
20150106.10593,2857,2,1258322,0,2857,48,2858,860,0
20150106.10593,2857,8,1258330,6,2857,46,2858,860,0
20150106.105931,2857,52,1258382,30,2857,70,2858,855,0
20150106.105933,2857,2,1258384,0,2857,81,2858,866,0
20150106.105933,2857,38,1258422,18,2857,63,2858,849,0
20150106.105935,2857,8,1258430,-2,2857,60,2858,851,0
20150106.105935,2857,12,1258442,-12,2857,55,2858,851,0
20150106.105937,2857,40,1258482,0,2857,40,2858,845,0
20150106.105937,2858,4,1258486,2,2857,40,2858,845,1
20150106.105937,2857,2,1258488,0,2857,39,2858,845,0
20150106.105938,2857,2,1258490,0,2857,40,2858,855,0
20150106.105939,2857,22,1258512,-22,2857,29,2858,860,0
20150106.10594,2857,60,1258572,-36,2856,685,2857,72,0
20150106.10594,2857,100,1258672,-90,2856,683,2857,300,0
20150106.105941,2856,10,1258682,4,2856,682,2857,298,0
20150106.105941,2857,2,1258684,-2,2856,682,2857,299,1
20150106.105942,2857,2,1258686,-2,2856,683,2857,298,1
20150106.105943,2856,2,1258688,2,2856,677,2857,299,0
20150106.105944,2856,4,1258692,-2,2856,678,2857,305,0
20150106.105944,2856,142,1258834,-28,2856,607,2857,305,0
20150106.105945,2856,4,1258838,0,2856,609,2857,305,0
20150106.105945,2856,2,1258840,2,2856,609,2857,306,0
20150106.105946,2856,2,1258842,0,2856,608,2857,342,0
20150106.105947,2856,10,1258852,-4,2856,604,2857,342,0
20150106.105947,2856,2,1258854,0,2856,604,2857,372,0
20150106.10595,2857,16,1258870,0,2856,605,2857,367,1
20150106.10595,2856,4,1258874,0,2856,600,2857,369,0
20150106.105951,2857,4,1258878,-4,2856,600,2857,368,1
20150106.105951,2857,4,1258882,0,2856,601,2857,367,1
20150106.105952,2856,2,1258884,-2,2856,601,2857,367,0
20150106.105953,2856,2,1258886,-2,2856,601,2857,367,0
20150106.105958,2856,12,1258898,2,2856,583,2857,828,0
20150106.105959,2856,2,1258900,2,2856,583,2857,828,0
20150106.105959,2856,6,1258906,4,2856,587,2857,838,0
20150106.11,2855,1736,1260642,732,2855,553,2856,148,0
20150106.11,2856,394,1261036,-100,2855,542,2856,175,1
20150106.110001,2856,518,1261554,-234,2855,287,2856,216,1
20150106.110001,2855,2,1261556,2,2855,286,2856,229,0
20150106.110002,2855,46,1261602,4,2855,294,2856,239,0
20150106.110002,2855,240,1261842,-34,2855,183,2856,314,0
20150106.110003,2855,32,1261874,24,2855,167,2856,410,0
20150106.110003,2855,36,1261910,36,2855,149,2856,436,0
20150106.110004,2855,24,1261934,2,2855,137,2856,448,0
20150106.110004,2855,80,1262014,-42,2855,127,2856,518,0
20150106.110005,2855,14,1262028,12,2855,121,2856,520,0
20150106.110005,2855,20,1262048,0,2855,137,2856,521,0
20150106.110006,2855,206,1262254,182,2855,54,2856,581,0
20150106.110006,2855,50,1262304,10,2855,31,2856,598,0
20150106.110007,2856,10,1262314,6,2855,29,2856,617,1
20150106.110007,2855,16,1262330,2,2855,73,2856,651,0
20150106.110008,2855,2,1262332,0,2855,76,2856,651,0
20150106.110008,2855,50,1262382,-10,2855,59,2856,651,0
20150106.110009,2856,8,1262390,-2,2855,56,2856,623,1
20150106.110009,2855,20,1262410,-2,2855,56,2856,622,0
20150106.11001,2856,6,1262416,0,2855,57,2856,627,1
20150106.110011,2855,46,1262462,-44,2855,54,2856,638,0
20150106.110011,2855,2,1262464,0,2855,63,2856,642,0
20150106.110012,2855,4,1262468,0,2855,86,2856,647,0
20150106.110013,2855,102,1262570,6,2855,40,2856,657,0
20150106.110013,2856,2,1262572,-2,2855,56,2856,647,1
20150106.110014,2855,4,1262576,2,2855,139,2856,647,0
20150106.110014,2856,4,1262580,0,2855,170,2856,651,1
20150106.110015,2856,4,1262584,-2,2855,174,2856,658,1
20150106.110016,2855,2,1262586,0,2855,192,2856,684,0
20150106.110016,2856,22,1262608,-16,2855,198,2856,678,1
20150106.110017,2855,6,1262614,-6,2855,197,2856,678,0
20150106.110018,2855,4,1262618,-4,2855,201,2856,678,0
20150106.110019,2855,40,1262658,-16,2855,213,2856,682,0
20150106.11002,2856,12,1262670,-12,2855,219,2856,653,1
20150106.110021,2856,14,1262684,-12,2855,226,2856,623,1
20150106.110021,2855,2,1262686,0,2855,236,2856,597,0
20150106.110022,2855,82,1262768,-80,2855,197,2856,555,0
20150106.110022,2855,8,1262776,-2,2855,200,2856,554,0
20150106.110023,2855,32,1262808,0,2855,203,2856,481,0
20150106.110023,2856,2,1262810,-2,2855,223,2856,477,1
20150106.110024,2855,2,1262812,0,2855,222,2856,477,0
20150106.110024,2856,2,1262814,0,2855,235,2856,476,1
20150106.110025,2856,2,1262816,0,2855,250,2856,475,1
20150106.110026,2856,2,1262818,-2,2855,278,2856,467,1
20150106.110027,2855,4,1262822,-2,2855,329,2856,451,0
20150106.110027,2856,8,1262830,-2,2855,369,2856,469,1
20150106.110028,2855,8,1262838,-4,2855,382,2856,473,0
20150106.110028,2856,6,1262844,-6,2855,382,2856,470,1
20150106.110029,2855,14,1262858,-10,2855,383,2856,464,0
20150106.110029,2855,4,1262862,2,2855,392,2856,464,0
20150106.11003,2855,14,1262876,4,2855,393,2856,460,0
20150106.110031,2856,14,1262890,0,2855,394,2856,583,1
20150106.110031,2855,2,1262892,2,2855,396,2856,583,0
20150106.110032,2856,210,1263102,-202,2855,399,2856,483,1
20150106.110033,2855,8,1263110,0,2855,398,2856,484,0
20150106.110034,2856,202,1263312,154,2855,308,2856,483,1
20150106.110035,2855,204,1263516,52,2855,209,2856,487,0
20150106.110035,2855,2,1263518,2,2855,211,2856,488,0
20150106.110036,2856,8,1263526,-8,2855,210,2856,485,1
20150106.110036,2855,212,1263738,80,2855,113,2856,479,0
20150106.110037,2855,164,1263902,-68,2855,30,2856,479,0
20150106.110037,2855,2,1263904,-2,2855,41,2856,494,0
20150106.110038,2856,4,1263908,-4,2855,45,2856,499,1
20150106.110039,2855,14,1263922,2,2855,36,2856,499,0
20150106.110039,2856,12,1263934,0,2855,97,2856,497,1
20150106.11004,2855,8,1263942,4,2855,97,2856,502,0
20150106.110041,2856,2,1263944,0,2855,102,2856,502,1
20150106.110042,2855,4,1263948,-2,2855,107,2856,502,0
20150106.110042,2855,32,1263980,-10,2855,192,2856,505,0
20150106.110043,2856,2,1263982,-2,2855,241,2856,504,1
20150106.110043,2856,62,1264044,6,2855,284,2856,473,1
20150106.110044,2856,20,1264064,-18,2855,289,2856,464,1
20150106.110044,2855,2,1264066,0,2855,300,2856,464,0
20150106.110045,2856,64,1264130,-42,2855,281,2856,488,1
20150106.110046,2855,4,1264134,-4,2855,281,2856,491,0
20150106.110046,2855,42,1264176,-42,2855,263,2856,490,0
20150106.110047,2855,2,1264178,-2,2855,264,2856,491,0
20150106.110047,2856,2,1264180,0,2855,267,2856,488,1
20150106.110049,2856,4,1264184,-2,2855,380,2856,488,1
20150106.11005,2855,2,1264186,-2,2855,382,2856,488,0
20150106.11005,2855,64,1264250,-20,2855,352,2856,487,0
20150106.110051,2855,2,1264252,0,2855,322,2856,487,0
20150106.110051,2856,8,1264260,-8,2855,341,2856,483,1
20150106.110052,2855,30,1264290,-30,2855,328,2856,483,0
20150106.110052,2855,8,1264298,-8,2855,324,2856,484,0
20150106.110053,2855,4,1264302,-4,2855,326,2856,486,0
20150106.110054,2855,10,1264312,-10,2855,351,2856,486,0
20150106.110054,2855,22,1264334,0,2855,348,2856,485,0
20150106.110055,2855,12,1264346,-2,2855,342,2856,686,0
20150106.110055,2855,12,1264358,-2,2855,338,2856,688,0
20150106.110057,2855,16,1264374,-2,2855,345,2856,693,0
20150106.110058,2855,8,1264382,-4,2855,396,2856,792,0
20150106.110059,2855,10,1264392,-8,2855,394,2856,800,0
20150106.1101,2855,6,1264398,0,2855,392,2856,799,0
20150106.1101,2855,10,1264408,0,2855,390,2856,800,0
20150106.110103,2855,22,1264430,-2,2855,355,2856,799,0
20150106.110105,2855,2,1264432,-2,2855,356,2856,798,0
20150106.110105,2856,2,1264434,0,2855,366,2856,797,1
20150106.110107,2855,8,1264442,-4,2855,348,2856,888,0
20150106.110108,2856,12,1264454,-8,2855,358,2856,882,1
20150106.110108,2855,10,1264464,8,2855,456,2856,880,0
20150106.110109,2855,6,1264470,0,2855,451,2856,883,0
20150106.110109,2855,10,1264480,0,2855,446,2856,898,0
20150106.11011,2856,4,1264484,0,2855,447,2856,894,1
20150106.11011,2856,100,1264584,0,2855,468,2856,855,1
20150106.110111,2855,16,1264600,6,2855,461,2856,862,0
20150106.110113,2856,4,1264604,4,2855,463,2856,861,1
20150106.110114,2855,2,1264606,2,2855,464,2856,840,0
20150106.110115,2856,2,1264608,0,2855,518,2856,846,1
20150106.110115,2855,2,1264610,0,2855,520,2856,846,0
20150106.110116,2855,72,1264682,-18,2855,501,2856,832,0
20150106.110118,2856,2,1264684,2,2855,513,2856,724,1
20150106.110118,2855,42,1264726,-2,2855,515,2856,704,0
20150106.110119,2856,14,1264740,0,2855,566,2856,690,1
20150106.11012,2856,18,1264758,-18,2855,574,2856,672,1
20150106.110121,2856,10,1264768,-10,2855,574,2856,682,1
20150106.110121,2856,10,1264778,-10,2855,592,2856,565,1
20150106.110122,2855,2,1264780,-2,2855,592,2856,575,0
20150106.110123,2856,16,1264796,-4,2855,593,2856,587,1
20150106.110123,2856,6,1264802,-6,2855,593,2856,585,1
20150106.110124,2856,4,1264806,0,2855,593,2856,584,1
20150106.110124,2856,2,1264808,0,2855,600,2856,583,1
20150106.110125,2856,2,1264810,0,2855,596,2856,582,1
20150106.110125,2855,2,1264812,-2,2855,595,2856,587,0
20150106.110126,2856,38,1264850,-12,2855,594,2856,569,1
20150106.110126,2855,2,1264852,0,2855,614,2856,569,0
20150106.110127,2856,12,1264864,0,2855,619,2856,548,1
20150106.110129,2855,2,1264866,0,2855,623,2856,547,0
20150106.110129,2856,12,1264878,12,2855,622,2856,522,1
20150106.110131,2856,2,1264880,2,2855,613,2856,521,1
20150106.110132,2856,4,1264884,0,2855,618,2856,519,1
20150106.110132,2856,2,1264886,0,2855,637,2856,518,1
20150106.110133,2856,4,1264890,0,2855,636,2856,517,1
20150106.110133,2855,402,1265292,-108,2855,442,2856,523,0
20150106.110134,2856,4,1265296,2,2855,523,2856,521,1
20150106.110135,2856,444,1265740,-382,2855,321,2856,499,1
20150106.110136,2856,410,1266150,-74,2855,120,2856,495,1
20150106.110137,2855,6,1266156,2,2855,119,2856,597,0
20150106.110137,2855,250,1266406,-172,2854,2056,2855,110,0
20150106.110138,2855,322,1266728,-266,2855,1,2856,659,0
20150106.110138,2855,12,1266740,-2,2855,99,2856,609,0
20150106.110139,2856,2,1266742,2,2855,99,2856,608,1
20150106.110139,2855,8,1266750,0,2855,95,2856,608,0
20150106.11014,2855,292,1267042,-214,2854,1753,2855,157,0
20150106.11014,2855,316,1267358,12,2855,53,2856,659,0
20150106.110141,2856,66,1267424,4,2855,78,2856,609,1
20150106.110141,2855,158,1267582,-144,2854,1748,2855,223,0
20150106.110142,2855,20,1267602,-20,2854,1748,2855,214,0
20150106.110142,2855,314,1267916,0,2854,1747,2855,57,0
20150106.110143,2855,134,1268050,-18,2855,228,2856,609,0
20150106.110143,2855,402,1268452,-398,2855,29,2856,609,0
20150106.110144,2856,12,1268464,0,2855,33,2856,607,1
20150106.110145,2855,2,1268466,0,2855,38,2856,613,0
20150106.110145,2855,86,1268552,-74,2854,1744,2855,111,0
20150106.110146,2855,8,1268560,-6,2854,1739,2855,163,0
20150106.110148,2855,6,1268566,0,2854,1553,2855,167,0
20150106.110148,2854,10,1268576,-4,2854,1552,2855,185,0
20150106.110149,2854,58,1268634,-32,2854,1542,2855,178,0
20150106.110149,2854,16,1268650,-8,2854,1534,2855,193,0
20150106.11015,2854,26,1268676,-22,2854,1522,2855,196,0
20150106.11015,2854,204,1268880,-200,2854,1422,2855,196,0
20150106.110151,2854,32,1268912,-6,2854,1409,2855,195,0
20150106.110152,2854,4,1268916,0,2854,1410,2855,210,0
20150106.110153,2854,2,1268918,-2,2854,1409,2855,230,0
20150106.110154,2854,6,1268924,0,2854,1407,2855,268,0
20150106.110155,2855,2,1268926,0,2854,1414,2855,288,1
20150106.110156,2854,2,1268928,0,2854,1413,2855,289,0
20150106.110156,2855,40,1268968,0,2854,1413,2855,269,1
20150106.110158,2854,602,1269570,0,2854,1103,2855,303,0
20150106.110158,2855,6,1269576,-6,2854,1103,2855,302,1
20150106.110159,2854,6,1269582,0,2854,1101,2855,303,0
20150106.110159,2854,12,1269594,0,2854,1095,2855,305,0
20150106.1102,2854,20,1269614,0,2854,1086,2855,324,0
20150106.110201,2854,2,1269616,0,2854,1085,2855,325,0
20150106.110202,2855,4,1269620,-2,2854,1087,2855,325,1
20150106.110203,2855,14,1269634,0,2854,1143,2855,320,1
20150106.110204,2854,2,1269636,-2,2854,1144,2855,321,0
20150106.110204,2855,2,1269638,0,2854,1146,2855,323,1
20150106.110205,2854,2,1269640,0,2854,1146,2855,314,0
20150106.110205,2854,4,1269644,0,2854,1145,2855,324,0
20150106.110206,2855,10,1269654,10,2854,1145,2855,319,1
20150106.110208,2855,2,1269656,0,2854,1155,2855,319,1
20150106.110209,2855,4,1269660,4,2854,1165,2855,318,1
20150106.11021,2855,16,1269676,6,2854,1175,2855,310,1
20150106.110211,2855,22,1269698,22,2854,1177,2855,309,1
20150106.110212,2855,14,1269712,2,2854,1177,2855,253,1
20150106.110212,2855,6,1269718,4,2854,1178,2855,248,1
20150106.110213,2855,14,1269732,-4,2854,1174,2855,267,1
20150106.110213,2855,28,1269760,8,2854,1174,2855,254,1
20150106.110214,2855,18,1269778,-8,2854,1170,2855,248,1
20150106.110214,2855,4,1269782,-4,2854,1171,2855,248,1
20150106.110215,2855,16,1269798,-2,2854,1165,2855,251,1
20150106.110215,2854,14,1269812,0,2854,1160,2855,249,0
20150106.110216,2855,12,1269824,8,2854,1160,2855,243,1
20150106.110216,2855,2,1269826,2,2854,1162,2855,243,1
20150106.110218,2855,8,1269834,0,2854,1163,2855,249,1
20150106.110218,2855,40,1269874,-36,2854,1163,2855,239,1
20150106.110219,2855,2,1269876,0,2854,1163,2855,238,1
20150106.11022,2855,6,1269882,-4,2854,1163,2855,238,1
20150106.110221,2855,2,1269884,-2,2854,1181,2855,246,1
20150106.110221,2855,6,1269890,-4,2854,1180,2855,244,1
20150106.110222,2855,10,1269900,-4,2854,1180,2855,241,1
20150106.110222,2855,2,1269902,0,2854,1185,2855,240,1
20150106.110223,2855,6,1269908,2,2854,1167,2855,237,1
20150106.110223,2855,8,1269916,2,2854,1167,2855,250,1
20150106.110224,2855,2,1269918,0,2854,1178,2855,249,1
20150106.110224,2854,8,1269926,-4,2854,1175,2855,251,0
20150106.110224,2855,2,1269928,0,2854,1189,2855,250,1
20150106.110225,2855,30,1269958,8,2854,1189,2855,236,1
20150106.110227,2855,22,1269980,2,2854,1192,2855,216,1
20150106.110228,2854,16,1269996,-14,2854,1194,2855,210,0
20150106.110228,2855,36,1270032,4,2854,1195,2855,192,1
20150106.110229,2855,242,1270274,-74,2854,1194,2855,73,1
20150106.110229,2855,52,1270326,4,2854,1184,2855,47,1
20150106.11023,2855,94,1270420,62,2854,1183,2855,1,1
20150106.11023,2855,18,1270438,10,2855,18,2856,3014,1
20150106.110231,2855,20,1270458,12,2855,192,2856,3010,1
20150106.110231,2855,12,1270470,-4,2855,188,2856,3010,1
20150106.110232,2855,2,1270472,-2,2855,207,2856,3011,1
20150106.110233,2855,2,1270474,-2,2855,206,2856,3010,1
20150106.110233,2855,128,1270602,126,2855,174,2856,3010,1
20150106.110234,2855,252,1270854,0,2855,58,2856,2992,1
20150106.110234,2855,150,1271004,6,2854,1124,2855,40,1
20150106.110235,2855,4,1271008,0,2854,1124,2855,58,1
20150106.110236,2855,22,1271030,2,2854,1124,2855,149,1
20150106.110237,2855,8,1271038,2,2854,1125,2855,146,1
20150106.110237,2855,18,1271056,10,2854,1141,2855,167,1
20150106.110238,2855,2,1271058,2,2854,1178,2855,166,1
20150106.110239,2855,2,1271060,2,2854,1178,2855,195,1
20150106.110239,2855,10,1271070,0,2854,1178,2855,200,1
20150106.11024,2855,32,1271102,32,2854,1178,2855,184,1
20150106.11024,2855,2,1271104,0,2854,1178,2855,183,1
20150106.110241,2855,2,1271106,0,2854,1160,2855,186,1
20150106.110241,2855,2,1271108,0,2854,1160,2855,185,1
20150106.110242,2855,42,1271150,40,2854,1160,2855,176,1
20150106.110242,2855,26,1271176,20,2854,1142,2855,166,1
20150106.110243,2855,4,1271180,0,2854,1152,2855,175,1
20150106.110246,2855,4,1271184,2,2854,1149,2855,183,1
20150106.110246,2854,22,1271206,-20,2854,1199,2855,182,0
20150106.110247,2855,4,1271210,0,2854,1200,2855,180,1
20150106.110247,2855,44,1271254,-40,2854,1200,2855,158,1
20150106.110248,2855,54,1271308,-10,2854,1200,2855,133,1
20150106.110248,2855,268,1271576,150,2855,214,2856,3056,1
20150106.110249,2856,4,1271580,-4,2855,310,2856,3054,1
20150106.110249,2856,2,1271582,-2,2855,334,2856,3053,1
20150106.11025,2855,6,1271588,6,2855,351,2856,3053,0
20150106.110252,2855,2,1271590,0,2855,381,2856,3047,0
20150106.110253,2856,4,1271594,0,2855,382,2856,3047,1
20150106.110253,2856,10,1271604,-4,2855,382,2856,3042,1
20150106.110254,2856,2,1271606,2,2855,392,2856,3008,1
20150106.110256,2855,6,1271612,0,2855,424,2856,3008,0
20150106.110256,2855,8,1271620,8,2855,422,2856,3007,0
20150106.110257,2855,2,1271622,2,2855,487,2856,2990,0
20150106.110259,2856,2,1271624,0,2855,502,2856,2989,1
20150106.110259,2856,20,1271644,0,2855,502,2856,2979,1
20150106.110301,2856,4,1271648,2,2855,505,2856,2978,1
20150106.110302,2856,2,1271650,2,2855,506,2856,3046,1
20150106.110306,2856,4,1271654,0,2855,577,2856,3050,1
20150106.110311,2856,10,1271664,10,2855,579,2856,3064,1
20150106.110312,2856,2,1271666,2,2855,580,2856,3063,1
20150106.110315,2856,204,1271870,-42,2855,602,2856,2962,1
20150106.110315,2856,2,1271872,0,2855,602,2856,2960,1
20150106.110322,2855,8,1271880,4,2855,634,2856,2934,0
20150106.110323,2856,2,1271882,0,2855,636,2856,2933,1
20150106.110327,2856,8,1271890,-8,2855,640,2856,2858,1
20150106.110328,2855,42,1271932,-2,2855,621,2856,2857,0
20150106.11033,2856,2,1271934,-2,2855,622,2856,2857,1
20150106.110332,2855,2,1271936,0,2855,451,2856,2853,0
20150106.110333,2856,2,1271938,0,2855,446,2856,2856,1
20150106.110335,2855,30,1271968,-4,2855,447,2856,2852,0
20150106.110335,2855,2,1271970,0,2855,450,2856,2852,0
20150106.110337,2856,4,1271974,0,2855,455,2856,2850,1
20150106.110337,2855,8,1271982,6,2855,435,2856,2850,0
20150106.11034,2855,4,1271986,0,2855,434,2856,2850,0
20150106.110341,2855,10,1271996,10,2855,429,2856,2850,0
20150106.110342,2855,2,1271998,2,2855,430,2856,2850,0
20150106.110343,2856,10,1272008,-10,2855,434,2856,2845,1
20150106.110346,2855,4,1272012,0,2855,437,2856,2850,0
20150106.110347,2855,2,1272014,0,2855,587,2856,2851,0
20150106.110348,2855,4,1272018,0,2855,585,2856,2851,0
20150106.110349,2855,10,1272028,10,2855,581,2856,2851,0
20150106.11035,2855,120,1272148,120,2855,518,2856,2791,0
20150106.11035,2855,2,1272150,0,2855,516,2856,2791,0
20150106.11035,2855,32,1272182,16,2855,500,2856,2775,0
20150106.110351,2855,40,1272222,2,2855,480,2856,2755,0
20150106.110352,2855,2,1272224,-2,2855,481,2856,2755,0
20150106.110352,2855,2,1272226,0,2855,480,2856,2755,0
20150106.110353,2855,2,1272228,0,2855,479,2856,2749,0
20150106.110354,2855,8,1272236,-4,2855,477,2856,2750,0
20150106.110354,2856,280,1272516,-18,2855,477,2856,2610,1
20150106.110355,2856,2,1272518,2,2855,478,2856,2609,1
20150106.110356,2856,2,1272520,0,2855,477,2856,2614,1
20150106.110356,2855,8,1272528,4,2855,475,2856,2611,0
20150106.110357,2855,202,1272730,112,2855,374,2856,2611,0
20150106.110357,2855,2,1272732,-2,2855,373,2856,2611,0
20150106.110357,2855,2,1272734,0,2855,372,2856,2611,0
20150106.110358,2855,20,1272754,0,2855,372,2856,2611,0
20150106.110359,2855,42,1272796,-28,2855,351,2856,2611,0
20150106.1104,2856,4,1272800,4,2855,362,2856,2609,1
20150106.110403,2855,132,1272932,16,2855,345,2856,2543,0
20150106.110404,2855,6,1272938,6,2855,344,2856,2543,0
20150106.110406,2855,2,1272940,0,2855,403,2856,2542,0
20150106.110406,2855,386,1273326,-20,2855,210,2856,2349,0
20150106.110407,2855,60,1273386,-2,2855,181,2856,2320,0
20150106.110407,2855,6,1273392,-2,2855,203,2856,2362,0
20150106.110408,2855,336,1273728,-208,2855,36,2856,2365,0
20150106.110408,2855,74,1273802,-20,2854,1135,2855,7,0
20150106.11041,2855,4,1273806,2,2854,1134,2855,95,0
20150106.11041,2855,10,1273816,-6,2854,1134,2855,90,0
20150106.110411,2855,24,1273840,20,2854,1129,2855,111,0
20150106.110412,2855,100,1273940,4,2854,1129,2855,63,0
20150106.110412,2854,120,1274060,-32,2854,1127,2855,7,0
20150106.110413,2855,6,1274066,-4,2854,1127,2855,5,1
20150106.110413,2855,2,1274068,2,2854,1127,2855,4,1
20150106.110414,2855,2,1274070,2,2854,1127,2855,3,1
20150106.110415,2855,12,1274082,0,2854,1127,2855,5,1
20150106.110417,2855,2,1274084,2,2854,1127,2855,14,1
20150106.11042,2855,90,1274174,14,2854,1127,2855,30,1
20150106.11042,2855,64,1274238,-48,2855,3,2856,2554,1
20150106.110421,2856,102,1274340,-14,2855,57,2856,2498,1
20150106.110421,2855,10,1274350,-4,2855,61,2856,2501,0
20150106.110422,2855,2,1274352,0,2855,62,2856,2550,0
20150106.110422,2856,2,1274354,0,2855,67,2856,2552,1
20150106.110424,2855,4,1274358,0,2855,65,2856,2542,0
20150106.110424,2855,64,1274422,0,2855,33,2856,2488,0
20150106.110424,2855,2,1274424,0,2855,33,2856,2488,0
20150106.110426,2855,2,1274426,0,2855,37,2856,2490,0
20150106.110426,2855,2,1274428,0,2855,41,2856,2495,0
20150106.110427,2855,32,1274460,2,2855,26,2856,2392,0
20150106.110428,2856,6,1274466,0,2855,28,2856,2273,1
20150106.110429,2855,12,1274478,0,2855,23,2856,2343,0
20150106.110429,2855,2,1274480,0,2855,23,2856,2343,0
20150106.11043,2855,90,1274570,-36,2855,9,2856,2312,0
20150106.110431,2855,2,1274572,0,2855,25,2856,2312,0
20150106.110432,2855,38,1274610,2,2855,30,2856,2328,0
20150106.110433,2855,8,1274618,-8,2855,28,2856,2328,0
20150106.110433,2855,6,1274624,2,2855,25,2856,2329,0
20150106.110435,2855,4,1274628,0,2855,23,2856,2329,0
20150106.110437,2855,2,1274630,0,2855,24,2856,2341,0
20150106.110438,2855,2,1274632,0,2855,25,2856,2341,0
20150106.110438,2856,46,1274678,-46,2855,25,2856,2318,1
20150106.11044,2855,4,1274682,0,2855,43,2856,2320,0
20150106.110442,2855,6,1274688,0,2855,167,2856,2320,0
20150106.110443,2855,2,1274690,-2,2855,176,2856,2320,0
20150106.110443,2855,2,1274692,0,2855,192,2856,2320,0
20150106.110444,2855,34,1274726,6,2855,180,2856,2522,0
20150106.110446,2855,4,1274730,0,2855,172,2856,2516,0
20150106.110447,2855,10,1274740,0,2855,168,2856,2522,0
20150106.110448,2856,2,1274742,0,2855,173,2856,2521,1
20150106.110449,2855,10,1274752,10,2855,170,2856,2521,0
20150106.110449,2856,10,1274762,6,2855,166,2856,2520,1
20150106.110451,2855,4,1274766,0,2855,170,2856,2516,0
20150106.110451,2855,2,1274768,0,2855,169,2856,2515,0
20150106.110455,2856,20,1274788,-20,2855,199,2856,2485,1
20150106.110456,2856,14,1274802,-14,2855,199,2856,2285,1
20150106.110458,2855,2,1274804,-2,2855,215,2856,2286,0
20150106.110458,2855,2,1274806,0,2855,215,2856,2287,0
20150106.110459,2856,2,1274808,-2,2855,216,2856,2288,1
20150106.1105,2855,20,1274828,16,2855,220,2856,2288,0
20150106.1105,2855,2,1274830,0,2855,222,2856,2288,0
20150106.110501,2856,2,1274832,-2,2855,219,2856,2288,1
20150106.110502,2855,2,1274834,2,2855,218,2856,2288,0
20150106.110502,2855,2,1274836,2,2855,217,2856,2348,0
20150106.110503,2856,2,1274838,0,2855,219,2856,2347,1
20150106.110503,2856,4,1274842,0,2855,221,2856,2345,1
20150106.110504,2856,2,1274844,0,2855,223,2856,2317,1
20150106.110504,2855,6,1274850,0,2855,223,2856,2317,0
20150106.110505,2855,2,1274852,2,2855,223,2856,2316,0
20150106.110506,2856,4,1274856,-4,2855,223,2856,2313,1
20150106.110507,2855,6,1274862,-2,2855,276,2856,2317,0
20150106.11051,2856,20,1274882,-20,2855,284,2856,2301,1
20150106.11051,2856,2,1274884,0,2855,286,2856,2300,1
20150106.110514,2856,12,1274896,8,2855,298,2856,2306,1
20150106.110515,2856,2,1274898,0,2855,302,2856,2294,1
20150106.110517,2856,4,1274902,-4,2855,305,2856,2313,1
20150106.110518,2856,510,1275412,-356,2855,306,2856,2054,1
20150106.110519,2856,2,1275414,-2,2855,319,2856,2050,1
20150106.110522,2855,6,1275420,-2,2855,325,2856,2043,0
20150106.110522,2856,2,1275422,-2,2855,330,2856,2042,1
20150106.110525,2855,2,1275424,2,2855,349,2856,2037,0
20150106.110526,2855,6,1275430,6,2855,348,2856,2039,0
20150106.110527,2856,8,1275438,-4,2855,348,2856,2044,1
20150106.110529,2855,10,1275448,10,2855,354,2856,2013,0
20150106.11053,2856,2,1275450,-2,2855,359,2856,2012,1
20150106.11053,2856,8,1275458,0,2855,358,2856,2009,1
20150106.110531,2856,1000,1276458,-1000,2855,359,2856,1509,1
20150106.110531,2856,2014,1278472,-6,2855,358,2856,505,1
20150106.110532,2856,1048,1279520,90,2856,309,2857,609,1
20150106.110532,2857,130,1279650,42,2856,356,2857,478,1
20150106.110533,2857,4,1279654,-2,2856,369,2857,479,1
20150106.110533,2857,6,1279660,0,2856,369,2857,477,1
20150106.110534,2857,4,1279664,0,2856,369,2857,478,1
20150106.110534,2857,22,1279686,2,2856,352,2857,503,1
20150106.110535,2857,2,1279688,0,2856,370,2857,504,1
20150106.110536,2857,10,1279698,4,2856,370,2857,500,1
20150106.110537,2857,2,1279700,0,2856,292,2857,499,1
20150106.110537,2857,2,1279702,2,2856,262,2857,497,1
20150106.110538,2856,30,1279732,-2,2856,249,2857,487,0
20150106.110538,2857,26,1279758,-24,2856,250,2857,475,1
20150106.110539,2857,40,1279798,-20,2856,250,2857,461,1
20150106.11054,2857,68,1279866,12,2856,5256,2857,264,1
20150106.11054,2857,500,1280366,70,2857,50,2858,988,1
20150106.11054,2858,26,1280392,0,2857,57,2858,969,1
20150106.110541,2857,146,1280538,-106,2856,5136,2857,981,0
20150106.110541,2856,4,1280542,-2,2856,5136,2857,980,0
20150106.110542,2857,4,1280546,-4,2856,5137,2857,984,1
20150106.110543,2857,24,1280570,-22,2856,5140,2857,1035,1
20150106.110543,2857,4,1280574,-4,2856,5139,2857,1037,1
20150106.110544,2857,4,1280578,-4,2856,5140,2857,1034,1
20150106.110545,2857,2,1280580,0,2856,5149,2857,1033,1
20150106.110546,2857,200,1280780,-200,2856,5149,2857,936,1
20150106.110546,2857,14,1280794,-12,2856,5150,2857,891,1
20150106.110547,2856,6,1280800,0,2856,5150,2857,888,0
20150106.110548,2857,52,1280852,-28,2856,5149,2857,862,1
20150106.110548,2857,34,1280886,-32,2856,5152,2857,911,1
20150106.110549,2857,16,1280902,-16,2856,5157,2857,908,1
20150106.11055,2857,2,1280904,0,2856,5157,2857,908,1
20150106.110551,2857,12,1280916,0,2856,5157,2857,959,1
20150106.110551,2857,12,1280928,-10,2856,5158,2857,953,1
20150106.110552,2857,22,1280950,-20,2856,5157,2857,946,1
20150106.110552,2857,20,1280970,-20,2856,5157,2857,970,1
20150106.110553,2857,378,1281348,-376,2856,5157,2857,784,1
20150106.110553,2857,206,1281554,-16,2856,5158,2857,683,1
20150106.110554,2857,44,1281598,0,2856,5158,2857,662,1
20150106.110554,2857,26,1281624,-24,2856,5159,2857,651,1
20150106.110555,2857,218,1281842,-16,2856,5159,2857,542,1
20150106.110556,2857,48,1281890,-46,2856,5159,2857,518,1
20150106.110557,2856,224,1282114,-214,2856,5155,2857,411,0
20150106.110557,2857,2,1282116,-2,2856,5154,2857,410,1
20150106.110558,2857,20,1282136,-20,2856,5159,2857,410,1
20150106.110558,2857,200,1282336,-26,2856,5159,2857,340,1
20150106.110558,2857,12,1282348,-12,2856,5160,2857,334,1
20150106.110559,2857,8,1282356,-4,2856,5157,2857,348,1
20150106.1106,2857,12,1282368,-10,2856,5157,2857,347,1
20150106.1106,2857,12,1282380,-6,2856,5161,2857,494,1
20150106.110601,2857,12,1282392,0,2856,5157,2857,491,1
20150106.110601,2857,4,1282396,0,2856,5158,2857,489,1
20150106.110603,2857,40,1282436,-12,2856,5194,2857,475,1
20150106.110604,2857,12,1282448,0,2856,194,2857,466,1
20150106.110604,2857,18,1282466,-8,2856,187,2857,541,1
20150106.110605,2857,10,1282476,0,2856,172,2857,536,1
20150106.110605,2857,2,1282478,2,2856,172,2857,556,1
20150106.110606,2857,4,1282482,-2,2856,170,2857,696,1
20150106.110607,2856,20,1282502,-2,2856,160,2857,706,0
20150106.110608,2856,2,1282504,-2,2856,159,2857,710,0
20150106.11061,2857,26,1282530,4,2856,164,2857,403,1
20150106.110611,2857,14,1282544,0,2856,162,2857,400,1
20150106.110611,2856,2,1282546,0,2856,162,2857,400,0
20150106.110612,2857,10,1282556,10,2856,162,2857,417,1
20150106.110613,2856,2,1282558,0,2856,161,2857,417,0
20150106.110614,2857,20,1282578,0,2856,159,2857,381,1
20150106.110616,2856,10,1282588,-10,2856,154,2857,603,0
20150106.110618,2856,12,1282600,-2,2856,200,2857,602,0
20150106.110619,2856,2,1282602,0,2856,204,2857,395,0
20150106.110622,2857,2,1282604,0,2856,208,2857,393,1
20150106.110626,2856,6,1282610,0,2856,190,2857,434,0
20150106.110627,2857,20,1282630,2,2856,195,2857,425,1
20150106.11063,2857,2,1282632,0,2856,193,2857,445,1
20150106.110636,2856,504,1283136,62,2855,503,2856,14,0
20150106.110637,2857,8,1283144,-2,2856,3,2857,607,1
20150106.110637,2856,10,1283154,-6,2856,7,2857,617,0
20150106.110638,2856,2,1283156,-2,2856,6,2857,622,0
20150106.110639,2856,26,1283182,-12,2855,556,2857,401,0
20150106.110641,2856,6,1283188,2,2855,487,2856,515,0
20150106.110644,2856,2,1283190,2,2855,480,2856,540,0
20150106.110646,2855,2,1283192,2,2855,499,2856,541,0
20150106.110648,2855,10,1283202,10,2855,496,2856,141,0
20150106.110649,2855,2,1283204,2,2855,498,2856,94,0
20150106.11065,2856,108,1283312,94,2855,497,2856,27,1
20150106.110651,2856,42,1283354,6,2855,493,2856,24,1
20150106.110652,2856,4,1283358,2,2855,487,2856,24,1
20150106.110652,2856,2,1283360,-2,2855,492,2856,25,1
20150106.110653,2856,4,1283364,-2,2855,511,2856,47,1
20150106.110656,2856,10,1283374,10,2855,544,2856,506,1
20150106.110659,2856,6,1283380,6,2855,527,2856,512,1
20150106.110659,2856,10,1283390,-2,2855,525,2856,509,1
20150106.1107,2856,4,1283394,0,2855,525,2856,507,1
20150106.110702,2856,2,1283396,0,2855,523,2856,408,1
20150106.110702,2856,2,1283398,2,2855,523,2856,407,1
20150106.110703,2855,2,1283400,0,2855,522,2856,407,0
20150106.110706,2855,10,1283410,10,2855,527,2856,428,0
20150106.110707,2856,2,1283412,2,2855,529,2856,428,1
20150106.110708,2855,2,1283414,0,2855,528,2856,256,0
20150106.110709,2856,10,1283424,8,2855,532,2856,250,1
20150106.110711,2855,60,1283484,58,2855,502,2856,250,0
20150106.110715,2855,20,1283504,10,2855,511,2856,254,0
20150106.110717,2856,2,1283506,0,2855,512,2856,823,1
20150106.110717,2856,6,1283512,0,2855,459,2856,860,1
20150106.110719,2856,8,1283520,0,2855,460,2856,860,1
20150106.11072,2855,4,1283524,4,2855,458,2856,865,0
20150106.110722,2855,406,1283930,-226,2855,259,2856,875,0
20150106.110723,2856,18,1283948,0,2855,256,2856,866,1
20150106.110724,2855,2,1283950,-2,2855,256,2856,867,0
20150106.110724,2855,4,1283954,4,2855,254,2856,867,0
20150106.110725,2855,2,1283956,2,2855,254,2856,867,0
20150106.110725,2855,50,1284006,36,2855,239,2856,850,0
20150106.110726,2855,20,1284026,0,2855,254,2856,852,0
20150106.110727,2855,4,1284030,-2,2855,252,2856,866,0
20150106.110729,2855,506,1284536,-350,2854,1179,2855,9,0
20150106.11073,2855,72,1284608,-68,2854,1181,2855,76,0
20150106.110731,2855,4,1284612,-2,2854,1181,2855,65,0
20150106.110733,2855,6,1284618,-4,2854,1183,2855,74,0
20150106.110733,2855,4,1284622,0,2854,1183,2855,72,0
20150106.110734,2854,22,1284644,-20,2854,1173,2855,71,0
20150106.110736,2854,6,1284650,-6,2854,1171,2855,89,0
20150106.110736,2855,188,1284838,-120,2855,259,2856,897,1
20150106.110737,2855,10,1284848,-8,2855,265,2856,892,1
20150106.110737,2855,2,1284850,0,2855,265,2856,891,1
20150106.110738,2855,14,1284864,0,2855,258,2856,891,1
20150106.110739,2855,8,1284872,-8,2855,256,2856,911,1
20150106.11074,2855,2,1284874,-2,2855,255,2856,911,1
20150106.110741,2855,10,1284884,0,2855,301,2856,911,1
20150106.110741,2855,10,1284894,0,2855,314,2856,912,1
20150106.110742,2855,4,1284898,0,2855,312,2856,912,1
20150106.110743,2855,2,1284900,0,2855,311,2856,913,1
20150106.110743,2855,2,1284902,-2,2855,310,2856,914,1
20150106.110744,2855,2,1284904,0,2855,309,2856,919,1
20150106.110745,2856,10,1284914,10,2855,310,2856,914,1
20150106.110746,2855,308,1285222,-308,2855,166,2856,910,0
20150106.110747,2855,2,1285224,0,2855,165,2856,911,0
20150106.110747,2855,256,1285480,2,2855,38,2856,911,0
20150106.110748,2855,76,1285556,-54,2854,1180,2855,100,0
20150106.110749,2855,2,1285558,0,2854,1181,2855,108,0
20150106.11075,2855,4,1285562,4,2854,1181,2855,106,0
20150106.11075,2855,212,1285774,-116,2855,8,2856,929,0
20150106.110751,2855,2,1285776,-2,2855,125,2856,925,0
20150106.110752,2855,6,1285782,0,2855,124,2856,924,0
20150106.110753,2855,2,1285784,0,2855,123,2856,934,0
20150106.110754,2856,54,1285838,-30,2855,103,2856,928,1
20150106.110754,2855,20,1285858,0,2855,94,2856,924,0
20150106.110756,2855,2,1285860,-2,2855,99,2856,925,0
20150106.110756,2855,42,1285902,-42,2855,78,2856,925,0
20150106.110757,2855,102,1286004,-2,2855,32,2856,925,0
20150106.110757,2855,2,1286006,2,2855,32,2856,925,0
20150106.110759,2855,66,1286072,-10,2854,1183,2855,101,0
20150106.110759,2855,6,1286078,0,2854,1183,2855,99,0
20150106.1108,2855,244,1286322,-100,2854,1183,2855,8,0
20150106.1108,2855,18,1286340,2,2855,4,2856,1250,0
20150106.110802,2855,10,1286350,-2,2854,1187,2855,1,0
20150106.110802,2855,2,1286352,0,2854,1225,2855,251,0
20150106.110803,2855,6,1286358,2,2854,1224,2855,250,0
20150106.110803,2855,12,1286370,0,2854,1224,2855,244,0
20150106.110804,2855,12,1286382,12,2854,1224,2855,245,0
20150106.110805,2855,8,1286390,6,2854,1216,2855,236,0
20150106.110806,2854,2,1286392,0,2854,1215,2855,239,0
20150106.110807,2855,8,1286400,8,2854,1226,2855,237,1
20150106.110809,2855,16,1286416,2,2854,1226,2855,230,1
20150106.110809,2855,4,1286420,0,2854,1257,2855,232,1
20150106.110811,2855,2,1286422,2,2854,1256,2855,233,1
20150106.110812,2855,4,1286426,4,2854,1256,2855,231,1
20150106.110814,2855,10,1286436,10,2854,1252,2855,226,1
20150106.110815,2855,16,1286452,6,2854,1223,2855,218,1
20150106.110816,2855,4,1286456,2,2854,1224,2855,217,1
20150106.110816,2855,4,1286460,-4,2854,1223,2855,244,1
20150106.110817,2854,2,1286462,0,2854,1252,2855,245,0
20150106.110817,2855,6,1286468,-6,2854,1253,2855,242,1
20150106.110818,2855,22,1286490,-22,2854,1253,2855,231,1
20150106.110818,2855,2,1286492,-2,2854,1253,2855,280,1
20150106.110819,2855,2,1286494,0,2854,1254,2855,279,1
20150106.11082,2855,2,1286496,0,2854,1254,2855,280,1
20150106.110821,2855,2,1286498,0,2854,1255,2855,280,1
20150106.110821,2854,2,1286500,-2,2854,1259,2855,280,0
20150106.110825,2854,2,1286502,-2,2854,1379,2855,303,0
20150106.110828,2854,2,1286504,0,2854,1381,2855,306,0
20150106.110829,2854,4,1286508,0,2854,1378,2855,306,0
20150106.11083,2854,2,1286510,0,2854,1377,2855,307,0
20150106.110832,2855,2,1286512,0,2854,1387,2855,346,1
20150106.110833,2854,2,1286514,0,2854,1386,2855,347,0
20150106.110834,2854,28,1286542,-14,2854,1371,2855,350,0
20150106.110835,2855,24,1286566,0,2854,1371,2855,343,1
20150106.110836,2855,2,1286568,0,2854,1373,2855,352,1
20150106.110837,2855,40,1286608,-40,2854,1373,2855,333,1
20150106.11084,2854,6,1286614,-4,2854,1370,2855,333,0
20150106.110841,2855,12,1286626,-2,2854,1369,2855,328,1
20150106.110841,2855,2,1286628,0,2854,1369,2855,327,1
20150106.110842,2855,6,1286634,-4,2854,1367,2855,327,1
20150106.110843,2854,2,1286636,-2,2854,1373,2855,327,0
20150106.110844,2855,4,1286640,-4,2854,1373,2855,325,1
20150106.110845,2854,2,1286642,0,2854,1372,2855,325,0
20150106.110846,2854,4,1286646,0,2854,1370,2855,330,0
20150106.110847,2854,4,1286650,0,2854,1383,2855,330,0
20150106.110847,2854,14,1286664,0,2854,1376,2855,330,0
20150106.110848,2854,4,1286668,0,2854,1379,2855,330,0
20150106.110849,2854,16,1286684,0,2854,1371,2855,331,0
20150106.110849,2854,12,1286696,2,2854,1365,2855,334,0
20150106.11085,2854,12,1286708,12,2854,1359,2855,334,0
20150106.110851,2855,2,1286710,0,2854,1353,2855,341,1
20150106.110851,2854,2,1286712,0,2854,1352,2855,341,0
20150106.110855,2855,22,1286734,0,2854,1352,2855,331,1
20150106.110856,2855,2,1286736,0,2854,1353,2855,332,1
20150106.110858,2854,14,1286750,-4,2854,1351,2855,330,0
20150106.110859,2855,2,1286752,-2,2854,1353,2855,330,1
20150106.1109,2854,104,1286856,-4,2854,1352,2855,280,0
20150106.110901,2855,30,1286886,0,2854,1352,2855,260,1
20150106.110902,2855,2,1286888,0,2854,1353,2855,259,1
20150106.110903,2855,6,1286894,-6,2854,1353,2855,368,1
20150106.110904,2854,6,1286900,-6,2854,1353,2855,367,0
20150106.110905,2855,116,1287016,4,2854,1355,2855,309,1
20150106.110907,2855,4,1287020,2,2854,1377,2855,309,1
20150106.110909,2854,2,1287022,0,2854,1376,2855,313,0
20150106.11091,2854,16,1287038,0,2854,1368,2855,416,0
20150106.110911,2854,10,1287048,-10,2854,1363,2855,416,0
20150106.110911,2855,8,1287056,-2,2854,1363,2855,412,1
20150106.110913,2855,2,1287058,0,2854,1363,2855,412,1
20150106.110914,2855,2,1287060,0,2854,1363,2855,411,1
20150106.110915,2855,8,1287068,2,2854,1362,2855,510,1
20150106.110915,2855,2,1287070,0,2854,1362,2855,509,1
20150106.110916,2855,4,1287074,0,2854,1360,2855,1453,1
20150106.110918,2854,4,1287078,0,2854,1358,2855,1471,0
20150106.110918,2854,6,1287084,-2,2854,1356,2855,1470,0
20150106.11092,2855,42,1287126,40,2854,1356,2855,1449,1
20150106.110922,2855,2,1287128,2,2854,1403,2855,1466,1
20150106.110928,2854,4,1287132,0,2854,1404,2855,1491,0
20150106.110929,2855,2,1287134,0,2854,1413,2855,1495,1
20150106.110931,2855,40,1287174,16,2854,1425,2855,1474,1
20150106.110933,2854,2,1287176,0,2854,1426,2855,1465,0
20150106.110936,2855,2,1287178,0,2854,1426,2855,1473,1
20150106.110936,2854,2,1287180,-2,2854,1423,2855,1473,0
20150106.110937,2855,2,1287182,0,2854,1423,2855,1472,1
20150106.11094,2854,6,1287188,-6,2854,1417,2855,1573,0
20150106.110944,2855,42,1287230,-42,2854,1419,2855,1545,1
20150106.110947,2855,4,1287234,-2,2854,1419,2855,1544,1
20150106.110948,2854,6,1287240,-6,2854,1416,2855,1546,0
20150106.110948,2854,2,1287242,-2,2854,1416,2855,1546,0
20150106.110949,2855,20,1287262,0,2854,1415,2855,1536,1
20150106.110952,2854,2,1287264,0,2854,1414,2855,1536,0
20150106.110955,2854,2,1287266,0,2854,1413,2855,1537,0
20150106.110955,2854,2,1287268,0,2854,1412,2855,1537,0
20150106.110956,2855,2,1287270,-2,2854,1413,2855,1536,1
20150106.111,2855,2,1287272,-2,2854,1419,2855,1538,1
20150106.111001,2854,22,1287294,0,2854,1418,2855,1529,0
20150106.111002,2855,102,1287396,-100,2854,1368,2855,1538,1
20150106.111008,2855,12,1287408,-12,2854,1377,2855,1556,1
20150106.111009,2855,2,1287410,0,2854,1377,2855,1557,1
20150106.111011,2855,8,1287418,-6,2854,1378,2855,1554,1
20150106.111013,2855,16,1287434,-12,2854,1384,2855,1547,1
20150106.111015,2855,44,1287478,-42,2854,1385,2855,1525,1
20150106.111019,2854,20,1287498,0,2854,1364,2855,1525,0
20150106.111019,2855,4,1287502,0,2854,1364,2855,1523,1
20150106.11102,2854,2,1287504,0,2854,1364,2855,1524,0
20150106.111022,2854,60,1287564,-60,2854,1334,2855,1523,0
20150106.111024,2855,80,1287644,-40,2854,1340,2855,1485,1
20150106.111025,2854,16,1287660,6,2854,1337,2855,1480,0
20150106.111026,2854,4,1287664,0,2854,1336,2855,1480,0
20150106.111027,2855,12,1287676,0,2854,1336,2855,1474,1
20150106.111027,2855,2,1287678,0,2854,1336,2855,1473,1
20150106.111028,2855,2,1287680,2,2854,1336,2855,1473,1
20150106.111031,2854,2,1287682,0,2854,1355,2855,1471,0
20150106.111034,2854,4,1287686,0,2854,1363,2855,1447,0
20150106.111034,2854,68,1287754,0,2854,1331,2855,1447,0
20150106.111035,2854,12,1287766,0,2854,1329,2855,1447,0
20150106.111036,2855,40,1287806,0,2854,1327,2855,1428,1
20150106.111039,2854,10,1287816,-10,2854,1322,2855,1428,0
20150106.111042,2854,2,1287818,-2,2854,1330,2855,1429,0
20150106.111045,2855,28,1287846,-12,2854,1320,2855,1425,1
20150106.111049,2854,14,1287860,0,2854,1317,2855,1434,0
20150106.11105,2855,2,1287862,2,2854,1318,2855,1432,1
20150106.11105,2855,20,1287882,0,2854,1318,2855,1420,1
20150106.111052,2854,2,1287884,-2,2854,1317,2855,1418,0
20150106.111052,2854,2,1287886,0,2854,1316,2855,1418,0
20150106.111054,2855,2,1287888,0,2854,1316,2855,1416,1
20150106.111055,2855,2,1287890,0,2854,1319,2855,1415,1
20150106.111056,2854,8,1287898,0,2854,1316,2855,1415,0
20150106.111057,2855,2,1287900,2,2854,1318,2855,1414,1
20150106.111059,2854,6,1287906,-4,2854,1315,2855,1414,0
20150106.1111,2854,6,1287912,-6,2854,1312,2855,1427,0
20150106.1111,2854,2,1287914,-2,2854,1312,2855,1427,0
20150106.111101,2854,100,1288014,-100,2854,1262,2855,1429,0
20150106.111102,2854,16,1288030,-6,2854,1260,2855,1424,0
20150106.111103,2854,12,1288042,0,2854,1254,2855,1433,0
20150106.111105,2855,2,1288044,0,2854,1196,2855,1432,1
20150106.111106,2854,4,1288048,-2,2854,1199,2855,1432,0
20150106.111106,2855,2,1288050,2,2854,1199,2855,1432,1
20150106.111106,2854,300,1288350,0,2854,1049,2855,1432,0
20150106.111107,2855,54,1288404,54,2854,1050,2855,1404,1
20150106.111111,2854,16,1288420,-6,2854,1054,2855,1456,0
20150106.111115,2855,6,1288426,6,2854,1053,2855,1469,1
20150106.111116,2854,58,1288484,34,2854,1041,2855,1459,0
20150106.111117,2854,4,1288488,4,2854,1039,2855,1460,0
20150106.111117,2854,2,1288490,2,2854,1038,2855,1461,0
20150106.111118,2855,18,1288508,0,2854,1038,2855,1457,1
20150106.111119,2854,2,1288510,2,2854,1038,2855,1457,0
20150106.11112,2855,2,1288512,2,2854,1038,2855,1456,1
20150106.111121,2855,10,1288522,0,2854,1038,2855,1451,1
20150106.111123,2855,4,1288526,4,2854,1086,2855,1451,1
20150106.111126,2855,40,1288566,8,2854,1089,2855,1431,1
20150106.111128,2854,2,1288568,0,2854,1088,2855,1432,0
20150106.111129,2854,70,1288638,-6,2854,1067,2855,1434,0
20150106.111132,2854,44,1288682,0,2854,1048,2855,1432,0
20150106.111135,2854,2,1288684,2,2854,1047,2855,1434,0
20150106.111136,2854,10,1288694,0,2854,1058,2855,1428,0
20150106.111139,2855,4,1288698,-4,2854,1053,2855,1425,1
20150106.111141,2854,6,1288704,0,2854,1052,2855,1425,0
20150106.111141,2855,62,1288766,-62,2854,1052,2855,1394,1
20150106.111142,2854,142,1288908,-136,2854,1051,2855,1324,0
20150106.111143,2855,2,1288910,-2,2854,1060,2855,1323,1
20150106.111144,2855,12,1288922,8,2854,1055,2855,1322,1
20150106.11115,2854,2,1288924,0,2854,1152,2855,1319,0
20150106.111151,2855,22,1288946,18,2854,1143,2855,1316,1
20150106.111152,2855,400,1289346,236,2854,1143,2855,1118,1
20150106.111154,2855,2,1289348,2,2854,1154,2855,1117,1
20150106.111154,2854,10,1289358,10,2854,1149,2855,1118,0
20150106.111155,2855,2,1289360,0,2854,1152,2855,1118,1
20150106.111157,2855,2,1289362,0,2854,1155,2855,1071,1
20150106.111158,2855,2,1289364,2,2854,1154,2855,1070,1
20150106.111159,2855,2,1289366,0,2854,1164,2855,1069,1
20150106.111159,2854,20,1289386,0,2854,1155,2855,1071,0
20150106.111201,2855,2,1289388,0,2854,1155,2855,1070,1
20150106.111202,2855,2,1289390,0,2854,1157,2855,1069,1
20150106.111204,2855,60,1289450,0,2854,1188,2855,1039,1
20150106.111204,2855,6,1289456,2,2854,1188,2855,1036,1
20150106.111205,2855,2,1289458,0,2854,1187,2855,1035,1
20150106.111206,2855,10,1289468,10,2854,1187,2855,1030,1
20150106.111206,2855,4,1289472,0,2854,1188,2855,1028,1
20150106.111208,2854,6,1289478,0,2854,1175,2855,1028,0
20150106.111208,2855,2,1289480,2,2854,1176,2855,1027,1
20150106.111209,2855,22,1289502,2,2854,1167,2855,1026,1
20150106.111215,2854,14,1289516,0,2854,1174,2855,1028,0
20150106.111217,2855,6,1289522,6,2854,1185,2855,1025,1
20150106.111219,2855,22,1289544,20,2854,1189,2855,1015,1
20150106.111219,2854,2,1289546,2,2854,1188,2855,1015,0
20150106.11122,2855,2,1289548,0,2854,1188,2855,1014,1
20150106.111222,2855,2,1289550,0,2854,1199,2855,1012,1
20150106.111227,2855,4,1289554,4,2854,1201,2855,1051,1
20150106.111228,2854,2,1289556,2,2854,1200,2855,1051,0
20150106.111228,2855,2,1289558,2,2854,1200,2855,1050,1
20150106.111229,2855,10,1289568,10,2854,1205,2855,1045,1
20150106.11123,2855,90,1289658,0,2854,1205,2855,1000,1
20150106.111231,2855,2,1289660,2,2854,1205,2855,999,1
20150106.111232,2855,12,1289672,0,2854,1205,2855,993,1
20150106.111232,2855,2,1289674,0,2854,1205,2855,992,1
20150106.111233,2855,2,1289676,0,2854,1208,2855,984,1
20150106.111234,2855,14,1289690,4,2854,1208,2855,978,1
20150106.111234,2855,4,1289694,0,2854,1208,2855,976,1
20150106.111235,2855,110,1289804,0,2854,1212,2855,921,1
20150106.111236,2855,2,1289806,0,2854,1217,2855,920,1
20150106.111237,2855,6,1289812,0,2854,1224,2855,917,1
20150106.111239,2855,10,1289822,2,2854,1224,2855,912,1
20150106.11124,2855,2,1289824,2,2854,1225,2855,921,1
20150106.11124,2855,6,1289830,0,2854,1225,2855,917,1
20150106.111241,2854,2,1289832,2,2854,1225,2855,917,0
20150106.111242,2855,4,1289836,4,2854,1225,2855,915,1
20150106.111243,2855,10,1289846,0,2854,1224,2855,910,1
20150106.111244,2855,12,1289858,0,2854,1224,2855,909,1
20150106.111245,2854,20,1289878,20,2854,1218,2855,904,0
20150106.111247,2855,42,1289920,22,2854,1228,2855,883,1
20150106.111247,2855,2,1289922,0,2854,1229,2855,884,1
20150106.111248,2854,2,1289924,2,2854,1233,2855,884,0
20150106.111248,2855,2,1289926,2,2854,1233,2855,883,1
20150106.11125,2855,2,1289928,0,2854,1239,2855,882,1
20150106.111251,2855,2,1289930,0,2854,1239,2855,881,1
20150106.111251,2854,34,1289964,34,2854,1222,2855,881,0
20150106.111253,2855,2,1289966,2,2854,1222,2855,891,1
20150106.111256,2855,2,1289968,0,2854,1223,2855,890,1
20150106.111257,2855,2,1289970,2,2854,1224,2855,889,1
20150106.111258,2854,4,1289974,4,2854,1222,2855,889,0
20150106.111259,2855,2,1289976,0,2854,1222,2855,888,1
20150106.1113,2855,16,1289992,0,2854,1222,2855,880,1
20150106.1113,2855,2,1289994,0,2854,1222,2855,878,1
20150106.111301,2855,2,1289996,2,2854,1227,2855,877,1
20150106.111302,2855,2,1289998,0,2854,1227,2855,876,1
20150106.111302,2855,28,1290026,8,2854,1217,2855,872,1
20150106.111305,2855,10,1290036,8,2854,1215,2855,871,1
20150106.111306,2855,2,1290038,0,2854,1219,2855,880,1
20150106.111307,2855,26,1290064,2,2854,1217,2855,869,1
20150106.111309,2855,4,1290068,4,2854,1218,2855,867,1
20150106.111309,2854,2,1290070,2,2854,1217,2855,867,0
20150106.111312,2855,2,1290072,2,2854,1215,2855,866,1
20150106.111313,2854,40,1290112,0,2854,1195,2855,866,0
20150106.111314,2854,2,1290114,2,2854,1191,2855,866,0
20150106.111315,2855,2,1290116,2,2854,1190,2855,865,1
20150106.11132,2855,2,1290118,2,2854,1194,2855,867,1
20150106.11132,2854,20,1290138,0,2854,1184,2855,867,0
20150106.111322,2854,10,1290148,0,2854,1180,2855,867,0
20150106.111323,2855,2,1290150,0,2854,1180,2855,866,1
20150106.111326,2855,10,1290160,10,2854,1175,2855,873,1
20150106.111328,2855,4,1290164,4,2854,1224,2855,872,1
20150106.11133,2854,100,1290264,100,2854,1175,2855,873,0
20150106.111331,2854,10,1290274,10,2854,1170,2855,874,0
20150106.111331,2855,8,1290282,0,2854,1175,2855,870,1
20150106.111332,2855,20,1290302,0,2854,1167,2855,867,1
20150106.111333,2855,2,1290304,0,2854,1157,2855,866,1
20150106.111334,2855,22,1290326,18,2854,1157,2855,855,1
20150106.111335,2855,2,1290328,0,2854,1158,2855,954,1
20150106.111335,2855,8,1290336,8,2854,1158,2855,950,1
20150106.111336,2855,36,1290372,36,2854,1158,2855,932,1
20150106.111337,2854,2,1290374,2,2854,1157,2855,932,0
20150106.111338,2854,10,1290384,10,2854,1152,2855,932,0
20150106.111339,2855,18,1290402,18,2854,1158,2855,924,1
20150106.11134,2855,2,1290404,2,2854,1158,2855,923,1
20150106.111343,2854,2,1290406,0,2854,1157,2855,926,0
20150106.111344,2854,4,1290410,4,2854,1156,2855,930,0
20150106.111345,2855,2,1290412,0,2854,1156,2855,929,1
20150106.111346,2854,16,1290428,0,2854,1148,2855,929,0
20150106.111348,2854,4,1290432,4,2854,1146,2855,930,0
20150106.11135,2855,14,1290446,14,2854,1147,2855,923,1
20150106.111352,2855,4,1290450,4,2854,1147,2855,921,1
20150106.111352,2855,2,1290452,2,2854,1149,2855,920,1
20150106.111355,2855,12,1290464,12,2854,1149,2855,915,1
20150106.111401,2854,30,1290494,14,2854,1139,2855,970,0
20150106.111403,2855,4,1290498,4,2854,1141,2855,968,1
20150106.111404,2854,2,1290500,2,2854,1140,2855,968,0
20150106.111406,2855,4,1290504,4,2854,1140,2855,966,1
20150106.111407,2855,2,1290506,2,2854,1140,2855,965,1
20150106.111409,2854,82,1290588,82,2854,1094,2855,973,0
20150106.111411,2855,2,1290590,2,2854,1091,2855,974,1
20150106.111411,2855,2,1290592,2,2854,1092,2855,973,1
20150106.111413,2854,8,1290600,0,2854,1093,2855,973,0
20150106.111414,2855,12,1290612,0,2854,1093,2855,967,1
20150106.111416,2855,4,1290616,0,2854,1093,2855,1022,1
20150106.111416,2854,16,1290632,0,2854,1085,2855,1022,0
20150106.111418,2855,2,1290634,0,2854,1085,2855,1010,1
20150106.111419,2855,4,1290638,4,2854,1085,2855,1008,1
20150106.11142,2855,2,1290640,2,2854,1084,2855,1017,1
20150106.111426,2854,20,1290660,-8,2854,1075,2855,1017,0
20150106.111426,2855,2,1290662,2,2854,1075,2855,1016,1
20150106.111427,2855,2,1290664,0,2854,1075,2855,1015,1
20150106.111429,2854,2,1290666,0,2854,1074,2855,1015,0
20150106.11143,2854,4,1290670,0,2854,1075,2855,1014,0
20150106.111431,2854,2,1290672,0,2854,1074,2855,1014,0
20150106.111431,2854,16,1290688,-16,2854,1066,2855,1014,0
20150106.111432,2855,2,1290690,0,2854,1136,2855,1013,1
20150106.111434,2854,26,1290716,18,2854,1125,2855,1003,0
20150106.111435,2855,2,1290718,0,2854,1125,2855,1002,1
20150106.111435,2855,4,1290722,0,2854,1125,2855,1000,1
20150106.111438,2854,2,1290724,2,2854,1177,2855,1000,0
20150106.111443,2855,18,1290742,18,2854,1177,2855,995,1
20150106.111445,2855,4,1290746,2,2854,1177,2855,996,1
20150106.111445,2855,2,1290748,2,2854,1177,2855,995,1
20150106.111445,2855,8,1290756,8,2854,1177,2855,992,1
20150106.111446,2854,16,1290772,0,2854,1169,2855,995,0
20150106.111448,2855,2,1290774,0,2854,1166,2855,995,1
20150106.111449,2855,4,1290778,0,2854,1166,2855,993,1
20150106.111449,2854,8,1290786,8,2854,1162,2855,993,0
20150106.111452,2855,4,1290790,4,2854,1171,2855,988,1
20150106.111453,2854,4,1290794,0,2854,1169,2855,988,0
20150106.111455,2854,4,1290798,0,2854,1167,2855,985,0
20150106.111457,2854,20,1290818,0,2854,1162,2855,1035,0
20150106.1115,2854,2,1290820,2,2854,1172,2855,1036,0
20150106.1115,2854,10,1290830,6,2854,1168,2855,1035,0
20150106.111501,2854,4,1290834,4,2854,1166,2855,1035,0
20150106.111502,2855,4,1290838,0,2854,1166,2855,1033,1
20150106.111502,2855,2,1290840,0,2854,1166,2855,1032,1
20150106.111503,2854,2,1290842,-2,2854,1165,2855,1032,0
20150106.111503,2854,10,1290852,2,2854,1160,2855,1033,0
20150106.111506,2854,4,1290856,0,2854,1158,2855,1033,0
20150106.111509,2854,8,1290864,4,2854,1156,2855,1033,0
20150106.111509,2854,2,1290866,-2,2854,1156,2855,1035,0
20150106.11151,2854,2,1290868,-2,2854,1155,2855,1035,0
20150106.111511,2854,2,1290870,2,2854,1154,2855,1035,0
20150106.111517,2854,20,1290890,16,2854,1148,2855,1034,0
20150106.111518,2854,4,1290894,2,2854,1145,2855,1034,0
20150106.111519,2854,10,1290904,-4,2854,1137,2855,1034,0
20150106.111519,2854,2,1290906,-2,2854,1136,2855,1049,0
20150106.11152,2854,2,1290908,0,2854,1136,2855,1049,0
20150106.111521,2854,8,1290916,0,2854,1132,2855,1049,0
20150106.111522,2854,2,1290918,0,2854,1131,2855,1069,0
20150106.111523,2854,8,1290926,2,2854,1127,2855,1069,0
20150106.111523,2854,2,1290928,0,2854,1126,2855,1069,0
20150106.111524,2854,2,1290930,2,2854,1125,2855,1069,0
20150106.111525,2855,2,1290932,2,2854,1125,2855,1161,1
20150106.111528,2855,2,1290934,0,2854,1127,2855,1161,1
20150106.111529,2855,6,1290940,6,2854,1126,2855,1159,1
20150106.11153,2855,2,1290942,0,2854,1128,2855,1158,1
20150106.111531,2855,4,1290946,0,2854,1128,2855,1161,1
20150106.111532,2855,2,1290948,2,2854,1128,2855,1160,1
20150106.111534,2855,2,1290950,0,2854,1127,2855,1181,1
20150106.111536,2855,2,1290952,2,2854,1128,2855,1180,1
20150106.111536,2854,4,1290956,0,2854,1126,2855,1180,0
20150106.111538,2855,2,1290958,0,2854,1129,2855,1188,1
20150106.111543,2854,24,1290982,-2,2854,1116,2855,1173,0
20150106.111544,2855,2,1290984,2,2854,1116,2855,1172,1
20150106.111546,2855,4,1290988,2,2854,1116,2855,1170,1
20150106.111551,2855,2,1290990,0,2854,1122,2855,1168,1
20150106.111554,2854,2,1290992,2,2854,1120,2855,1167,0
20150106.111555,2854,180,1291172,-80,2854,1041,2855,1163,0
20150106.111557,2854,2,1291174,-2,2854,1040,2855,1163,0
20150106.111559,2855,4,1291178,0,2854,1035,2855,1162,1
20150106.1116,2855,6,1291184,0,2854,1035,2855,1159,1
20150106.111604,2854,2,1291186,0,2854,970,2855,1157,0
20150106.111605,2854,146,1291332,6,2854,967,2855,1087,0
20150106.111605,2855,2,1291334,0,2854,967,2855,1086,1
20150106.111606,2854,1018,1292352,562,2854,459,2855,1086,0
20150106.111607,2854,52,1292404,20,2854,433,2855,1086,0
20150106.111607,2854,546,1292950,-26,2854,190,2855,1086,0
20150106.111608,2854,382,1293332,-246,2853,949,2854,117,0
20150106.111608,2854,8,1293340,-6,2853,950,2854,145,0
20150106.111608,2854,2,1293342,-2,2853,950,2854,737,0
20150106.111609,2853,2,1293344,-2,2853,949,2854,772,0
20150106.111609,2853,34,1293378,2,2853,952,2854,787,0
20150106.11161,2854,36,1293414,-20,2853,935,2854,787,1
20150106.11161,2853,6,1293420,0,2853,932,2854,789,0
20150106.111611,2853,10,1293430,4,2853,927,2854,789,0
20150106.111611,2853,10,1293440,10,2853,922,2854,789,0
20150106.111613,2853,20,1293460,20,2853,912,2854,788,0
20150106.111614,2853,10,1293470,10,2853,907,2854,788,0
20150106.111615,2853,2,1293472,2,2853,906,2854,792,0
20150106.111615,2853,22,1293494,-18,2853,905,2854,783,0
20150106.111616,2853,8,1293502,0,2853,902,2854,783,0
20150106.111616,2853,10,1293512,6,2853,898,2854,782,0
20150106.111617,2853,32,1293544,8,2853,882,2854,782,0
20150106.111622,2854,4,1293548,4,2853,1010,2854,788,1
20150106.111623,2853,2,1293550,2,2853,1015,2854,801,0
20150106.111624,2853,14,1293564,14,2853,1016,2854,807,0
20150106.111625,2853,72,1293636,0,2853,982,2854,808,0
20150106.111626,2853,2,1293638,0,2853,982,2854,808,0
20150106.111627,2854,4,1293642,4,2853,982,2854,807,1
20150106.111628,2853,2,1293644,2,2853,1003,2854,823,0
20150106.11163,2853,38,1293682,18,2853,984,2854,825,0
20150106.111631,2853,74,1293756,34,2853,950,2854,824,0
20150106.111631,2853,2,1293758,2,2853,949,2854,824,0
20150106.111632,2853,2,1293760,2,2853,949,2854,866,0
20150106.111633,2853,18,1293778,18,2853,940,2854,868,0
20150106.111634,2854,24,1293802,24,2853,925,2854,979,1
20150106.111635,2853,2,1293804,2,2853,924,2854,985,0
20150106.111636,2853,20,1293824,20,2853,914,2854,985,0
20150106.111638,2854,2,1293826,0,2853,918,2854,985,1
20150106.11164,2854,6,1293832,-4,2853,923,2854,984,1
20150106.11164,2853,32,1293864,28,2853,910,2854,982,0
20150106.111642,2853,2,1293866,0,2853,687,2854,1119,0
20150106.111643,2853,30,1293896,30,2853,672,2854,1123,0
20150106.111643,2853,86,1293982,80,2853,630,2854,1125,0
20150106.111644,2853,40,1294022,20,2853,616,2854,1132,0
20150106.111644,2853,20,1294042,16,2853,607,2854,1131,0
20150106.111645,2853,10,1294052,0,2853,605,2854,1127,0
20150106.111645,2853,34,1294086,12,2853,588,2854,1120,0
20150106.111646,2853,18,1294104,18,2853,578,2854,1120,0
20150106.111646,2853,102,1294206,102,2853,537,2854,1120,0
20150106.111647,2853,38,1294244,-30,2853,526,2854,1111,0
20150106.111647,2853,6,1294250,-4,2853,525,2854,1112,0
20150106.111648,2853,30,1294280,2,2853,510,2854,1112,0
20150106.111648,2853,16,1294296,10,2853,603,2854,1112,0
20150106.111649,2853,26,1294322,-8,2853,591,2854,1112,0
20150106.11165,2853,68,1294390,4,2853,557,2854,1118,0
20150106.111651,2853,4,1294394,-2,2853,555,2854,1119,0
20150106.111652,2853,2,1294396,0,2853,554,2854,1119,0
20150106.111653,2853,20,1294416,0,2853,549,2854,1119,0
20150106.111654,2854,4,1294420,-2,2853,549,2854,1117,1
20150106.111654,2853,10,1294430,-10,2853,544,2854,1114,0
20150106.111655,2854,8,1294438,-6,2853,542,2854,1116,1
20150106.111656,2853,8,1294446,0,2853,538,2854,1119,0
20150106.111656,2853,20,1294466,0,2853,528,2854,1120,0
20150106.111657,2853,20,1294486,-20,2853,518,2854,1120,0
20150106.111658,2853,6,1294492,-6,2853,515,2854,1120,0
20150106.111658,2853,2,1294494,0,2853,510,2854,1120,0
20150106.111659,2853,4,1294498,2,2853,508,2854,1130,0
20150106.111701,2853,18,1294516,-18,2853,554,2854,1130,0
20150106.111702,2853,4,1294520,0,2853,552,2854,1130,0
20150106.111702,2853,204,1294724,114,2853,490,2854,1130,0
20150106.111703,2853,250,1294974,70,2853,367,2854,1129,0
20150106.111704,2853,36,1295010,4,2853,380,2854,1128,0
20150106.111704,2853,160,1295170,44,2853,300,2854,1157,0
20150106.111705,2853,8,1295178,4,2853,296,2854,1157,0
20150106.111705,2853,224,1295402,-164,2853,184,2854,1157,0
20150106.111706,2853,2,1295404,0,2853,203,2854,1157,0
20150106.111706,2853,28,1295432,-12,2853,194,2854,1153,0
20150106.111707,2853,16,1295448,-2,2853,187,2854,1155,0
20150106.111708,2853,16,1295464,-10,2853,190,2854,1155,0
20150106.111708,2853,4,1295468,0,2853,189,2854,1175,0
20150106.111708,2853,94,1295562,-64,2853,153,2854,1174,0
20150106.111709,2853,8,1295570,6,2853,149,2854,1174,0
20150106.111709,2853,12,1295582,6,2853,145,2854,1174,0
20150106.11171,2853,10,1295592,10,2853,141,2854,1173,0
20150106.111711,2853,2,1295594,2,2853,140,2854,1173,0
20150106.111712,2853,6,1295600,2,2853,146,2854,1173,0
20150106.111712,2853,8,1295608,6,2853,142,2854,1176,0
20150106.111713,2853,68,1295676,-46,2853,108,2854,1176,0
20150106.111714,2853,4,1295680,-4,2853,107,2854,1176,0
20150106.111715,2853,2,1295682,0,2853,108,2854,1177,0
20150106.111716,2853,318,1296000,-248,2852,2031,2853,4,0
20150106.111716,2853,34,1296034,-10,2852,2033,2853,72,0
20150106.111717,2852,16,1296050,-2,2852,2025,2853,110,0
20150106.111717,2852,348,1296398,14,2852,1854,2853,120,0
20150106.111717,2852,100,1296498,0,2852,1804,2853,121,0
20150106.111718,2852,18,1296516,6,2852,1795,2853,204,0
20150106.111719,2853,14,1296530,-8,2852,1796,2853,211,1
20150106.111719,2853,12,1296542,-12,2852,1796,2853,246,1
20150106.11172,2852,12,1296554,-10,2852,1795,2853,240,0
20150106.11172,2853,2,1296556,0,2852,1796,2853,239,1
20150106.111721,2853,10,1296566,0,2852,1800,2853,234,1
20150106.111722,2853,6,1296572,4,2852,1798,2853,239,1
20150106.111722,2852,8,1296580,0,2852,1796,2853,239,0
20150106.111722,2853,8,1296588,0,2852,1798,2853,235,1
20150106.111723,2853,2,1296590,0,2852,1800,2853,239,1
20150106.111724,2852,4,1296594,2,2852,1806,2853,239,0
20150106.111724,2853,30,1296624,-22,2852,1805,2853,225,1
20150106.111725,2853,100,1296724,-100,2852,1801,2853,178,1
20150106.111725,2853,4,1296728,-2,2852,1800,2853,177,1
20150106.111726,2853,2,1296730,-2,2852,1802,2853,176,1
20150106.111726,2853,20,1296750,-20,2852,1803,2853,166,1
20150106.111727,2853,4,1296754,0,2852,1803,2853,165,1
20150106.111728,2852,2,1296756,2,2852,1797,2853,166,0
20150106.111729,2853,10,1296766,4,2852,1798,2853,171,1
20150106.111729,2852,8,1296774,2,2852,1798,2853,168,0
20150106.11173,2853,12,1296786,4,2852,1798,2853,163,1
20150106.111731,2852,34,1296820,34,2852,1798,2853,263,0
20150106.111732,2853,18,1296838,2,2852,1790,2853,287,1
20150106.111732,2853,42,1296880,42,2852,1770,2853,317,1
20150106.111733,2852,20,1296900,0,2852,1760,2853,317,0
20150106.111733,2852,12,1296912,10,2852,1759,2853,312,0
20150106.111734,2852,2,1296914,2,2852,1758,2853,431,0
20150106.111734,2852,4,1296918,4,2852,1756,2853,437,0
20150106.111736,2852,4,1296922,2,2852,1760,2853,455,0
20150106.111737,2853,32,1296954,30,2852,1760,2853,440,1
20150106.111737,2852,4,1296958,0,2852,1758,2853,440,0
20150106.111739,2852,2,1296960,0,2852,1757,2853,447,0
20150106.111739,2853,12,1296972,12,2852,1757,2853,444,1
20150106.11174,2853,36,1297008,16,2852,1758,2853,533,1
20150106.111741,2853,12,1297020,2,2852,1754,2853,534,1
20150106.111742,2852,8,1297028,8,2852,1751,2853,539,0
20150106.111742,2852,4,1297032,2,2852,1750,2853,540,0
20150106.111743,2853,2,1297034,2,2852,1751,2853,540,1
20150106.111744,2852,6,1297040,6,2852,1749,2853,540,0
20150106.111745,2853,16,1297056,16,2852,1743,2853,540,1
20150106.111745,2853,10,1297066,0,2852,1743,2853,535,1
20150106.111746,2852,18,1297084,2,2852,1734,2853,565,0
20150106.111747,2852,6,1297090,0,2852,1731,2853,570,0
20150106.111748,2853,6,1297096,2,2852,1730,2853,570,1
20150106.111748,2852,2,1297098,2,2852,1729,2853,570,0
20150106.111749,2853,2,1297100,2,2852,1729,2853,586,1
20150106.111751,2853,2,1297102,2,2852,1730,2853,589,1
20150106.111751,2852,2,1297104,2,2852,1728,2853,588,0
20150106.111752,2853,8,1297112,6,2852,1736,2853,587,1
20150106.111753,2852,22,1297134,20,2852,1734,2853,577,0
20150106.111753,2852,10,1297144,6,2852,1729,2853,574,0
20150106.111754,2852,400,1297544,138,2852,1529,2853,574,0
20150106.111754,2853,2,1297546,2,2852,1529,2853,575,1
20150106.111755,2852,2,1297548,0,2852,1528,2853,576,0
20150106.111755,2852,14,1297562,-12,2852,1521,2853,579,0
20150106.111756,2852,2,1297564,0,2852,1520,2853,599,0
20150106.111757,2852,20,1297584,0,2852,1513,2853,599,0
20150106.111757,2852,4,1297588,0,2852,1511,2853,599,0
20150106.111759,2852,16,1297604,-16,2852,1515,2853,604,0
20150106.111759,2852,12,1297616,-4,2852,1509,2853,604,0
20150106.1118,2852,86,1297702,-58,2852,1451,2853,599,0
20150106.111801,2852,16,1297718,-16,2852,1434,2853,599,0
20150106.111805,2852,2,1297720,0,2852,1435,2853,596,0
20150106.111807,2852,8,1297728,-2,2852,1433,2853,604,0
20150106.111807,2852,16,1297744,2,2852,1426,2853,604,0
20150106.111808,2852,2,1297746,0,2852,1445,2853,605,0
20150106.111809,2852,6,1297752,0,2852,1449,2853,604,0
20150106.111811,2852,4,1297756,0,2852,1444,2853,630,0
20150106.111812,2852,4,1297760,0,2852,1442,2853,629,0
20150106.111813,2852,22,1297782,-16,2852,1432,2853,627,0
20150106.111813,2852,4,1297786,-4,2852,1481,2853,627,0
20150106.111814,2852,2,1297788,0,2852,1481,2853,632,0
20150106.111815,2853,10,1297798,0,2852,1508,2853,628,1
20150106.111816,2852,4,1297802,0,2852,1507,2853,627,0
20150106.111816,2852,16,1297818,-16,2852,1499,2853,628,0
20150106.111819,2852,40,1297858,0,2852,1273,2853,651,0
20150106.111819,2853,38,1297896,0,2852,1255,2853,651,1
20150106.11182,2853,26,1297922,2,2852,1255,2853,638,1
20150106.11182,2852,2,1297924,0,2852,1256,2853,640,0
20150106.111824,2852,20,1297944,0,2852,1258,2853,646,0
20150106.111826,2852,162,1298106,-160,2852,1168,2853,645,0
20150106.111826,2852,16,1298122,-2,2852,1168,2853,640,0
20150106.111828,2852,2,1298124,0,2852,1167,2853,703,0
20150106.111829,2852,20,1298144,0,2852,1188,2853,735,0
20150106.11183,2853,2,1298146,2,2852,1188,2853,735,1
20150106.111831,2853,2,1298148,2,2852,1197,2853,737,1
20150106.111832,2853,18,1298166,-14,2852,1189,2853,736,1
20150106.111835,2853,2,1298168,2,2852,1192,2853,676,1
20150106.111835,2853,6,1298174,0,2852,1211,2853,674,1
20150106.111836,2852,20,1298194,0,2852,1206,2853,673,0
20150106.111837,2853,2,1298196,2,2852,1208,2853,635,1
20150106.111838,2852,12,1298208,2,2852,1205,2853,634,0
20150106.111841,2853,6,1298214,0,2852,1262,2853,632,1
20150106.111843,2852,200,1298414,0,2852,1170,2853,653,0
20150106.111844,2852,2,1298416,0,2852,1169,2853,654,0
20150106.111844,2852,10,1298426,-4,2852,1166,2853,655,0
20150106.111845,2853,2,1298428,0,2852,1165,2853,654,1
20150106.111845,2853,2,1298430,0,2852,1168,2853,653,1
20150106.111849,2853,100,1298530,-62,2852,1197,2853,622,1
20150106.11185,2853,2,1298532,0,2852,1191,2853,621,1
20150106.11185,2853,10,1298542,0,2852,1179,2853,616,1
20150106.111852,2853,2,1298544,-2,2852,1179,2853,613,1
20150106.111853,2853,4,1298548,-2,2852,1193,2853,614,1
20150106.111854,2852,2,1298550,0,2852,1193,2853,614,0
20150106.111854,2853,18,1298568,0,2852,1189,2853,610,1
20150106.111855,2852,8,1298576,-4,2852,1186,2853,608,0
20150106.111856,2852,2,1298578,0,2852,1189,2853,608,0
20150106.111857,2853,10,1298588,0,2852,1239,2853,601,1
20150106.111857,2852,404,1298992,-2,2852,1046,2853,603,0
20150106.111858,2853,2,1298994,-2,2852,1046,2853,602,1
20150106.111858,2853,2,1298996,0,2852,1066,2853,601,1
20150106.111859,2853,2,1298998,0,2852,1067,2853,600,1
20150106.111859,2852,46,1299044,0,2852,1067,2853,611,0
20150106.1119,2852,400,1299444,0,2852,868,2853,611,0
20150106.1119,2852,4,1299448,0,2852,868,2853,610,0
20150106.111901,2852,24,1299472,-22,2852,839,2853,616,0
20150106.111902,2852,140,1299612,-40,2852,772,2853,596,0
20150106.111903,2853,24,1299636,-4,2852,754,2853,593,1
20150106.111904,2853,124,1299760,0,2852,695,2853,594,1
20150106.111906,2852,22,1299782,-20,2852,702,2853,620,0
20150106.111907,2853,10,1299792,0,2852,714,2853,617,1
20150106.111907,2852,2,1299794,-2,2852,714,2853,617,0
20150106.111908,2853,20,1299814,0,2852,716,2853,609,1
20150106.111908,2852,10,1299824,0,2852,713,2853,607,0
20150106.111909,2852,2,1299826,0,2852,735,2853,608,0
20150106.11191,2853,4,1299830,-4,2852,735,2853,606,1
20150106.111913,2852,40,1299870,-4,2852,714,2853,643,0
20150106.111915,2852,22,1299892,0,2852,704,2853,643,0
20150106.111916,2852,34,1299926,-34,2852,692,2853,641,0
20150106.111917,2853,20,1299946,-10,2852,695,2853,631,1
20150106.111917,2852,6,1299952,0,2852,692,2853,631,0
20150106.111922,2852,8,1299960,-8,2852,697,2853,633,0
20150106.111922,2852,2,1299962,0,2852,696,2853,633,0
20150106.111923,2853,24,1299986,-4,2852,701,2853,636,1
20150106.111923,2853,6,1299992,2,2852,711,2853,635,1
20150106.111924,2852,2,1299994,-2,2852,716,2853,636,0
20150106.111925,2852,2,1299996,0,2852,716,2853,636,0
20150106.111926,2853,600,1300596,-528,2852,755,2853,356,1
20150106.111927,2853,2,1300598,-2,2852,756,2853,353,1
20150106.111927,2853,4,1300602,-4,2852,757,2853,362,1
20150106.111928,2853,8,1300610,0,2852,758,2853,358,1
20150106.111928,2853,2,1300612,-2,2852,761,2853,359,1
20150106.111929,2853,600,1301212,-244,2852,764,2853,59,1
20150106.111929,2853,46,1301258,10,2852,770,2853,69,1
20150106.11193,2853,14,1301272,-6,2852,771,2853,65,1
20150106.11193,2853,78,1301350,-48,2852,770,2853,32,1
20150106.111931,2853,66,1301416,-50,2853,319,2854,1628,1
20150106.111931,2854,2,1301418,-2,2853,321,2854,1612,1
20150106.111932,2854,26,1301444,-26,2853,331,2854,1586,1
20150106.111933,2854,14,1301458,-12,2853,371,2854,1557,1
20150106.111934,2853,14,1301472,-4,2853,394,2854,1555,0
20150106.111935,2854,2,1301474,-2,2853,400,2854,1549,1
20150106.111936,2854,2,1301476,-2,2853,403,2854,1548,1
20150106.111936,2853,22,1301498,-20,2853,392,2854,1554,0
20150106.111937,2853,4,1301502,0,2853,391,2854,1554,0
20150106.111938,2854,2,1301504,-2,2853,414,2854,1552,1
20150106.111939,2854,2,1301506,0,2853,440,2854,1651,1
20150106.11194,2853,2,1301508,0,2853,441,2854,1679,0
20150106.111942,2853,4,1301512,-2,2853,461,2854,1668,0
20150106.111944,2854,2,1301514,-2,2853,547,2854,1755,1
20150106.111944,2853,16,1301530,-16,2853,551,2854,1755,0
20150106.111947,2854,2,1301532,-2,2853,571,2854,1748,1
20150106.111951,2854,4,1301536,-4,2853,591,2854,1746,1
20150106.111954,2853,20,1301556,0,2853,612,2854,1835,0
20150106.111956,2854,2,1301558,0,2853,645,2854,1832,1
20150106.111957,2854,2,1301560,-2,2853,659,2854,1821,1
20150106.111957,2853,6,1301566,0,2853,651,2854,1819,0
20150106.111959,2853,4,1301570,0,2853,652,2854,1824,0
20150106.112,2853,80,1301650,0,2853,614,2854,1815,0
20150106.112001,2853,2,1301652,-2,2853,613,2854,1816,0
20150106.112001,2853,8,1301660,-4,2853,609,2854,1816,0
20150106.112008,2854,2,1301662,-2,2853,630,2854,1762,1
20150106.11201,2854,8,1301670,-4,2853,937,2854,1759,1
20150106.112012,2854,2,1301672,-2,2853,968,2854,1726,1
20150106.112013,2854,2,1301674,-2,2853,948,2854,1725,1
20150106.112015,2854,2,1301676,-2,2853,947,2854,1724,1
20150106.112016,2854,80,1301756,-80,2853,933,2854,1685,1
20150106.112018,2854,10,1301766,-10,2853,921,2854,1700,1
20150106.112018,2854,2,1301768,-2,2853,921,2854,1699,1
20150106.112019,2854,2,1301770,0,2853,920,2854,1698,1
20150106.11202,2854,20,1301790,-10,2853,921,2854,1688,1
20150106.112021,2854,8,1301798,0,2853,922,2854,1753,1
20150106.112022,2854,2,1301800,-2,2853,922,2854,1751,1
20150106.112022,2854,2,1301802,-2,2853,929,2854,1749,1
20150106.112023,2854,26,1301828,-26,2853,929,2854,1743,1
20150106.112025,2854,20,1301848,-20,2853,927,2854,1728,1
20150106.112025,2854,2,1301850,-2,2853,927,2854,1727,1
20150106.112025,2853,4,1301854,-4,2853,925,2854,1726,0
20150106.112028,2854,24,1301878,-24,2853,974,2854,1760,1
20150106.112029,2854,2,1301880,0,2853,973,2854,1754,1
20150106.11203,2853,2,1301882,0,2853,973,2854,1755,0
20150106.112036,2854,30,1301912,-30,2853,989,2854,1722,1
20150106.112038,2854,2,1301914,-2,2853,989,2854,1707,1
20150106.11204,2854,4,1301918,-4,2853,1026,2854,1705,1
20150106.112041,2853,2,1301920,-2,2853,1025,2854,1649,0
20150106.112042,2854,2,1301922,0,2853,1026,2854,1646,1
20150106.112044,2854,2,1301924,0,2853,1033,2854,1644,1
20150106.112045,2854,804,1302728,-2,2853,1074,2854,1235,1
20150106.112045,2854,2430,1305158,-256,2853,1090,2854,19,1
20150106.112046,2854,38,1305196,4,2854,104,2855,901,1
20150106.112047,2855,22,1305218,2,2854,160,2855,810,1
20150106.112047,2855,2,1305220,0,2854,200,2855,810,1
20150106.112048,2855,10,1305230,0,2854,202,2855,802,1
20150106.112049,2855,2,1305232,0,2854,618,2855,801,1
20150106.11205,2855,2,1305234,0,2854,618,2855,800,1
20150106.112052,2854,4,1305238,2,2854,627,2855,780,0
20150106.112053,2855,2,1305240,2,2854,670,2855,770,1
20150106.112053,2855,4,1305244,4,2854,680,2855,768,1
20150106.112054,2855,4,1305248,0,2854,679,2855,766,1
20150106.112055,2855,4,1305252,0,2854,680,2855,764,1
20150106.112055,2854,60,1305312,-60,2854,651,2855,764,0
20150106.112057,2855,2,1305314,0,2854,657,2855,765,1
20150106.112058,2855,2,1305316,2,2854,658,2855,765,1
20150106.112059,2855,4,1305320,4,2854,711,2855,763,1
20150106.1121,2855,2,1305322,2,2854,727,2855,762,1
20150106.1121,2855,20,1305342,20,2854,728,2855,752,1
20150106.112101,2855,6,1305348,0,2854,739,2855,827,1
20150106.112102,2855,12,1305360,2,2854,746,2855,853,1
20150106.112103,2854,4,1305364,0,2854,743,2855,855,0
20150106.112103,2855,12,1305376,12,2854,743,2855,849,1
20150106.112106,2855,4,1305380,4,2854,794,2855,847,1
20150106.112106,2855,2,1305382,0,2854,800,2855,848,1
20150106.112108,2855,4,1305386,2,2854,808,2855,845,1
20150106.112111,2855,2,1305388,2,2854,933,2855,845,1
20150106.112111,2855,12,1305400,0,2854,933,2855,839,1
20150106.112112,2855,602,1306002,-106,2854,935,2855,538,1
20150106.112112,2855,8,1306010,-8,2854,935,2855,534,1
20150106.112113,2855,26,1306036,-26,2854,870,2855,521,1
20150106.112114,2855,4,1306040,0,2854,871,2855,519,1
20150106.112114,2855,14,1306054,0,2854,877,2855,548,1
20150106.112115,2855,24,1306078,-4,2854,877,2855,536,1
20150106.112115,2855,90,1306168,46,2854,889,2855,487,1
20150106.112116,2855,2,1306170,0,2854,894,2855,486,1
20150106.112116,2855,20,1306190,-6,2854,899,2855,477,1
20150106.112117,2855,4,1306194,-2,2854,869,2855,475,1
20150106.112118,2855,62,1306256,28,2854,869,2855,444,1
20150106.112118,2855,64,1306320,-6,2854,870,2855,442,1
20150106.112119,2855,6,1306326,4,2854,869,2855,439,1
20150106.112119,2855,12,1306338,12,2854,879,2855,433,1
20150106.11212,2855,8,1306346,6,2854,879,2855,429,1
20150106.11212,2855,12,1306358,0,2854,879,2855,423,1
20150106.112121,2855,204,1306562,122,2854,880,2855,322,1
20150106.112121,2855,644,1307206,-478,2855,130,2856,860,1
20150106.112123,2856,6,1307212,-6,2855,178,2856,738,1
20150106.112123,2855,52,1307264,-20,2855,178,2856,714,0
20150106.112123,2856,810,1308074,-30,2855,178,2856,309,1
20150106.112124,2855,2,1308076,-2,2855,177,2856,311,0
20150106.112125,2856,6,1308082,6,2855,190,2856,400,1
20150106.112126,2856,6,1308088,2,2855,190,2856,398,1
20150106.112126,2855,378,1308466,170,2854,941,2855,812,0
20150106.112127,2855,18,1308484,0,2854,942,2855,803,0
20150106.112127,2855,4,1308488,2,2854,941,2855,801,0
20150106.112128,2855,26,1308514,4,2854,941,2855,788,0
20150106.112128,2855,8,1308522,4,2854,941,2855,784,0
20150106.112129,2855,2,1308524,2,2854,941,2855,783,0
20150106.112129,2855,6,1308530,0,2854,941,2855,780,0
20150106.11213,2855,12,1308542,4,2854,936,2855,784,0
20150106.11213,2855,404,1308946,0,2854,936,2855,582,0
20150106.112131,2855,20,1308966,2,2854,929,2855,580,0
20150106.112132,2855,8,1308974,8,2854,930,2855,576,0
20150106.112132,2855,8,1308982,6,2854,932,2855,575,0
20150106.112133,2855,2,1308984,2,2854,931,2855,574,0
20150106.112133,2854,4,1308988,2,2854,937,2855,574,0
20150106.112134,2855,2,1308990,2,2854,945,2855,573,1
20150106.112135,2855,42,1309032,0,2854,941,2855,552,1
20150106.112136,2855,2,1309034,2,2854,940,2855,552,1
20150106.112139,2855,4,1309038,0,2854,943,2855,551,1
20150106.11214,2855,2,1309040,0,2854,943,2855,550,1
20150106.112142,2854,10,1309050,4,2854,940,2855,549,0
20150106.112143,2855,2,1309052,0,2854,941,2855,550,1
20150106.112144,2854,2,1309054,2,2854,941,2855,549,0
20150106.112144,2855,12,1309066,0,2854,941,2855,544,1
20150106.112145,2854,2,1309068,2,2854,941,2855,544,0
20150106.112146,2855,2,1309070,0,2854,945,2855,543,1
20150106.112147,2855,12,1309082,0,2854,945,2855,537,1
20150106.112147,2855,4,1309086,0,2854,945,2855,536,1
20150106.112148,2855,6,1309092,0,2854,947,2855,533,1
20150106.112149,2855,2,1309094,0,2854,947,2855,542,1
20150106.11215,2854,8,1309102,0,2854,946,2855,540,0
20150106.112153,2855,12,1309114,10,2854,1080,2855,535,1
20150106.112155,2855,2,1309116,2,2854,1082,2855,535,1
20150106.112155,2855,6,1309122,6,2854,1081,2855,532,1
20150106.112156,2854,50,1309172,0,2854,1058,2855,532,0
20150106.112158,2855,2,1309174,2,2854,1059,2855,533,1
20150106.1122,2855,10,1309184,4,2854,1060,2855,528,1
20150106.112201,2855,2,1309186,2,2854,1060,2855,518,1
20150106.112203,2854,4,1309190,4,2854,1059,2855,518,0
20150106.112203,2855,2,1309192,2,2854,1064,2855,517,1
20150106.112204,2855,20,1309212,0,2854,1064,2855,507,1
20150106.112205,2854,20,1309232,0,2854,1059,2855,507,0
20150106.112206,2855,2,1309234,0,2854,1059,2855,505,1
20150106.112207,2855,2,1309236,0,2854,1056,2855,505,1
20150106.112208,2855,2,1309238,0,2854,1057,2855,509,1
20150106.112208,2855,182,1309420,180,2854,1057,2855,418,1
20150106.112209,2855,230,1309650,230,2854,1057,2855,303,1
20150106.11221,2855,4,1309654,0,2854,1058,2855,301,1
20150106.112211,2855,304,1309958,0,2854,1058,2855,149,1
20150106.112211,2855,4,1309962,2,2854,1058,2855,159,1
20150106.112212,2855,2,1309964,2,2854,1057,2855,158,1
20150106.112212,2855,44,1310008,42,2854,1058,2855,136,1
20150106.112213,2855,12,1310020,12,2854,1058,2855,130,1
20150106.112213,2855,150,1310170,150,2854,1058,2855,55,1
20150106.112214,2855,28,1310198,22,2854,1057,2855,112,1
20150106.112215,2855,424,1310622,-226,2854,912,2855,44,1
20150106.112215,2855,2,1310624,-2,2854,912,2855,43,1
20150106.112216,2855,10,1310634,-2,2854,960,2855,48,1
20150106.112216,2855,4,1310638,-2,2854,960,2855,46,1
20150106.112217,2855,20,1310658,-20,2854,961,2855,37,1
20150106.112217,2855,22,1310680,-20,2854,961,2855,46,1
20150106.112218,2855,6,1310686,-6,2854,961,2855,43,1
20150106.112219,2855,8,1310694,-6,2854,961,2855,39,1
20150106.11222,2855,8,1310702,-6,2854,964,2855,41,1
20150106.112221,2855,12,1310714,-6,2854,963,2855,37,1
20150106.112222,2854,12,1310726,8,2854,958,2855,36,0
20150106.112223,2854,14,1310740,-2,2854,955,2855,30,0
20150106.112223,2855,10,1310750,6,2854,955,2855,26,1
20150106.112224,2855,10,1310760,4,2854,956,2855,36,1
20150106.112225,2855,2,1310762,0,2854,954,2855,36,1
20150106.112225,2855,2,1310764,0,2854,954,2855,38,1
20150106.112226,2855,2,1310766,2,2854,954,2855,37,1
20150106.112227,2855,40,1310806,-4,2854,955,2855,17,1
20150106.112227,2855,10,1310816,6,2854,960,2855,13,1
20150106.112228,2855,10,1310826,-10,2855,51,2856,563,1
20150106.112228,2855,132,1310958,-126,2854,967,2855,72,1
20150106.112229,2855,62,1311020,0,2854,963,2855,62,1
20150106.112236,2855,10,1311030,-10,2854,970,2855,138,1
20150106.112236,2855,8,1311038,0,2854,970,2855,135,1
20150106.112237,2855,6,1311044,0,2854,970,2855,132,1
20150106.112237,2855,2,1311046,0,2854,970,2855,132,1
20150106.112238,2855,268,1311314,-106,2855,270,2856,499,1
20150106.112242,2855,2,1311316,-2,2855,279,2856,549,1
20150106.112243,2855,10,1311326,-10,2855,275,2856,545,1
20150106.112245,2855,2,1311328,0,2855,294,2856,546,1
20150106.112247,2855,2,1311330,0,2855,314,2856,551,1
20150106.112249,2855,664,1311994,304,2854,971,2855,770,1
20150106.112251,2855,400,1312394,0,2854,971,2855,589,1
20150106.112252,2855,6,1312400,0,2854,971,2855,544,1
20150106.112255,2855,400,1312800,0,2854,950,2855,413,1
20150106.112255,2855,20,1312820,20,2854,951,2855,403,1
20150106.112256,2855,22,1312842,0,2854,951,2855,392,1
20150106.112256,2855,4,1312846,4,2854,952,2855,390,1
20150106.112259,2855,400,1313246,0,2854,953,2855,190,1
20150106.1123,2855,2,1313248,2,2854,955,2855,189,1
20150106.112301,2855,404,1313652,-318,2855,53,2856,543,1
20150106.112302,2856,2,1313654,2,2855,53,2856,543,1
20150106.112303,2855,408,1314062,-46,2855,49,2856,342,0
20150106.112303,2855,2,1314064,2,2855,57,2856,345,0
20150106.112304,2855,2,1314066,2,2855,126,2856,379,0
20150106.112306,2855,22,1314088,18,2855,157,2856,370,0
20150106.112307,2855,2,1314090,2,2855,162,2856,390,0
20150106.112308,2856,40,1314130,-40,2855,178,2856,369,1
20150106.112309,2855,2,1314132,0,2855,179,2856,369,0
20150106.112309,2855,20,1314152,20,2855,172,2856,369,0
20150106.11231,2855,2,1314154,0,2855,182,2856,370,0
20150106.112311,2856,20,1314174,4,2855,185,2856,345,1
20150106.112311,2856,2,1314176,0,2855,185,2856,344,1
20150106.112312,2856,2,1314178,0,2855,217,2856,343,1
20150106.112313,2856,20,1314198,14,2855,242,2856,333,1
20150106.112315,2855,2,1314200,0,2855,256,2856,339,0
20150106.112318,2856,4,1314204,0,2855,256,2856,376,1
20150106.112318,2856,4,1314208,0,2855,256,2856,375,1
20150106.112319,2855,2,1314210,2,2855,259,2856,375,0
20150106.112319,2856,2,1314212,0,2855,260,2856,374,1
20150106.112321,2856,20,1314232,0,2855,262,2856,369,1
20150106.112325,2856,4,1314236,0,2855,290,2856,368,1
20150106.112325,2856,100,1314336,-82,2855,294,2856,322,1
20150106.112326,2856,400,1314736,-264,2855,319,2856,116,1
20150106.112326,2856,6,1314742,-2,2855,356,2856,161,1
20150106.112327,2856,8,1314750,-6,2855,357,2856,158,1
20150106.112328,2856,2,1314752,-2,2855,370,2856,167,1
20150106.11233,2855,4,1314756,4,2855,371,2856,176,0
20150106.112331,2856,14,1314770,-14,2855,387,2856,168,1
20150106.112333,2855,2,1314772,2,2855,386,2856,168,0
20150106.112333,2856,22,1314794,0,2855,386,2856,154,1
20150106.112334,2856,6,1314800,-6,2855,390,2856,152,1
20150106.112335,2855,32,1314832,2,2855,493,2856,138,0
20150106.112335,2856,4,1314836,-4,2855,493,2856,146,1
20150106.112336,2856,4,1314840,-2,2855,494,2856,145,1
20150106.112338,2856,4,1314844,-2,2855,506,2856,154,1
20150106.112339,2856,4,1314848,-4,2855,509,2856,152,1
20150106.11234,2856,20,1314868,10,2855,509,2856,143,1
20150106.112341,2856,408,1315276,-350,2855,525,2857,733,1
20150106.112341,2856,24,1315300,16,2855,550,2856,78,1
20150106.112342,2856,22,1315322,-4,2855,550,2856,69,1
20150106.112343,2856,10,1315332,-8,2855,546,2856,64,1
20150106.112344,2856,20,1315352,-12,2855,546,2856,57,1
20150106.112345,2856,2,1315354,-2,2855,546,2856,56,1
20150106.112345,2856,2,1315356,-2,2855,546,2856,55,1
20150106.112346,2856,4,1315360,-4,2855,548,2856,54,1
20150106.112347,2856,4,1315364,-4,2855,548,2856,73,1
20150106.112347,2856,208,1315572,-154,2855,573,2856,29,1
20150106.112348,2856,32,1315604,0,2855,548,2856,64,1
20150106.112348,2856,2,1315606,0,2855,549,2856,63,1
20150106.112349,2856,4,1315610,0,2855,551,2856,61,1
20150106.112349,2856,4,1315614,-4,2855,551,2856,99,1
20150106.11235,2856,2,1315616,0,2855,551,2856,109,1
20150106.112351,2855,10,1315626,0,2855,546,2856,157,0
20150106.112351,2856,2,1315628,0,2855,546,2856,157,1
20150106.112352,2856,2,1315630,0,2855,546,2856,156,1
20150106.112353,2856,4,1315634,-4,2855,547,2856,155,1
20150106.112354,2856,2,1315636,0,2855,548,2856,159,1
20150106.112355,2856,2,1315638,0,2855,548,2856,158,1
20150106.112356,2856,2,1315640,-2,2855,548,2856,157,1
20150106.112357,2855,4,1315644,4,2855,546,2856,167,0
20150106.112357,2856,4,1315648,-4,2855,546,2856,165,1
20150106.112358,2856,4,1315652,-2,2855,546,2856,166,1
20150106.112359,2856,40,1315692,0,2855,546,2856,147,1
20150106.112359,2856,2,1315694,-2,2855,546,2856,146,1
20150106.1124,2856,2,1315696,0,2855,546,2856,150,1
20150106.112402,2856,4,1315700,0,2855,548,2856,152,1
20150106.112404,2856,2,1315702,0,2855,536,2856,157,1
20150106.112407,2855,10,1315712,10,2855,529,2856,162,0
20150106.112408,2856,2,1315714,0,2855,532,2856,263,1
20150106.11241,2856,4,1315718,0,2855,533,2856,313,1
20150106.112411,2855,10,1315728,0,2855,535,2856,314,0
20150106.112411,2856,2,1315730,0,2855,535,2856,313,1
20150106.112412,2856,2,1315732,-2,2855,521,2856,365,1
20150106.112414,2855,2,1315734,0,2855,529,2856,417,0
20150106.112415,2855,4,1315738,2,2855,478,2856,410,0
20150106.11242,2855,20,1315758,12,2855,409,2856,433,0
20150106.112421,2856,4,1315762,-4,2855,409,2856,429,1
20150106.112422,2856,2,1315764,0,2855,409,2856,428,1
20150106.112423,2855,2,1315766,0,2855,408,2856,431,0
20150106.112424,2856,2,1315768,-2,2855,408,2856,433,1
20150106.112426,2856,4,1315772,-4,2855,408,2856,432,1
20150106.112427,2856,22,1315794,2,2855,395,2856,421,1
20150106.11243,2856,2,1315796,2,2855,394,2856,421,1
20150106.112432,2855,6,1315802,2,2855,363,2856,423,0
20150106.112433,2856,8,1315810,0,2855,364,2856,419,1
20150106.112436,2856,30,1315840,0,2855,364,2856,410,1
20150106.112436,2856,600,1316440,-272,2855,366,2856,111,1
20150106.112437,2856,6,1316446,2,2855,368,2856,108,1
20150106.112438,2856,4,1316450,4,2855,369,2856,106,1
20150106.112439,2856,12,1316462,2,2855,361,2856,99,1
20150106.11244,2856,2,1316464,0,2855,362,2856,98,1
20150106.112441,2856,2,1316466,0,2855,364,2856,97,1
20150106.112442,2856,4,1316470,0,2855,363,2856,95,1
20150106.112443,2856,4,1316474,2,2855,363,2856,98,1
20150106.112444,2856,474,1316948,192,2856,48,2857,1075,1
20150106.112444,2856,98,1317046,0,2855,389,2856,106,1
20150106.112445,2856,2,1317048,0,2855,389,2856,105,1
20150106.112447,2856,2,1317050,-2,2855,390,2856,106,1
20150106.112448,2856,22,1317072,4,2855,395,2856,99,1
20150106.112449,2856,10,1317082,-4,2855,402,2856,95,1
20150106.112449,2856,20,1317102,-20,2855,402,2856,86,1
20150106.11245,2856,4,1317106,-4,2855,402,2856,84,1
20150106.112451,2856,606,1317712,-460,2856,101,2857,865,1
20150106.112452,2856,18,1317730,-10,2856,104,2857,864,1
20150106.112453,2856,4,1317734,-2,2856,102,2857,864,1
20150106.112454,2856,34,1317768,-34,2856,85,2857,863,1
20150106.112454,2857,2,1317770,0,2856,85,2857,862,1
20150106.112455,2857,6,1317776,0,2856,89,2857,862,1
20150106.112455,2857,20,1317796,-8,2856,92,2857,854,1
20150106.112456,2857,404,1318200,-128,2856,92,2857,658,1
20150106.112456,2857,4,1318204,2,2856,103,2857,656,1
20150106.112457,2856,4,1318208,0,2856,109,2857,656,0
20150106.112458,2856,412,1318620,-114,2856,109,2858,744,0
20150106.1125,2857,400,1319020,0,2856,257,2858,983,1
20150106.1125,2856,28,1319048,-8,2856,220,2858,1023,0
20150106.112501,2858,20,1319068,0,2856,257,2858,1043,1
20150106.112502,2858,44,1319112,-8,2856,259,2858,1014,1
20150106.112502,2858,6,1319118,-6,2856,259,2858,1011,1
20150106.112502,2857,20,1319138,-18,2856,260,2857,7,0
20150106.112503,2857,6,1319144,-6,2856,264,2857,34,0
20150106.112504,2857,2,1319146,-2,2856,297,2857,60,0
20150106.112505,2857,2,1319148,0,2856,297,2857,60,0
20150106.112505,2857,8,1319156,-2,2856,297,2857,59,0
20150106.112506,2857,4,1319160,4,2856,399,2857,58,0
20150106.112507,2857,8,1319168,0,2856,395,2857,53,0
20150106.112508,2857,22,1319190,20,2856,408,2857,91,0
20150106.112509,2857,2,1319192,2,2856,408,2857,111,0
20150106.112509,2856,2,1319194,0,2856,407,2857,120,0
20150106.112509,2857,2,1319196,0,2856,407,2857,124,1
20150106.11251,2857,4,1319200,0,2856,408,2857,125,1
20150106.112511,2856,4,1319204,2,2856,406,2857,624,0
20150106.112512,2857,26,1319230,-4,2856,403,2857,623,1
20150106.112514,2857,2,1319232,0,2856,426,2857,635,1
20150106.112515,2856,8,1319240,0,2856,389,2857,640,0
20150106.112516,2856,16,1319256,0,2856,384,2857,637,0
20150106.112518,2856,2,1319258,0,2856,408,2857,637,0
20150106.112518,2857,6,1319264,0,2856,405,2857,634,1
20150106.112521,2856,4,1319268,2,2856,430,2857,641,0
20150106.112522,2857,20,1319288,20,2856,430,2857,628,1
20150106.112523,2856,2,1319290,2,2856,530,2857,629,0
20150106.112525,2856,8,1319298,8,2856,532,2857,639,0
20150106.112526,2856,4,1319302,4,2856,531,2857,639,0
20150106.11253,2856,2,1319304,0,2856,534,2857,651,0
20150106.112531,2856,2,1319306,2,2856,530,2857,751,0
20150106.112531,2856,16,1319322,0,2856,522,2857,751,0
20150106.112532,2856,16,1319338,0,2856,514,2857,751,0
20150106.112533,2856,2,1319340,0,2856,513,2857,751,0
20150106.112534,2856,10,1319350,10,2856,509,2857,752,0
20150106.112535,2856,44,1319394,36,2856,487,2857,754,0
20150106.112536,2857,2,1319396,0,2856,487,2857,754,1
20150106.112538,2856,20,1319416,-20,2856,477,2857,774,0
20150106.112539,2857,600,1320016,-140,2856,477,2857,475,1
20150106.11254,2856,6,1320022,-2,2856,474,2857,474,0
20150106.112541,2856,8,1320030,-6,2856,471,2857,474,0
20150106.112542,2857,2,1320032,2,2856,473,2857,484,1
20150106.112543,2857,2,1320034,0,2856,473,2857,487,1
20150106.112547,2857,2,1320036,0,2856,477,2857,917,1
20150106.112547,2857,2,1320038,2,2856,479,2857,919,1
20150106.112548,2857,4,1320042,0,2856,479,2857,918,1
20150106.112549,2857,4,1320046,4,2856,479,2857,916,1
20150106.112551,2857,4,1320050,4,2856,479,2857,915,1
20150106.112552,2857,2,1320052,2,2856,479,2857,914,1
20150106.112554,2857,4,1320056,4,2856,518,2857,923,1
20150106.112555,2857,22,1320078,0,2856,498,2857,973,1
20150106.112558,2857,4,1320082,2,2856,509,2857,973,1
20150106.112559,2856,6,1320088,2,2856,506,2857,1023,0
20150106.1126,2857,2,1320090,2,2856,506,2857,1022,1
20150106.112601,2857,2,1320092,2,2856,506,2857,1022,1
20150106.112602,2856,4,1320096,-2,2856,505,2857,1024,0
20150106.112605,2856,2,1320098,0,2856,507,2857,1024,0
20150106.112606,2857,2,1320100,2,2856,506,2857,1023,1
20150106.112607,2857,2,1320102,2,2856,515,2857,1022,1
20150106.112607,2856,2,1320104,0,2856,514,2857,1022,0
20150106.112608,2857,4,1320108,0,2856,514,2857,1020,1
20150106.112608,2856,2,1320110,0,2856,513,2857,1020,0
20150106.112611,2857,2,1320112,0,2856,825,2857,1020,1
20150106.112612,2856,8,1320120,-8,2856,821,2857,1020,0
20150106.112613,2857,2,1320122,0,2856,871,2857,1027,1
20150106.112615,2857,2,1320124,0,2856,580,2857,1025,1
20150106.112617,2857,606,1320730,-44,2856,585,2857,723,1
20150106.112619,2857,608,1321338,-136,2856,585,2857,418,1
20150106.11262,2856,2,1321340,0,2856,647,2857,418,0
20150106.112621,2857,24,1321364,2,2856,648,2857,406,1
20150106.112622,2857,4,1321368,2,2856,680,2857,404,1
20150106.112623,2857,2,1321370,2,2856,679,2857,393,1
20150106.112623,2856,12,1321382,0,2856,679,2857,893,0
20150106.112624,2857,2,1321384,2,2856,679,2857,893,1
20150106.112625,2857,30,1321414,0,2856,679,2857,878,1
20150106.112625,2857,2,1321416,0,2856,679,2857,877,1
20150106.112626,2857,400,1321816,0,2856,680,2857,727,1
20150106.112627,2857,402,1322218,-128,2856,680,2857,531,1
20150106.112627,2857,2,1322220,0,2856,680,2857,534,1
20150106.112628,2857,2,1322222,2,2856,682,2857,533,1
20150106.112629,2857,4,1322226,0,2856,683,2857,531,1
20150106.112629,2857,2,1322228,0,2856,693,2857,530,1
20150106.11263,2857,4,1322232,4,2856,695,2857,528,1
20150106.112631,2857,2,1322234,2,2856,693,2857,565,1
20150106.112633,2857,2,1322236,0,2856,693,2857,566,1
20150106.112634,2857,2,1322238,2,2856,697,2857,567,1
20150106.112634,2857,2,1322240,2,2856,698,2857,566,1
20150106.112635,2857,2,1322242,0,2856,638,2857,570,1
20150106.112638,2857,2,1322244,2,2856,640,2857,581,1
20150106.112639,2857,2,1322246,0,2856,640,2857,580,1
20150106.11264,2857,4,1322250,2,2856,641,2857,578,1
20150106.112641,2857,2,1322252,2,2856,701,2857,578,1
20150106.112642,2857,2,1322254,2,2856,701,2857,581,1
20150106.112645,2857,268,1322522,2,2856,702,2857,568,1
20150106.112645,2857,6,1322528,0,2856,703,2857,565,1
20150106.112646,2857,4,1322532,0,2856,703,2857,565,1
20150106.112647,2856,2,1322534,0,2856,722,2857,566,0
20150106.112648,2857,2,1322536,2,2856,722,2857,565,1
20150106.112649,2857,2,1322538,0,2856,722,2857,564,1
20150106.112649,2857,10,1322548,0,2856,772,2857,559,1
20150106.11265,2857,400,1322948,0,2856,772,2857,360,1
20150106.112651,2857,4,1322952,4,2856,772,2857,445,1
20150106.112652,2857,4,1322956,0,2856,771,2857,442,1
20150106.112652,2857,6,1322962,2,2856,771,2857,442,1
20150106.112654,2857,30,1322992,0,2856,781,2857,431,1
20150106.112654,2857,14,1323006,14,2856,781,2857,424,1
20150106.112656,2857,6,1323012,2,2856,781,2857,427,1
20150106.112657,2857,8,1323020,2,2856,781,2857,423,1
20150106.112658,2857,2,1323022,2,2856,784,2857,420,1
20150106.1127,2856,2,1323024,-2,2856,783,2857,421,0
20150106.112701,2857,10,1323034,0,2856,793,2857,417,1
20150106.112704,2857,2,1323036,0,2856,808,2857,418,1
20150106.112707,2856,4,1323040,-4,2856,806,2857,418,0
20150106.112708,2857,2,1323042,2,2856,787,2857,418,1
20150106.112708,2856,4,1323046,0,2856,785,2857,418,0
20150106.11271,2857,100,1323146,0,2856,789,2857,367,1
20150106.11271,2856,2,1323148,-2,2856,788,2857,367,0
20150106.112715,2857,2,1323150,2,2856,816,2857,366,1
20150106.112716,2857,14,1323164,-8,2856,810,2857,366,1
20150106.112716,2856,2,1323166,0,2856,809,2857,366,0
20150106.112717,2856,2,1323168,0,2856,808,2857,367,0
20150106.112719,2857,32,1323200,0,2856,808,2857,362,1
20150106.11272,2857,2,1323202,0,2856,813,2857,361,1
20150106.112723,2857,22,1323224,0,2856,821,2857,349,1
20150106.112726,2857,84,1323308,0,2856,820,2857,309,1
20150106.112727,2857,2,1323310,2,2856,820,2857,308,1
20150106.112731,2857,2,1323312,0,2856,830,2857,305,1
20150106.112731,2857,2,1323314,2,2856,830,2857,304,1
20150106.112733,2857,4,1323318,-4,2856,841,2857,302,1
20150106.112734,2857,2,1323320,-2,2856,856,2857,301,1
20150106.112736,2856,6,1323326,6,2856,852,2857,282,0
20150106.112738,2857,6,1323332,-2,2856,852,2857,279,1
20150106.112739,2857,4,1323336,-4,2856,852,2857,265,1
20150106.112739,2857,2,1323338,0,2856,852,2857,264,1
20150106.112739,2857,2,1323340,0,2856,852,2857,278,1
20150106.11274,2857,6,1323346,0,2856,849,2857,275,1
20150106.112742,2857,2,1323348,-2,2856,849,2857,275,1
20150106.112743,2857,274,1323622,-24,2856,849,2857,118,1
20150106.112744,2857,2,1323624,0,2856,848,2857,118,1
20150106.112745,2857,12,1323636,10,2856,855,2857,112,1
20150106.112745,2857,8,1323644,8,2856,855,2857,107,1
20150106.112746,2857,10,1323654,6,2856,855,2857,102,1
20150106.112746,2857,30,1323684,-18,2856,855,2857,87,1
20150106.112747,2857,6,1323690,-6,2856,860,2857,83,1
20150106.112748,2857,6,1323696,-6,2856,860,2857,79,1
20150106.112749,2857,6,1323702,4,2856,861,2858,898,1
20150106.112749,2857,2,1323704,2,2856,846,2857,76,1
20150106.11275,2857,150,1323854,0,2857,85,2858,1188,1
20150106.112751,2857,2,1323856,-2,2857,85,2858,1190,1
20150106.112752,2857,6,1323862,-2,2857,132,2858,1188,1
20150106.112752,2857,2,1323864,-2,2857,161,2858,1188,1
20150106.112754,2857,6,1323870,0,2857,259,2858,1186,1
20150106.112755,2857,48,1323918,-48,2857,238,2858,1187,1
20150106.112756,2857,476,1324394,-474,2856,779,2857,83,1
20150106.112756,2857,4,1324398,-4,2856,779,2857,82,1
20150106.112756,2857,10,1324408,-10,2856,769,2857,79,1
20150106.112759,2857,182,1324590,14,2857,9,2858,1179,1
20150106.112759,2857,2,1324592,0,2857,8,2858,1175,1
20150106.1128,2857,6,1324598,6,2857,17,2858,1175,1
20150106.1128,2857,34,1324632,0,2856,678,2857,16,1
20150106.112801,2857,6,1324638,0,2856,679,2857,24,1
20150106.112801,2857,12,1324650,0,2856,679,2857,21,1
20150106.112802,2857,6,1324656,-2,2856,679,2857,51,1
20150106.112802,2857,14,1324670,-4,2856,679,2857,45,1
20150106.112803,2857,60,1324730,0,2856,679,2857,16,1
20150106.112804,2856,38,1324768,14,2856,681,2857,14,0
20150106.112805,2856,4,1324772,-4,2856,679,2857,21,0
20150106.112806,2857,10,1324782,6,2856,679,2857,17,1
20150106.112807,2857,200,1324982,-166,2856,697,2858,1187,1
20150106.112809,2858,4,1324986,-4,2856,700,2858,1179,1
20150106.11281,2858,4,1324990,0,2857,9,2858,1189,1
20150106.112811,2857,26,1325016,-24,2856,733,2857,12,0
20150106.112812,2857,30,1325046,-28,2856,703,2857,17,0
20150106.112813,2857,2,1325048,-2,2856,704,2857,21,0
20150106.112814,2857,26,1325074,-6,2856,704,2857,8,0
20150106.112814,2857,16,1325090,-2,2857,96,2858,1215,0
20150106.112815,2858,4,1325094,0,2857,95,2858,1210,1
20150106.112815,2857,4,1325098,0,2857,95,2858,1211,0
20150106.112816,2857,30,1325128,-4,2857,85,2858,1211,0
20150106.112816,2857,44,1325172,0,2857,65,2858,1209,0
20150106.112817,2858,26,1325198,2,2857,63,2858,1198,1
20150106.112817,2857,2,1325200,0,2857,62,2858,1205,0
20150106.112818,2857,126,1325326,8,2856,696,2857,2,0
20150106.112818,2858,16,1325342,-14,2857,1,2858,1203,1
20150106.112819,2857,14,1325356,2,2856,691,2857,43,0
20150106.112819,2858,104,1325460,102,2856,691,2858,1192,1
20150106.11282,2857,2,1325462,0,2856,691,2857,2,0
20150106.112821,2857,4,1325466,0,2857,5,2858,1193,0
20150106.112821,2857,10,1325476,0,2857,1,2858,1192,0
20150106.112822,2857,2,1325478,-2,2856,731,2857,2,0
20150106.112822,2858,26,1325504,-2,2857,1,2858,1195,1
20150106.112823,2857,6,1325510,-2,2857,31,2858,1191,0
20150106.112824,2857,20,1325530,0,2857,78,2858,1191,0
20150106.112825,2857,16,1325546,-2,2857,74,2858,1189,0
20150106.112825,2857,6,1325552,0,2857,74,2858,1189,0
20150106.112827,2857,2,1325554,0,2857,76,2858,1192,0
20150106.112827,2857,6,1325560,0,2857,83,2858,1192,0
20150106.112828,2857,4,1325564,-2,2857,86,2858,1192,0
20150106.112829,2858,8,1325572,-6,2857,85,2858,1193,1
20150106.11283,2857,2,1325574,-2,2857,83,2858,1198,0
20150106.112831,2857,10,1325584,-4,2857,78,2858,1198,0
20150106.112831,2858,2,1325586,-2,2857,80,2858,1198,1
20150106.112832,2857,8,1325594,6,2857,78,2858,1200,0
20150106.112832,2858,8,1325602,-8,2857,81,2858,1197,1
20150106.112833,2857,6,1325608,4,2857,78,2858,1197,0
20150106.112834,2858,6,1325614,-2,2857,78,2858,1209,1
20150106.112834,2858,4,1325618,0,2857,78,2858,1207,1
20150106.112835,2858,2,1325620,0,2857,90,2858,1207,1
20150106.112835,2858,2,1325622,0,2857,95,2858,1208,1
20150106.112836,2857,6,1325628,2,2857,94,2858,1209,0
20150106.112836,2857,14,1325642,2,2857,91,2858,1211,0
20150106.112837,2858,2,1325644,-2,2857,94,2858,1210,1
20150106.112838,2857,2,1325646,0,2857,144,2858,1208,0
20150106.112838,2857,2,1325648,2,2857,145,2858,1208,0
20150106.112839,2857,6,1325654,6,2857,142,2858,1208,0
20150106.11284,2858,6,1325660,0,2857,142,2858,1206,1
20150106.112842,2857,2,1325662,0,2857,146,2858,1206,0
20150106.112842,2857,6,1325668,0,2857,199,2858,1207,0
20150106.112843,2858,2,1325670,2,2857,201,2858,1207,1
20150106.112843,2858,8,1325678,0,2857,207,2858,1698,1
20150106.112844,2857,2,1325680,0,2857,206,2858,1700,0
20150106.112844,2858,22,1325702,8,2857,208,2858,1490,1
20150106.112845,2857,2,1325704,2,2857,212,2858,1487,0
20150106.112845,2857,2,1325706,2,2857,211,2858,1486,0
20150106.112846,2858,20,1325726,0,2857,212,2858,1466,1
20150106.112847,2858,16,1325742,0,2857,242,2858,1459,1
20150106.112847,2857,4,1325746,0,2857,240,2858,1461,0
20150106.11285,2857,2,1325748,0,2857,416,2858,1400,0
20150106.112851,2858,24,1325772,-12,2857,417,2858,1415,1
20150106.112853,2858,2,1325774,0,2857,424,2858,1404,1
20150106.112854,2858,8,1325782,4,2857,422,2858,1402,1
20150106.112855,2857,2,1325784,-2,2857,371,2858,1443,0
20150106.112855,2857,2,1325786,-2,2857,373,2858,1443,0
20150106.112856,2858,2,1325788,2,2857,374,2858,1424,1
20150106.112857,2857,200,1325988,-118,2857,274,2858,1426,0
20150106.112858,2857,202,1326190,-134,2857,173,2858,1426,0
20150106.112858,2857,12,1326202,-12,2857,267,2858,1447,0
20150106.112858,2857,2,1326204,0,2857,196,2858,1442,0
20150106.112859,2857,10,1326214,0,2857,194,2858,1487,0
20150106.1129,2858,8,1326222,0,2857,193,2858,1488,1
20150106.1129,2857,32,1326254,-30,2857,179,2858,1487,0
20150106.112901,2857,12,1326266,-10,2857,175,2858,1487,0
20150106.112902,2857,2,1326268,0,2857,174,2858,1487,0
20150106.112903,2857,2,1326270,-2,2857,193,2858,1506,0
20150106.112904,2857,4,1326274,0,2857,192,2858,1506,0
20150106.112904,2858,4,1326278,4,2857,228,2858,1504,1
20150106.112905,2857,8,1326286,4,2857,227,2858,1681,0
20150106.112906,2857,4,1326290,-2,2857,227,2858,1796,0
20150106.112908,2857,2,1326292,-2,2857,228,2858,1826,0
20150106.112908,2857,6,1326298,0,2857,225,2858,1826,0
20150106.11291,2857,12,1326310,-2,2857,223,2858,1826,0
20150106.112911,2858,4,1326314,0,2857,222,2858,1826,1
20150106.112912,2858,178,1326492,-24,2857,221,2858,1740,1
20150106.112912,2857,6,1326498,-2,2857,218,2858,1740,0
20150106.112914,2857,6,1326504,-2,2857,223,2858,1741,0
20150106.112914,2858,2,1326506,2,2857,248,2858,1740,1
20150106.112914,2858,2,1326508,0,2857,248,2858,1739,1
20150106.112915,2857,2,1326510,0,2857,263,2858,1744,0
20150106.112917,2858,4,1326514,2,2857,275,2858,1745,1
20150106.112918,2858,2,1326516,2,2857,275,2858,1743,1
20150106.11292,2858,62,1326578,14,2857,249,2858,1740,1
20150106.11292,2858,4,1326582,2,2857,248,2858,1739,1
20150106.112921,2857,10,1326592,4,2857,250,2858,1739,0
20150106.112921,2857,10,1326602,2,2857,247,2858,1740,0
20150106.112923,2857,4,1326606,2,2857,354,2858,1739,0
20150106.112923,2857,4,1326610,4,2857,353,2858,1740,0
20150106.112924,2858,140,1326750,140,2857,351,2858,1677,1
20150106.112925,2857,6,1326756,0,2857,343,2858,1676,0
20150106.112925,2857,6,1326762,6,2857,343,2858,1674,0
20150106.112926,2857,2,1326764,0,2857,342,2858,1673,0
20150106.112926,2858,100,1326864,34,2857,342,2858,1624,1
20150106.112927,2857,80,1326944,30,2857,333,2858,1528,0
20150106.112928,2858,28,1326972,14,2857,334,2858,1514,1
20150106.112929,2858,18,1326990,-18,2857,334,2858,1506,1
20150106.11293,2857,2,1326992,2,2857,333,2858,1507,0
20150106.11293,2858,40,1327032,0,2857,333,2858,1487,1
20150106.112931,2858,150,1327182,-98,2857,333,2858,1405,1
20150106.112932,2858,30,1327212,26,2857,333,2858,1389,1
20150106.112932,2857,28,1327240,26,2857,321,2858,1404,0
20150106.112933,2858,4,1327244,0,2857,381,2858,1403,1
20150106.112935,2858,14,1327258,14,2857,429,2858,1402,1
20150106.112936,2858,2,1327260,0,2857,420,2858,1401,1
20150106.112936,2857,10,1327270,10,2857,419,2858,1400,0
20150106.112937,2858,6,1327276,4,2857,420,2858,1398,1
20150106.112938,2857,4,1327280,4,2857,421,2858,1399,0
20150106.112939,2857,14,1327294,8,2857,417,2858,1397,0
20150106.11294,2858,2,1327296,0,2857,417,2858,1395,1
20150106.112941,2857,2,1327298,2,2857,416,2858,1396,0
20150106.112941,2857,2,1327300,2,2857,415,2858,1396,0
20150106.112942,2858,2,1327302,0,2857,415,2858,1397,1
20150106.112943,2858,6,1327308,2,2857,423,2858,1397,1
20150106.112943,2858,6,1327314,4,2857,423,2858,1396,1
20150106.112944,2857,4,1327318,0,2857,421,2858,1400,0
20150106.112945,2857,4,1327322,0,2857,424,2858,1401,0
20150106.112946,2857,8,1327330,4,2857,422,2858,1405,0
20150106.112946,2858,6,1327336,0,2857,423,2858,1401,1
20150106.112947,2857,4,1327340,2,2857,421,2858,1396,0
20150106.112949,2857,4,1327344,0,2857,419,2858,1400,0
20150106.112949,2857,20,1327364,0,2857,409,2858,1399,0
20150106.11295,2857,6,1327370,4,2857,406,2858,1395,0
20150106.112951,2857,2,1327372,0,2857,405,2858,1395,0
20150106.112952,2857,38,1327410,38,2857,386,2858,1398,0
20150106.112952,2857,2,1327412,0,2857,378,2858,1398,0
20150106.112953,2857,18,1327430,10,2857,377,2858,1389,0
20150106.112953,2857,4,1327434,-2,2857,375,2858,1389,0
20150106.112954,2857,4,1327438,-2,2857,373,2858,1382,0
20150106.112955,2857,110,1327548,-52,2857,329,2858,1368,0
20150106.112956,2857,22,1327570,-2,2857,318,2858,1372,0
20150106.112956,2857,2,1327572,0,2857,327,2858,1373,0
20150106.112957,2858,20,1327592,20,2857,327,2858,1363,1
20150106.112958,2857,6,1327598,-6,2857,324,2858,1359,0
20150106.112958,2857,2,1327600,0,2857,323,2858,1359,0
20150106.112959,2858,6,1327606,4,2857,324,2858,1354,1
20150106.112959,2857,4,1327610,0,2857,322,2858,1354,0
20150106.133,2858,46,1327656,38,2857,290,2858,1342,1
20150106.133001,2857,294,1327950,182,2857,188,2858,1321,0
20150106.133002,2857,32,1327982,2,2857,122,2858,1350,0
20150106.133002,2857,706,1328688,384,2856,293,2857,13,0
20150106.133003,2856,298,1328986,-220,2856,158,2857,354,0
20150106.133003,2855,362,1329348,-124,2855,145,2856,84,0
20150106.133004,2855,8,1329356,-2,2855,144,2856,89,0
20150106.133004,2856,298,1329654,174,2854,274,2855,1,1
20150106.133005,2855,122,1329776,-66,2855,34,2856,62,0
20150106.133005,2856,8,1329784,2,2855,34,2856,74,1
20150106.133006,2855,24,1329808,6,2855,31,2856,72,0
20150106.133006,2856,10,1329818,0,2855,38,2856,107,1
20150106.133007,2856,4,1329822,0,2855,39,2856,102,1
20150106.133007,2855,34,1329856,2,2855,48,2856,118,0
20150106.133008,2855,134,1329990,78,2854,309,2855,244,0
20150106.133009,2855,298,1330288,12,2854,312,2855,115,0
20150106.133009,2854,238,1330526,34,2854,336,2856,140,0
20150106.133009,2855,110,1330636,10,2854,336,2856,87,1
20150106.13301,2856,22,1330658,6,2855,7,2857,386,1
20150106.133011,2856,10,1330668,4,2855,61,2856,42,1
20150106.133011,2856,96,1330764,4,2856,2,2857,364,1
20150106.133012,2857,10,1330774,8,2856,2,2857,360,1
20150106.133013,2856,2,1330776,0,2856,4,2857,360,0
20150106.133013,2856,16,1330792,-16,2856,7,2857,364,0
20150106.133014,2857,44,1330836,-14,2855,171,2857,348,1
20150106.133014,2856,2,1330838,2,2856,2,2857,143,0
20150106.133015,2856,32,1330870,-28,2856,36,2857,143,0
20150106.133015,2856,84,1330954,0,2855,178,2856,58,0
20150106.133015,2856,6,1330960,4,2855,172,2856,56,0
20150106.133016,2855,42,1331002,22,2855,170,2856,38,0
20150106.133016,2856,44,1331046,38,2855,149,2856,16,1
20150106.133017,2855,24,1331070,6,2855,148,2856,12,0
20150106.133018,2856,50,1331120,2,2855,132,2856,23,1
20150106.133018,2856,8,1331128,8,2855,132,2856,19,1
20150106.133019,2856,44,1331172,12,2855,118,2856,15,1
20150106.13302,2856,12,1331184,0,2855,143,2856,67,1
20150106.13302,2855,2,1331186,0,2855,142,2856,72,0
20150106.133021,2856,18,1331204,-4,2855,143,2856,168,1
20150106.133021,2855,8,1331212,-4,2855,139,2856,177,0
20150106.133021,2856,4,1331216,2,2855,138,2856,179,1
20150106.133022,2855,40,1331256,14,2855,124,2856,171,0
20150106.133023,2855,6,1331262,4,2855,115,2856,225,0
20150106.133024,2855,234,1331496,108,2854,505,2855,1,0
20150106.133024,2855,4,1331500,2,2855,1,2856,185,0
20150106.133024,2855,10,1331510,4,2855,47,2856,168,0
20150106.133025,2855,102,1331612,2,2855,55,2856,191,0
20150106.133026,2855,4,1331616,2,2855,4,2856,259,0
20150106.133027,2855,28,1331644,12,2855,4,2856,261,0
20150106.133027,2855,4,1331648,0,2855,4,2856,267,0
20150106.133028,2855,10,1331658,4,2854,482,2856,267,0
20150106.133029,2855,4,1331662,-2,2855,9,2856,269,0
20150106.13303,2856,2,1331664,2,2855,15,2856,271,1
20150106.13303,2856,54,1331718,-18,2855,3,2856,260,1
20150106.133031,2854,16,1331734,-6,2854,483,2856,260,0
20150106.133031,2855,6,1331740,0,2855,44,2856,258,1
20150106.133032,2856,16,1331756,0,2855,44,2856,234,1
20150106.133032,2855,4,1331760,4,2855,44,2856,233,0
20150106.133034,2855,178,1331938,66,2854,571,2855,15,0
20150106.133035,2854,90,1332028,-8,2854,552,2856,198,0
20150106.133037,2856,4,1332032,0,2855,30,2856,198,1
20150106.133037,2856,10,1332042,-2,2855,45,2856,198,1
20150106.133038,2855,10,1332052,6,2855,40,2856,218,0
20150106.133039,2855,2,1332054,2,2855,39,2856,248,0
20150106.13304,2855,20,1332074,20,2855,44,2856,257,0
20150106.13304,2855,2,1332076,2,2855,54,2856,262,0
20150106.133041,2855,68,1332144,6,2855,20,2856,255,0
20150106.133042,2855,2,1332146,2,2855,20,2856,259,0
20150106.133042,2855,40,1332186,4,2855,1,2856,273,0
20150106.133042,2855,2,1332188,-2,2854,498,2855,5,0
20150106.133043,2855,12,1332200,-10,2855,7,2856,295,0
20150106.133044,2855,6,1332206,-2,2855,43,2856,299,0
20150106.133045,2855,2,1332208,0,2855,44,2856,300,0
20150106.133045,2855,2,1332210,2,2855,45,2856,295,0
20150106.133046,2855,8,1332218,6,2855,42,2856,294,0
20150106.133047,2855,94,1332312,32,2854,507,2855,64,0
20150106.133048,2855,130,1332442,26,2855,215,2856,321,0
20150106.133048,2855,6,1332448,2,2855,214,2856,321,0
20150106.133049,2856,4,1332452,2,2855,214,2856,315,1
20150106.133049,2856,10,1332462,10,2855,212,2856,312,1
20150106.13305,2856,2,1332464,2,2855,229,2856,315,1
20150106.133051,2855,4,1332468,4,2855,228,2856,315,0
20150106.133052,2856,20,1332488,12,2855,230,2856,305,1
20150106.133052,2856,6,1332494,-4,2855,260,2856,299,1
20150106.133053,2856,10,1332504,-4,2855,305,2856,294,1
20150106.133054,2855,40,1332544,0,2855,292,2856,275,0
20150106.133054,2855,2,1332546,2,2855,302,2856,275,0
20150106.133055,2856,10,1332556,-10,2855,302,2856,271,1
20150106.133055,2855,96,1332652,0,2855,255,2856,270,0
20150106.133056,2855,94,1332746,0,2855,208,2856,262,0
20150106.133056,2856,14,1332760,-2,2855,202,2856,261,1
20150106.133057,2856,4,1332764,0,2855,201,2856,260,1
20150106.133057,2856,2,1332766,-2,2855,204,2856,258,1
20150106.133059,2856,2,1332768,-2,2855,208,2856,262,1
20150106.133102,2855,16,1332784,0,2855,215,2856,268,0
20150106.133102,2855,4,1332788,0,2855,215,2856,268,0
20150106.133102,2855,2,1332790,0,2855,215,2856,268,0
20150106.133103,2855,40,1332830,40,2855,198,2856,265,0
20150106.133104,2856,4,1332834,2,2855,197,2856,259,1
20150106.133105,2855,2,1332836,2,2855,196,2856,261,0
20150106.133106,2856,6,1332842,0,2855,196,2856,258,1
20150106.133106,2854,400,1333242,-100,2855,12,2856,261,0
20150106.133107,2855,14,1333256,0,2855,10,2856,266,1
20150106.133107,2855,42,1333298,-10,2855,28,2856,278,1
20150106.133108,2855,14,1333312,14,2855,80,2856,278,1
20150106.133109,2854,402,1333714,-270,2854,365,2856,278,0
20150106.133109,2855,4,1333718,-2,2855,3,2856,302,1
20150106.133109,2855,6,1333724,-2,2854,360,2856,302,1
20150106.13311,2854,400,1334124,-286,2854,142,2855,70,0
20150106.133111,2855,12,1334136,10,2854,84,2855,97,1
20150106.133111,2855,4,1334140,4,2854,62,2855,81,1
20150106.133112,2854,142,1334282,-82,2853,1072,2854,134,0
20150106.133112,2854,268,1334550,0,2854,129,2855,123,0
20150106.133113,2854,262,1334812,-24,2853,1072,2854,72,0
20150106.133113,2855,146,1334958,-142,2854,36,2855,102,1
20150106.133114,2855,440,1335398,-26,2853,1072,2855,81,1
20150106.133114,2855,6,1335404,-2,2854,8,2855,110,1
20150106.133115,2854,118,1335522,0,2853,1088,2854,155,0
20150106.133115,2854,4,1335526,-2,2853,1088,2854,153,0
20150106.133116,2854,258,1335784,-250,2853,1034,2854,227,0
20150106.133116,2854,2,1335786,-2,2853,1034,2854,229,0
20150106.133116,2854,10,1335796,-6,2853,1034,2854,224,0
20150106.133117,2853,12,1335808,-4,2853,1034,2854,219,0
20150106.133118,2854,14,1335822,-6,2853,1079,2854,213,1
20150106.133118,2854,20,1335842,-4,2853,1075,2854,408,1
20150106.133119,2854,18,1335860,0,2853,1076,2854,399,1
20150106.133119,2854,34,1335894,-24,2853,1078,2854,383,1
20150106.13312,2853,6,1335900,0,2853,1078,2854,381,0
20150106.13312,2854,24,1335924,-22,2853,1078,2854,369,1
20150106.133121,2854,10,1335934,-8,2853,1077,2854,362,1
20150106.133121,2854,46,1335980,-44,2853,1075,2854,341,1
20150106.133122,2854,682,1336662,-602,2854,40,2855,224,1
20150106.133123,2854,16,1336678,14,2854,363,2855,213,1
20150106.133124,2854,62,1336740,62,2854,355,2855,188,1
20150106.133125,2854,6,1336746,2,2854,355,2855,187,1
20150106.133125,2855,46,1336792,18,2854,336,2855,188,1
20150106.133126,2854,12,1336804,0,2854,345,2855,174,0
20150106.133126,2854,2,1336806,0,2854,348,2855,183,0
20150106.133127,2854,404,1337210,-402,2854,151,2855,184,0
20150106.133127,2855,142,1337352,-98,2854,178,2855,137,1
20150106.133129,2855,2,1337354,0,2854,272,2855,107,1
20150106.13313,2854,2,1337356,0,2854,313,2855,107,0
20150106.133131,2854,200,1337556,34,2854,213,2855,107,0
20150106.133132,2854,8,1337564,0,2854,213,2855,104,0
20150106.133132,2855,2,1337566,0,2854,213,2855,103,1
20150106.133134,2855,2,1337568,0,2854,264,2855,104,1
20150106.133134,2855,6,1337574,2,2854,266,2855,101,1
20150106.133135,2855,6,1337580,4,2854,276,2855,99,1
20150106.133135,2854,2,1337582,2,2854,296,2855,100,0
20150106.133136,2855,200,1337782,144,2855,3,2856,434,1
20150106.133136,2855,12,1337794,8,2854,324,2855,3,1
20150106.133137,2855,4,1337798,4,2854,321,2855,22,1
20150106.133138,2855,6,1337804,0,2854,318,2855,27,1
20150106.133138,2855,2,1337806,0,2854,319,2855,27,1
20150106.133138,2854,12,1337818,0,2854,314,2855,32,0
20150106.133139,2855,2,1337820,0,2854,315,2855,41,1
20150106.13314,2854,6,1337826,-6,2854,334,2855,41,0
20150106.133141,2855,6,1337832,-4,2854,336,2855,47,1
20150106.133142,2855,8,1337840,-8,2854,184,2855,283,1
20150106.133143,2855,2,1337842,0,2854,159,2855,332,1
20150106.133144,2854,2,1337844,-2,2854,175,2855,333,0
20150106.133144,2854,240,1338084,130,2854,57,2855,336,0
20150106.133145,2854,2,1338086,0,2854,59,2855,378,0
20150106.133146,2854,2,1338088,-2,2854,63,2855,404,0
20150106.133146,2855,4,1338092,0,2854,63,2855,402,1
20150106.133147,2855,400,1338492,-356,2854,63,2855,209,1
20150106.133148,2854,10,1338502,-6,2854,82,2855,208,0
20150106.133148,2854,10,1338512,0,2854,84,2855,212,0
20150106.133149,2854,4,1338516,0,2854,83,2855,214,0
20150106.133149,2854,14,1338530,-4,2854,112,2855,216,0
20150106.13315,2855,2,1338532,-2,2854,113,2855,210,1
20150106.133151,2855,6,1338538,0,2854,121,2855,212,1
20150106.133151,2854,2,1338540,-2,2854,120,2855,213,0
20150106.133153,2855,4,1338544,-4,2854,131,2855,221,1
20150106.133154,2854,6,1338550,0,2854,128,2855,217,0
20150106.133156,2854,2,1338552,0,2854,143,2855,226,0
20150106.133157,2854,486,1339038,-336,2853,1457,2854,142,0
20150106.133158,2854,2,1339040,0,2853,1431,2854,143,0
20150106.133158,2854,2,1339042,0,2853,1434,2854,145,0
20150106.133159,2853,14,1339056,-2,2853,1428,2854,143,0
20150106.1332,2853,6,1339062,0,2853,1432,2854,161,0
20150106.1332,2855,604,1339666,-506,2854,81,2855,260,1
20150106.1332,2854,22,1339688,4,2854,70,2855,270,0
20150106.133201,2855,32,1339720,0,2854,55,2855,276,1
20150106.133202,2854,2,1339722,0,2854,90,2855,260,0
20150106.133202,2854,2,1339724,0,2854,90,2855,260,0
20150106.133203,2854,2,1339726,0,2854,102,2855,250,0
20150106.133204,2854,6,1339732,-2,2854,108,2855,256,0
20150106.133204,2854,2,1339734,0,2854,107,2855,241,0
20150106.133205,2854,2,1339736,2,2854,106,2855,242,0
20150106.133205,2854,4,1339740,4,2854,105,2855,242,0
20150106.133206,2854,2,1339742,0,2854,105,2855,242,0
20150106.133207,2854,40,1339782,40,2854,86,2855,242,0
20150106.133207,2854,4,1339786,0,2854,97,2855,242,0
20150106.133208,2854,16,1339802,16,2854,89,2855,242,0
20150106.13321,2854,4,1339806,4,2854,130,2855,231,0
20150106.133211,2854,2,1339808,2,2854,128,2855,231,0
20150106.133212,2854,14,1339822,-4,2854,132,2855,254,0
20150106.133213,2854,18,1339840,4,2854,140,2855,306,0
20150106.133214,2854,10,1339850,10,2854,135,2855,306,0
20150106.133214,2855,2,1339852,-2,2854,135,2855,305,1
20150106.133216,2855,2,1339854,0,2854,137,2855,315,1
20150106.133217,2854,664,1340518,-308,2854,105,2856,853,0
20150106.133218,2855,24,1340542,2,2854,162,2855,50,1
20150106.133218,2854,2,1340544,2,2854,178,2855,50,0
20150106.13322,2854,2,1340546,0,2854,216,2855,57,0
20150106.133221,2854,410,1340956,-182,2854,19,2855,83,0
20150106.133221,2855,2,1340958,0,2854,46,2855,130,1
20150106.133222,2854,436,1341394,-374,2854,11,2855,113,0
20150106.133222,2855,4,1341398,-4,2854,12,2855,139,1
20150106.133223,2854,404,1341802,-302,2854,15,2855,149,0
20150106.133224,2853,402,1342204,-318,2853,1033,2855,183,0
20150106.133225,2853,402,1342606,-358,2854,1,2855,196,0
20150106.133226,2854,2,1342608,0,2854,2,2855,196,1
20150106.133226,2855,2,1342610,0,2854,3,2855,196,1
20150106.133227,2853,400,1343010,-314,2853,600,2854,1,0
20150106.133227,2853,402,1343412,-352,2853,395,2854,4,0
20150106.133228,2854,6,1343418,-2,2853,395,2854,38,1
20150106.133228,2854,602,1344020,-542,2853,395,2855,211,1
20150106.133229,2854,4,1344024,0,2853,407,2854,74,1
20150106.133229,2853,404,1344428,-348,2853,209,2854,86,0
20150106.13323,2854,6,1344434,-6,2853,173,2854,111,1
20150106.133231,2853,442,1344876,-388,2853,27,2854,104,0
20150106.133232,2854,2,1344878,0,2853,51,2854,205,1
20150106.133232,2854,2,1344880,0,2853,56,2854,203,1
20150106.133233,2854,4,1344884,0,2853,56,2854,201,1
20150106.133235,2853,102,1344986,2,2853,6,2854,204,0
20150106.133235,2854,2,1344988,0,2853,11,2854,203,1
20150106.133236,2854,12,1345000,-2,2853,37,2854,157,1
20150106.133237,2853,48,1345048,0,2853,38,2854,152,0
20150106.133237,2854,2,1345050,-2,2853,39,2854,151,1
20150106.133238,2853,4,1345054,0,2853,64,2854,206,0
20150106.133239,2853,2,1345056,2,2853,103,2854,213,0
20150106.13324,2853,2,1345058,2,2853,105,2854,224,0
20150106.13324,2854,22,1345080,-14,2853,105,2854,214,1
20150106.133241,2854,6,1345086,2,2853,112,2854,213,1
20150106.133242,2854,2,1345088,2,2853,116,2854,212,1
20150106.133243,2853,14,1345102,14,2853,124,2854,212,0
20150106.133244,2853,2,1345104,0,2853,131,2854,213,0
20150106.133247,2853,2,1345106,2,2853,146,2854,233,0
20150106.133247,2853,62,1345168,38,2853,93,2854,241,0
20150106.133248,2854,42,1345210,36,2853,95,2854,218,1
20150106.133249,2853,8,1345218,0,2853,103,2854,225,0
20150106.133249,2854,10,1345228,-4,2853,106,2854,234,1
20150106.13325,2853,2,1345230,-2,2853,123,2854,234,0
20150106.133252,2853,6,1345236,-4,2853,251,2854,227,0
20150106.133253,2854,6,1345242,0,2853,254,2854,226,1
20150106.133255,2853,10,1345252,-10,2853,330,2854,228,0
20150106.133255,2853,10,1345262,0,2853,326,2854,229,0
20150106.133256,2853,40,1345302,16,2853,306,2854,231,0
20150106.133256,2854,2,1345304,0,2853,307,2854,231,1
20150106.133257,2854,74,1345378,-32,2853,320,2854,197,1
20150106.133257,2853,80,1345458,68,2853,291,2854,197,0
20150106.133258,2854,62,1345520,6,2853,291,2854,168,1
20150106.133258,2854,4,1345524,0,2853,315,2854,167,1
20150106.133259,2853,2,1345526,0,2853,314,2854,167,0
20150106.133259,2853,14,1345540,-6,2853,309,2854,165,0
20150106.1333,2853,4,1345544,0,2853,447,2854,253,0
20150106.133302,2853,2,1345546,0,2853,446,2854,263,0
20150106.133303,2853,40,1345586,16,2853,430,2854,439,0
20150106.133304,2853,204,1345790,-118,2853,379,2854,393,0
20150106.133304,2853,4,1345794,-2,2853,377,2854,393,0
20150106.133305,2854,2,1345796,2,2853,381,2854,392,1
20150106.133305,2853,402,1346198,-350,2853,190,2854,392,0
20150106.133306,2853,398,1346596,-306,2852,1685,2853,53,0
20150106.133307,2853,12,1346608,-2,2852,1686,2853,423,0
20150106.133307,2853,160,1346768,-102,2852,1704,2853,345,0
20150106.133308,2853,48,1346816,-40,2852,1597,2853,554,0
20150106.133308,2853,4,1346820,0,2852,1401,2853,552,0
20150106.133309,2852,2,1346822,0,2852,1205,2853,560,0
20150106.13331,2852,2,1346824,-2,2852,1204,2853,561,0
20150106.13331,2852,14,1346838,-8,2852,1198,2853,560,0
20150106.133312,2852,48,1346886,12,2852,1277,2853,559,0
20150106.133312,2853,22,1346908,0,2852,1276,2853,554,1
20150106.133313,2852,6,1346914,-6,2852,1273,2853,645,0
20150106.133314,2852,12,1346926,-4,2852,1293,2853,648,0
20150106.133315,2852,2,1346928,0,2852,1293,2853,648,0
20150106.133315,2852,4,1346932,-4,2852,1291,2853,648,0
20150106.133316,2853,602,1347534,-598,2852,1291,2853,347,1
20150106.133316,2853,14,1347548,-2,2852,1295,2853,337,1
20150106.133317,2853,24,1347572,-20,2852,1295,2853,325,1
20150106.133317,2853,134,1347706,-134,2852,1235,2853,258,1
20150106.133318,2853,240,1347946,-164,2852,1215,2853,158,1
20150106.133318,2853,22,1347968,2,2852,1215,2853,148,1
20150106.133319,2852,12,1347980,-10,2852,1214,2853,143,0
20150106.133319,2853,406,1348386,-386,2852,1213,2853,144,1
20150106.13332,2853,16,1348402,-12,2852,1213,2853,136,1
20150106.13332,2853,276,1348678,-236,2853,53,2854,512,1
20150106.133321,2853,212,1348890,-112,2852,1214,2853,159,1
20150106.133321,2852,18,1348908,-8,2852,1209,2853,160,0
20150106.133322,2853,224,1349132,-158,2852,1211,2853,47,1
20150106.133322,2853,16,1349148,6,2852,1211,2853,243,1
20150106.133323,2852,6,1349154,2,2852,1210,2853,267,0
20150106.133323,2852,4,1349158,4,2852,1215,2853,317,0
20150106.133324,2853,4,1349162,0,2852,1220,2853,318,1
20150106.133325,2852,2,1349164,0,2852,1219,2853,323,0
20150106.133325,2852,8,1349172,2,2852,1217,2853,324,0
20150106.133326,2852,4,1349176,-2,2852,1215,2853,338,0
20150106.133327,2852,4,1349180,0,2852,1170,2853,299,0
20150106.133327,2852,10,1349190,-4,2852,1164,2853,299,0
20150106.133328,2853,4,1349194,2,2852,1162,2853,518,1
20150106.133329,2853,4,1349198,4,2852,1163,2853,526,1
20150106.133329,2852,2,1349200,2,2852,1162,2853,626,0
20150106.13333,2853,200,1349400,-142,2852,1162,2853,536,1
20150106.133331,2852,10,1349410,0,2852,1158,2853,536,0
20150106.133332,2852,8,1349418,8,2852,1155,2853,543,0
20150106.133332,2853,2,1349420,0,2852,1156,2853,542,1
20150106.133333,2852,22,1349442,14,2852,1145,2853,542,0
20150106.133333,2853,2,1349444,0,2852,1145,2853,541,1
20150106.133334,2853,602,1350046,-330,2852,1144,2853,241,1
20150106.133335,2852,18,1350064,0,2852,1136,2853,242,0
20150106.133336,2853,504,1350568,-24,2853,101,2854,274,1
20150106.133336,2854,38,1350606,-4,2853,139,2854,256,1
20150106.133337,2853,12,1350618,-12,2853,133,2854,256,0
20150106.133337,2853,12,1350630,0,2853,137,2854,256,0
20150106.133338,2854,102,1350732,14,2853,206,2854,206,1
20150106.133339,2853,10,1350742,0,2853,226,2854,209,0
20150106.133339,2853,4,1350746,-4,2853,226,2854,185,0
20150106.13334,2853,620,1351366,262,2852,1376,2853,94,0
20150106.133341,2853,98,1351464,96,2852,1274,2853,46,0
20150106.133341,2853,24,1351488,18,2852,1272,2853,35,0
20150106.133342,2853,70,1351558,66,2853,26,2854,368,0
20150106.133342,2854,32,1351590,-6,2853,18,2854,356,1
20150106.133343,2854,4,1351594,4,2853,54,2854,356,1
20150106.133343,2853,12,1351606,6,2853,61,2854,356,0
20150106.133344,2853,2,1351608,2,2853,72,2854,358,0
20150106.133345,2853,2,1351610,0,2853,77,2854,374,0
20150106.133346,2853,4,1351614,4,2853,106,2854,359,0
20150106.133346,2853,140,1351754,88,2853,178,2854,311,0
20150106.133349,2853,28,1351782,12,2853,199,2854,318,0
20150106.133349,2854,2,1351784,2,2853,231,2854,337,1
20150106.13335,2853,52,1351836,48,2853,255,2854,338,0
20150106.133352,2853,2,1351838,2,2853,265,2854,378,0
20150106.133353,2854,4,1351842,4,2853,266,2854,376,1
20150106.133353,2853,4,1351846,2,2853,265,2854,376,0
20150106.133354,2853,2,1351848,2,2853,264,2854,381,0
20150106.133355,2853,2,1351850,2,2853,265,2854,382,0
20150106.133356,2854,26,1351876,6,2853,265,2854,369,1
20150106.133357,2854,2,1351878,0,2853,320,2854,369,1
20150106.133358,2853,2,1351880,0,2853,775,2854,368,0
20150106.133359,2854,2,1351882,0,2853,786,2854,343,1
20150106.1334,2854,4,1351886,4,2853,791,2854,342,1
20150106.1334,2853,8,1351894,0,2853,790,2854,340,0
20150106.133401,2853,4,1351898,4,2853,794,2854,341,0
20150106.133402,2853,2,1351900,2,2853,346,2854,341,0
20150106.133404,2854,4,1351904,4,2853,447,2854,340,1
20150106.133405,2854,2,1351906,2,2853,446,2854,341,1
20150106.133405,2853,2,1351908,0,2853,497,2854,341,0
20150106.133406,2853,8,1351916,4,2853,495,2854,341,0
20150106.133408,2854,8,1351924,6,2853,515,2854,331,1
20150106.133408,2854,2,1351926,2,2853,520,2854,330,1
20150106.133409,2855,664,1352590,-234,2854,222,2855,307,1
20150106.13341,2854,2,1352592,-2,2854,222,2855,192,0
20150106.133411,2854,4,1352596,0,2854,283,2855,189,0
20150106.133412,2855,4,1352600,2,2854,282,2855,190,1
20150106.133412,2854,2,1352602,0,2854,290,2855,190,0
20150106.133413,2855,102,1352704,-88,2854,290,2855,137,1
20150106.133416,2855,22,1352726,16,2854,303,2855,113,1
20150106.133416,2855,16,1352742,2,2854,348,2855,105,1
20150106.133417,2855,30,1352772,-30,2854,314,2855,112,1
20150106.133418,2855,10,1352782,-10,2854,314,2855,111,1
20150106.133419,2855,2,1352784,0,2854,321,2855,116,1
20150106.13342,2855,12,1352796,2,2854,321,2855,118,1
20150106.133421,2855,4,1352800,-4,2854,369,2855,120,1
20150106.133422,2855,4,1352804,-2,2854,368,2855,118,1
20150106.133423,2855,10,1352814,-4,2854,370,2855,112,1
20150106.133423,2854,402,1353216,-400,2854,170,2855,114,0
20150106.133424,2855,4,1353220,2,2854,170,2855,154,1
20150106.133425,2855,422,1353642,-282,2853,601,2855,289,1
20150106.133426,2855,2,1353644,0,2854,5,2855,312,1
20150106.133427,2854,412,1354056,-162,2853,501,2854,3,0
20150106.133428,2854,26,1354082,14,2853,406,2854,42,0
20150106.133428,2854,10,1354092,10,2853,385,2854,43,0
20150106.133428,2854,6,1354098,6,2853,385,2854,40,0
20150106.133429,2854,36,1354134,34,2853,385,2854,24,0
20150106.13343,2854,66,1354200,-22,2854,25,2855,325,0
20150106.13343,2854,50,1354250,-34,2853,555,2854,17,0
20150106.133431,2854,12,1354262,-2,2853,441,2854,68,0
20150106.133431,2854,20,1354282,18,2853,421,2854,68,0
20150106.133432,2854,354,1354636,18,2853,523,2854,23,0
20150106.133433,2854,10,1354646,8,2853,423,2854,69,0
20150106.133433,2854,20,1354666,4,2853,408,2854,62,0
20150106.133434,2854,2,1354668,0,2853,414,2854,68,0
20150106.133435,2854,4,1354672,2,2853,420,2854,66,0
20150106.133436,2854,104,1354776,12,2853,426,2854,14,0
20150106.133436,2854,8,1354784,-4,2853,431,2854,9,0
20150106.133437,2854,2,1354786,-2,2853,454,2854,8,0
20150106.133437,2854,20,1354806,-16,2853,457,2854,2,0
20150106.133438,2854,6,1354812,-4,2854,2,2855,393,0
20150106.133438,2855,214,1355026,148,2854,3,2855,305,1
20150106.133439,2855,6,1355032,0,2854,3,2855,302,1
20150106.133439,2855,2,1355034,0,2854,4,2855,301,1
20150106.133441,2855,2,1355036,0,2854,14,2855,336,1
20150106.133442,2854,4,1355040,0,2854,16,2855,336,0
20150106.133442,2854,2,1355042,0,2854,69,2855,336,0
20150106.133448,2854,60,1355102,54,2854,84,2855,293,0
20150106.13345,2854,92,1355194,-6,2854,54,2855,296,0
20150106.13345,2854,16,1355210,-12,2854,40,2855,298,0
20150106.133453,2855,2,1355212,0,2854,49,2855,295,1
20150106.133453,2854,2,1355214,0,2854,48,2855,298,0
20150106.133454,2855,22,1355236,8,2854,151,2855,291,1
20150106.133455,2855,2,1355238,0,2854,156,2855,290,1
20150106.133458,2855,6,1355244,4,2854,173,2855,245,1
20150106.133459,2855,2,1355246,2,2854,173,2855,244,1
20150106.133459,2855,14,1355260,0,2854,175,2855,237,1
20150106.133501,2855,6,1355266,-6,2854,169,2855,238,1
20150106.133501,2855,4,1355270,0,2854,176,2855,246,1
20150106.133502,2855,4,1355274,-4,2854,176,2855,244,1
20150106.133503,2854,10,1355284,-10,2854,172,2855,240,0
20150106.133503,2854,2,1355286,0,2854,171,2855,240,0
20150106.133504,2855,4,1355290,0,2854,171,2855,238,1
20150106.133505,2855,8,1355298,0,2854,195,2855,246,1
20150106.133505,2855,8,1355306,0,2854,194,2855,245,1
20150106.133506,2854,12,1355318,2,2854,194,2855,241,0
20150106.133506,2855,8,1355326,-2,2854,193,2855,238,1
20150106.133507,2854,14,1355340,4,2854,186,2855,238,0
20150106.133507,2854,2,1355342,-2,2854,185,2855,238,0
20150106.133508,2854,2,1355344,0,2854,234,2855,238,0
20150106.133509,2855,40,1355384,-32,2854,160,2855,199,1
20150106.133509,2854,6,1355390,-2,2854,163,2855,247,0
20150106.133511,2855,2,1355392,0,2854,192,2855,248,1
20150106.133512,2855,10,1355402,0,2854,207,2855,244,1
20150106.133514,2855,2,1355404,0,2854,207,2855,243,1
20150106.133514,2854,8,1355412,8,2854,203,2855,243,0
20150106.133514,2855,2,1355414,-2,2854,203,2855,244,1
20150106.133515,2854,4,1355418,4,2854,197,2855,244,0
20150106.133516,2855,20,1355438,-20,2854,231,2855,235,1
20150106.133518,2855,2,1355440,-2,2854,237,2855,276,1
20150106.133519,2854,8,1355448,8,2854,236,2855,278,0
20150106.13352,2854,82,1355530,-26,2854,205,2855,238,0
20150106.133522,2854,10,1355540,2,2854,201,2855,244,0
20150106.133522,2855,2,1355542,0,2854,201,2855,243,1
20150106.133523,2855,6,1355548,6,2854,232,2855,241,1
20150106.133524,2855,2,1355550,0,2854,332,2855,240,1
20150106.133525,2855,6,1355556,2,2854,356,2855,214,1
20150106.133526,2854,2,1355558,-2,2854,357,2855,214,0
20150106.133527,2855,600,1356158,24,2854,198,2855,115,1
20150106.133528,2854,404,1356562,-34,2854,1,2855,241,0
20150106.133528,2854,32,1356594,-22,2853,363,2854,38,0
20150106.133529,2854,492,1357086,-144,2853,413,2854,49,0
20150106.133529,2854,98,1357184,0,2854,58,2855,279,0
20150106.13353,2853,402,1357586,-86,2853,319,2854,1,0
20150106.13353,2854,88,1357674,4,2853,282,2854,56,1
20150106.133531,2854,602,1358276,-336,2853,109,2854,65,1
20150106.133532,2853,256,1358532,10,2852,1549,2853,89,0
20150106.133532,2854,230,1358762,-68,2853,48,2854,290,1
20150106.133532,2853,100,1358862,-84,2852,1448,2853,152,0
20150106.133533,2853,2,1358864,-2,2852,1448,2853,351,0
20150106.133534,2853,12,1358876,-10,2852,1441,2853,349,0
20150106.133534,2853,8,1358884,0,2852,1441,2853,346,0
20150106.133534,2853,8,1358892,0,2852,1442,2853,342,0
20150106.133535,2853,8,1358900,-4,2852,1444,2853,205,0
20150106.133536,2853,14,1358914,0,2852,1445,2853,198,0
20150106.133536,2853,14,1358928,-12,2852,1445,2853,191,0
20150106.133537,2853,8,1358936,0,2852,1445,2853,187,0
20150106.133537,2852,30,1358966,-8,2852,1444,2853,173,0
20150106.133537,2853,10,1358976,-10,2852,1444,2853,168,1
20150106.133538,2853,22,1358998,-22,2852,1444,2853,259,1
20150106.133539,2853,16,1359014,-10,2852,1442,2853,483,1
20150106.133539,2853,76,1359090,0,2852,1428,2853,460,1
20150106.13354,2853,2,1359092,0,2852,1429,2853,459,1
20150106.13354,2853,48,1359140,-48,2852,1405,2853,435,1
20150106.13354,2853,2,1359142,0,2852,1406,2853,434,1
20150106.133541,2853,2,1359144,-2,2852,1415,2853,443,1
20150106.133542,2853,32,1359176,-2,2852,1415,2853,430,1
20150106.133542,2852,20,1359196,-2,2852,1405,2853,430,0
20150106.133545,2853,10,1359206,-10,2852,1430,2853,429,1
20150106.133545,2853,6,1359212,-6,2852,1427,2853,427,1
20150106.133546,2852,26,1359238,6,2852,1417,2853,427,0
20150106.133547,2853,4,1359242,-4,2852,1416,2853,425,1
20150106.133548,2853,4,1359246,2,2852,1415,2853,428,1
20150106.133549,2852,6,1359252,0,2852,1413,2853,427,0
20150106.13355,2853,4,1359256,-2,2852,1412,2853,426,1
20150106.133551,2853,2,1359258,0,2852,1413,2853,425,1
20150106.133552,2853,6,1359264,-6,2852,1413,2853,422,1
20150106.133553,2852,4,1359268,0,2852,1421,2853,422,0
20150106.133553,2853,16,1359284,-12,2852,1420,2853,417,1
20150106.133554,2853,44,1359328,-24,2852,1415,2853,395,1
20150106.133554,2853,2,1359330,0,2852,1415,2853,395,1
20150106.133555,2852,28,1359358,-20,2852,1413,2853,384,0
20150106.133556,2853,4,1359362,-2,2852,1413,2853,388,1
20150106.133557,2853,2,1359364,-2,2852,1418,2853,392,1
20150106.133557,2853,14,1359378,-8,2852,1418,2853,385,1
20150106.133558,2853,10,1359388,-10,2852,1418,2853,380,1
20150106.133558,2853,6,1359394,-4,2852,1416,2853,379,1
20150106.133559,2853,46,1359440,-16,2852,1396,2853,356,1
20150106.1336,2853,12,1359452,10,2852,1398,2853,351,1
20150106.133601,2853,4,1359456,0,2852,1418,2853,354,1
20150106.133601,2853,2,1359458,0,2852,1418,2853,353,1
20150106.133603,2853,6,1359464,4,2852,1467,2853,351,1
20150106.133603,2853,4,1359468,0,2852,1468,2853,349,1
20150106.133604,2853,4,1359472,2,2852,1467,2853,348,1
20150106.133605,2853,210,1359682,-66,2852,1467,2853,243,1
20150106.133605,2853,362,1360044,-88,2852,1408,2853,62,1
20150106.133606,2853,150,1360194,-12,2853,91,2854,409,1
20150106.133607,2853,2,1360196,2,2853,67,2854,409,1
20150106.133608,2853,134,1360330,-18,2852,1462,2853,186,1
20150106.133608,2853,266,1360596,-2,2852,1365,2853,53,1
20150106.133608,2853,122,1360718,74,2853,46,2854,534,1
20150106.133609,2854,48,1360766,22,2853,50,2854,453,1
20150106.133609,2853,2,1360768,0,2853,56,2854,397,0
20150106.13361,2853,6,1360774,-2,2853,96,2854,392,0
20150106.13361,2853,396,1361170,-312,2852,1552,2853,59,0
20150106.133611,2853,4,1361174,0,2852,1453,2853,69,0
20150106.133611,2853,66,1361240,34,2852,1422,2853,37,0
20150106.133612,2852,4,1361244,0,2852,1415,2853,37,0
20150106.133613,2853,4,1361248,2,2852,1416,2853,54,1
20150106.133613,2853,10,1361258,10,2852,1416,2853,49,1
20150106.133613,2853,12,1361270,0,2852,1416,2853,43,1
20150106.133614,2853,14,1361284,2,2852,1411,2853,39,1
20150106.133615,2852,10,1361294,2,2852,1409,2853,48,0
20150106.133615,2853,18,1361312,18,2852,1409,2853,39,1
20150106.133616,2853,4,1361316,2,2852,1409,2853,28,1
20150106.133616,2853,74,1361390,46,2852,1410,2853,12,1
20150106.133617,2853,28,1361418,4,2853,52,2854,393,1
20150106.133617,2853,4,1361422,0,2853,71,2854,393,1
20150106.133619,2854,64,1361486,-22,2853,122,2854,385,1
20150106.133619,2853,2,1361488,0,2853,123,2854,385,0
20150106.13362,2853,4,1361492,0,2853,122,2854,385,0
20150106.133621,2853,214,1361706,122,2853,26,2854,384,0
20150106.133622,2853,8,1361714,0,2852,1467,2854,384,0
20150106.133622,2854,2,1361716,-2,2853,26,2854,383,1
20150106.133623,2854,2,1361718,0,2853,83,2854,385,1
20150106.133624,2853,2,1361720,2,2853,1085,2854,344,0
20150106.133624,2853,4,1361724,0,2853,1086,2854,343,0
20150106.133625,2853,4,1361728,2,2853,1105,2854,273,0
20150106.133626,2854,2,1361730,0,2853,1105,2854,277,1
20150106.133627,2853,4,1361734,2,2853,1104,2854,276,0
20150106.133628,2853,10,1361744,8,2853,1100,2854,277,0
20150106.13363,2854,2,1361746,0,2853,1100,2854,276,1
20150106.133632,2853,140,1361886,0,2853,1042,2854,277,0
20150106.133634,2853,6,1361892,0,2853,1043,2854,280,0
20150106.133635,2853,22,1361914,0,2853,1042,2854,270,0
20150106.133637,2853,2,1361916,0,2853,1096,2854,274,0
20150106.133638,2854,4,1361920,-2,2853,1096,2854,263,1
20150106.133638,2853,2,1361922,0,2853,1095,2854,263,0
20150106.133639,2853,90,1362012,0,2853,1056,2854,263,0
20150106.133639,2854,18,1362030,12,2853,1090,2854,254,1
20150106.13364,2853,20,1362050,0,2853,1089,2854,245,0
20150106.13364,2854,124,1362174,-98,2853,1094,2854,185,1
20150106.133641,2854,366,1362540,-10,2853,1025,2855,298,1
20150106.133641,2854,4,1362544,-2,2854,29,2855,279,1
20150106.133642,2855,4,1362548,0,2854,36,2855,277,1
20150106.133642,2854,4,1362552,4,2854,65,2855,278,0
20150106.133644,2854,32,1362584,10,2854,146,2855,276,0
20150106.133644,2854,2,1362586,0,2854,156,2855,276,0
20150106.133645,2854,10,1362596,0,2854,152,2855,277,0
20150106.133646,2854,200,1362796,190,2854,52,2855,278,0
20150106.133646,2854,10,1362806,6,2854,41,2855,281,0
20150106.133647,2854,2,1362808,2,2854,40,2855,281,0
20150106.133647,2854,2,1362810,2,2854,39,2855,282,0
20150106.133648,2855,20,1362830,16,2854,44,2855,272,1
20150106.133649,2854,2,1362832,0,2854,43,2855,273,0
20150106.13365,2854,8,1362840,6,2854,44,2855,291,0
20150106.133651,2854,414,1363254,-314,2853,913,2854,95,0
20150106.133651,2854,508,1363762,-310,2853,714,2854,46,0
20150106.133652,2854,10,1363772,0,2853,714,2854,71,0
20150106.133652,2854,408,1364180,-400,2853,515,2854,67,0
20150106.133653,2853,10,1364190,0,2853,514,2854,63,0
20150106.133653,2854,8,1364198,0,2853,514,2854,59,1
20150106.133654,2854,420,1364618,-404,2853,313,2854,85,1
20150106.133655,2853,402,1365020,-244,2853,110,2854,182,0
20150106.133656,2853,224,1365244,-22,2852,1648,2853,2,0
20150106.133656,2853,32,1365276,-2,2852,1424,2853,211,0
20150106.133657,2853,30,1365306,-2,2852,1424,2853,196,0
20150106.133657,2853,2,1365308,0,2852,1424,2853,192,0
20150106.133658,2853,20,1365328,0,2852,1425,2853,180,0
20150106.133658,2853,2,1365330,0,2852,1426,2853,379,0
20150106.133659,2853,82,1365412,-80,2852,1424,2853,339,0
20150106.1337,2853,6,1365418,-4,2852,1425,2853,337,0
20150106.133701,2853,8,1365426,-8,2852,1426,2853,333,0
20150106.133702,2853,60,1365486,0,2852,1408,2853,300,0
20150106.133703,2853,2,1365488,0,2852,1408,2853,300,0
20150106.133704,2853,4,1365492,-2,2852,1409,2853,398,0
20150106.133704,2853,10,1365502,-6,2852,1408,2853,394,0
20150106.133704,2852,4,1365506,-2,2852,1407,2853,394,0
20150106.133705,2853,60,1365566,-56,2852,1402,2853,369,1
20150106.133706,2853,44,1365610,-42,2852,1400,2853,349,1
20150106.133706,2853,2,1365612,0,2852,1400,2853,348,1
20150106.133707,2853,2,1365614,0,2852,1400,2853,347,1
20150106.133707,2853,4,1365618,0,2852,1400,2853,345,1
20150106.133708,2852,10,1365628,-4,2852,1397,2853,343,0
20150106.133708,2852,14,1365642,-10,2852,1395,2853,351,0
20150106.133709,2852,10,1365652,-6,2852,1390,2853,351,0
20150106.133709,2853,154,1365806,-148,2852,1390,2853,274,1
20150106.13371,2853,4,1365810,0,2852,1390,2853,273,1
20150106.13371,2853,6,1365816,0,2852,1406,2853,270,1
20150106.133711,2853,4,1365820,0,2852,1405,2853,269,1
20150106.133712,2853,12,1365832,0,2852,1410,2853,262,1
20150106.133712,2853,4,1365836,0,2852,1410,2853,260,1
20150106.133713,2853,18,1365854,-16,2852,1405,2853,256,1
20150106.133713,2853,4,1365858,0,2852,1406,2853,254,1
20150106.133714,2853,8,1365866,-2,2852,1413,2853,250,1
20150106.133714,2853,4,1365870,-4,2852,1413,2853,248,1
20150106.133715,2852,2,1365872,0,2852,1412,2853,248,0
20150106.133715,2852,4,1365876,0,2852,1427,2853,247,0
20150106.133716,2853,2,1365878,-2,2852,1463,2853,246,1
20150106.133716,2852,2,1365880,0,2852,1462,2853,246,0
20150106.133717,2853,2,1365882,0,2852,1462,2853,246,1
20150106.133718,2853,4,1365886,0,2852,1468,2853,244,1
20150106.133719,2852,2,1365888,-2,2852,1483,2853,246,0
20150106.13372,2852,2,1365890,0,2852,1482,2853,246,0
20150106.133721,2853,10,1365900,0,2852,1717,2853,241,1
20150106.133722,2853,60,1365960,0,2852,1728,2853,211,1
20150106.133723,2853,18,1365978,-10,2852,1725,2853,204,1
20150106.133724,2853,82,1366060,0,2852,1724,2853,164,1
20150106.133725,2853,46,1366106,0,2852,1725,2853,341,1
20150106.133725,2853,22,1366128,0,2852,1721,2853,336,1
20150106.133726,2852,204,1366332,166,2852,1722,2853,235,0
20150106.133726,2853,6,1366338,0,2852,1762,2853,232,1
20150106.133727,2852,8,1366346,2,2852,1767,2853,231,0
20150106.133727,2853,46,1366392,4,2852,1765,2853,211,1
20150106.133729,2852,20,1366412,-12,2852,1762,2853,219,0
20150106.13373,2853,2,1366414,2,2852,1763,2853,220,1
20150106.13373,2852,2,1366416,0,2852,1762,2853,220,0
20150106.133731,2853,6,1366422,2,2852,1762,2853,217,1
20150106.133732,2852,4,1366426,0,2852,1772,2853,216,0
20150106.133732,2853,6,1366432,0,2852,1772,2853,214,1
20150106.133733,2853,2,1366434,0,2852,1772,2853,223,1
20150106.133734,2853,2,1366436,0,2852,1732,2853,222,1
20150106.133734,2853,2,1366438,-2,2852,1735,2853,221,1
20150106.133735,2853,4,1366442,0,2852,1735,2853,220,1
20150106.133736,2853,14,1366456,0,2852,1735,2853,214,1
20150106.133736,2853,88,1366544,-80,2852,1735,2853,170,1
20150106.133737,2853,6,1366550,0,2852,1735,2853,167,1
20150106.133737,2853,8,1366558,0,2852,1735,2853,166,1
20150106.133738,2852,12,1366570,-10,2852,1735,2853,161,0
20150106.133739,2853,64,1366634,-58,2852,1744,2853,139,1
20150106.133739,2853,16,1366650,-4,2852,1743,2853,133,1
20150106.13374,2853,8,1366658,0,2852,1738,2853,329,1
20150106.13374,2853,160,1366818,-94,2852,1739,2853,256,1
20150106.133741,2853,86,1366904,34,2852,1740,2853,213,1
20150106.133742,2852,8,1366912,-4,2852,1744,2853,211,0
20150106.133743,2853,2,1366914,0,2852,1749,2853,220,1
20150106.133744,2852,4,1366918,-2,2852,1750,2853,220,0
20150106.133745,2853,4,1366922,0,2852,1750,2853,218,1
20150106.133745,2853,22,1366944,0,2852,1740,2853,217,1
20150106.133746,2853,6,1366950,-4,2852,1741,2853,215,1
20150106.133747,2853,8,1366958,-4,2852,1739,2853,216,1
20150106.133747,2853,44,1367002,0,2852,1739,2853,194,1
20150106.133748,2853,4,1367006,-4,2852,1742,2853,192,1
20150106.133749,2853,110,1367116,0,2852,1741,2853,142,1
20150106.13375,2852,2,1367118,0,2852,1760,2853,143,0
20150106.13375,2852,2,1367120,0,2852,1744,2853,144,0
20150106.13375,2853,88,1367208,0,2852,1745,2853,100,1
20150106.133751,2853,102,1367310,-2,2852,1744,2853,50,1
20150106.133752,2853,268,1367578,-66,2852,1745,2853,120,1
20150106.133752,2853,28,1367606,-22,2852,1749,2853,106,1
20150106.133753,2852,24,1367630,-4,2852,1747,2853,96,0
20150106.133753,2853,2,1367632,-2,2852,1747,2853,95,1
20150106.133754,2853,6,1367638,0,2852,1774,2853,92,1
20150106.133755,2853,2,1367640,0,2852,1774,2853,91,1
20150106.133756,2853,4,1367644,-4,2852,1779,2853,89,1
20150106.133756,2852,4,1367648,0,2852,1778,2853,88,0
20150106.133757,2853,44,1367692,-42,2852,1778,2853,66,1
20150106.133757,2853,12,1367704,0,2852,1778,2853,62,1
20150106.133759,2853,10,1367714,0,2852,1778,2853,57,1
20150106.133759,2853,18,1367732,-2,2852,1778,2853,48,1
20150106.1338,2853,4,1367736,-2,2852,1779,2853,46,1
20150106.1338,2853,2,1367738,0,2852,1779,2853,51,1
20150106.133801,2853,10,1367748,0,2852,1780,2853,52,1
20150106.133802,2853,22,1367770,0,2852,1780,2853,50,1
20150106.133803,2853,8,1367778,0,2852,1780,2853,48,1
20150106.133804,2853,26,1367804,0,2852,1823,2853,35,1
20150106.133806,2853,8,1367812,-4,2852,1829,2853,31,1
20150106.133806,2853,6,1367818,-2,2852,1830,2853,28,1
20150106.133807,2853,58,1367876,-16,2853,26,2854,445,1
20150106.133808,2853,2,1367878,0,2853,48,2854,431,1
20150106.13381,2853,12,1367890,-2,2853,54,2854,430,1
20150106.13381,2854,82,1367972,-40,2853,18,2854,429,1
20150106.133811,2853,2,1367974,0,2853,37,2854,430,0
20150106.133814,2854,2,1367976,-2,2853,58,2854,433,1
20150106.133815,2853,4,1367980,2,2853,57,2854,433,0
20150106.133816,2853,102,1368082,-12,2853,7,2854,418,0
20150106.133816,2854,42,1368124,-40,2853,17,2854,397,1
20150106.133817,2854,22,1368146,-12,2853,16,2854,387,1
20150106.133817,2853,6,1368152,6,2853,16,2854,387,0
20150106.13382,2853,10,1368162,-4,2853,59,2854,388,0
20150106.13382,2854,2,1368164,0,2853,65,2854,387,1
20150106.133821,2854,4,1368168,2,2853,68,2854,387,1
20150106.133825,2853,4,1368172,0,2853,170,2854,385,0
20150106.133826,2854,200,1368372,-58,2853,243,2854,262,1
20150106.133827,2853,2,1368374,0,2853,245,2854,265,0
20150106.133828,2854,6,1368380,-2,2853,282,2854,262,1
20150106.133829,2853,10,1368390,4,2853,308,2854,241,0
20150106.133829,2853,2,1368392,0,2853,308,2854,241,0
20150106.133831,2853,2,1368394,-2,2853,313,2854,248,0
20150106.133833,2853,4,1368398,4,2853,314,2854,247,0
20150106.133836,2854,6,1368404,-4,2853,321,2854,243,1
20150106.133837,2854,4,1368408,0,2853,322,2854,242,1
20150106.133839,2853,2,1368410,0,2853,340,2854,267,0
20150106.13384,2854,4,1368414,-4,2853,343,2854,268,1
20150106.133842,2853,2,1368416,0,2853,346,2854,268,0
20150106.133844,2854,6,1368422,-4,2853,394,2854,276,1
20150106.133845,2853,2,1368424,0,2853,405,2854,282,0
20150106.133851,2853,2,1368426,0,2853,420,2854,310,0
20150106.133853,2854,6,1368432,-4,2853,538,2854,310,1
20150106.133854,2853,108,1368540,-10,2853,489,2854,316,0
20150106.133855,2854,6,1368546,0,2853,489,2854,274,1
20150106.133857,2853,2,1368548,2,2853,487,2854,273,0
20150106.133858,2854,2,1368550,2,2853,491,2854,271,1
20150106.133859,2854,2,1368552,2,2853,552,2854,269,1
20150106.1339,2854,6,1368558,2,2853,556,2854,267,1
20150106.133901,2854,12,1368570,0,2853,556,2854,261,1
20150106.133901,2854,2,1368572,0,2853,557,2854,260,1
20150106.133904,2853,2,1368574,2,2853,562,2854,266,0
20150106.133904,2854,4,1368578,0,2853,562,2854,264,1
20150106.133907,2854,4,1368582,4,2853,565,2854,272,1
20150106.133908,2853,2,1368584,2,2853,564,2854,273,0
20150106.133909,2853,2,1368586,0,2853,564,2854,375,0
20150106.133909,2853,2,1368588,2,2853,539,2854,375,0
20150106.133909,2853,2,1368590,2,2853,540,2854,375,0
20150106.133911,2854,2,1368592,0,2853,540,2854,375,1
20150106.133911,2854,10,1368602,0,2853,540,2854,370,1
20150106.133913,2853,8,1368610,8,2853,603,2854,375,0
20150106.133914,2854,4,1368614,4,2853,603,2854,373,1
20150106.133915,2854,26,1368640,24,2853,602,2854,361,1
20150106.133916,2854,4,1368644,2,2853,602,2854,359,1
20150106.133918,2854,22,1368666,20,2853,602,2854,248,1
20150106.133919,2853,4,1368670,2,2853,602,2854,247,0
20150106.13392,2854,2,1368672,0,2853,603,2854,246,1
20150106.13392,2854,40,1368712,0,2853,603,2854,226,1
20150106.133921,2854,72,1368784,20,2853,597,2854,191,1
20150106.133922,2854,4,1368788,2,2853,598,2854,189,1
20150106.133923,2854,60,1368848,-24,2853,568,2854,144,1
20150106.133924,2854,2,1368850,2,2853,568,2854,143,1
20150106.133925,2854,4,1368854,4,2853,593,2854,141,1
20150106.133926,2854,2,1368856,-2,2853,593,2854,146,1
20150106.133928,2853,2,1368858,2,2853,592,2854,149,0
20150106.133929,2854,2,1368860,2,2853,592,2854,148,1
20150106.13393,2854,2,1368862,0,2853,593,2854,148,1
20150106.133931,2854,2,1368864,2,2853,593,2854,147,1
20150106.133932,2854,4,1368868,0,2853,594,2854,145,1
20150106.133933,2854,20,1368888,20,2853,595,2854,135,1
20150106.133933,2854,222,1369110,-104,2854,252,2855,380,1
20150106.133934,2854,6,1369116,-2,2854,322,2855,344,1
20150106.133936,2854,4,1369120,-2,2854,295,2855,531,1
20150106.133936,2855,8,1369128,-2,2854,295,2855,527,1
20150106.133937,2855,6,1369134,-4,2854,295,2855,496,1
20150106.133938,2854,2,1369136,-2,2854,295,2855,497,0
20150106.133939,2855,30,1369166,0,2854,286,2855,599,1
20150106.133941,2855,4,1369170,-4,2854,286,2855,626,1
20150106.133942,2855,8,1369178,-8,2854,289,2855,622,1
20150106.133943,2854,4,1369182,-4,2854,289,2855,626,0
20150106.133943,2854,4,1369186,0,2854,291,2855,626,0
20150106.133944,2854,2,1369188,0,2854,290,2855,626,0
20150106.133944,2854,2,1369190,0,2854,289,2855,626,0
20150106.133944,2855,4,1369194,-4,2854,293,2855,624,1
20150106.133946,2855,2,1369196,0,2854,309,2855,622,1
20150106.133948,2855,6,1369202,-4,2854,312,2855,620,1
20150106.13395,2855,4,1369206,-2,2854,320,2855,617,1
20150106.133951,2855,6,1369212,0,2854,319,2855,615,1
20150106.133952,2855,2,1369214,0,2854,323,2855,615,1
20150106.133952,2855,20,1369234,10,2854,321,2855,586,1
20150106.133953,2855,4,1369238,4,2854,321,2855,584,1
20150106.133953,2855,2,1369240,0,2854,323,2855,583,1
20150106.133953,2854,2,1369242,0,2854,323,2855,583,0
20150106.133955,2855,2,1369244,0,2854,324,2855,540,1
20150106.133955,2855,4,1369248,2,2854,324,2855,538,1
20150106.133955,2855,24,1369272,18,2854,324,2855,526,1
20150106.133956,2854,26,1369298,0,2854,312,2855,529,0
20150106.133956,2854,50,1369348,0,2854,287,2855,529,0
20150106.133958,2855,4,1369352,-2,2854,292,2855,527,1
20150106.134001,2854,22,1369374,0,2854,292,2855,518,0
20150106.134002,2854,2,1369376,0,2854,292,2855,518,0
20150106.134005,2855,2,1369378,0,2854,298,2855,478,1
20150106.134006,2855,2,1369380,0,2854,300,2855,478,1
20150106.134009,2855,2,1369382,0,2854,359,2855,458,1
20150106.13401,2855,2,1369384,2,2854,360,2855,457,1
20150106.134011,2855,10,1369394,0,2854,361,2855,451,1
20150106.134012,2855,102,1369496,-14,2854,363,2855,372,1
20150106.134012,2855,6,1369502,-2,2854,363,2855,369,1
20150106.134014,2854,2,1369504,-2,2854,361,2855,370,0
20150106.134014,2854,6,1369510,-4,2854,359,2855,370,0
20150106.134014,2855,16,1369526,-14,2854,359,2855,364,1
20150106.134015,2855,4,1369530,-2,2854,361,2855,362,1
20150106.134016,2854,8,1369538,0,2854,359,2855,361,0
20150106.134017,2854,404,1369942,-208,2854,159,2855,401,0
20150106.134017,2854,2,1369944,0,2854,157,2855,403,0
20150106.134018,2854,4,1369948,-2,2854,156,2855,402,0
20150106.134019,2854,54,1370002,38,2854,183,2855,358,0
20150106.134019,2853,400,1370402,-176,2853,1263,2855,359,0
20150106.13402,2854,4,1370406,-2,2853,1263,2855,359,1
20150106.13402,2854,2,1370408,-2,2853,1213,2854,11,1
20150106.134021,2854,14,1370422,-2,2853,1207,2854,4,1
20150106.134021,2854,8,1370430,-2,2853,1207,2854,3,1
20150106.134022,2854,10,1370440,-10,2854,53,2855,375,1
20150106.134022,2854,450,1370890,-160,2854,10,2855,370,1
20150106.134023,2854,26,1370916,-16,2853,1059,2854,67,1
20150106.134023,2853,404,1371320,-104,2853,890,2854,66,0
20150106.134024,2853,2,1371322,2,2853,890,2854,77,0
20150106.134025,2854,20,1371342,-20,2853,890,2854,112,1
20150106.134026,2854,102,1371444,0,2853,901,2854,192,1
20150106.134027,2854,10,1371454,0,2853,902,2854,200,1
20150106.134027,2853,400,1371854,-164,2853,702,2854,203,0
20150106.134028,2854,12,1371866,-10,2853,702,2854,200,1
20150106.134028,2854,2,1371868,0,2853,703,2854,200,1
20150106.134029,2853,408,1372276,-104,2853,502,2854,206,0
20150106.134031,2853,406,1372682,-32,2853,300,2854,211,0
20150106.134032,2853,2,1372684,0,2853,341,2854,243,0
20150106.134033,2854,2,1372686,0,2853,345,2854,242,1
20150106.134033,2854,2,1372688,0,2853,345,2854,240,1
20150106.134034,2853,406,1373094,-402,2853,117,2854,253,0
20150106.134035,2853,302,1373396,122,2852,2347,2853,19,0
20150106.134036,2852,64,1373460,-58,2852,2320,2853,18,0
20150106.134036,2853,12,1373472,-2,2852,2319,2853,214,1
20150106.134038,2853,12,1373484,2,2852,2317,2853,209,1
20150106.134038,2853,2,1373486,2,2852,2318,2853,408,1
20150106.13404,2853,4,1373490,-2,2852,2349,2853,408,1
20150106.134041,2852,12,1373502,-4,2852,2349,2853,403,0
20150106.134042,2853,8,1373510,0,2852,2345,2853,399,1
20150106.134042,2853,4,1373514,-2,2852,2345,2853,397,1
20150106.134044,2853,4,1373518,-2,2852,2347,2853,407,1
20150106.134045,2853,4,1373522,0,2852,2346,2853,405,1
20150106.134046,2853,14,1373536,-14,2852,2346,2853,398,1
20150106.134049,2852,508,1374044,-2,2852,2149,2853,346,0
20150106.13405,2853,2,1374046,0,2852,2150,2853,345,1
20150106.13405,2852,400,1374446,0,2852,1950,2853,345,0
20150106.134051,2853,18,1374464,0,2852,1950,2853,336,1
20150106.134052,2853,26,1374490,-26,2852,1947,2853,323,1
20150106.134052,2852,2,1374492,-2,2852,1949,2853,323,0
20150106.134053,2853,4,1374496,0,2852,1948,2853,322,1
20150106.134054,2852,4,1374500,0,2852,1951,2853,322,0
20150106.134055,2852,2,1374502,0,2852,1931,2853,322,0
20150106.134057,2852,4,1374506,-4,2852,1872,2853,322,0
20150106.134057,2853,4,1374510,0,2852,1872,2853,320,1
20150106.1341,2852,4,1374514,0,2852,1845,2853,329,0
20150106.1341,2853,642,1375156,-126,2852,1696,2853,209,1
20150106.134102,2853,4,1375160,0,2852,1695,2853,207,1
20150106.134102,2853,12,1375172,0,2852,1695,2853,201,1
20150106.134103,2852,402,1375574,266,2852,1499,2853,200,0
20150106.134103,2853,2,1375576,0,2852,1498,2853,200,1
20150106.134104,2853,4,1375580,2,2852,1498,2853,199,1
20150106.134105,2852,2,1375582,2,2852,1497,2853,199,0
20150106.134106,2852,2,1375584,2,2852,1532,2853,199,0
20150106.134107,2853,20,1375604,-20,2852,1532,2853,189,1
20150106.134107,2852,8,1375612,8,2852,1529,2853,189,0
20150106.134108,2853,2,1375614,0,2852,1529,2853,188,1
20150106.134109,2853,102,1375716,2,2852,1528,2853,151,1
20150106.13411,2853,42,1375758,-42,2852,1528,2853,130,1
20150106.13411,2853,2,1375760,0,2852,1530,2853,129,1
20150106.134111,2853,402,1376162,334,2852,1333,2853,128,1
20150106.134111,2852,4,1376166,2,2852,1291,2853,128,0
20150106.134112,2852,8,1376174,0,2852,1247,2853,128,0
20150106.134112,2852,12,1376186,12,2852,1241,2853,131,0
20150106.134114,2852,2,1376188,0,2852,1240,2853,135,0
20150106.134115,2853,4,1376192,-2,2852,1250,2853,134,1
20150106.134116,2853,4,1376196,-2,2852,1250,2853,132,1
20150106.134116,2853,4,1376200,0,2852,1250,2853,130,1
20150106.134118,2852,402,1376602,230,2852,1050,2853,140,0
20150106.134119,2853,14,1376616,-6,2852,1045,2853,138,1
20150106.13412,2853,2,1376618,0,2852,1045,2853,149,1
20150106.134121,2852,6,1376624,-2,2852,1045,2853,147,0
20150106.134121,2852,8,1376632,-8,2852,1041,2853,147,0
20150106.134122,2852,4,1376636,-4,2852,1039,2853,148,0
20150106.134123,2852,4,1376640,0,2852,1041,2853,147,0
20150106.134123,2853,4,1376644,-2,2852,1049,2853,296,1
20150106.134123,2853,2,1376646,-2,2852,1049,2853,297,1
20150106.134124,2852,410,1377056,46,2852,839,2853,300,0
20150106.134124,2853,6,1377062,-2,2852,797,2853,329,1
20150106.134125,2852,42,1377104,-2,2852,774,2853,329,0
20150106.134125,2852,70,1377174,-36,2852,739,2853,363,0
20150106.134126,2852,14,1377188,0,2852,742,2853,366,0
20150106.134127,2852,30,1377218,-6,2852,727,2853,366,0
20150106.134128,2852,4,1377222,-4,2852,725,2853,367,0
20150106.134128,2852,6,1377228,-4,2852,723,2853,367,0
20150106.134129,2852,6,1377234,-2,2852,725,2853,368,0
20150106.134131,2853,2,1377236,-2,2852,727,2853,368,1
20150106.134131,2852,12,1377248,-2,2852,723,2853,367,0
20150106.134133,2852,2,1377250,0,2852,725,2853,380,0
20150106.134134,2852,12,1377262,8,2852,725,2853,382,0
20150106.134135,2853,8,1377270,-2,2852,736,2853,400,1
20150106.134136,2852,402,1377672,138,2852,496,2853,401,0
20150106.134136,2853,8,1377680,-2,2852,503,2853,410,1
20150106.134137,2852,66,1377746,18,2852,525,2853,411,0
20150106.134137,2852,28,1377774,-26,2852,511,2853,410,0
20150106.134138,2852,8,1377782,-8,2852,16,2853,430,0
20150106.134138,2852,28,1377810,-24,2851,2259,2852,69,0
20150106.134139,2851,140,1377950,-106,2851,2197,2852,54,0
20150106.134139,2851,24,1377974,-2,2851,2185,2852,141,0
20150106.13414,2851,158,1378132,-42,2851,2116,2852,105,0
20150106.13414,2851,20,1378152,-16,2851,2108,2852,105,0
20150106.134141,2851,12,1378164,-10,2851,2103,2852,105,0
20150106.134142,2851,6,1378170,0,2851,2099,2852,106,0
20150106.134142,2851,2,1378172,0,2851,2098,2852,106,0
20150106.134143,2852,70,1378242,-32,2851,2093,2852,87,1
20150106.134143,2851,4,1378246,-2,2851,2093,2852,89,0
20150106.134144,2851,34,1378280,-4,2851,2088,2852,78,0
20150106.134145,2852,2,1378282,0,2851,2113,2852,78,1
20150106.134146,2852,2,1378284,0,2851,2113,2852,79,1
20150106.134146,2851,400,1378684,44,2851,1914,2852,83,0
20150106.134147,2851,124,1378808,-102,2851,1854,2852,113,0
20150106.134147,2852,2,1378810,0,2851,1854,2852,114,1
20150106.134148,2852,4,1378814,-2,2851,1853,2852,114,1
20150106.134148,2852,104,1378918,-2,2851,1852,2852,65,1
20150106.134149,2852,100,1379018,66,2851,1853,2852,42,1
20150106.134149,2852,8,1379026,2,2851,1853,2852,50,1
20150106.13415,2851,404,1379430,272,2851,1651,2852,49,0
20150106.13415,2852,2,1379432,2,2851,1651,2852,48,1
20150106.134151,2851,58,1379490,-2,2851,1626,2852,44,0
20150106.134151,2852,4,1379494,2,2851,1625,2852,53,1
20150106.134152,2852,2,1379496,0,2851,1625,2852,52,1
20150106.134152,2852,2,1379498,0,2851,1646,2852,91,1
20150106.134153,2851,26,1379524,20,2851,1633,2852,92,0
20150106.134153,2852,2,1379526,2,2851,1633,2852,91,1
20150106.134154,2852,64,1379590,56,2851,1664,2852,72,1
20150106.134155,2852,10,1379600,-4,2851,1665,2852,73,1
20150106.134155,2852,12,1379612,2,2851,1666,2852,73,1
20150106.134156,2852,12,1379624,0,2851,1663,2852,77,1
20150106.134156,2852,4,1379628,-2,2851,1663,2852,75,1
20150106.134157,2852,2,1379630,-2,2851,1673,2852,85,1
20150106.134158,2852,4,1379634,0,2851,1675,2852,83,1
20150106.134158,2851,164,1379798,160,2851,1594,2852,84,0
20150106.134159,2851,52,1379850,2,2851,1569,2852,111,0
20150106.1342,2852,2,1379852,-2,2851,1550,2852,111,1
20150106.134202,2852,6,1379858,-2,2851,1551,2852,105,1
20150106.134202,2852,2,1379860,-2,2851,1551,2852,104,1
20150106.134204,2851,2,1379862,2,2851,1551,2852,111,0
20150106.134204,2851,200,1380062,-98,2851,1451,2852,112,0
20150106.134206,2851,8,1380070,0,2851,1466,2852,191,0
20150106.134206,2851,4,1380074,-2,2851,1464,2852,193,0
20150106.134207,2852,6,1380080,0,2851,1466,2852,201,1
20150106.134207,2851,2,1380082,0,2851,1465,2852,201,0
20150106.134208,2851,14,1380096,4,2851,1463,2852,196,0
20150106.134208,2851,142,1380238,34,2851,1393,2852,196,0
20150106.134209,2851,78,1380316,22,2851,1354,2852,158,0
20150106.13421,2851,8,1380324,2,2851,1351,2852,157,0
20150106.13421,2852,4,1380328,2,2851,1350,2852,162,1
20150106.134211,2852,2,1380330,0,2851,1352,2852,164,1
20150106.134212,2852,6,1380336,4,2851,1349,2852,163,1
20150106.134212,2851,2,1380338,0,2851,1348,2852,163,0
20150106.134213,2851,28,1380366,0,2851,1334,2852,163,0
20150106.134213,2851,20,1380386,0,2851,1327,2852,158,0
20150106.134214,2851,24,1380410,-18,2851,1317,2852,158,0
20150106.134215,2852,42,1380452,2,2851,1317,2852,158,1
20150106.134215,2851,4,1380456,0,2851,1316,2852,159,0
20150106.134218,2852,4,1380460,0,2851,1335,2852,170,1
20150106.134218,2852,10,1380470,-4,2851,1335,2852,165,1
20150106.134219,2851,2,1380472,-2,2851,1333,2852,165,0
20150106.134219,2852,332,1380804,-72,2852,186,2853,594,1
20150106.13422,2852,4,1380808,-2,2852,185,2853,596,1
20150106.13422,2852,40,1380848,0,2852,165,2853,595,1
20150106.134221,2852,4,1380852,0,2852,241,2853,594,1
20150106.134223,2852,22,1380874,0,2852,260,2853,594,1
20150106.134224,2852,4,1380878,-2,2852,270,2853,587,1
20150106.134225,2852,2,1380880,-2,2852,270,2853,587,1
20150106.134226,2852,2,1380882,-2,2852,330,2853,590,1
20150106.134227,2852,2,1380884,0,2852,331,2853,589,1
20150106.134227,2852,2,1380886,0,2852,330,2853,602,1
20150106.134228,2852,2,1380888,-2,2852,331,2853,602,1
20150106.134228,2852,40,1380928,-38,2852,312,2853,602,1
20150106.134229,2852,10,1380938,-4,2852,319,2853,600,1
20150106.13423,2852,6,1380944,-6,2852,316,2853,600,1
20150106.13423,2853,2,1380946,0,2852,316,2853,599,1
20150106.13423,2852,2,1380948,-2,2852,316,2853,599,0
20150106.134231,2852,2,1380950,0,2852,315,2853,600,0
20150106.134233,2853,4,1380954,-4,2852,489,2853,598,1
20150106.134235,2852,2,1380956,-2,2852,492,2853,595,0
20150106.134235,2852,2,1380958,0,2852,530,2853,645,0
20150106.134236,2852,4,1380962,-4,2852,529,2853,645,0
20150106.134236,2852,4,1380966,-2,2852,528,2853,644,0
20150106.134238,2853,2,1380968,-2,2852,535,2853,640,1
20150106.13424,2852,2,1380970,0,2852,539,2853,646,0
20150106.134242,2853,2,1380972,-2,2852,544,2853,646,1
20150106.134243,2853,2,1380974,-2,2852,552,2853,645,1
20150106.134244,2852,4,1380978,-4,2852,555,2853,655,0
20150106.134245,2853,2,1380980,-2,2852,575,2853,650,1
20150106.134246,2852,4,1380984,-2,2852,583,2853,648,0
20150106.134248,2853,2,1380986,-2,2852,616,2853,644,1
20150106.134249,2853,6,1380992,-2,2852,610,2853,642,1
20150106.13425,2852,12,1381004,-10,2852,610,2853,637,0
20150106.134251,2852,2,1381006,0,2852,619,2853,637,0
20150106.134252,2853,6,1381012,-6,2852,719,2853,637,1
20150106.134254,2853,8,1381020,0,2852,729,2853,633,1
20150106.134254,2853,14,1381034,-4,2852,730,2853,626,1
20150106.134255,2852,2,1381036,-2,2852,728,2853,626,0
20150106.134256,2853,4,1381040,0,2852,728,2853,621,1
20150106.134256,2853,6,1381046,0,2852,728,2853,619,1
20150106.134257,2853,10,1381056,0,2852,574,2853,624,1
20150106.134258,2853,40,1381096,0,2852,574,2853,604,1
20150106.134259,2852,4,1381100,-2,2852,572,2853,614,0
20150106.134259,2853,2,1381102,0,2852,573,2853,608,1
20150106.1343,2853,160,1381262,44,2852,573,2853,528,1
20150106.134304,2853,2,1381264,0,2852,586,2853,514,1
20150106.134304,2853,2,1381266,0,2852,586,2853,513,1
20150106.134306,2853,2,1381268,-2,2852,589,2853,517,1
20150106.134309,2853,34,1381302,0,2852,584,2853,546,1
20150106.134314,2853,2,1381304,0,2852,609,2853,559,1
20150106.134315,2853,12,1381316,-12,2852,609,2853,555,1
20150106.134317,2852,2,1381318,0,2852,608,2853,724,0
20150106.134319,2852,2,1381320,-2,2852,607,2853,735,0
20150106.134319,2852,2,1381322,0,2852,606,2853,735,0
20150106.13432,2853,2,1381324,0,2852,607,2853,734,1
20150106.134323,2853,10,1381334,-10,2852,643,2853,736,1
20150106.134323,2852,2,1381336,-2,2852,642,2853,737,0
20150106.134324,2853,404,1381740,144,2852,1107,2853,505,1
20150106.134325,2852,4,1381744,-4,2852,1106,2853,505,0
20150106.134325,2853,54,1381798,-18,2852,1106,2853,505,1
20150106.134326,2853,40,1381838,-30,2852,1086,2853,486,1
20150106.134326,2853,2,1381840,0,2852,1087,2853,485,1
20150106.134327,2853,14,1381854,-4,2852,1116,2853,481,1
20150106.134328,2853,2,1381856,-2,2852,1170,2853,481,1
20150106.134329,2852,4,1381860,-2,2852,1166,2853,481,0
20150106.134329,2853,10,1381870,0,2852,1166,2853,476,1
20150106.13433,2852,8,1381878,-6,2852,1163,2853,476,0
20150106.134332,2852,4,1381882,0,2852,1159,2853,477,0
20150106.134333,2853,794,1382676,-438,2852,1159,2853,80,1
20150106.134334,2853,2,1382678,-2,2852,1163,2853,79,1
20150106.134334,2853,162,1382840,24,2853,2,2854,723,1
20150106.134335,2853,4,1382844,0,2853,98,2854,656,1
20150106.134335,2854,2,1382846,2,2853,168,2854,655,1
20150106.134336,2853,6,1382852,-2,2853,166,2854,655,0
20150106.134337,2853,2,1382854,0,2853,167,2854,656,0
20150106.134337,2853,338,1383192,-238,2852,1153,2853,119,0
20150106.134338,2853,4,1383196,0,2852,1149,2853,123,0
20150106.134338,2853,42,1383238,0,2852,1142,2853,102,0
20150106.134339,2853,12,1383250,-10,2852,1139,2853,304,0
20150106.134343,2853,100,1383350,62,2852,1101,2853,292,0
20150106.134343,2853,2,1383352,2,2852,1101,2853,291,0
20150106.134344,2853,6,1383358,0,2852,1111,2853,312,0
20150106.134345,2853,4,1383362,0,2852,1111,2853,311,0
20150106.134345,2853,4,1383366,-2,2852,1111,2853,309,0
20150106.134346,2853,98,1383464,-98,2852,1112,2853,346,0
20150106.134347,2853,4,1383468,0,2852,1112,2853,345,0
20150106.134347,2853,200,1383668,-192,2852,1212,2853,245,0
20150106.134348,2853,4,1383672,-4,2852,1212,2853,241,0
20150106.134349,2853,2,1383674,0,2852,1212,2853,240,0
20150106.134351,2853,4,1383678,-4,2852,1213,2853,238,0
20150106.134352,2853,2,1383680,-2,2852,1213,2853,237,0
20150106.134353,2853,6,1383686,-2,2852,1265,2853,259,0
20150106.134355,2853,2,1383688,0,2852,1316,2853,258,0
20150106.134356,2853,2,1383690,-2,2852,1318,2853,259,0
20150106.134357,2853,4,1383694,-2,2852,1319,2853,257,0
20150106.134358,2853,4,1383698,0,2852,1319,2853,255,0
20150106.134358,2853,4,1383702,0,2852,1321,2853,253,0
20150106.1344,2852,2,1383704,0,2852,1321,2853,268,0
20150106.134401,2853,60,1383764,0,2852,1291,2853,243,1
20150106.134401,2853,2,1383766,-2,2852,1291,2853,242,1
20150106.134402,2853,486,1384252,-294,2853,359,2854,666,1
20150106.134402,2853,730,1384982,-606,2853,9,2854,642,1
20150106.134403,2853,20,1385002,-14,2852,1416,2853,53,1
20150106.134404,2852,2,1385004,0,2852,1311,2853,311,0
20150106.134405,2853,2,1385006,2,2852,1314,2853,310,1
20150106.134406,2853,10,1385016,8,2852,1313,2853,307,1
20150106.134407,2853,2,1385018,0,2852,1313,2853,308,1
20150106.134407,2852,12,1385030,6,2852,1299,2853,307,0
20150106.134408,2853,2,1385032,2,2852,1299,2853,307,1
20150106.134409,2853,2,1385034,2,2852,1289,2853,316,1
20150106.13441,2853,2,1385036,0,2852,1278,2853,315,1
20150106.134411,2853,14,1385050,14,2852,1277,2853,308,1
20150106.134412,2853,10,1385060,0,2852,1278,2853,303,1
20150106.134413,2853,4,1385064,4,2852,1280,2853,296,1
20150106.134414,2853,2,1385066,2,2852,1180,2853,346,1
20150106.134415,2853,22,1385088,2,2852,1181,2853,372,1
20150106.134416,2852,4,1385092,0,2852,1180,2853,372,0
20150106.134417,2853,20,1385112,20,2852,1130,2853,367,1
20150106.134417,2853,40,1385152,-34,2852,1130,2853,387,1
20150106.134419,2852,40,1385192,0,2852,1136,2853,389,0
20150106.13442,2852,2,1385194,0,2852,1135,2853,389,0
20150106.134421,2853,2,1385196,0,2852,1185,2853,388,1
20150106.134423,2852,2,1385198,-2,2852,1186,2853,390,0
20150106.134423,2853,2,1385200,-2,2852,1186,2853,389,1
20150106.134424,2852,2,1385202,0,2852,1186,2853,389,0
20150106.134426,2852,2,1385204,-2,2852,1185,2853,393,0
20150106.134428,2853,2,1385206,0,2852,1187,2853,392,1
20150106.13443,2853,4,1385210,0,2852,1187,2853,441,1
20150106.13443,2852,6,1385216,-4,2852,1187,2853,442,0
20150106.134431,2852,4,1385220,0,2852,1187,2853,442,0
20150106.134431,2852,2,1385222,0,2852,1186,2853,442,0
20150106.134434,2852,2,1385224,0,2852,1131,2853,443,0
20150106.134436,2853,958,1386182,-860,2853,124,2854,727,1
20150106.134437,2853,248,1386430,16,2852,1188,2853,113,1
20150106.134438,2853,6,1386436,4,2852,1185,2853,110,1
20150106.134439,2853,22,1386458,20,2852,1184,2853,107,1
20150106.13444,2853,2,1386460,2,2852,1184,2853,107,1
20150106.13444,2853,2,1386462,2,2852,1183,2853,106,1
20150106.134441,2853,6,1386468,0,2852,1182,2853,104,1
20150106.134441,2853,4,1386472,2,2852,1183,2853,103,1
20150106.134443,2853,2,1386474,2,2852,1188,2853,102,1
20150106.134444,2853,204,1386678,92,2853,28,2854,778,1
20150106.134444,2853,8,1386686,-6,2853,175,2854,727,1
20150106.134445,2853,6,1386692,0,2853,173,2854,728,1
20150106.134445,2853,2,1386694,0,2853,172,2854,728,1
20150106.134446,2853,2,1386696,-2,2853,175,2854,728,1
20150106.134447,2853,10,1386706,-10,2853,171,2854,728,1
20150106.13445,2853,8,1386714,0,2853,185,2854,678,1
20150106.134453,2853,2,1386716,0,2853,188,2854,681,1
20150106.134454,2854,4,1386720,0,2853,189,2854,679,1
20150106.134456,2854,4,1386724,0,2853,190,2854,671,1
20150106.1345,2853,14,1386738,-2,2853,184,2854,682,0
20150106.1345,2853,16,1386754,-4,2853,176,2854,692,0
20150106.134509,2853,2,1386756,2,2853,209,2854,670,0
20150106.134511,2854,4,1386760,0,2853,316,2854,702,1
20150106.134512,2853,10,1386770,10,2853,311,2854,702,0
20150106.134515,2853,2,1386772,0,2853,327,2854,703,0
20150106.134517,2853,2,1386774,2,2853,326,2854,703,0
20150106.134519,2853,2,1386776,2,2853,325,2854,705,0
20150106.13452,2853,646,1387422,-264,2852,1408,2853,21,0
20150106.134521,2853,2,1387424,-2,2852,1296,2853,297,0
20150106.134523,2853,2,1387426,0,2852,1295,2853,299,0
20150106.134523,2852,20,1387446,-20,2852,1256,2853,300,0
20150106.134524,2853,10,1387456,-8,2852,1225,2853,318,1
20150106.134524,2852,4,1387460,-4,2852,1223,2853,343,0
20150106.134525,2853,4,1387464,-4,2852,1183,2853,344,1
20150106.134526,2853,10,1387474,-10,2852,1183,2853,338,1
20150106.134526,2853,4,1387478,-4,2852,1183,2853,360,1
20150106.134527,2853,2,1387480,0,2852,1183,2853,366,1
20150106.134534,2852,8,1387488,-6,2852,1269,2853,352,0
20150106.134538,2853,10,1387498,10,2852,1181,2853,346,1
20150106.134539,2852,2,1387500,-2,2852,1188,2853,346,0
20150106.13454,2853,2,1387502,2,2852,1184,2853,345,1
20150106.134541,2853,2,1387504,2,2852,1215,2853,344,1
20150106.134543,2852,2,1387506,-2,2852,1213,2853,349,0
20150106.134543,2852,2,1387508,-2,2852,1212,2853,350,0
20150106.134544,2853,2,1387510,2,2852,1212,2853,356,1
20150106.134545,2853,4,1387514,2,2852,1213,2853,355,1
20150106.134546,2852,8,1387522,-8,2852,1209,2853,355,0
20150106.134546,2853,44,1387566,6,2852,1188,2853,354,1
20150106.134547,2852,2,1387568,0,2852,1187,2853,357,0
20150106.134548,2853,20,1387588,20,2852,1186,2853,347,1
20150106.13455,2852,2,1387590,2,2852,1190,2853,347,0
20150106.134552,2853,2,1387592,2,2852,1189,2853,347,1
20150106.134553,2853,2,1387594,0,2852,1188,2853,346,1
20150106.134553,2853,4,1387598,0,2852,1188,2853,346,1
20150106.134555,2853,4,1387602,2,2852,1189,2853,345,1
20150106.134556,2853,2,1387604,-2,2852,1189,2853,344,1
20150106.134557,2852,2,1387606,0,2852,1187,2853,384,0
20150106.134558,2852,2,1387608,2,2852,1187,2853,384,0
20150106.134601,2852,22,1387630,-12,2852,1198,2853,378,0
20150106.134602,2853,2,1387632,0,2852,1196,2853,377,1
20150106.134603,2853,12,1387644,10,2852,1190,2853,380,1
20150106.134605,2852,2,1387646,2,2852,1184,2853,409,0
20150106.134611,2853,4,1387650,0,2852,1248,2853,410,1
20150106.134613,2852,80,1387730,-20,2852,1208,2853,407,0
20150106.134614,2853,2,1387732,-2,2852,1208,2853,408,1
20150106.134614,2852,10,1387742,8,2852,1208,2853,408,0
20150106.134614,2852,2,1387744,2,2852,1208,2853,408,0
20150106.134615,2853,2,1387746,0,2852,1208,2853,407,1
20150106.134616,2853,2,1387748,-2,2852,1209,2853,368,1
20150106.134617,2853,4,1387752,-4,2852,1209,2853,366,1
20150106.134618,2853,96,1387848,0,2852,1219,2853,321,1
20150106.134619,2853,4,1387852,-4,2852,1219,2853,319,1
20150106.13462,2853,44,1387896,0,2852,1217,2853,297,1
20150106.13462,2853,2,1387898,-2,2852,1217,2853,297,1
20150106.134621,2853,8,1387906,-4,2852,1215,2853,295,1
20150106.134622,2853,42,1387948,-2,2852,1217,2853,284,1
20150106.134625,2853,554,1388502,-74,2853,55,2854,702,1
20150106.134625,2854,64,1388566,0,2853,25,2854,651,1
20150106.134626,2853,50,1388616,-50,2852,1330,2853,228,0
20150106.134626,2853,240,1388856,0,2852,1227,2853,109,0
20150106.134627,2853,150,1389006,38,2852,1227,2853,34,0
20150106.134627,2853,2,1389008,2,2852,1227,2853,233,0
20150106.134629,2853,76,1389084,54,2852,1237,2853,195,0
20150106.134629,2853,2,1389086,0,2852,1238,2853,396,0
20150106.13463,2853,4,1389090,-4,2852,1238,2853,394,0
20150106.134634,2853,2,1389092,0,2852,1241,2853,402,0
20150106.134635,2853,6,1389098,2,2852,1240,2853,400,0
20150106.134636,2852,2,1389100,0,2852,1239,2853,400,0
20150106.134638,2853,2,1389102,0,2852,1242,2853,412,1
20150106.134639,2853,2,1389104,0,2852,1245,2853,411,1
20150106.134641,2853,2,1389106,0,2852,1245,2853,410,1
20150106.134641,2853,2,1389108,0,2852,1245,2853,409,1
20150106.134642,2852,22,1389130,-18,2852,1245,2853,399,0
20150106.134643,2852,2,1389132,2,2852,1246,2853,399,0
20150106.134643,2852,2,1389134,0,2852,1245,2853,399,0
20150106.134644,2853,2,1389136,-2,2852,1244,2853,398,1
20150106.134644,2853,2,1389138,-2,2852,1244,2853,398,1
20150106.134645,2853,4,1389142,-4,2852,1244,2853,396,1
20150106.134646,2853,4,1389146,0,2852,1290,2853,401,1
20150106.134646,2853,6,1389152,2,2852,1286,2853,399,1
20150106.134648,2853,4,1389156,-4,2852,1287,2853,397,1
20150106.134649,2853,2,1389158,0,2852,1287,2853,396,1
20150106.13465,2853,6,1389164,0,2852,1288,2853,393,1
20150106.13465,2853,10,1389174,-10,2852,1292,2853,388,1
20150106.134651,2853,4,1389178,-2,2852,1292,2853,387,1
20150106.134652,2853,4,1389182,0,2852,1290,2853,385,1
20150106.134652,2853,4,1389186,0,2852,1288,2853,383,1
20150106.134655,2853,4,1389190,-4,2852,1277,2853,400,1
20150106.134656,2853,2,1389192,-2,2852,1277,2853,401,1
20150106.134658,2853,88,1389280,0,2852,1233,2853,362,1
20150106.134659,2853,2,1389282,0,2852,1234,2853,562,1
20150106.1347,2853,2,1389284,0,2852,1234,2853,561,1
20150106.1347,2852,2,1389286,2,2852,1233,2853,561,0
20150106.134701,2853,2,1389288,0,2852,1233,2853,560,1
20150106.134703,2853,10,1389298,-10,2852,1254,2853,555,1
20150106.134706,2853,4,1389302,-4,2852,1267,2853,554,1
20150106.134707,2852,8,1389310,0,2852,1264,2853,553,0
20150106.134711,2853,20,1389330,0,2852,1320,2853,555,1
20150106.134713,2853,14,1389344,0,2852,1321,2853,548,1
20150106.134714,2853,20,1389364,0,2852,1321,2853,538,1
20150106.134716,2853,20,1389384,-20,2852,1331,2853,528,1
20150106.134718,2853,2,1389386,-2,2852,1330,2853,527,1
20150106.134719,2853,2,1389388,0,2852,1333,2853,527,1
20150106.13472,2853,2,1389390,-2,2852,1333,2853,526,1
20150106.13472,2853,32,1389422,-32,2852,1333,2853,510,1
20150106.134721,2852,4,1389426,0,2852,1331,2853,510,0
20150106.134723,2852,2,1389428,0,2852,1333,2853,498,0
20150106.134726,2853,2,1389430,-2,2852,1343,2853,485,1
20150106.134729,2852,26,1389456,0,2852,1382,2853,492,0
20150106.13473,2852,2,1389458,2,2852,1381,2853,492,0
20150106.134734,2852,2,1389460,2,2852,1378,2853,496,0
20150106.134738,2853,2,1389462,0,2852,1393,2853,503,1
20150106.13474,2853,22,1389484,0,2852,1383,2853,492,1
20150106.134741,2853,10,1389494,0,2852,1383,2853,487,1
20150106.134741,2852,12,1389506,2,2852,1388,2853,482,0
20150106.134742,2853,42,1389548,0,2852,1359,2853,481,1
20150106.134745,2853,2,1389550,-2,2852,1367,2853,480,1
20150106.134745,2852,4,1389554,2,2852,1365,2853,480,0
20150106.134746,2852,2,1389556,0,2852,1364,2853,480,0
20150106.134747,2853,2,1389558,-2,2852,1363,2853,479,1
20150106.134747,2853,4,1389562,-2,2852,1363,2853,477,1
20150106.134749,2852,14,1389576,-10,2852,1463,2853,471,0
20150106.134754,2853,12,1389588,0,2852,1474,2853,467,1
20150106.134754,2852,2,1389590,2,2852,1474,2853,467,0
20150106.134755,2853,2,1389592,0,2852,1474,2853,466,1
20150106.134756,2853,8,1389600,-8,2852,1474,2853,470,1
20150106.134759,2853,2,1389602,0,2852,1476,2853,467,1
20150106.134804,2853,42,1389644,-40,2852,1490,2853,445,1
20150106.134805,2852,2,1389646,2,2852,1489,2853,445,0
20150106.134806,2853,22,1389668,-20,2852,1489,2853,434,1
20150106.134806,2853,2,1389670,0,2852,1489,2853,433,1
20150106.134807,2853,20,1389690,0,2852,1499,2853,423,1
20150106.134807,2853,4,1389694,-4,2852,1498,2853,421,1
20150106.134809,2853,2,1389696,0,2852,1503,2853,419,1
20150106.134811,2853,4,1389700,0,2852,1504,2853,422,1
20150106.134813,2853,2,1389702,0,2852,1520,2853,421,1
20150106.134814,2853,14,1389716,0,2852,1572,2853,414,1
20150106.134815,2853,110,1389826,-110,2852,1574,2853,360,1
20150106.134816,2853,6,1389832,0,2852,1577,2853,357,1
20150106.134816,2853,2,1389834,0,2852,1577,2853,356,1
20150106.134817,2853,50,1389884,-6,2852,1574,2853,531,1
20150106.134819,2853,6,1389890,-2,2852,1572,2853,540,1
20150106.13482,2853,4,1389894,-2,2852,1572,2853,538,1
20150106.134821,2852,2,1389896,0,2852,1578,2853,550,0
20150106.134822,2853,2,1389898,-2,2852,1576,2853,565,1
20150106.134824,2853,4,1389902,-4,2852,1575,2853,583,1
20150106.134825,2853,6,1389908,-4,2852,1576,2853,580,1
20150106.134827,2853,2,1389910,0,2852,1632,2853,579,1
20150106.134828,2853,2,1389912,0,2852,1632,2853,578,1
20150106.134829,2853,6,1389918,0,2852,1627,2853,575,1
20150106.134831,2852,2,1389920,0,2852,1625,2853,575,0
20150106.134832,2853,2,1389922,0,2852,1640,2853,574,1
20150106.134832,2853,2,1389924,0,2852,1642,2853,573,1
20150106.134834,2853,20,1389944,-20,2852,1642,2853,564,1
20150106.134834,2852,2,1389946,0,2852,1642,2853,564,0
20150106.134835,2852,12,1389958,0,2852,1641,2853,559,0
20150106.134835,2852,2,1389960,0,2852,1640,2853,559,0
20150106.134836,2852,2,1389962,0,2852,1639,2853,559,0
20150106.134836,2852,2,1389964,0,2852,1637,2853,560,0
20150106.134837,2853,18,1389982,0,2852,1629,2853,559,1
20150106.134837,2852,22,1390004,0,2852,1628,2853,549,0
20150106.134838,2852,4,1390008,-2,2852,1627,2853,551,0
20150106.134838,2852,4,1390012,0,2852,1634,2853,551,0
20150106.134839,2852,4,1390016,0,2852,1632,2853,546,0
20150106.134839,2852,2,1390018,0,2852,1631,2853,546,0
20150106.13484,2852,4,1390022,0,2852,1627,2853,547,0
20150106.134841,2852,4,1390026,2,2852,1626,2853,547,0
20150106.134841,2852,4,1390030,0,2852,1644,2853,547,0
20150106.134842,2852,2,1390032,0,2852,1643,2853,547,0
20150106.134842,2852,2,1390034,2,2852,1642,2853,547,0
20150106.134843,2853,4,1390038,-4,2852,1641,2853,545,1
20150106.134843,2853,2,1390040,-2,2852,1641,2853,544,1
20150106.134845,2853,8,1390048,-6,2852,1642,2853,540,1
20150106.134845,2853,4,1390052,0,2852,1642,2853,538,1
20150106.134846,2853,2,1390054,0,2852,1642,2853,538,1
20150106.134847,2852,6,1390060,-2,2852,1625,2853,538,0
20150106.134848,2853,2,1390062,-2,2852,1625,2853,537,1
20150106.134848,2853,4,1390066,2,2852,1624,2853,536,1
20150106.134849,2853,400,1390466,386,2852,1632,2853,335,1
20150106.134849,2853,2,1390468,0,2852,1650,2853,334,1
20150106.13485,2853,10,1390478,8,2852,1650,2853,330,1
20150106.13485,2853,6,1390484,0,2852,1655,2853,327,1
20150106.134852,2853,6,1390490,6,2852,1657,2853,324,1
20150106.134852,2852,2,1390492,0,2852,1657,2853,324,0
20150106.134854,2853,2,1390494,0,2852,1657,2853,323,1
20150106.134854,2853,30,1390524,20,2852,1669,2853,308,1
20150106.134855,2853,4,1390528,0,2852,1682,2853,306,1
20150106.134856,2853,44,1390572,-20,2852,1682,2853,284,1
20150106.134856,2853,42,1390614,14,2852,1682,2853,266,1
20150106.134857,2853,2,1390616,0,2852,1682,2853,265,1
20150106.134857,2853,4,1390620,0,2852,1694,2853,263,1
20150106.134858,2853,204,1390824,-4,2852,1697,2853,150,1
20150106.134858,2853,2,1390826,0,2852,1632,2853,149,1
20150106.134859,2853,180,1391006,2,2852,1632,2853,59,1
20150106.134859,2853,50,1391056,-8,2852,1634,2853,34,1
20150106.1349,2853,88,1391144,46,2852,1634,2853,191,1
20150106.1349,2853,84,1391228,-8,2852,1640,2853,239,1
20150106.134901,2853,40,1391268,-40,2852,1632,2853,219,1
20150106.134902,2853,4,1391272,-4,2852,1651,2853,217,1
20150106.134902,2853,140,1391412,-140,2852,1652,2853,147,1
20150106.134903,2853,2,1391414,0,2852,1694,2853,346,1
20150106.134904,2853,2,1391416,-2,2852,1695,2853,345,1
20150106.134904,2853,158,1391574,-140,2852,1689,2853,272,1
20150106.134905,2853,22,1391596,0,2852,1691,2853,261,1
20150106.134906,2853,2,1391598,-2,2852,1692,2853,260,1
20150106.134907,2853,4,1391602,-2,2852,1692,2853,258,1
20150106.134908,2853,4,1391606,-4,2852,1697,2853,256,1
20150106.134909,2853,32,1391638,-10,2852,1698,2853,241,1
20150106.134909,2853,2,1391640,0,2852,1698,2853,240,1
20150106.13491,2853,10,1391650,-2,2852,1718,2853,235,1
20150106.134911,2853,2,1391652,-2,2852,1729,2853,254,1
20150106.134912,2853,10,1391662,0,2852,1735,2853,249,1
20150106.134912,2852,2,1391664,2,2852,1740,2853,249,0
20150106.134914,2852,2,1391666,0,2852,1752,2853,252,0
20150106.134914,2853,2,1391668,0,2852,1733,2853,251,1
20150106.134916,2853,8,1391676,-8,2852,1734,2853,247,1
20150106.134917,2853,4,1391680,0,2852,1734,2853,246,1
20150106.134917,2853,28,1391708,0,2852,1734,2853,233,1
20150106.134918,2853,302,1392010,-300,2852,1734,2853,82,1
20150106.134919,2853,8,1392018,-8,2852,1732,2853,78,1
20150106.134919,2853,14,1392032,0,2852,1732,2853,73,1
20150106.13492,2853,30,1392062,-20,2852,1732,2853,259,1
20150106.13492,2853,204,1392266,50,2852,1732,2853,158,1
20150106.134921,2853,140,1392406,0,2852,1733,2853,90,1
20150106.134922,2853,14,1392420,-8,2852,1731,2853,88,1
20150106.134922,2853,10,1392430,0,2852,1733,2853,87,1
20150106.134923,2853,6,1392436,-6,2852,1733,2853,84,1
20150106.134923,2853,4,1392440,-4,2852,1763,2853,82,1
20150106.134924,2853,10,1392450,0,2852,1762,2853,287,1
20150106.134924,2853,2,1392452,0,2852,1761,2853,292,1
20150106.134925,2853,344,1392796,-306,2852,1761,2853,120,1
20150106.134926,2853,22,1392818,-2,2852,1762,2853,107,1
20150106.134927,2853,2,1392820,0,2852,1782,2853,106,1
20150106.134927,2853,12,1392832,-2,2852,1782,2853,100,1
20150106.134928,2853,4,1392836,-4,2852,1786,2853,98,1
20150106.134928,2853,8,1392844,-8,2852,1786,2853,111,1
20150106.134929,2853,22,1392866,0,2852,1788,2853,100,1
20150106.134929,2853,2,1392868,0,2852,1793,2853,99,1
20150106.13493,2853,10,1392878,0,2852,1793,2853,94,1
20150106.13493,2853,16,1392894,-8,2852,1795,2853,88,1
20150106.134931,2853,10,1392904,0,2852,1796,2853,83,1
20150106.134931,2853,2,1392906,0,2852,1797,2853,82,1
20150106.134932,2853,4,1392910,-2,2852,1802,2853,80,1
20150106.134934,2853,2,1392912,0,2852,1798,2853,80,1
20150106.134934,2853,2,1392914,0,2852,1798,2853,83,1
20150106.134935,2853,20,1392934,0,2852,1790,2853,123,1
20150106.134937,2853,42,1392976,-40,2852,1790,2853,102,1
20150106.134937,2853,2,1392978,0,2852,1790,2853,101,1
20150106.134939,2852,4,1392982,-2,2852,1809,2853,100,0
20150106.13494,2853,22,1393004,-2,2852,1813,2853,89,1
20150106.134941,2853,102,1393106,-54,2852,1803,2854,993,1
20150106.134941,2853,2,1393108,0,2853,2,2854,972,1
20150106.134942,2853,4,1393112,0,2853,8,2854,957,1
20150106.134943,2853,2,1393114,0,2853,8,2854,958,1
20150106.134944,2853,2,1393116,2,2853,23,2854,958,1
20150106.134945,2854,2,1393118,0,2853,125,2854,957,1
20150106.134945,2854,2,1393120,0,2853,127,2854,956,1
20150106.134946,2854,2,1393122,-2,2853,128,2854,955,1
20150106.134947,2853,4,1393126,0,2853,240,2854,954,0
20150106.134949,2853,8,1393134,8,2853,249,2854,952,0
20150106.13495,2854,42,1393176,36,2853,350,2854,932,1
20150106.134952,2854,10,1393186,0,2853,388,2854,909,1
20150106.134953,2854,8,1393194,6,2853,410,2854,901,1
20150106.134956,2853,4,1393198,4,2853,413,2854,922,0
20150106.134957,2854,12,1393210,0,2853,413,2854,916,1
20150106.134958,2854,2,1393212,2,2853,426,2854,916,1
20150106.134959,2854,4,1393216,2,2853,439,2854,914,1
20150106.135001,2854,2,1393218,-2,2853,457,2854,913,1
20150106.135002,2854,10,1393228,0,2853,455,2854,931,1
20150106.135002,2854,14,1393242,6,2853,452,2854,929,1
20150106.135004,2854,4,1393246,-4,2853,570,2854,928,1
20150106.135006,2854,2,1393248,-2,2853,572,2854,927,1
20150106.135008,2854,6,1393254,-4,2853,587,2854,925,1
20150106.135008,2854,2,1393256,-2,2853,587,2854,924,1
20150106.13501,2854,2,1393258,0,2853,597,2854,968,1
20150106.13501,2854,2,1393260,-2,2853,597,2854,967,1
20150106.135011,2853,6,1393266,-4,2853,596,2854,965,0
20150106.135012,2854,4,1393270,-4,2853,622,2854,965,1
20150106.135014,2854,12,1393282,2,2853,623,2854,963,1
20150106.135015,2854,2,1393284,2,2853,629,2854,962,1
20150106.135018,2853,80,1393364,10,2853,706,2854,962,0
20150106.135019,2854,2,1393366,2,2853,712,2854,962,1
20150106.13502,2854,4,1393370,4,2853,713,2854,959,1
20150106.135021,2853,12,1393382,-6,2853,1012,2854,955,0
20150106.135024,2854,2,1393384,0,2853,1018,2854,958,1
20150106.135026,2854,2,1393386,-2,2853,1019,2854,959,1
20150106.135027,2854,4,1393390,-4,2853,1022,2854,957,1
20150106.135028,2854,2,1393392,0,2853,1026,2854,956,1
20150106.13503,2854,72,1393464,-60,2853,996,2854,950,1
20150106.13503,2854,6,1393470,4,2853,995,2854,947,1
20150106.135031,2854,6,1393476,6,2853,997,2854,944,1
20150106.135034,2854,2,1393478,0,2853,997,2854,943,1
20150106.135035,2854,10,1393488,0,2853,1007,2854,938,1
20150106.135037,2854,10,1393498,0,2853,1004,2854,934,1
20150106.135037,2854,20,1393518,0,2853,1005,2854,922,1
20150106.135038,2854,42,1393560,42,2853,1006,2854,901,1
20150106.135038,2854,2,1393562,2,2853,1006,2854,900,1
20150106.135039,2854,2,1393564,0,2853,1011,2854,899,1
20150106.13504,2854,2,1393566,0,2853,1012,2854,910,1
20150106.135041,2854,2,1393568,0,2853,1014,2854,909,1
20150106.135045,2854,4,1393572,-4,2853,1023,2854,907,1
20150106.135047,2854,2,1393574,-2,2853,1028,2854,909,1
20150106.13505,2854,2,1393576,0,2853,1028,2854,908,1
20150106.135051,2854,10,1393586,-10,2853,1028,2854,903,1
20150106.135053,2854,600,1394186,-572,2853,1028,2854,604,1
20150106.135054,2854,4,1394190,0,2853,1028,2854,600,1
20150106.135054,2854,8,1394198,-4,2853,1027,2854,566,1
20150106.135056,2854,8,1394206,0,2853,1029,2854,562,1
20150106.135057,2854,2,1394208,0,2853,1029,2854,561,1
20150106.135058,2854,4,1394212,-2,2853,1028,2854,559,1
20150106.135059,2854,102,1394314,-92,2853,1028,2854,507,1
20150106.135059,2853,10,1394324,-2,2853,1027,2854,518,0
20150106.135101,2854,18,1394342,-4,2853,1021,2854,519,1
20150106.135101,2854,10,1394352,0,2853,1021,2854,514,1
20150106.135103,2854,12,1394364,0,2853,1024,2854,508,1
20150106.135106,2854,40,1394404,0,2853,1035,2854,522,1
20150106.135107,2854,6,1394410,-4,2853,1035,2854,519,1
20150106.135108,2853,4,1394414,-4,2853,1033,2854,519,0
20150106.135108,2854,4,1394418,2,2853,1033,2854,567,1
20150106.135109,2853,2,1394420,-2,2853,1032,2854,567,0
20150106.135112,2854,10,1394430,-8,2853,1059,2854,565,1
20150106.135113,2854,200,1394630,176,2853,1059,2854,465,1
20150106.135114,2854,10,1394640,10,2853,1063,2854,461,1
20150106.135114,2854,4,1394644,0,2853,1064,2854,460,1
20150106.135115,2854,12,1394656,12,2853,1064,2854,454,1
20150106.135116,2854,2,1394658,2,2853,1064,2854,453,1
20150106.135116,2854,30,1394688,30,2853,1064,2854,438,1
20150106.135117,2854,2,1394690,0,2853,1064,2854,437,1
20150106.13512,2854,24,1394714,24,2853,1051,2854,425,1
20150106.135121,2853,2,1394716,0,2853,1053,2854,445,0
20150106.135124,2854,2,1394718,0,2853,1059,2854,444,1
20150106.135127,2854,2,1394720,2,2853,1058,2854,445,1
20150106.135128,2854,2,1394722,0,2853,1058,2854,446,1
20150106.135129,2854,18,1394740,-2,2853,1057,2854,438,1
20150106.135129,2854,2,1394742,2,2853,1058,2854,437,1
20150106.13513,2854,2,1394744,0,2853,1058,2854,441,1
20150106.135131,2854,6,1394750,0,2853,1058,2854,439,1
20150106.135132,2854,2,1394752,2,2853,1060,2854,440,1
20150106.135133,2854,2,1394754,0,2853,1059,2854,439,1
20150106.135135,2853,2,1394756,0,2853,1538,2854,439,0
20150106.135136,2854,2,1394758,2,2853,1536,2854,438,1
20150106.135137,2854,2,1394760,2,2853,1536,2854,437,1
20150106.135137,2854,10,1394770,0,2853,1536,2854,432,1
20150106.135139,2853,12,1394782,0,2853,1530,2854,441,0
20150106.13514,2853,18,1394800,-18,2853,1521,2854,432,0
20150106.135141,2854,10,1394810,0,2853,1515,2854,427,1
20150106.135145,2853,4,1394814,2,2853,1513,2854,432,0
20150106.135149,2853,2,1394816,-2,2853,1038,2854,432,0
20150106.135151,2854,2,1394818,2,2853,1039,2854,431,1
20150106.135155,2853,8,1394826,2,2853,1043,2854,447,0
20150106.135156,2853,130,1394956,2,2853,978,2854,510,0
20150106.135158,2853,6,1394962,-6,2853,976,2854,510,0
20150106.135159,2854,130,1395092,-58,2853,976,2854,445,1
20150106.135202,2854,4,1395096,0,2853,976,2854,451,1
20150106.135202,2854,2,1395098,-2,2853,976,2854,450,1
20150106.135204,2854,2,1395100,0,2853,975,2854,450,1
20150106.135205,2854,2,1395102,0,2853,975,2854,449,1
20150106.135207,2853,6,1395108,0,2853,973,2854,447,0
20150106.135208,2854,4,1395112,-2,2853,973,2854,446,1
20150106.13521,2854,104,1395216,0,2853,992,2854,400,1
20150106.135211,2854,20,1395236,0,2853,993,2854,386,1
20150106.135212,2854,2,1395238,-2,2853,993,2854,385,1
20150106.135212,2854,6,1395244,-4,2853,993,2854,382,1
20150106.135213,2854,34,1395278,-34,2853,984,2854,365,1
20150106.135213,2854,2,1395280,0,2853,984,2854,364,1
20150106.135213,2854,20,1395300,14,2853,984,2854,354,1
20150106.135215,2854,2,1395302,2,2853,983,2854,358,1
20150106.135215,2853,2,1395304,0,2853,982,2854,358,0
20150106.135216,2854,2,1395306,2,2853,996,2854,357,1
20150106.135217,2853,2,1395308,0,2853,996,2854,357,0
20150106.135218,2854,18,1395326,0,2853,996,2854,348,1
20150106.135218,2854,2,1395328,2,2853,996,2854,347,1
20150106.13522,2854,16,1395344,-10,2853,990,2854,338,1
20150106.135221,2854,2,1395346,0,2853,990,2854,337,1
20150106.135223,2854,6,1395352,-6,2853,990,2854,334,1
20150106.135224,2854,2,1395354,0,2853,987,2854,333,1
20150106.135224,2854,8,1395362,-8,2853,987,2854,329,1
20150106.135226,2854,2,1395364,0,2853,987,2854,348,1
20150106.135228,2854,4,1395368,0,2853,1087,2854,346,1
20150106.135229,2854,22,1395390,-20,2853,1088,2854,335,1
20150106.13523,2853,6,1395396,-6,2853,1085,2854,339,0
20150106.135231,2854,4,1395400,-4,2853,1087,2854,337,1
20150106.135233,2854,20,1395420,0,2853,1087,2854,327,1
20150106.135234,2854,2,1395422,0,2853,1087,2854,326,1
20150106.135235,2854,2,1395424,0,2853,1102,2854,323,1
20150106.135237,2854,10,1395434,-10,2853,1102,2854,319,1
20150106.135239,2854,2,1395436,-2,2853,1104,2854,319,1
20150106.13524,2854,2,1395438,-2,2853,1105,2854,285,1
20150106.13524,2854,2,1395440,0,2853,1116,2854,275,1
20150106.135241,2854,6,1395446,-6,2853,1116,2854,273,1
20150106.135243,2854,22,1395468,-8,2853,1105,2854,262,1
20150106.135243,2854,6,1395474,-6,2853,1135,2854,264,1
20150106.135244,2854,4,1395478,0,2853,1135,2854,255,1
20150106.135245,2854,16,1395494,2,2853,1135,2854,257,1
20150106.135245,2854,6,1395500,-2,2853,1134,2854,255,1
20150106.135247,2854,10,1395510,0,2853,1124,2854,250,1
20150106.135248,2854,30,1395540,12,2853,1121,2854,236,1
20150106.13525,2853,400,1395940,238,2853,964,2854,262,0
20150106.135253,2854,8,1395948,8,2853,922,2854,275,1
20150106.135256,2854,710,1396658,-394,2854,48,2855,439,1
20150106.135256,2854,14,1396672,12,2854,42,2855,442,1
20150106.135257,2854,2,1396674,0,2854,41,2855,442,1
20150106.135259,2854,6,1396680,6,2854,45,2855,442,1
20150106.1353,2855,100,1396780,-40,2854,45,2855,392,1
20150106.1353,2855,4,1396784,0,2854,48,2855,396,1
20150106.135301,2854,2,1396786,2,2854,156,2855,396,0
20150106.135301,2855,200,1396986,68,2854,157,2855,296,1
20150106.135304,2855,8,1396994,-8,2854,222,2855,298,1
20150106.135304,2855,200,1397194,94,2854,246,2855,198,1
20150106.135305,2855,4,1397198,2,2854,284,2855,194,1
20150106.135306,2855,8,1397206,0,2854,284,2855,190,1
20150106.135306,2855,2,1397208,0,2854,298,2855,169,1
20150106.135307,2855,4,1397212,0,2854,263,2855,167,1
20150106.135307,2854,2,1397214,2,2854,263,2855,171,0
20150106.135308,2855,2,1397216,0,2854,263,2855,170,1
20150106.135308,2855,86,1397302,70,2854,264,2855,128,1
20150106.135309,2855,2,1397304,2,2854,264,2855,128,1
20150106.13531,2855,20,1397324,0,2854,265,2855,118,1
20150106.13531,2855,2,1397326,2,2854,265,2855,125,1
20150106.135311,2855,10,1397336,0,2854,313,2855,123,1
20150106.135312,2855,8,1397344,2,2854,313,2855,119,1
20150106.135315,2855,24,1397368,0,2854,323,2855,112,1
20150106.135315,2855,6,1397374,2,2854,323,2855,109,1
20150106.135316,2855,4,1397378,-2,2854,333,2855,107,1
20150106.135317,2855,50,1397428,12,2854,333,2855,117,1
20150106.135319,2855,6,1397434,0,2854,333,2855,116,1
20150106.135319,2855,10,1397444,-10,2854,333,2855,115,1
20150106.13532,2855,2,1397446,0,2854,333,2855,114,1
20150106.13532,2855,2,1397448,0,2854,333,2855,115,1
20150106.135322,2855,6,1397454,-6,2854,334,2855,115,1
20150106.135323,2855,18,1397472,-14,2854,334,2855,106,1
20150106.135323,2855,18,1397490,-6,2854,335,2855,100,1
20150106.135324,2855,4,1397494,2,2854,339,2855,98,1
20150106.135326,2855,26,1397520,-18,2854,342,2855,86,1
20150106.135326,2855,4,1397524,-2,2854,342,2855,84,1
20150106.135327,2855,4,1397528,-2,2854,343,2855,83,1
20150106.135327,2855,2,1397530,-2,2854,351,2855,82,1
20150106.135328,2855,10,1397540,-2,2854,339,2855,81,1
20150106.135328,2855,90,1397630,-4,2854,349,2855,36,1
20150106.135329,2855,76,1397706,2,2855,20,2856,628,1
20150106.135329,2855,26,1397732,0,2855,17,2856,579,1
20150106.13533,2855,34,1397766,0,2854,351,2855,117,1
20150106.13533,2855,16,1397782,6,2854,351,2855,110,1
20150106.135331,2855,26,1397808,20,2854,361,2855,97,1
20150106.135332,2855,14,1397822,2,2854,365,2855,91,1
20150106.135332,2855,6,1397828,6,2854,365,2855,90,1
20150106.135333,2855,22,1397850,22,2854,365,2855,175,1
20150106.135334,2855,100,1397950,-90,2854,366,2855,138,1
20150106.135336,2855,22,1397972,-4,2854,365,2855,130,1
20150106.135336,2854,6,1397978,-4,2854,364,2855,130,0
20150106.135337,2854,6,1397984,0,2854,361,2855,135,0
20150106.135338,2855,6,1397990,0,2854,374,2855,152,1
20150106.135339,2855,2,1397992,-2,2854,374,2855,151,1
20150106.135339,2855,6,1397998,-6,2854,374,2855,148,1
20150106.13534,2855,46,1398044,2,2854,377,2855,126,1
20150106.135343,2854,6,1398050,4,2854,398,2855,147,0
20150106.135343,2855,4,1398054,0,2854,399,2855,145,1
20150106.135344,2855,6,1398060,6,2854,399,2855,157,1
20150106.135345,2855,6,1398066,6,2854,399,2855,154,1
20150106.135345,2855,4,1398070,2,2854,398,2855,153,1
20150106.135347,2855,20,1398090,20,2854,406,2855,144,1
20150106.135348,2854,8,1398098,-8,2854,402,2855,255,0
20150106.135348,2855,2,1398100,0,2854,402,2855,255,1
20150106.135349,2855,2,1398102,2,2854,406,2855,254,1
20150106.13535,2855,2,1398104,-2,2854,406,2855,195,1
20150106.135353,2855,14,1398118,0,2854,435,2855,216,1
20150106.135354,2855,4,1398122,-4,2854,435,2855,215,1
20150106.135355,2855,6,1398128,0,2854,435,2855,213,1
20150106.135357,2855,46,1398174,-22,2854,438,2855,215,1
20150106.135358,2855,10,1398184,-4,2854,437,2855,212,1
20150106.135358,2855,2,1398186,0,2854,438,2855,216,1
20150106.135358,2855,2,1398188,2,2854,405,2855,215,1
20150106.1354,2855,40,1398228,-2,2854,425,2855,199,1
20150106.135403,2855,122,1398350,-2,2854,425,2855,149,1
20150106.135404,2855,14,1398364,0,2854,425,2855,142,1
20150106.135404,2855,18,1398382,2,2854,425,2855,153,1
20150106.135407,2855,2,1398384,0,2854,429,2855,152,1
20150106.135408,2855,2,1398386,0,2854,431,2855,153,1
20150106.135409,2855,44,1398430,4,2854,432,2855,130,1
20150106.13541,2855,2,1398432,2,2854,432,2855,129,1
20150106.135412,2855,4,1398436,0,2854,427,2855,142,1
20150106.135413,2855,10,1398446,0,2854,429,2855,121,1
20150106.135413,2855,20,1398466,20,2854,430,2855,112,1
20150106.135415,2854,50,1398516,-50,2854,402,2855,112,0
20150106.135416,2855,206,1398722,102,2854,403,2855,12,1
20150106.135417,2855,2,1398724,-2,2854,404,2855,12,1
20150106.135418,2855,2,1398726,-2,2854,396,2855,15,1
20150106.135418,2855,8,1398734,4,2854,401,2855,14,1
20150106.135419,2855,22,1398756,-8,2854,522,2855,16,1
20150106.13542,2855,6,1398762,2,2854,534,2855,84,1
20150106.135421,2855,22,1398784,-14,2854,544,2855,78,1
20150106.135422,2855,108,1398892,100,2854,543,2855,30,1
20150106.135423,2855,2,1398894,0,2854,543,2855,28,1
20150106.135423,2855,2,1398896,0,2854,545,2855,27,1
20150106.135424,2855,56,1398952,-16,2855,44,2856,632,1
20150106.135424,2855,4,1398956,0,2855,44,2856,626,1
20150106.135425,2855,6,1398962,0,2855,51,2856,627,1
20150106.135425,2855,108,1399070,-96,2855,3,2856,626,1
20150106.135426,2855,10,1399080,0,2855,44,2856,626,1
20150106.135427,2855,6,1399086,-6,2855,103,2856,552,1
20150106.135428,2855,2,1399088,-2,2855,102,2856,552,1
20150106.135429,2856,102,1399190,42,2855,100,2856,498,1
20150106.135429,2856,18,1399208,4,2855,100,2856,484,1
20150106.13543,2856,8,1399216,0,2855,103,2856,451,1
20150106.13543,2856,6,1399222,2,2855,105,2856,432,1
20150106.135432,2856,104,1399326,-70,2855,85,2856,433,1
20150106.135433,2856,2,1399328,2,2855,88,2856,432,1
20150106.135433,2855,218,1399546,-68,2855,62,2856,439,0
20150106.135434,2856,2,1399548,0,2855,63,2856,439,1
20150106.135434,2856,2,1399550,2,2855,63,2856,438,1
20150106.135435,2855,14,1399564,-4,2855,189,2856,440,0
20150106.135436,2856,6,1399570,6,2855,201,2856,414,1
20150106.135436,2856,10,1399580,0,2855,238,2856,409,1
20150106.135437,2856,20,1399600,0,2855,238,2856,399,1
20150106.135437,2856,8,1399608,8,2855,239,2856,395,1
20150106.135438,2856,2,1399610,2,2855,254,2856,395,1
20150106.135439,2856,10,1399620,0,2855,275,2856,390,1
20150106.13544,2856,12,1399632,0,2855,276,2856,387,1
20150106.135443,2856,2,1399634,2,2855,334,2856,398,1
20150106.135443,2856,2,1399636,0,2855,334,2856,397,1
20150106.135444,2856,42,1399678,0,2855,340,2856,381,1
20150106.135444,2856,6,1399684,6,2855,340,2856,380,1
20150106.135444,2856,2,1399686,0,2855,370,2856,380,1
20150106.135445,2856,770,1400456,-372,2856,617,2857,512,1
20150106.135446,2856,30,1400486,-26,2856,688,2857,460,1
20150106.135446,2856,10,1400496,-10,2856,688,2857,459,1
20150106.135447,2857,4,1400500,-4,2856,699,2857,458,1
20150106.135448,2857,62,1400562,-56,2856,699,2857,435,1
20150106.135449,2856,4,1400566,-4,2856,703,2857,434,0
20150106.135449,2857,2,1400568,-2,2856,703,2857,433,1
20150106.13545,2857,38,1400606,-30,2856,703,2857,414,1
20150106.13545,2857,24,1400630,-2,2856,703,2857,402,1
20150106.135451,2856,20,1400650,-20,2856,694,2857,406,0
20150106.135451,2856,10,1400660,-10,2856,689,2857,406,0
20150106.135452,2857,6,1400666,0,2856,699,2857,405,1
20150106.135452,2857,40,1400706,-18,2856,697,2857,385,1
20150106.135453,2857,6,1400712,-4,2856,702,2857,381,1
20150106.135453,2857,2,1400714,0,2856,702,2857,387,1
20150106.135453,2857,24,1400738,-4,2856,702,2857,376,1
20150106.135454,2856,20,1400758,-12,2856,701,2857,370,0
20150106.135456,2857,184,1400942,-164,2856,724,2857,278,1
20150106.135456,2857,2,1400944,0,2856,724,2857,280,1
20150106.135457,2857,32,1400976,-30,2856,723,2857,265,1
20150106.135458,2857,42,1401018,-28,2856,728,2857,310,1
20150106.135459,2857,4,1401022,-2,2856,728,2857,311,1
20150106.135459,2857,6,1401028,-6,2856,728,2857,311,1
20150106.1355,2857,26,1401054,-8,2856,723,2857,305,1
20150106.1355,2857,30,1401084,22,2856,727,2857,290,1
20150106.135501,2857,6,1401090,0,2856,727,2857,290,1
20150106.135501,2857,8,1401098,0,2856,728,2857,316,1
20150106.135502,2857,82,1401180,52,2856,728,2857,275,1
20150106.135502,2856,2,1401182,-2,2856,727,2857,284,0
20150106.135503,2857,4,1401186,0,2856,932,2857,282,1
20150106.135504,2857,30,1401216,0,2856,934,2857,267,1
20150106.135504,2857,20,1401236,0,2856,934,2857,259,1
20150106.135505,2857,4,1401240,-4,2856,935,2857,249,1
20150106.135505,2857,30,1401270,0,2856,935,2857,239,1
20150106.135506,2857,22,1401292,18,2856,940,2857,231,1
20150106.135507,2857,108,1401400,84,2856,944,2858,763,1
20150106.135507,2856,8,1401408,-8,2856,940,2857,188,0
20150106.135508,2857,10,1401418,0,2856,938,2857,156,1
20150106.135508,2856,16,1401434,-4,2856,1106,2857,152,0
20150106.135509,2857,126,1401560,60,2856,1104,2858,804,1
20150106.135509,2857,14,1401574,10,2856,1104,2857,86,1
20150106.135511,2857,28,1401602,14,2856,1275,2857,68,1
20150106.135511,2857,66,1401668,62,2856,1275,2857,11,1
20150106.135512,2857,14,1401682,-6,2856,1275,2857,82,1
20150106.135512,2857,16,1401698,-12,2856,1276,2857,74,1
20150106.135513,2857,4,1401702,0,2856,1271,2857,72,1
20150106.135513,2857,22,1401724,0,2856,1398,2857,61,1
20150106.135514,2857,24,1401748,-6,2856,1231,2857,180,1
20150106.135515,2857,26,1401774,-4,2856,1231,2857,197,1
20150106.135516,2857,4,1401778,-2,2856,1231,2857,199,1
20150106.135516,2857,18,1401796,-8,2856,1230,2857,194,1
20150106.135517,2857,42,1401838,-40,2856,1231,2857,174,1
20150106.135518,2857,8,1401846,2,2856,1240,2857,169,1
20150106.135519,2857,16,1401862,14,2856,1240,2857,216,1
20150106.13552,2857,4,1401866,2,2856,1240,2857,259,1
20150106.13552,2857,24,1401890,0,2856,1237,2857,284,1
20150106.135521,2857,6,1401896,4,2856,1231,2857,287,1
20150106.135521,2857,16,1401912,0,2856,1231,2857,281,1
20150106.135522,2857,12,1401924,0,2856,1229,2857,278,1
20150106.135523,2857,10,1401934,2,2856,1228,2857,423,1
20150106.135524,2857,2,1401936,-2,2856,1223,2857,429,1
20150106.135525,2857,108,1402044,-4,2856,1253,2857,384,1
20150106.135526,2856,10,1402054,-2,2856,1252,2857,381,0
20150106.135527,2856,4,1402058,-4,2856,1251,2857,403,0
20150106.135527,2857,8,1402066,-8,2856,1250,2857,407,1
20150106.135528,2856,4,1402070,-4,2856,1248,2857,420,0
20150106.135528,2856,4,1402074,-4,2856,1245,2857,420,0
20150106.135529,2857,20,1402094,-18,2856,1236,2857,418,1
20150106.13553,2857,40,1402134,0,2856,1236,2857,400,1
20150106.135531,2856,26,1402160,-6,2856,1223,2857,403,0
20150106.135531,2857,10,1402170,-6,2856,1221,2857,400,1
20150106.135532,2856,10,1402180,-10,2856,1216,2857,400,0
20150106.135533,2857,30,1402210,6,2856,1226,2857,409,1
20150106.135534,2857,216,1402426,162,2856,1226,2857,303,1
20150106.135534,2857,20,1402446,20,2856,1227,2857,293,1
20150106.135536,2857,606,1403052,-316,2856,1227,2857,6,1
20150106.135537,2857,46,1403098,0,2857,146,2858,1032,1
20150106.135538,2857,12,1403110,6,2857,317,2858,977,1
20150106.135539,2857,4,1403114,0,2857,336,2858,977,1
20150106.135539,2857,72,1403186,72,2857,300,2858,980,1
20150106.13554,2857,2,1403188,2,2857,299,2858,979,1
20150106.135541,2858,6,1403194,0,2857,371,2858,977,1
20150106.135542,2858,16,1403210,2,2857,372,2858,970,1
20150106.135542,2858,10,1403220,0,2857,371,2858,976,1
20150106.135543,2858,50,1403270,-2,2857,360,2858,964,1
20150106.135543,2858,6,1403276,2,2857,536,2858,972,1
20150106.135544,2857,4,1403280,2,2857,536,2858,973,0
20150106.135544,2857,4,1403284,0,2857,534,2858,973,0
20150106.135545,2858,106,1403390,2,2857,457,2858,971,1
20150106.135545,2857,426,1403816,-20,2857,296,2858,977,0
20150106.135546,2857,848,1404664,410,2856,748,2857,161,0
20150106.135546,2857,24,1404688,8,2856,749,2857,156,0
20150106.135547,2856,4,1404692,-4,2856,747,2857,191,0
20150106.135548,2857,2,1404694,2,2856,752,2857,195,1
20150106.135549,2857,8,1404702,0,2856,751,2857,197,1
20150106.13555,2857,2,1404704,0,2856,751,2857,196,1
20150106.13555,2856,6,1404710,0,2856,750,2857,205,0
20150106.135551,2857,2,1404712,2,2856,751,2857,210,1
20150106.135551,2857,8,1404720,4,2856,752,2857,208,1
20150106.135553,2857,4,1404724,4,2856,752,2857,247,1
20150106.135553,2857,14,1404738,0,2856,763,2857,238,1
20150106.135554,2856,18,1404756,-18,2856,754,2857,243,0
20150106.135556,2857,102,1404858,-48,2856,769,2857,255,1
20150106.135556,2856,2,1404860,0,2856,768,2857,249,0
20150106.135557,2856,2,1404862,0,2856,776,2857,250,0
20150106.135557,2857,2,1404864,0,2856,776,2857,250,1
20150106.135558,2856,18,1404882,-18,2856,800,2857,250,0
20150106.1356,2856,2,1404884,0,2856,839,2857,287,0
20150106.1356,2856,6,1404890,0,2856,836,2857,288,0
20150106.135601,2857,30,1404920,-30,2856,836,2857,273,1
20150106.135601,2857,2,1404922,0,2856,836,2857,272,1
20150106.135602,2857,6,1404928,0,2856,841,2857,273,1
20150106.135603,2857,20,1404948,-20,2856,834,2857,264,1
20150106.135603,2857,12,1404960,0,2856,855,2857,258,1
20150106.135604,2857,12,1404972,-12,2856,850,2857,251,1
20150106.135605,2857,2,1404974,0,2856,850,2857,247,1
20150106.135605,2857,4,1404978,-4,2856,850,2857,257,1
20150106.135606,2857,4,1404982,-4,2856,851,2857,255,1
20150106.135607,2856,30,1405012,4,2856,847,2857,247,0
20150106.135608,2857,2,1405014,2,2856,847,2857,247,1
20150106.13561,2857,4,1405018,0,2856,850,2857,260,1
20150106.135611,2856,20,1405038,0,2856,860,2857,268,0
20150106.135612,2856,12,1405050,-10,2856,851,2857,284,0
20150106.135612,2856,26,1405076,-6,2856,843,2857,285,0
20150106.135613,2857,6,1405082,4,2856,843,2857,287,1
20150106.135613,2856,10,1405092,-10,2856,842,2857,291,0
20150106.135614,2857,14,1405106,2,2856,836,2857,290,1
20150106.135615,2856,10,1405116,-10,2856,832,2857,296,0
20150106.135615,2856,10,1405126,-10,2856,827,2857,297,0
20150106.135616,2856,2,1405128,0,2856,855,2857,298,0
20150106.135617,2856,8,1405136,-8,2856,851,2857,298,0
20150106.135617,2857,2,1405138,0,2856,851,2857,297,1
20150106.135619,2856,8,1405146,2,2856,866,2857,310,0
20150106.135621,2857,2,1405148,2,2856,838,2857,325,1
20150106.135622,2857,12,1405160,8,2856,836,2857,322,1
20150106.135625,2857,2,1405162,0,2856,837,2857,333,1
20150106.135628,2857,2,1405164,2,2856,848,2857,340,1
20150106.135628,2857,2,1405166,2,2856,847,2857,339,1
20150106.13563,2857,678,1405844,-332,2856,870,2857,1,1
20150106.13563,2857,6,1405850,-4,2857,52,2858,1143,1
20150106.135631,2857,12,1405862,-8,2857,86,2858,1100,1
20150106.135631,2857,6,1405868,-4,2857,103,2858,1100,1
20150106.135631,2857,20,1405888,-12,2857,94,2858,1085,1
20150106.135632,2857,4,1405892,-2,2857,94,2858,1087,1
20150106.135633,2857,10,1405902,-2,2857,97,2858,1055,1
20150106.135633,2857,4,1405906,0,2857,96,2858,1065,1
20150106.135634,2857,2,1405908,0,2857,95,2858,1075,1
20150106.135634,2858,6,1405914,-2,2857,95,2858,1074,1
20150106.135635,2858,2,1405916,0,2857,95,2858,1074,1
20150106.135635,2858,10,1405926,-4,2857,96,2858,1069,1
20150106.135636,2857,4,1405930,-4,2857,99,2858,1070,0
20150106.135636,2858,10,1405940,0,2857,105,2858,1065,1
20150106.135637,2857,4,1405944,-2,2857,107,2858,1064,0
20150106.135638,2857,6,1405950,-4,2857,252,2858,1066,0
20150106.135639,2857,4,1405954,-4,2857,251,2858,1066,0
20150106.135639,2857,58,1406012,-28,2857,224,2858,1059,0
20150106.13564,2857,8,1406020,-6,2857,220,2858,1060,0
20150106.13564,2857,10,1406030,-10,2857,215,2858,1059,0
20150106.135641,2857,12,1406042,-8,2857,209,2858,1059,0
20150106.135641,2857,8,1406050,-8,2857,206,2858,1061,0
20150106.135642,2858,104,1406154,-90,2857,204,2858,1010,1
20150106.135643,2857,6,1406160,-4,2857,204,2858,1014,0
20150106.135643,2858,12,1406172,0,2857,204,2858,1010,1
20150106.135644,2857,20,1406192,-20,2857,195,2858,1010,0
20150106.135644,2857,6,1406198,-6,2857,203,2858,1010,0
20150106.135645,2857,2,1406200,0,2857,202,2858,1010,0
20150106.135645,2858,4,1406204,-4,2857,201,2858,1009,1
20150106.135646,2857,8,1406212,-8,2857,197,2858,1280,0
20150106.135646,2857,8,1406220,0,2857,193,2858,1280,0
20150106.135647,2857,6,1406226,0,2857,190,2858,1276,0
20150106.135647,2858,22,1406248,-20,2857,203,2858,1266,1
20150106.135649,2857,10,1406258,-2,2857,199,2858,1266,0
20150106.13565,2857,6,1406264,0,2857,189,2858,1267,0
20150106.13565,2858,2,1406266,-2,2857,193,2858,1266,1
20150106.135651,2857,4,1406270,2,2857,192,2858,1265,0
20150106.135652,2858,4,1406274,0,2857,209,2858,1267,1
20150106.135653,2857,2,1406276,2,2857,211,2858,1267,0
20150106.135653,2857,4,1406280,-4,2857,209,2858,1267,0
20150106.135653,2858,6,1406286,-2,2857,211,2858,1266,1
20150106.135654,2857,4,1406290,0,2857,209,2858,1266,0
20150106.135654,2857,6,1406296,0,2857,206,2858,1271,0
20150106.135655,2858,2,1406298,2,2857,206,2858,1270,1
20150106.135656,2857,2,1406300,0,2857,205,2858,1275,0
20150106.135656,2858,6,1406306,0,2857,203,2858,1272,1
20150106.135657,2858,202,1406508,200,2857,214,2858,1211,1
20150106.135658,2858,6,1406514,6,2857,226,2858,1208,1
20150106.1357,2857,12,1406526,-10,2857,249,2858,1207,0
20150106.135701,2858,4,1406530,4,2857,250,2858,1214,1
20150106.135702,2857,4,1406534,0,2857,251,2858,1216,0
20150106.135703,2858,12,1406546,-10,2857,246,2858,1217,1
20150106.135703,2858,4,1406550,2,2857,245,2858,1216,1
20150106.135704,2858,4,1406554,4,2857,245,2858,1216,1
20150106.135705,2857,400,1406954,66,2857,45,2858,1217,0
20150106.135706,2857,46,1407000,10,2856,972,2857,100,0
20150106.135706,2857,14,1407014,-6,2856,972,2857,93,0
20150106.135707,2857,24,1407038,-24,2856,923,2857,198,0
20150106.135709,2857,8,1407046,0,2856,923,2857,325,0
20150106.13571,2857,4,1407050,0,2856,923,2857,318,0
20150106.135711,2857,2,1407052,-2,2856,923,2857,319,0
20150106.135713,2856,4,1407056,0,2856,928,2857,328,0
20150106.135715,2857,2,1407058,-2,2856,932,2857,401,1
20150106.135716,2857,4,1407062,0,2856,935,2857,398,1
20150106.135716,2857,2,1407064,0,2856,935,2857,394,1
20150106.135718,2857,2,1407066,-2,2856,938,2857,396,1
20150106.135718,2857,2,1407068,-2,2856,938,2857,396,1
20150106.135719,2857,8,1407076,0,2856,936,2857,410,1
20150106.13572,2857,4,1407080,0,2856,937,2857,408,1
20150106.135722,2857,4,1407084,-4,2856,931,2857,411,1
20150106.135723,2856,200,1407284,-200,2856,843,2857,479,0
20150106.135725,2857,8,1407292,-8,2856,846,2857,519,1
20150106.135727,2857,50,1407342,-14,2856,846,2857,529,1
20150106.135728,2856,2,1407344,-2,2856,845,2857,530,0
20150106.135728,2856,2,1407346,-2,2856,844,2857,530,0
20150106.135729,2856,6,1407352,-4,2856,841,2857,555,0
20150106.135729,2856,2,1407354,0,2856,830,2857,556,0
20150106.13573,2857,2,1407356,0,2856,830,2857,542,1
20150106.135731,2857,14,1407370,6,2856,831,2857,539,1
20150106.135731,2857,4,1407374,4,2856,830,2857,553,1
20150106.135733,2856,2,1407376,-2,2856,827,2857,556,0
20150106.135734,2856,100,1407476,-100,2856,804,2857,558,0
20150106.135735,2857,8,1407484,0,2856,806,2857,568,1
20150106.135736,2857,6,1407490,0,2856,808,2857,569,1
20150106.135738,2856,2,1407492,-2,2856,807,2857,567,0
20150106.135741,2856,2,1407494,-2,2856,711,2857,556,0
20150106.135744,2857,16,1407510,0,2856,711,2857,541,1
20150106.135749,2857,2,1407512,2,2856,701,2857,598,1
20150106.135751,2857,10,1407522,10,2856,704,2857,482,1
20150106.135752,2857,4,1407526,-4,2856,704,2857,454,1
20150106.135753,2857,2,1407528,0,2856,704,2857,454,1
20150106.135754,2856,4,1407532,0,2856,704,2857,445,0
20150106.135756,2856,20,1407552,-20,2856,694,2857,447,0
20150106.135757,2856,400,1407952,-400,2856,515,2857,421,0
20150106.135758,2856,4,1407956,0,2856,514,2857,414,0
20150106.1358,2856,20,1407976,-20,2856,505,2857,444,0
20150106.1358,2856,8,1407984,-8,2856,500,2857,448,0
20150106.135801,2856,4,1407988,0,2856,498,2857,451,0
20150106.135801,2856,100,1408088,-94,2856,448,2857,451,0
20150106.135802,2856,2,1408090,-2,2856,448,2857,472,0
20150106.135802,2856,4,1408094,0,2856,446,2857,472,0
20150106.135802,2856,120,1408214,-50,2856,436,2857,442,0
20150106.135803,2856,20,1408234,-20,2856,426,2857,443,0
20150106.135804,2856,2,1408236,-2,2856,423,2857,453,0
20150106.135805,2856,4,1408240,-2,2856,454,2857,427,0
20150106.135806,2856,2,1408242,0,2856,458,2857,427,0
20150106.135806,2856,4,1408246,0,2856,456,2857,426,0
20150106.135808,2857,26,1408272,0,2856,457,2857,414,1
20150106.135809,2856,2,1408274,-2,2856,456,2857,424,0
20150106.135809,2856,2,1408276,-2,2856,456,2857,425,0
20150106.135811,2856,458,1408734,-142,2856,238,2857,420,0
20150106.135813,2856,76,1408810,4,2856,175,2857,432,0
20150106.135813,2856,116,1408926,-18,2856,123,2857,435,0
20150106.135813,2856,14,1408940,6,2856,116,2857,441,0
20150106.135814,2856,6,1408946,4,2856,113,2857,445,0
20150106.135815,2856,16,1408962,4,2856,117,2857,446,0
20150106.135816,2856,2,1408964,0,2856,114,2857,447,0
20150106.135816,2857,8,1408972,8,2856,113,2857,443,1
20150106.135817,2856,2,1408974,0,2856,113,2857,445,0
20150106.135817,2856,4,1408978,0,2856,112,2857,443,0
20150106.135818,2857,24,1409002,22,2856,111,2857,433,1
20150106.135818,2857,2,1409004,2,2856,113,2857,431,1
20150106.135819,2856,2,1409006,0,2856,112,2857,440,0
20150106.135819,2856,8,1409014,0,2856,108,2857,440,0
20150106.13582,2856,4,1409018,2,2856,107,2857,440,0
20150106.13582,2856,16,1409034,16,2856,99,2857,442,0
20150106.135821,2857,888,1409922,-462,2857,560,2858,1158,1
20150106.135822,2857,222,1410144,-212,2857,451,2858,997,1
20150106.135822,2857,12,1410156,-10,2857,457,2858,997,1
20150106.135823,2857,8,1410164,-2,2857,583,2858,997,1
20150106.135825,2857,4,1410168,0,2857,584,2858,989,1
20150106.135826,2857,64,1410232,-64,2857,552,2858,988,1
20150106.135826,2857,2,1410234,0,2857,551,2858,987,1
20150106.135828,2857,4,1410238,0,2857,580,2858,988,1
20150106.135828,2857,2,1410240,-2,2857,579,2858,1488,1
20150106.13583,2857,6,1410246,-4,2857,575,2858,1488,1
20150106.135831,2857,2,1410248,-2,2857,574,2858,1482,1
20150106.135833,2857,2,1410250,0,2857,573,2858,1482,1
20150106.135835,2858,30,1410280,0,2857,575,2858,1468,1
20150106.135835,2857,2,1410282,0,2857,574,2858,1470,0
20150106.135836,2857,8,1410290,-4,2857,571,2858,1469,0
20150106.135836,2858,2,1410292,2,2857,571,2858,1467,1
20150106.135837,2857,10,1410302,0,2857,565,2858,1469,0
20150106.135838,2857,2,1410304,-2,2857,564,2858,1369,0
20150106.13584,2857,2,1410306,-2,2857,565,2858,1379,0
20150106.135844,2858,2,1410308,0,2857,585,2858,1466,1
20150106.135845,2857,32,1410340,0,2857,572,2858,1467,0
20150106.135846,2857,2,1410342,0,2857,573,2858,1467,0
20150106.135848,2857,2,1410344,0,2857,593,2858,1431,0
20150106.135849,2858,2,1410346,0,2857,593,2858,1430,1
20150106.135851,2857,42,1410388,2,2857,577,2858,1440,0
20150106.135852,2858,8,1410396,0,2857,575,2858,1438,1
20150106.135853,2857,2,1410398,0,2857,575,2858,1441,0
20150106.135853,2857,26,1410424,16,2857,572,2858,1430,0
20150106.135855,2858,6,1410430,0,2857,613,2858,1503,1
20150106.135857,2857,2,1410432,0,2857,614,2858,1508,0
20150106.1359,2857,2,1410434,0,2857,613,2858,1508,0
20150106.135901,2858,20,1410454,0,2857,613,2858,1502,1
20150106.135902,2858,26,1410480,0,2857,619,2858,1491,1
20150106.135904,2857,4,1410484,-4,2857,780,2858,1491,0
20150106.135904,2858,2,1410486,2,2857,781,2858,1490,1
20150106.135904,2857,2,1410488,-2,2857,780,2858,1490,0
20150106.135909,2858,2,1410490,2,2857,833,2858,1464,1
20150106.13591,2857,8,1410498,-8,2857,827,2858,1464,0
20150106.13591,2858,10,1410508,-8,2857,827,2858,1460,1
20150106.135911,2857,2,1410510,0,2857,832,2858,1460,0
20150106.135912,2857,2,1410512,0,2857,831,2858,1465,0
20150106.135913,2857,2,1410514,0,2857,831,2858,1467,0
20150106.135913,2857,4,1410518,-2,2857,830,2858,1466,0
20150106.135914,2857,10,1410528,0,2857,825,2858,1467,0
20150106.135918,2858,32,1410560,-10,2857,813,2858,1463,1
20150106.135918,2858,8,1410568,0,2857,813,2858,1459,1
20150106.135921,2857,2,1410570,0,2857,810,2858,1531,0
20150106.135922,2857,6,1410576,0,2857,807,2858,1518,0
20150106.135923,2858,100,1410676,0,2857,807,2858,1468,1
20150106.135924,2857,2,1410678,-2,2857,806,2858,1468,0
20150106.135924,2857,10,1410688,0,2857,801,2858,1468,0
20150106.135925,2857,2,1410690,0,2857,800,2858,1475,0
20150106.135925,2857,2,1410692,0,2857,799,2858,1475,0
20150106.135928,2857,10,1410702,0,2857,798,2858,1486,0
20150106.135929,2858,2,1410704,-2,2857,798,2858,1485,1
20150106.135929,2857,408,1411112,-2,2857,597,2858,1487,0
20150106.13593,2857,48,1411160,0,2857,572,2858,1495,0
20150106.135931,2857,2,1411162,0,2857,571,2858,1495,0
20150106.135931,2857,10,1411172,-6,2857,567,2858,1494,0
20150106.135932,2857,4,1411176,0,2857,565,2858,1495,0
20150106.135933,2857,4,1411180,0,2857,564,2858,1494,0
20150106.135934,2857,12,1411192,0,2857,534,2858,1496,0
20150106.135934,2857,4,1411196,-4,2857,520,2858,1497,0
20150106.135935,2857,2,1411198,0,2857,520,2858,1497,0
20150106.135936,2857,2,1411200,0,2857,526,2858,1498,0
20150106.135936,2857,2,1411202,0,2857,525,2858,1498,0
20150106.135938,2858,2,1411204,-2,2857,525,2858,1497,1
20150106.135939,2857,12,1411216,-10,2857,520,2858,1496,0
20150106.13594,2858,2,1411218,-2,2857,520,2858,1495,1
20150106.13594,2857,2,1411220,-2,2857,519,2858,1495,0
20150106.135941,2857,40,1411260,0,2857,499,2858,1495,0
20150106.135941,2858,20,1411280,-20,2857,499,2858,1485,1
20150106.135941,2857,24,1411304,-24,2857,487,2858,1489,0
20150106.135942,2858,2,1411306,-2,2857,487,2858,1488,1
20150106.135943,2857,2,1411308,-2,2857,486,2858,1488,0
20150106.135943,2857,2,1411310,0,2857,485,2858,1488,0
20150106.135944,2857,62,1411372,-62,2857,484,2858,1458,0
20150106.135945,2857,20,1411392,0,2857,474,2858,1458,0
20150106.135945,2858,2,1411394,0,2857,483,2858,1457,1
20150106.135946,2858,26,1411420,-12,2857,477,2858,1451,1
20150106.135947,2857,2,1411422,0,2857,481,2858,1452,0
20150106.135947,2857,20,1411442,-20,2857,472,2858,1452,0
20150106.135953,2857,2,1411444,-2,2857,478,2858,1502,0
20150106.135954,2857,6,1411450,-6,2857,475,2858,1503,0
20150106.135955,2858,2,1411452,0,2857,475,2858,1502,1
20150106.135959,2857,2,1411454,-2,2857,545,2858,1541,0
20150106.14,2857,10,1411464,-6,2857,541,2858,1537,0
20150106.140002,2857,2,1411466,0,2857,542,2858,1536,0
20150106.140003,2858,102,1411568,-14,2857,545,2858,1495,1
20150106.140005,2857,524,1412092,112,2857,291,2858,1494,0
20150106.140005,2857,172,1412264,12,2857,209,2858,1481,0
20150106.140005,2857,20,1412284,20,2857,199,2858,1481,0
20150106.140006,2857,400,1412684,-204,2856,441,2857,52,0
20150106.140006,2857,2,1412686,-2,2856,397,2857,78,0
20150106.140007,2856,10,1412696,-8,2856,393,2857,209,0
20150106.140008,2857,18,1412714,-6,2856,420,2857,298,1
20150106.140009,2856,4,1412718,-2,2856,419,2857,297,0
20150106.140009,2857,6,1412724,-6,2856,419,2857,296,1
20150106.14001,2857,6,1412730,-6,2856,419,2857,293,1
20150106.14001,2857,8,1412738,-6,2856,419,2857,287,1
20150106.140011,2857,2,1412740,0,2856,425,2857,284,1
20150106.140012,2856,16,1412756,0,2856,417,2857,295,0
20150106.140012,2857,12,1412768,-12,2856,417,2857,290,1
20150106.140014,2857,8,1412776,2,2856,391,2857,345,1
20150106.140016,2857,2,1412778,0,2856,391,2857,343,1
20150106.140016,2856,4,1412782,2,2856,390,2857,345,0
20150106.140019,2856,2,1412784,2,2856,409,2857,391,0
20150106.140021,2857,2,1412786,0,2856,409,2857,404,1
20150106.140026,2856,2,1412788,0,2856,411,2857,416,0
20150106.140032,2857,2,1412790,-2,2856,433,2857,429,1
20150106.140033,2856,2,1412792,0,2856,438,2857,439,0
20150106.140035,2857,2,1412794,0,2856,552,2857,440,1
20150106.140038,2856,2,1412796,2,2856,557,2857,442,0
20150106.140039,2856,2,1412798,0,2856,556,2857,442,0
20150106.140039,2857,2,1412800,0,2856,556,2857,441,1
20150106.140042,2856,2,1412802,0,2856,555,2857,418,0
20150106.140043,2857,10,1412812,0,2856,555,2857,413,1
20150106.140044,2857,22,1412834,2,2856,554,2857,412,1
20150106.140047,2856,2,1412836,0,2856,553,2857,423,0
20150106.140048,2856,20,1412856,18,2856,543,2857,428,0
20150106.140049,2857,2,1412858,0,2856,573,2857,427,1
20150106.140052,2857,6,1412864,0,2856,573,2857,427,1
20150106.140054,2856,2,1412866,0,2856,573,2857,453,0
20150106.140056,2856,2,1412868,0,2856,577,2857,459,0
20150106.140056,2856,2,1412870,0,2856,576,2857,459,0
20150106.140101,2857,60,1412930,-44,2856,581,2857,434,1
20150106.140102,2856,2,1412932,0,2856,582,2857,435,0
20150106.140103,2856,2,1412934,0,2856,577,2857,669,0
20150106.140104,2856,2,1412936,0,2856,546,2857,671,0
20150106.140105,2857,4,1412940,-2,2856,545,2857,670,1
20150106.140106,2856,2,1412942,-2,2856,544,2857,675,0
20150106.140107,2857,2,1412944,2,2856,544,2857,673,1
20150106.140108,2857,2,1412946,0,2856,544,2857,672,1
20150106.14011,2856,8,1412954,0,2856,538,2857,690,0
20150106.140111,2857,2,1412956,0,2856,533,2857,689,1
20150106.140115,2857,10,1412966,10,2856,533,2857,708,1
20150106.140118,2857,10,1412976,0,2856,532,2857,704,1
20150106.140118,2856,42,1413018,-20,2856,523,2857,705,0
20150106.14012,2856,4,1413022,2,2856,521,2857,711,0
20150106.140121,2857,16,1413038,2,2856,522,2857,705,1
20150106.140125,2856,52,1413090,46,2856,496,2857,711,0
20150106.140127,2856,4,1413094,4,2856,536,2857,713,0
20150106.140128,2856,4,1413098,0,2856,535,2857,712,0
20150106.140132,2856,2,1413100,0,2856,532,2857,701,0
20150106.140135,2856,2,1413102,2,2856,531,2857,712,0
20150106.140137,2856,6,1413108,6,2856,528,2857,709,0
20150106.14014,2856,2,1413110,2,2856,497,2857,1237,0
20150106.140142,2857,2,1413112,0,2856,500,2857,1278,1
20150106.140144,2856,2,1413114,0,2856,497,2857,1290,0
20150106.140144,2856,40,1413154,0,2856,477,2857,1290,0
20150106.140145,2856,4,1413158,2,2856,475,2857,1291,0
20150106.140147,2856,4,1413162,4,2856,479,2857,1295,0
20150106.140147,2857,2,1413164,2,2856,479,2857,1294,1
20150106.140147,2856,4,1413168,4,2856,477,2857,1294,0
20150106.140148,2856,10,1413178,4,2856,472,2857,1294,0
20150106.14015,2856,8,1413186,-8,2856,468,2857,1294,0
20150106.140151,2856,18,1413204,-18,2856,459,2857,1286,0
20150106.140152,2856,6,1413210,-6,2856,456,2857,1286,0
20150106.140155,2856,2,1413212,0,2856,442,2857,1294,0
20150106.140156,2856,2,1413214,2,2856,440,2857,1293,0
20150106.140157,2857,2,1413216,2,2856,439,2857,1292,1
20150106.140158,2856,6,1413222,0,2856,436,2857,1293,0
20150106.140202,2856,2,1413224,2,2856,429,2857,1295,0
20150106.140203,2856,4,1413228,2,2856,427,2857,1295,0
20150106.140204,2857,4,1413232,0,2856,427,2857,1293,1
20150106.140205,2856,8,1413240,-6,2856,423,2857,1293,0
20150106.140206,2856,6,1413246,4,2856,420,2857,1293,0
20150106.140211,2856,2,1413248,2,2856,426,2857,1303,0
20150106.140211,2857,2,1413250,0,2856,427,2857,1302,1
20150106.140213,2856,2,1413252,0,2856,426,2857,1302,0
20150106.140215,2857,4,1413256,0,2856,426,2857,1301,1
20150106.140216,2856,2,1413258,2,2856,426,2857,1301,0
20150106.140226,2856,6,1413264,0,2856,422,2857,1322,0
20150106.140227,2856,2,1413266,-2,2856,421,2857,1321,0
20150106.140228,2856,12,1413278,-10,2856,415,2857,1322,0
20150106.14023,2856,2,1413280,0,2856,415,2857,1322,0
20150106.140231,2856,2,1413282,-2,2856,414,2857,1322,0
20150106.140232,2856,4,1413286,-2,2856,412,2857,1322,0
20150106.140238,2856,2,1413288,0,2856,417,2857,1321,0
20150106.14024,2856,2,1413290,-2,2856,416,2857,1322,0
20150106.140241,2856,2,1413292,0,2856,416,2857,1323,0
20150106.140243,2857,2,1413294,0,2856,415,2857,1324,1
20150106.140243,2856,14,1413308,0,2856,414,2857,1318,0
20150106.140245,2856,4,1413312,-4,2856,413,2857,1318,0
20150106.140247,2856,10,1413322,0,2856,408,2857,1315,0
20150106.140247,2856,6,1413328,-6,2856,407,2857,1315,0
20150106.14025,2856,4,1413332,-4,2856,403,2857,1315,0
20150106.140252,2856,24,1413356,0,2856,392,2857,1315,0
20150106.140252,2857,2,1413358,2,2856,392,2857,1314,1
20150106.140253,2856,202,1413560,2,2856,292,2857,1313,0
20150106.140254,2856,6,1413566,-6,2856,290,2857,1316,0
20150106.140255,2856,20,1413586,-12,2856,278,2857,1317,0
20150106.140256,2856,8,1413594,0,2856,274,2857,1317,0
20150106.140256,2856,26,1413620,4,2856,261,2857,1317,0
20150106.140257,2856,4,1413624,-4,2856,259,2857,1330,0
20150106.140258,2856,12,1413636,0,2856,255,2857,1328,0
20150106.140259,2856,2,1413638,-2,2856,254,2857,1328,0
20150106.1403,2856,10,1413648,-6,2856,249,2857,1332,0
20150106.140301,2856,8,1413656,-8,2856,274,2857,1332,0
20150106.140302,2856,2,1413658,0,2856,273,2857,1333,0
20150106.140303,2856,40,1413698,32,2856,252,2857,1333,0
20150106.140306,2856,12,1413710,0,2856,244,2857,1333,0
20150106.140307,2856,22,1413732,-22,2856,235,2857,1333,0
20150106.140308,2856,4,1413736,-4,2856,233,2857,1333,0
20150106.140308,2856,42,1413778,-42,2856,211,2857,1333,0
20150106.140309,2856,62,1413840,-62,2856,180,2857,1333,0
20150106.140309,2856,364,1414204,138,2855,433,2856,67,0
20150106.140311,2855,202,1414406,-58,2855,334,2856,121,0
20150106.140312,2856,8,1414414,-2,2855,369,2856,125,1
20150106.140313,2856,4,1414418,-4,2855,373,2856,123,1
20150106.140314,2856,288,1414706,-156,2856,156,2857,1119,1
20150106.140315,2856,2,1414708,0,2856,160,2857,1119,1
20150106.140316,2856,6,1414714,-2,2856,157,2857,1119,1
20150106.140316,2856,4,1414718,-2,2856,155,2857,1119,1
20150106.140317,2856,60,1414778,-60,2856,125,2857,1119,1
20150106.140318,2856,252,1415030,-144,2855,546,2856,387,1
20150106.140318,2856,2,1415032,-2,2855,375,2856,440,1
20150106.14032,2855,12,1415044,2,2855,373,2856,418,0
20150106.140321,2856,2,1415046,0,2855,386,2856,419,1
20150106.140324,2856,10,1415056,-10,2855,386,2856,411,1
20150106.140324,2856,200,1415256,-200,2855,386,2856,312,1
20150106.140326,2856,2,1415258,0,2855,388,2856,313,1
20150106.14033,2855,2,1415260,0,2855,391,2856,317,0
20150106.140331,2856,22,1415282,0,2855,392,2856,308,1
20150106.140333,2856,60,1415342,0,2855,394,2856,278,1
20150106.140335,2856,20,1415362,-20,2855,394,2856,269,1
20150106.140336,2856,10,1415372,-10,2855,394,2856,264,1
20150106.14034,2856,2,1415374,-2,2855,397,2856,264,1
20150106.14034,2855,2,1415376,-2,2855,296,2856,264,0
20150106.140345,2856,2,1415378,0,2855,310,2856,270,1
20150106.140346,2855,4,1415382,0,2855,308,2856,281,0
20150106.140349,2855,2,1415384,0,2855,320,2856,291,0
20150106.14035,2855,2,1415386,-2,2855,319,2856,292,0
20150106.140351,2855,4,1415390,-4,2855,318,2856,303,0
20150106.140357,2855,2,1415392,0,2855,289,2856,350,0
20150106.140405,2856,2,1415394,-2,2855,291,2856,361,1
20150106.140406,2855,12,1415406,0,2855,285,2856,365,0
20150106.140408,2855,2,1415408,0,2855,281,2856,364,0
20150106.140408,2855,20,1415428,-18,2855,271,2856,372,0
20150106.140411,2856,100,1415528,0,2855,270,2856,328,1
20150106.140412,2855,2,1415530,2,2855,269,2856,328,0
20150106.140414,2855,252,1415782,-188,2855,169,2856,328,0
20150106.140415,2855,12,1415794,-12,2855,202,2856,331,0
20150106.140416,2855,34,1415828,-24,2855,187,2856,329,0
20150106.140416,2855,2,1415830,-2,2855,186,2856,331,0
20150106.140417,2855,2,1415832,0,2855,185,2856,369,0
20150106.140418,2855,2,1415834,0,2855,184,2856,370,0
20150106.140418,2855,6,1415840,-6,2855,181,2856,370,0
20150106.140419,2855,12,1415852,-12,2855,175,2856,404,0
20150106.14042,2855,8,1415860,0,2855,174,2856,403,0
20150106.140421,2855,2,1415862,0,2855,198,2856,400,0
20150106.140421,2855,2,1415864,-2,2855,197,2856,403,0
20150106.140424,2856,14,1415878,-14,2855,205,2856,368,1
20150106.140427,2855,2,1415880,-2,2855,206,2856,369,0
20150106.140433,2855,472,1416352,140,2855,1,2856,409,0
20150106.140433,2855,6,1416358,0,2855,1,2856,521,0
20150106.140434,2855,2,1416360,0,2855,4,2856,500,0
20150106.140434,2856,10,1416370,-4,2854,701,2855,2,1
20150106.140435,2855,8,1416378,-2,2855,2,2856,538,0
20150106.140436,2855,16,1416394,10,2855,68,2856,423,0
20150106.140436,2855,2,1416396,2,2855,67,2856,414,0
20150106.140436,2855,2,1416398,2,2855,93,2856,414,0
20150106.140437,2855,2,1416400,2,2855,92,2856,414,0
20150106.140439,2855,42,1416442,0,2855,73,2856,425,0
20150106.140441,2855,4,1416446,0,2855,72,2856,426,0
20150106.140441,2855,24,1416470,14,2855,60,2856,426,0
20150106.140443,2855,2,1416472,0,2855,59,2856,431,0
20150106.140443,2855,2,1416474,0,2855,58,2856,431,0
20150106.140444,2855,2,1416476,0,2855,57,2856,430,0
20150106.140444,2855,62,1416538,52,2855,26,2856,430,0
20150106.140445,2855,4,1416542,-2,2855,25,2856,430,0
20150106.140446,2855,42,1416584,-40,2855,4,2856,431,0
20150106.140446,2855,2,1416586,2,2855,3,2856,431,0
20150106.140447,2855,2,1416588,0,2855,3,2856,431,0
20150106.140447,2855,14,1416602,10,2855,4,2856,431,0
20150106.140449,2856,2,1416604,-2,2855,5,2856,428,1
20150106.14045,2855,4,1416608,4,2855,62,2856,429,0
20150106.140451,2855,2,1416610,0,2855,61,2856,439,0
20150106.140451,2856,2,1416612,0,2855,61,2856,431,1
20150106.140452,2856,26,1416638,-26,2855,62,2856,418,1
20150106.140454,2855,34,1416672,-32,2855,48,2856,433,0
20150106.140455,2856,12,1416684,-4,2855,48,2856,432,1
20150106.140458,2856,2,1416686,-2,2855,51,2856,430,1
20150106.1405,2855,12,1416698,8,2855,44,2856,439,0
20150106.140501,2856,180,1416878,-180,2855,44,2856,349,1
20150106.140501,2856,10,1416888,0,2855,54,2856,355,1
20150106.140502,2856,2,1416890,0,2855,70,2856,364,1
20150106.140504,2855,18,1416908,0,2855,62,2856,374,0
20150106.140505,2856,2,1416910,0,2855,63,2856,373,1
20150106.140505,2855,8,1416918,4,2855,61,2856,372,0
20150106.140509,2856,10,1416928,0,2855,68,2856,366,1
20150106.140509,2856,2,1416930,-2,2855,71,2856,366,1
20150106.14051,2855,12,1416942,0,2855,65,2856,364,0
20150106.140511,2855,2,1416944,2,2855,64,2856,366,0
20150106.140513,2855,2,1416946,0,2855,73,2856,368,0
20150106.140515,2855,18,1416964,-12,2855,64,2856,368,0
20150106.140517,2855,40,1417004,-18,2855,47,2856,368,0
20150106.140519,2855,40,1417044,-32,2855,32,2856,369,0
20150106.140519,2855,248,1417292,-118,2854,688,2855,19,0
20150106.14052,2855,38,1417330,-36,2855,34,2856,476,0
20150106.14052,2855,6,1417336,2,2855,81,2856,360,0
20150106.140522,2855,6,1417342,4,2855,84,2856,342,0
20150106.140522,2855,22,1417364,2,2855,86,2856,342,0
20150106.140524,2855,2,1417366,2,2855,85,2856,342,0
20150106.140525,2855,20,1417386,0,2855,75,2856,342,0
20150106.140525,2855,254,1417640,-34,2855,21,2856,690,0
20150106.140525,2855,76,1417716,-36,2854,617,2855,48,0
20150106.140526,2855,158,1417874,-156,2854,617,2855,4,0
20150106.140526,2854,24,1417898,-16,2854,616,2856,393,0
20150106.140527,2855,42,1417940,-22,2854,616,2855,2,1
20150106.140528,2854,76,1418016,-66,2854,582,2856,391,0
20150106.140528,2855,2,1418018,0,2854,582,2856,392,1
20150106.140529,2854,2,1418020,-2,2854,582,2856,391,0
20150106.140529,2854,2,1418022,-2,2854,581,2856,391,0
20150106.14053,2854,4,1418026,-2,2854,579,2855,73,0
20150106.140531,2855,90,1418116,-88,2854,548,2856,686,1
20150106.140532,2855,4,1418120,-4,2855,11,2856,686,1
20150106.140532,2855,24,1418144,0,2854,598,2856,415,1
20150106.140534,2855,40,1418184,-36,2854,578,2856,415,1
20150106.140534,2855,2,1418186,0,2855,5,2856,657,1
20150106.140535,2854,14,1418200,-6,2854,637,2856,415,0
20150106.140536,2855,58,1418258,-14,2854,587,2855,16,1
20150106.140537,2855,32,1418290,2,2855,68,2856,577,1
20150106.140537,2855,4,1418294,2,2855,66,2856,611,1
20150106.140538,2855,30,1418324,0,2855,51,2856,581,1
20150106.140539,2855,6,1418330,0,2855,50,2856,581,1
20150106.140539,2855,2,1418332,0,2855,49,2856,581,1
20150106.14054,2856,8,1418340,0,2855,47,2856,580,1
20150106.14054,2856,68,1418408,58,2855,215,2856,578,1
20150106.140541,2855,8,1418416,8,2855,240,2856,578,0
20150106.140541,2855,10,1418426,10,2855,238,2856,583,0
20150106.140542,2855,8,1418434,0,2855,234,2856,579,0
20150106.140544,2855,2,1418436,0,2855,234,2856,648,0
20150106.140548,2855,2,1418438,0,2855,243,2856,649,0
20150106.140549,2855,20,1418458,-20,2855,235,2856,649,0
20150106.140549,2855,4,1418462,0,2855,227,2856,655,0
20150106.14055,2855,4,1418466,-2,2855,225,2856,654,0
20150106.140552,2855,2,1418468,0,2855,224,2856,654,0
20150106.140556,2855,50,1418518,-50,2855,220,2856,1166,0
20150106.140556,2856,4,1418522,2,2855,219,2856,1164,1
20150106.140557,2856,2,1418524,0,2855,216,2856,1163,1
20150106.140558,2855,4,1418528,-2,2855,214,2856,1164,0
20150106.140558,2855,58,1418586,0,2855,185,2856,1164,0
20150106.140601,2855,2,1418588,-2,2855,189,2856,1164,0
20150106.140602,2855,10,1418598,0,2855,184,2856,1167,0
20150106.140603,2856,280,1418878,-98,2855,167,2856,1117,1
20150106.140603,2855,4,1418882,-4,2855,165,2856,1114,0
20150106.140604,2855,106,1418988,-6,2855,162,2856,1064,0
20150106.140605,2855,8,1418996,-8,2855,158,2856,1063,0
20150106.140607,2855,2,1418998,-2,2855,158,2856,1062,0
20150106.140608,2856,4,1419002,0,2855,158,2856,1061,1
20150106.14061,2855,2,1419004,0,2855,157,2856,1061,0
20150106.140611,2856,100,1419104,-54,2855,160,2856,1011,1
20150106.140612,2855,12,1419116,0,2855,154,2856,1011,0
20150106.140613,2855,18,1419134,-2,2855,646,2856,1011,0
20150106.140614,2855,2,1419136,0,2855,646,2856,1014,0
20150106.140614,2855,6,1419142,-6,2855,643,2856,1011,0
20150106.140615,2856,130,1419272,86,2855,644,2856,946,1
20150106.140616,2856,2,1419274,2,2855,689,2856,915,1
20150106.140617,2856,2,1419276,0,2855,697,2856,914,1
20150106.140618,2856,4,1419280,2,2855,697,2856,912,1
20150106.140619,2856,100,1419380,-56,2855,697,2856,862,1
20150106.14062,2855,2,1419382,-2,2855,696,2856,862,0
20150106.140621,2856,60,1419442,-58,2855,696,2856,833,1
20150106.140622,2855,4,1419446,-4,2855,697,2856,833,0
20150106.140623,2856,38,1419484,-38,2855,697,2856,814,1
20150106.140624,2856,200,1419684,-54,2855,698,2856,714,1
20150106.140624,2856,4,1419688,2,2855,698,2856,712,1
20150106.140625,2856,6,1419694,4,2855,700,2856,710,1
20150106.140626,2856,134,1419828,-10,2855,700,2856,643,1
20150106.140626,2856,4,1419832,-2,2855,700,2856,641,1
20150106.140627,2856,20,1419852,-10,2855,701,2856,631,1
20150106.140627,2856,8,1419860,0,2855,700,2856,627,1
20150106.140628,2856,2,1419862,2,2855,701,2856,627,1
20150106.140629,2856,4,1419866,0,2855,702,2856,625,1
20150106.140631,2856,18,1419884,18,2855,724,2856,616,1
20150106.140633,2856,92,1419976,-84,2855,738,2857,523,1
20150106.140634,2856,36,1420012,0,2855,738,2857,523,1
20150106.140635,2856,14,1420026,-2,2855,732,2857,523,1
20150106.140635,2856,20,1420046,-20,2855,732,2857,523,1
20150106.140636,2856,4,1420050,0,2855,732,2857,523,1
20150106.140637,2856,2,1420052,0,2855,782,2857,522,1
20150106.14064,2855,2,1420054,0,2855,783,2857,533,0
20150106.140641,2856,100,1420154,0,2855,783,2856,558,1
20150106.140642,2856,16,1420170,0,2855,788,2856,552,1
20150106.140643,2856,2,1420172,0,2855,788,2856,551,1
20150106.140644,2856,4,1420176,-4,2855,788,2856,549,1
20150106.140645,2856,2,1420178,0,2855,788,2856,548,1
20150106.140649,2855,2,1420180,0,2855,789,2856,549,0
20150106.140649,2855,2,1420182,0,2855,788,2856,550,0
20150106.14065,2855,2,1420184,0,2855,787,2856,550,0
20150106.140652,2856,4,1420188,0,2855,786,2856,549,1
20150106.140654,2855,2,1420190,0,2855,770,2856,1017,0
20150106.140655,2855,2,1420192,0,2855,794,2856,1080,0
20150106.140657,2855,2,1420194,0,2855,794,2856,1080,0
20150106.140658,2856,2,1420196,-2,2855,795,2856,1077,1
20150106.140658,2855,2,1420198,0,2855,793,2856,1082,0
20150106.140701,2856,8,1420206,-8,2855,796,2856,1078,1
20150106.140702,2855,20,1420226,0,2855,786,2856,1073,0
20150106.140704,2856,12,1420238,-12,2855,788,2856,1069,1
20150106.140704,2856,44,1420282,0,2855,789,2856,1047,1
20150106.140705,2855,2,1420284,0,2855,788,2856,1048,0
20150106.140707,2856,24,1420308,-24,2855,789,2856,975,1
20150106.140707,2855,102,1420410,-62,2855,768,2856,974,0
20150106.140708,2855,248,1420658,-62,2855,644,2856,974,0
20150106.140708,2856,10,1420668,0,2855,644,2856,971,1
20150106.140709,2855,272,1420940,-8,2855,512,2856,839,0
20150106.14071,2856,110,1421050,0,2855,430,2856,840,1
20150106.14071,2856,2,1421052,0,2855,437,2856,840,1
20150106.140711,2855,100,1421152,0,2855,386,2856,840,0
20150106.140711,2855,782,1421934,-192,2854,655,2855,138,0
20150106.140712,2855,280,1422214,-274,2854,606,2856,464,0
20150106.140715,2855,18,1422232,0,2854,606,2855,435,0
20150106.140716,2855,34,1422266,-30,2854,604,2855,699,0
20150106.140718,2854,4,1422270,-2,2854,603,2855,711,0
20150106.140721,2854,6,1422276,0,2854,600,2855,713,0
20150106.140722,2854,2,1422278,-2,2854,598,2855,713,0
20150106.140727,2854,2,1422280,-2,2854,601,2855,713,0
20150106.140727,2855,2,1422282,0,2854,601,2855,712,1
20150106.140728,2854,2,1422284,-2,2854,600,2855,712,0
20150106.140729,2855,10,1422294,-8,2854,597,2855,709,1
20150106.14073,2854,102,1422396,-2,2854,597,2855,660,0
20150106.140736,2855,2,1422398,0,2854,599,2855,662,1
20150106.140737,2854,14,1422412,0,2854,594,2855,660,0
20150106.140739,2854,4,1422416,0,2854,600,2855,662,0
20150106.14074,2855,12,1422428,2,2854,599,2855,658,1
20150106.14074,2854,4,1422432,-2,2854,597,2855,658,0
20150106.140742,2855,2,1422434,0,2854,611,2855,665,1
20150106.140743,2855,2,1422436,-2,2854,621,2855,664,1
20150106.140745,2854,2,1422438,2,2854,620,2855,664,0
20150106.140747,2854,2,1422440,0,2854,619,2855,665,0
20150106.140749,2855,2,1422442,0,2854,620,2855,667,1
20150106.14075,2855,2,1422444,0,2854,619,2855,666,1
20150106.14075,2855,4,1422448,-4,2854,619,2855,664,1
20150106.140752,2855,2,1422450,-2,2854,618,2855,663,1
20150106.140753,2854,4,1422454,-2,2854,636,2855,665,0
20150106.140755,2855,4,1422458,2,2854,636,2855,311,1
20150106.140756,2855,2,1422460,0,2854,636,2855,310,1
20150106.140756,2855,6,1422466,-2,2854,636,2855,42,1
20150106.140757,2855,2,1422468,-2,2854,634,2855,41,1
20150106.140758,2855,2,1422470,0,2854,634,2855,40,1
20150106.140759,2855,90,1422560,22,2855,58,2856,605,1
20150106.140759,2855,2,1422562,0,2855,107,2856,555,1
20150106.140801,2855,14,1422576,10,2855,108,2856,570,1
20150106.140802,2855,212,1422788,200,2854,616,2855,946,1
20150106.140804,2854,2,1422790,-2,2854,586,2855,1002,0
20150106.140806,2855,2,1422792,0,2854,587,2855,1005,1
20150106.140816,2854,2,1422794,0,2854,615,2855,1048,0
20150106.140819,2855,2,1422796,2,2854,618,2855,1057,1
20150106.14082,2855,4,1422800,2,2854,648,2855,122,1
20150106.140821,2854,2,1422802,0,2854,648,2855,92,0
20150106.140823,2855,2,1422804,-2,2854,673,2855,92,1
20150106.140823,2854,38,1422842,10,2854,624,2855,93,0
20150106.140824,2854,4,1422846,0,2854,625,2855,99,0
20150106.140824,2854,2,1422848,0,2854,623,2855,99,0
20150106.140825,2854,4,1422852,-4,2854,632,2855,99,0
20150106.140826,2854,4,1422856,-4,2854,639,2855,98,0
20150106.140826,2855,8,1422864,0,2854,639,2855,94,1
20150106.140827,2855,2,1422866,-2,2854,639,2855,93,1
20150106.140827,2855,2,1422868,0,2854,639,2855,93,1
20150106.140828,2855,2,1422870,-2,2854,639,2855,93,1
20150106.140828,2855,2,1422872,-2,2854,639,2855,92,1
20150106.14083,2855,2,1422874,-2,2854,639,2855,92,1
20150106.140833,2855,2,1422876,0,2854,639,2855,92,1
20150106.140834,2854,2,1422878,0,2854,618,2855,91,0
20150106.140834,2854,28,1422906,0,2854,604,2855,93,0
20150106.140836,2855,4,1422910,0,2854,604,2855,90,1
20150106.140837,2855,4,1422914,0,2854,611,2855,88,1
20150106.140838,2855,18,1422932,-2,2854,600,2855,79,1
20150106.140839,2855,2,1422934,0,2854,600,2855,78,1
20150106.140839,2855,158,1423092,62,2855,56,2856,560,1
20150106.14084,2855,8,1423100,6,2855,49,2856,560,1
20150106.14084,2855,6,1423106,6,2855,48,2856,560,1
20150106.140841,2855,60,1423166,60,2855,18,2856,563,1
20150106.140841,2855,8,1423174,2,2855,14,2856,553,1
20150106.140842,2855,2,1423176,2,2855,33,2856,553,1
20150106.140843,2855,20,1423196,-2,2855,23,2856,543,1
20150106.140843,2855,42,1423238,38,2855,2,2856,528,1
20150106.140844,2856,60,1423298,-54,2855,3,2856,498,1
20150106.140845,2855,22,1423320,-12,2854,658,2855,4,0
20150106.140845,2855,8,1423328,0,2854,597,2856,555,0
20150106.140845,2854,2,1423330,-2,2854,596,2856,555,0
20150106.140847,2855,6,1423336,-2,2854,596,2855,49,1
20150106.140849,2855,98,1423434,2,2855,92,2856,521,1
20150106.140851,2854,1248,1424682,-496,2854,605,2855,2,0
20150106.140851,2855,522,1425204,-350,2855,6,2856,249,1
20150106.140852,2855,46,1425250,-36,2854,370,2856,290,1
20150106.140852,2855,34,1425284,-4,2854,370,2855,6,1
20150106.140853,2855,18,1425302,0,2854,320,2855,71,1
20150106.140853,2855,2,1425304,-2,2854,320,2855,70,1
20150106.140854,2855,40,1425344,-36,2854,337,2855,49,1
20150106.140855,2854,4,1425348,-4,2854,336,2855,38,0
20150106.140855,2855,2,1425350,-2,2854,336,2855,39,1
20150106.140858,2854,2,1425352,0,2854,348,2855,39,0
20150106.1409,2855,556,1425908,-310,2855,200,2856,127,1
20150106.1409,2856,216,1426124,-176,2855,195,2857,468,1
20150106.1409,2856,6,1426130,0,2855,222,2856,100,1
20150106.140901,2856,2,1426132,2,2855,223,2856,105,1
20150106.140906,2856,100,1426232,44,2855,259,2856,64,1
20150106.140907,2856,2,1426234,0,2855,263,2856,69,1
20150106.140909,2856,2,1426236,0,2855,273,2856,68,1
20150106.140909,2856,2,1426238,0,2855,273,2856,67,1
20150106.14091,2856,56,1426294,-2,2855,332,2856,39,1
20150106.140911,2855,6,1426300,-6,2855,330,2856,40,0
20150106.140913,2856,8,1426308,-6,2855,336,2856,57,1
20150106.140914,2856,2,1426310,0,2855,336,2856,56,1
20150106.140914,2856,4,1426314,0,2855,336,2856,55,1
20150106.140915,2856,8,1426322,0,2855,337,2856,584,1
20150106.140916,2856,2,1426324,-2,2855,314,2856,585,1
20150106.140918,2855,40,1426364,-40,2855,296,2856,597,0
20150106.140919,2856,4,1426368,-2,2855,301,2856,596,1
20150106.14092,2856,76,1426444,-26,2855,301,2856,559,1
20150106.140922,2856,16,1426460,0,2855,302,2856,558,1
20150106.140925,2856,22,1426482,18,2855,315,2856,545,1
20150106.140925,2855,6,1426488,-4,2855,312,2856,545,0
20150106.140927,2856,52,1426540,0,2855,313,2856,521,1
20150106.14093,2856,2,1426542,2,2855,310,2856,520,1
20150106.140931,2856,28,1426570,2,2855,310,2856,506,1
20150106.140932,2855,2,1426572,2,2855,309,2856,506,0
20150106.140933,2855,2,1426574,2,2855,308,2856,514,0
20150106.140935,2855,6,1426580,0,2855,310,2856,542,0
20150106.140939,2856,2,1426582,0,2855,269,2856,563,1
20150106.140943,2855,2,1426584,0,2855,275,2856,563,0
20150106.140952,2855,6,1426590,6,2855,288,2856,578,0
20150106.140953,2856,4,1426594,-2,2855,298,2856,576,1
20150106.140955,2855,2,1426596,2,2855,297,2856,576,0
20150106.140957,2855,4,1426600,0,2855,293,2856,577,0
20150106.140957,2855,18,1426618,-12,2855,284,2856,577,0
20150106.140958,2856,2,1426620,0,2855,283,2856,576,1
20150106.140958,2856,4,1426624,0,2855,283,2856,574,1
20150106.140959,2855,2,1426626,2,2855,292,2856,575,0
20150106.141,2855,2,1426628,0,2855,291,2856,575,0
20150106.141002,2855,620,1427248,-360,2854,463,2856,51,0
20150106.141003,2855,18,1427266,-6,2854,463,2856,254,0
20150106.141004,2855,6,1427272,2,2855,1,2856,373,0
20150106.141004,2855,4,1427276,-4,2855,70,2856,355,0
20150106.141006,2856,2,1427278,-2,2855,70,2856,366,1
20150106.141007,2855,6,1427284,-2,2855,73,2856,371,0
20150106.141008,2855,2,1427286,0,2855,78,2856,372,0
20150106.141009,2856,2,1427288,0,2855,78,2856,371,1
20150106.141011,2855,24,1427312,-4,2855,80,2856,376,0
20150106.141015,2856,4,1427316,0,2855,100,2856,377,1
20150106.14102,2855,20,1427336,-20,2855,102,2856,379,0
20150106.141023,2856,2,1427338,2,2855,107,2856,380,1
20150106.141024,2856,2,1427340,0,2855,117,2856,379,1
20150106.141026,2855,2,1427342,-2,2855,116,2856,379,0
20150106.141027,2856,6,1427348,0,2855,117,2856,377,1
20150106.141027,2856,2,1427350,0,2855,133,2856,376,1
20150106.14103,2855,20,1427370,-4,2855,120,2856,377,0
20150106.14103,2856,10,1427380,10,2855,120,2856,372,1
20150106.141033,2855,4,1427384,4,2855,119,2856,373,0
20150106.141035,2855,14,1427398,0,2855,113,2856,366,0
20150106.141042,2855,8,1427406,0,2855,155,2856,356,0
20150106.141046,2855,8,1427414,0,2855,161,2856,354,0
20150106.141047,2855,2,1427416,0,2855,160,2856,354,0
20150106.141052,2855,20,1427436,20,2855,162,2856,358,0
20150106.141052,2856,4,1427440,0,2855,165,2856,356,1
20150106.141053,2855,10,1427450,0,2855,160,2856,356,0
20150106.141057,2856,4,1427454,4,2855,172,2856,356,1
20150106.1411,2856,6,1427460,0,2855,200,2856,364,1
20150106.141102,2856,2,1427462,2,2855,230,2856,363,1
20150106.141105,2856,6,1427468,4,2855,233,2856,460,1
20150106.141112,2855,2,1427470,0,2855,237,2856,506,0
20150106.141113,2856,6,1427476,0,2855,248,2856,491,1
20150106.141116,2856,2,1427478,0,2855,248,2856,491,1
20150106.141117,2856,4,1427482,4,2855,260,2856,489,1
20150106.141121,2856,4,1427486,0,2855,260,2856,487,1
20150106.141121,2856,2,1427488,2,2855,264,2856,486,1
20150106.141125,2856,26,1427514,16,2855,258,2856,503,1
20150106.141126,2856,38,1427552,-2,2855,275,2856,485,1
20150106.141129,2856,4,1427556,0,2855,277,2856,484,1
20150106.14113,2856,2,1427558,0,2855,279,2856,483,1
20150106.141133,2855,330,1427888,-170,2855,132,2856,530,0
20150106.141134,2855,200,1428088,66,2854,509,2855,150,0
20150106.141134,2855,6,1428094,4,2854,462,2855,198,0
20150106.141135,2855,2,1428096,0,2854,462,2855,199,0
20150106.141137,2854,2,1428098,0,2854,461,2855,242,0
20150106.141138,2855,60,1428158,0,2854,462,2855,212,1
20150106.141141,2855,12,1428170,12,2854,462,2855,206,1
20150106.141141,2855,6,1428176,6,2854,463,2855,203,1
20150106.141142,2855,2,1428178,2,2854,463,2855,202,1
20150106.141145,2855,10,1428188,0,2854,465,2855,197,1
20150106.141148,2855,4,1428192,4,2854,466,2855,192,1
20150106.141149,2855,2,1428194,0,2854,466,2855,191,1
20150106.141149,2855,2,1428196,2,2854,466,2855,189,1
20150106.14115,2854,6,1428202,-6,2854,463,2855,189,0
20150106.141151,2854,6,1428208,-6,2854,461,2855,190,0
20150106.141201,2854,202,1428410,-4,2854,458,2855,156,0
20150106.141204,2854,12,1428422,-6,2854,452,2855,157,0
20150106.141206,2855,4,1428426,0,2854,452,2855,172,1
20150106.141208,2854,2,1428428,-2,2854,451,2855,172,0
20150106.141212,2854,2,1428430,0,2854,450,2855,188,0
20150106.141214,2854,2,1428432,-2,2854,450,2855,188,0
20150106.141215,2855,4,1428436,-2,2854,450,2855,186,1
20150106.141216,2854,2,1428438,0,2854,464,2855,187,0
20150106.141217,2854,60,1428498,-46,2854,434,2855,187,0
20150106.141219,2855,2,1428500,0,2854,435,2855,201,1
20150106.141221,2855,4,1428504,-4,2854,435,2855,199,1
20150106.141221,2855,4,1428508,0,2854,435,2855,197,1
20150106.141224,2854,10,1428518,0,2854,430,2855,202,0
20150106.141225,2855,2,1428520,0,2854,429,2855,200,1
20150106.141228,2855,144,1428664,22,2854,906,2855,32,1
20150106.141228,2855,68,1428732,-26,2855,749,2856,269,1
20150106.141229,2855,2,1428734,2,2855,1019,2856,263,1
20150106.141237,2855,2,1428736,2,2855,1029,2856,240,1
20150106.141239,2855,2,1428738,0,2855,1028,2856,266,1
20150106.14124,2856,4,1428742,4,2855,1029,2856,264,1
20150106.141243,2856,6,1428748,0,2855,1030,2856,272,1
20150106.141244,2855,6,1428754,0,2855,1027,2856,269,0
20150106.141248,2856,58,1428812,0,2855,999,2856,266,1
20150106.141251,2856,8,1428820,0,2855,999,2856,266,1
20150106.141252,2856,4,1428824,0,2855,1007,2856,265,1
20150106.141254,2856,42,1428866,0,2855,996,2856,258,1
20150106.141255,2855,4,1428870,-2,2855,995,2856,256,0
20150106.141256,2856,4,1428874,-2,2855,995,2856,257,1
20150106.141257,2855,6,1428880,0,2855,992,2856,254,0
20150106.141259,2856,2,1428882,0,2855,1013,2856,252,1
20150106.1413,2855,8,1428890,0,2855,1012,2856,252,0
20150106.141301,2856,4,1428894,-4,2855,1012,2856,252,1
20150106.141303,2856,4,1428898,0,2855,1013,2856,249,1
20150106.141304,2855,8,1428906,8,2855,1009,2856,251,0
20150106.141304,2856,8,1428914,0,2855,1009,2856,250,1
20150106.141305,2856,2,1428916,-2,2855,1011,2856,249,1
20150106.141305,2856,2,1428918,-2,2855,1011,2856,248,1
20150106.141306,2856,2,1428920,0,2855,1011,2856,247,1
20150106.141307,2856,10,1428930,-10,2855,1011,2856,242,1
20150106.14131,2855,2,1428932,0,2855,598,2856,240,0
20150106.14131,2855,4,1428936,-2,2855,596,2856,240,0
20150106.141311,2855,2,1428938,-2,2855,610,2856,244,0
20150106.141312,2856,2,1428940,0,2855,610,2856,243,1
20150106.141313,2856,4,1428944,-4,2855,610,2856,241,1
20150106.141315,2855,2,1428946,0,2855,610,2856,241,0
20150106.141316,2855,100,1429046,6,2855,561,2856,248,0
20150106.141316,2856,10,1429056,-10,2855,561,2856,243,1
20150106.141317,2856,2,1429058,-2,2855,561,2856,242,1
20150106.141318,2856,2,1429060,-2,2855,561,2856,243,1
20150106.141319,2855,8,1429068,0,2855,557,2856,245,0
20150106.141321,2856,2,1429070,0,2855,557,2856,249,1
20150106.141321,2856,300,1429370,56,2855,899,2856,99,1
20150106.141322,2856,200,1429570,132,2856,231,2857,496,1
20150106.141322,2856,200,1429770,0,2856,168,2857,498,1
20150106.141324,2856,2,1429772,0,2856,174,2857,498,1
20150106.141325,2857,20,1429792,20,2856,175,2857,488,1
20150106.141325,2857,6,1429798,2,2856,174,2857,492,1
20150106.141326,2856,4,1429802,0,2856,172,2857,492,0
20150106.141327,2857,62,1429864,0,2856,172,2857,461,1
20150106.141328,2856,268,1430132,22,2855,691,2856,21,0
20150106.141328,2856,2,1430134,-2,2855,593,2856,93,0
20150106.141329,2856,10,1430144,-8,2855,593,2856,117,0
20150106.14133,2856,20,1430164,0,2855,593,2856,114,0
20150106.141332,2856,48,1430212,-48,2855,593,2856,90,0
20150106.141332,2856,2,1430214,-2,2855,593,2856,89,0
20150106.141333,2856,2,1430216,-2,2855,594,2856,85,0
20150106.141334,2856,6,1430222,-4,2855,594,2856,79,0
20150106.141335,2856,18,1430240,0,2855,595,2856,73,0
20150106.141337,2856,2,1430242,0,2855,595,2856,72,0
20150106.141337,2855,4,1430246,4,2855,593,2856,72,0
20150106.14134,2856,6,1430252,-2,2855,695,2856,66,1
20150106.141344,2856,4,1430256,-2,2855,697,2856,65,1
20150106.141346,2856,10,1430266,-10,2855,699,2856,71,1
20150106.141347,2856,100,1430366,48,2855,699,2856,21,1
20150106.141347,2856,2,1430368,2,2855,700,2856,20,1
20150106.141348,2856,2,1430370,2,2855,700,2856,19,1
20150106.141349,2856,2,1430372,-2,2855,705,2856,19,1
20150106.141349,2856,2,1430374,-2,2855,705,2856,18,1
20150106.141352,2856,10,1430384,-10,2855,810,2856,15,1
20150106.141353,2856,2,1430386,-2,2855,812,2856,16,1
20150106.141357,2856,2,1430388,0,2855,813,2856,31,1
20150106.141358,2856,10,1430398,0,2855,824,2856,30,1
20150106.141401,2855,8,1430406,2,2855,821,2856,30,0
20150106.141402,2856,2,1430408,0,2855,806,2856,360,1
20150106.141404,2856,16,1430424,2,2855,805,2856,352,1
20150106.141408,2856,16,1430440,-2,2855,909,2856,352,1
20150106.141412,2856,4,1430444,0,2855,930,2856,353,1
20150106.141418,2856,2,1430446,0,2855,930,2856,352,1
20150106.14142,2856,2,1430448,-2,2855,930,2856,352,1
20150106.14142,2855,4,1430452,4,2855,928,2856,352,0
20150106.141426,2856,2,1430454,0,2855,932,2856,377,1
20150106.141428,2856,2,1430456,0,2855,932,2856,377,1
20150106.14143,2856,2,1430458,0,2855,912,2856,376,1
20150106.141431,2856,2,1430460,0,2855,912,2856,377,1
20150106.141433,2856,2,1430462,0,2855,912,2856,376,1
20150106.141442,2855,2,1430464,0,2855,914,2856,379,0
20150106.141444,2856,26,1430490,-26,2855,914,2856,366,1
20150106.141445,2855,4,1430494,0,2855,913,2856,367,0
20150106.14145,2856,4,1430498,0,2855,913,2856,371,1
20150106.141452,2855,2,1430500,0,2855,910,2856,375,0
20150106.141455,2856,6,1430506,-6,2855,910,2856,379,1
20150106.141457,2856,20,1430526,-20,2855,910,2856,369,1
20150106.141458,2856,20,1430546,0,2855,910,2856,359,1
20150106.141504,2856,2,1430548,0,2855,1062,2856,365,1
20150106.141506,2856,32,1430580,-32,2855,1062,2856,349,1
20150106.141506,2856,8,1430588,-2,2855,1062,2856,343,1
20150106.141511,2855,2,1430590,0,2855,1062,2856,343,0
20150106.14152,2856,4,1430594,-4,2855,1062,2856,357,1
20150106.141524,2855,2,1430596,0,2855,1061,2856,358,0
20150106.141529,2856,32,1430628,0,2855,1063,2856,344,1
20150106.14153,2856,566,1431194,-440,2855,1062,2856,63,1
20150106.14153,2856,126,1431320,6,2856,114,2857,680,1
20150106.141531,2856,8,1431328,-6,2856,238,2857,679,1
20150106.141532,2856,2,1431330,2,2856,264,2857,679,1
20150106.141533,2856,2,1431332,0,2856,295,2857,679,1
20150106.141535,2856,2,1431334,0,2856,404,2857,678,1
20150106.141536,2856,2,1431336,2,2856,404,2857,678,1
20150106.141536,2856,2,1431338,2,2856,503,2857,678,1
20150106.141537,2856,4,1431342,4,2856,533,2857,648,1
20150106.14154,2857,200,1431542,-82,2856,534,2857,548,1
20150106.141541,2857,202,1431744,-100,2856,546,2857,448,1
20150106.141541,2857,276,1432020,-94,2856,546,2857,308,1
20150106.141542,2856,20,1432040,0,2856,536,2857,308,0
20150106.141542,2857,202,1432242,-110,2856,550,2857,207,1
20150106.141543,2857,208,1432450,-188,2856,532,2857,103,1
20150106.141543,2857,30,1432480,0,2856,532,2857,88,1
20150106.141544,2857,8,1432488,0,2856,532,2857,109,1
20150106.141544,2857,2,1432490,-2,2856,532,2857,108,1
20150106.141545,2857,2,1432492,0,2856,531,2857,147,1
20150106.141546,2857,206,1432698,-146,2856,540,2857,60,1
20150106.141547,2857,206,1432904,-58,2856,607,2857,53,1
20150106.141547,2857,90,1432994,-86,2856,558,2857,50,1
20150106.141548,2857,78,1433072,-68,2856,553,2857,13,1
20150106.141548,2857,12,1433084,-10,2856,549,2857,38,1
20150106.141549,2857,28,1433112,10,2856,549,2857,25,1
20150106.141549,2857,16,1433128,-12,2856,549,2857,20,1
20150106.14155,2857,6,1433134,-2,2856,549,2857,17,1
20150106.14155,2857,116,1433250,-32,2857,50,2858,1031,1
20150106.141551,2857,266,1433516,102,2857,125,2858,1134,1
20150106.141551,2857,252,1433768,128,2856,446,2857,70,1
20150106.141552,2856,76,1433844,-4,2856,359,2857,110,0
20150106.141552,2857,8,1433852,0,2856,358,2857,106,1
20150106.141554,2856,2,1433854,0,2856,357,2857,156,0
20150106.141554,2856,8,1433862,2,2856,356,2857,153,0
20150106.141555,2857,16,1433878,-4,2856,357,2857,145,1
20150106.141556,2856,2,1433880,2,2856,357,2857,149,0
20150106.141557,2857,2,1433882,-2,2856,358,2857,150,1
20150106.141558,2857,2,1433884,0,2856,358,2857,149,1
20150106.141559,2857,10,1433894,-10,2856,359,2857,163,1
20150106.1416,2856,2,1433896,2,2856,358,2857,186,0
20150106.1416,2857,2,1433898,-2,2856,358,2857,185,1
20150106.141601,2857,2,1433900,-2,2856,361,2857,190,1
20150106.141601,2857,2,1433902,0,2856,362,2857,191,1
20150106.141602,2857,2,1433904,-2,2856,362,2857,191,1
20150106.141603,2857,2,1433906,0,2856,369,2857,193,1
20150106.141604,2857,2,1433908,0,2856,377,2857,192,1
20150106.141604,2856,2,1433910,2,2856,376,2857,192,0
20150106.141605,2856,24,1433934,-18,2856,372,2857,183,0
20150106.141605,2857,12,1433946,-2,2856,372,2857,178,1
20150106.141607,2856,4,1433950,-2,2856,422,2857,122,0
20150106.141607,2857,10,1433960,-10,2856,423,2857,114,1
20150106.141608,2856,2,1433962,0,2856,423,2857,147,0
20150106.141609,2857,6,1433968,-6,2856,421,2857,141,1
20150106.141609,2856,2,1433970,-2,2856,419,2857,184,0
20150106.14161,2856,2,1433972,0,2856,421,2857,212,0
20150106.141611,2856,2,1433974,-2,2856,430,2857,214,0
20150106.141611,2856,20,1433994,0,2856,429,2857,214,0
20150106.141615,2856,8,1434002,-6,2856,257,2857,221,0
20150106.141617,2857,4,1434006,-2,2856,259,2857,254,1
20150106.141618,2856,40,1434046,30,2856,267,2857,273,0
20150106.141619,2857,30,1434076,20,2856,267,2857,274,1
20150106.14162,2857,2,1434078,2,2856,268,2857,274,1
20150106.141621,2857,68,1434146,56,2856,317,2857,233,1
20150106.141622,2857,176,1434322,34,2856,342,2857,98,1
20150106.141622,2856,6,1434328,4,2856,340,2857,96,0
20150106.141623,2856,2,1434330,2,2856,339,2857,90,0
20150106.141623,2857,2,1434332,-2,2856,342,2857,89,1
20150106.141625,2856,20,1434352,-16,2856,341,2857,187,0
20150106.141626,2857,2,1434354,-2,2856,341,2857,186,1
20150106.141626,2857,4,1434358,0,2856,341,2857,184,1
20150106.141627,2856,2,1434360,2,2856,342,2857,197,0
20150106.141628,2857,2,1434362,-2,2856,342,2857,197,1
20150106.14163,2857,2,1434364,0,2856,352,2857,198,1
20150106.14163,2856,2,1434366,2,2856,351,2857,199,0
20150106.141631,2857,2,1434368,-2,2856,351,2857,198,1
20150106.141632,2857,6,1434374,-2,2856,352,2857,197,1
20150106.141632,2857,2,1434376,-2,2856,352,2857,196,1
20150106.141636,2856,2,1434378,2,2856,374,2857,198,0
20150106.141637,2857,2,1434380,0,2856,374,2857,197,1
20150106.141638,2856,6,1434386,-4,2856,372,2857,210,0
20150106.141639,2857,4,1434390,-4,2856,373,2857,209,1
20150106.14164,2856,2,1434392,0,2856,374,2857,210,0
20150106.141641,2856,4,1434396,0,2856,376,2857,235,0
20150106.141643,2857,200,1434596,106,2856,376,2857,141,1
20150106.141644,2857,4,1434600,0,2856,377,2857,139,1
20150106.141645,2857,20,1434620,20,2856,377,2857,129,1
20150106.141646,2857,204,1434824,158,2856,377,2857,29,1
20150106.141647,2857,2,1434826,0,2856,377,2857,28,1
20150106.14165,2857,110,1434936,-18,2857,47,2858,1344,1
20150106.14165,2857,8,1434944,-8,2857,44,2858,1344,1
20150106.141651,2857,20,1434964,-14,2857,37,2858,1344,1
20150106.141651,2857,8,1434972,-4,2857,34,2858,1344,1
20150106.141652,2857,2,1434974,0,2857,34,2858,1344,1
20150106.141652,2857,4,1434978,-4,2857,35,2858,1344,1
20150106.141653,2857,6,1434984,-6,2857,32,2858,1344,1
20150106.141653,2857,22,1435006,-12,2857,21,2858,1341,1
20150106.141654,2857,8,1435014,-8,2857,17,2858,1341,1
20150106.141654,2857,6,1435020,-4,2857,14,2858,1341,1
20150106.141655,2857,42,1435062,-2,2856,531,2857,44,1
20150106.141656,2857,14,1435076,-6,2856,433,2857,46,1
20150106.141656,2857,42,1435118,-40,2856,445,2857,31,1
20150106.141657,2857,6,1435124,-6,2856,444,2857,34,1
20150106.141658,2857,20,1435144,0,2856,448,2857,37,1
20150106.141659,2857,4,1435148,0,2856,452,2857,36,1
20150106.141659,2857,4,1435152,0,2856,452,2857,35,1
20150106.1417,2857,4,1435156,0,2856,454,2857,88,1
20150106.141702,2857,2,1435158,0,2856,409,2857,103,1
20150106.141703,2857,2,1435160,0,2856,412,2857,109,1
20150106.141707,2857,392,1435552,-182,2857,158,2858,1369,1
20150106.141708,2857,10,1435562,-4,2857,153,2858,1369,1
20150106.141708,2857,2,1435564,0,2857,159,2858,1371,1
20150106.141709,2858,4,1435568,2,2857,160,2858,1369,1
20150106.141709,2857,24,1435592,-12,2857,158,2858,1365,0
20150106.14171,2858,38,1435630,-30,2857,150,2858,1354,1
20150106.141711,2858,20,1435650,20,2857,150,2858,1345,1
20150106.141711,2857,12,1435662,-2,2857,149,2858,1341,0
20150106.141713,2857,8,1435670,0,2857,148,2858,1344,0
20150106.141713,2858,10,1435680,-8,2857,149,2858,1339,1
20150106.141716,2858,6,1435686,-2,2857,158,2858,1352,1
20150106.141716,2857,30,1435716,-20,2857,143,2858,1352,0
20150106.141717,2857,2,1435718,0,2857,142,2858,1352,0
20150106.141717,2857,10,1435728,0,2857,137,2858,1352,0
20150106.141718,2857,2,1435730,-2,2857,136,2858,1352,0
20150106.141719,2857,14,1435744,-2,2857,129,2858,1354,0
20150106.14172,2857,12,1435756,-2,2857,124,2858,1359,0
20150106.14172,2857,12,1435768,-2,2857,119,2858,1358,0
20150106.141721,2857,4,1435772,0,2857,120,2858,1016,0
20150106.141722,2857,42,1435814,-40,2857,101,2858,1016,0
20150106.141722,2857,2,1435816,-2,2857,101,2858,1016,0
20150106.141723,2858,4,1435820,-4,2857,105,2858,1014,1
20150106.141724,2857,2,1435822,0,2857,264,2858,999,0
20150106.141725,2857,12,1435834,0,2857,259,2858,999,0
20150106.141725,2857,2,1435836,-2,2857,262,2858,998,0
20150106.141726,2858,2,1435838,0,2857,262,2858,1037,1
20150106.141727,2857,10,1435848,-10,2857,260,2858,1028,0
20150106.141728,2857,6,1435854,0,2857,227,2858,1028,0
20150106.141729,2857,2,1435856,0,2857,266,2858,1028,0
20150106.141731,2857,2,1435858,-2,2857,269,2858,1034,0
20150106.141732,2857,12,1435870,10,2857,268,2858,1134,0
20150106.141733,2858,4,1435874,-4,2857,270,2858,1136,1
20150106.141733,2858,2,1435876,-2,2857,270,2858,1135,1
20150106.141734,2857,10,1435886,10,2857,267,2858,1136,0
20150106.141735,2857,10,1435896,10,2857,263,2858,1137,0
20150106.141736,2857,2,1435898,0,2857,263,2858,1137,0
20150106.141737,2857,2,1435900,2,2857,262,2858,1139,0
20150106.141738,2857,14,1435914,6,2857,257,2858,1137,0
20150106.141738,2857,2,1435916,2,2857,256,2858,1138,0
20150106.141739,2858,2,1435918,-2,2857,257,2858,1142,1
20150106.141739,2858,6,1435924,6,2857,258,2858,1140,1
20150106.141742,2858,2,1435926,2,2857,294,2858,1161,1
20150106.141742,2858,6,1435932,0,2857,299,2858,1158,1
20150106.141743,2858,2,1435934,2,2857,299,2858,1156,1
20150106.141743,2858,2,1435936,2,2857,299,2858,1157,1
20150106.141744,2857,4,1435940,4,2857,297,2858,1151,0
20150106.141745,2858,2,1435942,0,2857,296,2858,1150,1
20150106.141745,2858,2,1435944,2,2857,296,2858,1149,1
20150106.141747,2858,6,1435950,4,2857,296,2858,1150,1
20150106.141747,2858,8,1435958,6,2857,299,2858,1147,1
20150106.141748,2858,2,1435960,2,2857,299,2858,1146,1
20150106.141748,2858,2,1435962,2,2857,298,2858,1145,1
20150106.141749,2857,2,1435964,2,2857,297,2858,1144,0
20150106.141749,2858,4,1435968,4,2857,297,2858,1142,1
20150106.14175,2857,8,1435976,6,2857,299,2858,1138,0
20150106.141752,2858,22,1435998,-16,2857,299,2858,1128,1
20150106.141755,2858,8,1436006,4,2857,300,2858,1177,1
20150106.141757,2858,10,1436016,2,2857,300,2858,1168,1
20150106.141757,2857,8,1436024,8,2857,298,2858,1168,0
20150106.141758,2858,10,1436034,4,2857,298,2858,1164,1
20150106.1418,2858,2,1436036,0,2857,296,2858,1094,1
20150106.141801,2858,16,1436052,-6,2857,300,2858,1086,1
20150106.141803,2857,142,1436194,-72,2857,278,2858,1086,0
20150106.141806,2857,2,1436196,0,2857,279,2858,1087,0
20150106.141807,2858,2,1436198,2,2857,279,2858,1087,1
20150106.141808,2857,2,1436200,-2,2857,281,2858,1095,0
20150106.141809,2857,2,1436202,-2,2857,282,2858,1097,0
20150106.14181,2858,2,1436204,0,2857,283,2858,1097,1
20150106.141811,2857,2,1436206,0,2857,283,2858,1097,0
20150106.141813,2857,4,1436210,-2,2857,287,2858,1100,0
20150106.141814,2858,2,1436212,0,2857,292,2858,1099,1
20150106.141818,2857,2,1436214,0,2857,304,2858,1103,0
20150106.141818,2858,4,1436218,0,2857,305,2858,1103,1
20150106.141819,2857,10,1436228,-10,2857,300,2858,1103,0
20150106.14182,2857,4,1436232,-4,2857,298,2858,1108,0
20150106.141821,2858,2,1436234,2,2857,298,2858,1108,1
20150106.141822,2858,2,1436236,2,2857,296,2858,1107,1
20150106.141823,2858,26,1436262,-2,2857,290,2858,1103,1
20150106.141824,2858,2,1436264,2,2857,291,2858,1103,1
20150106.141825,2858,2,1436266,0,2857,293,2858,1102,1
20150106.141826,2858,16,1436282,2,2857,316,2858,1109,1
20150106.141831,2857,6,1436288,-6,2857,319,2858,1113,0
20150106.141832,2857,4,1436292,-4,2857,318,2858,1113,0
20150106.141832,2857,2,1436294,-2,2857,317,2858,1113,0
20150106.141833,2857,2,1436296,-2,2857,315,2858,1113,0
20150106.141836,2858,2,1436298,2,2857,315,2858,1114,1
20150106.141837,2857,2,1436300,-2,2857,319,2858,1113,0
20150106.141838,2858,20,1436320,4,2857,319,2858,1103,1
20150106.141842,2857,2,1436322,0,2857,317,2858,1102,0
20150106.141843,2857,2,1436324,-2,2857,318,2858,1103,0
20150106.141844,2857,6,1436330,-6,2857,315,2858,1109,0
20150106.141845,2858,2,1436332,2,2857,315,2858,1108,1
20150106.141846,2857,2,1436334,-2,2857,314,2858,1109,0
20150106.141849,2857,6,1436340,-6,2857,322,2858,1109,0
20150106.141851,2857,10,1436350,-10,2857,321,2858,1102,0
20150106.141852,2857,2,1436352,0,2857,320,2858,1104,0
20150106.141853,2858,26,1436378,-8,2857,322,2858,1094,1
20150106.141853,2857,10,1436388,0,2857,317,2858,1095,0
20150106.141855,2857,4,1436392,0,2857,355,2858,1096,0
20150106.141856,2858,2,1436394,2,2857,354,2858,1094,1
20150106.1419,2858,4,1436398,0,2857,362,2858,1086,1
20150106.141902,2857,2,1436400,-2,2857,361,2858,1086,0
20150106.141904,2858,2,1436402,2,2857,367,2858,1131,1
20150106.141906,2858,2,1436404,2,2857,367,2858,1131,1
20150106.141907,2858,2,1436406,0,2857,367,2858,1131,1
20150106.141911,2858,8,1436414,-2,2857,350,2858,1130,1
20150106.141913,2858,2,1436416,0,2857,347,2858,1141,1
20150106.141914,2858,4,1436420,0,2857,346,2858,1138,1
20150106.141917,2858,8,1436428,-6,2857,347,2858,1139,1
20150106.141919,2857,2,1436430,0,2857,348,2858,1140,0
20150106.141919,2857,16,1436446,-14,2857,340,2858,1140,0
20150106.141921,2857,10,1436456,2,2857,336,2858,1124,0
20150106.141927,2858,2,1436458,2,2857,345,2858,1131,1
20150106.141929,2857,4,1436462,-2,2857,343,2858,1131,0
20150106.14193,2857,4,1436466,-4,2857,341,2858,1131,0
20150106.141933,2858,44,1436510,-12,2857,342,2858,1110,1
20150106.141933,2857,42,1436552,12,2857,341,2858,1092,0
20150106.141938,2857,4,1436556,-2,2857,455,2858,1098,0
20150106.141939,2857,4,1436560,-4,2857,454,2858,1098,0
20150106.141939,2857,274,1436834,-132,2857,329,2858,1098,0
20150106.14194,2857,2,1436836,0,2857,328,2858,1098,0
20150106.14194,2857,2,1436838,2,2857,327,2858,1099,0
20150106.141941,2858,4,1436842,2,2857,326,2858,1099,1
20150106.141943,2858,2,1436844,-2,2857,327,2858,1117,1
20150106.141945,2857,6,1436850,0,2857,325,2858,1116,0
20150106.141946,2857,4,1436854,4,2857,323,2858,1122,0
20150106.141947,2858,2,1436856,-2,2857,323,2858,1121,1
20150106.141948,2857,2,1436858,0,2857,322,2858,1121,0
20150106.141955,2857,4,1436862,0,2857,336,2858,1120,0
20150106.141956,2858,40,1436902,-10,2857,350,2858,1100,1
20150106.141957,2857,2,1436904,0,2857,349,2858,1100,0
20150106.141959,2858,2,1436906,0,2857,355,2858,1106,1
20150106.142,2857,2,1436908,2,2857,354,2858,1109,0
20150106.142004,2858,22,1436930,-12,2857,357,2858,1103,1
20150106.142006,2858,346,1437276,-204,2857,390,2858,879,1
20150106.142007,2858,2,1437278,-2,2857,433,2858,473,1
20150106.142008,2858,946,1438224,56,2858,148,2859,714,1
20150106.142008,2859,496,1438720,-288,2858,88,2859,605,1
20150106.142009,2859,622,1439342,-136,2858,17,2859,552,1
20150106.14201,2859,132,1439474,-52,2858,45,2859,508,1
20150106.14201,2859,24,1439498,-10,2858,49,2859,502,1
20150106.142011,2859,14,1439512,2,2858,131,2859,434,1
20150106.142011,2859,10,1439522,6,2858,272,2859,411,1
20150106.142012,2858,20,1439542,8,2858,372,2859,376,0
20150106.142012,2859,280,1439822,112,2858,375,2859,236,1
20150106.142013,2859,58,1439880,2,2858,375,2859,205,1
20150106.142013,2859,8,1439888,8,2858,376,2859,201,1
20150106.142014,2859,260,1440148,36,2859,35,2860,1593,1
20150106.142015,2858,100,1440248,-14,2858,522,2860,1596,0
20150106.142015,2859,20,1440268,20,2858,509,2860,1572,1
20150106.142016,2860,6,1440274,4,2858,506,2860,1612,1
20150106.142016,2860,76,1440350,10,2859,1,2860,1586,1
20150106.142017,2860,240,1440590,-18,2859,1,2860,1472,1
20150106.142017,2860,108,1440698,0,2859,114,2860,1468,1
20150106.142018,2860,14,1440712,2,2859,146,2860,1463,1
20150106.142018,2860,4,1440716,0,2859,153,2860,1451,1
20150106.142019,2860,2,1440718,0,2859,170,2860,1454,1
20150106.142019,2859,46,1440764,4,2859,169,2860,1433,0
20150106.14202,2860,6,1440770,2,2859,195,2860,1429,1
20150106.14202,2860,14,1440784,14,2859,211,2860,1421,1
20150106.142021,2860,4,1440788,0,2859,218,2860,1420,1
20150106.142022,2860,14,1440802,2,2859,246,2860,1414,1
20150106.142022,2860,4,1440806,2,2859,245,2860,2416,1
20150106.142022,2859,12,1440818,4,2859,242,2860,4409,0
20150106.142023,2859,734,1441552,-168,2859,171,2860,7286,0
20150106.142024,2859,372,1441924,-214,2859,10,2860,1382,0
20150106.142024,2859,34,1441958,-16,2859,5,2860,1279,0
20150106.142025,2859,218,1442176,-144,2859,37,2860,1276,0
20150106.142025,2859,90,1442266,-62,2858,321,2859,202,0
20150106.142026,2859,2,1442268,2,2858,321,2859,247,0
20150106.142026,2859,4,1442272,4,2858,327,2859,249,0
20150106.142027,2859,4,1442276,4,2858,328,2859,276,0
20150106.142027,2859,204,1442480,198,2858,326,2859,188,0
20150106.142028,2859,376,1442856,198,2859,52,2860,1407,0
20150106.142028,2859,24,1442880,-20,2859,42,2860,1298,0
20150106.142029,2859,90,1442970,-84,2858,353,2859,103,0
20150106.142029,2859,2,1442972,2,2858,353,2859,103,0
20150106.14203,2859,210,1443182,6,2859,57,2860,1405,0
20150106.142031,2859,42,1443224,-2,2859,106,2860,1273,0
20150106.142031,2860,2,1443226,0,2859,114,2860,1272,1
20150106.142032,2859,2,1443228,0,2859,124,2860,1273,0
20150106.142032,2860,2,1443230,-2,2859,126,2860,1274,1
20150106.142033,2859,20,1443250,-20,2859,128,2860,1276,0
20150106.142034,2859,8,1443258,-2,2859,164,2860,1277,0
20150106.142034,2860,4,1443262,-2,2859,165,2860,1322,1
20150106.142035,2859,272,1443534,-180,2858,345,2859,152,0
20150106.142035,2859,204,1443738,0,2858,345,2859,77,0
20150106.142036,2860,214,1443952,-84,2859,78,2860,1566,1
20150106.142036,2859,10,1443962,-10,2859,125,2860,1460,0
20150106.142037,2860,56,1444018,-4,2859,148,2860,1438,1
20150106.142038,2860,6,1444024,-2,2859,178,2860,1457,1
20150106.142038,2859,218,1444242,-16,2859,178,2860,1456,0
20150106.142038,2860,4,1444246,-4,2859,178,2860,1454,1
20150106.142039,2859,22,1444268,-20,2859,200,2860,1446,0
20150106.142039,2860,16,1444284,-10,2859,245,2860,1439,1
20150106.14204,2860,12,1444296,0,2859,248,2860,1445,1
20150106.142041,2860,36,1444332,-30,2859,249,2860,1429,1
20150106.142041,2859,8,1444340,-4,2859,257,2860,1429,0
20150106.142042,2859,4,1444344,0,2859,287,2860,1429,0
20150106.142042,2859,202,1444546,-202,2859,292,2860,1329,0
20150106.142043,2860,8,1444554,-2,2859,337,2860,1325,1
20150106.142044,2860,4,1444558,-2,2859,337,2860,1326,1
20150106.142044,2859,204,1444762,-204,2859,340,2860,1265,0
20150106.142045,2859,2,1444764,2,2859,352,2860,1252,0
20150106.142046,2859,12,1444776,-2,2859,353,2860,1250,0
20150106.142046,2859,12,1444788,0,2859,357,2860,1217,0
20150106.142047,2860,6,1444794,0,2859,360,2860,1214,1
20150106.142047,2860,14,1444808,-2,2859,360,2860,1228,1
20150106.142047,2860,2,1444810,-2,2859,360,2860,1227,1
20150106.142048,2859,16,1444826,0,2859,426,2860,1222,0
20150106.142049,2859,750,1445576,-198,2859,312,2860,911,0
20150106.142049,2860,1442,1447018,-242,2860,19,2861,1050,1
20150106.14205,2860,10,1447028,0,2860,97,2861,967,1
20150106.14205,2861,154,1447182,72,2860,153,2861,896,1
20150106.142051,2861,50,1447232,2,2860,156,2861,861,1
20150106.142051,2861,132,1447364,20,2860,149,2861,804,1
20150106.142052,2861,14,1447378,0,2860,149,2861,807,1
20150106.142052,2861,22,1447400,12,2860,150,2861,808,1
20150106.142053,2861,4,1447404,4,2860,148,2861,806,1
20150106.142053,2861,12,1447416,2,2860,148,2861,803,1
20150106.142054,2860,2,1447418,0,2860,175,2861,843,0
20150106.142054,2861,6,1447424,2,2860,177,2861,837,1
20150106.142055,2861,14,1447438,2,2860,185,2861,829,1
20150106.142055,2860,18,1447456,6,2860,184,2861,826,0
20150106.142056,2860,6,1447462,6,2860,184,2861,829,0
20150106.142056,2860,190,1447652,42,2860,170,2861,739,0
20150106.142057,2861,10,1447662,6,2860,177,2861,764,1
20150106.142058,2861,60,1447722,0,2860,184,2861,723,1
20150106.142058,2860,2,1447724,2,2860,189,2861,707,0
20150106.142059,2861,10,1447734,0,2860,212,2861,717,1
20150106.1421,2861,206,1447940,10,2860,227,2861,616,1
20150106.1421,2861,22,1447962,0,2860,259,2861,608,1
20150106.1421,2860,22,1447984,20,2860,265,2861,607,0
20150106.142102,2861,128,1448112,-20,2860,234,2861,597,1
20150106.142102,2861,6,1448118,6,2860,256,2861,596,1
20150106.142103,2860,50,1448168,8,2860,240,2861,593,0
20150106.142104,2860,64,1448232,-16,2860,265,2861,569,0
20150106.142104,2861,26,1448258,-20,2860,258,2861,564,1
20150106.142105,2861,6,1448264,0,2860,324,2861,586,1
20150106.142105,2861,6,1448270,-6,2860,328,2861,583,1
20150106.142106,2861,2,1448272,0,2860,328,2861,582,1
20150106.142106,2861,36,1448308,-14,2860,318,2861,577,1
20150106.142107,2861,236,1448544,120,2860,215,2861,649,1
20150106.142107,2861,24,1448568,20,2860,213,2861,692,1
20150106.142107,2861,4,1448572,-4,2860,213,2861,691,1
20150106.142108,2861,90,1448662,-44,2860,213,2861,661,1
20150106.142109,2861,2,1448664,2,2860,214,2861,705,1
20150106.142109,2860,24,1448688,-18,2860,209,2861,700,0
20150106.14211,2861,4,1448692,0,2860,209,2861,669,1
20150106.142111,2860,438,1449130,-86,2859,504,2860,283,0
20150106.142111,2860,6,1449136,0,2859,503,2860,356,0
20150106.142112,2860,20,1449156,0,2859,479,2860,377,0
20150106.142112,2860,56,1449212,-2,2859,477,2860,518,0
20150106.142113,2860,22,1449234,-2,2859,411,2860,578,0
20150106.142114,2860,4,1449238,-4,2859,410,2860,576,0
20150106.142114,2860,22,1449260,-16,2859,409,2860,562,0
20150106.142115,2860,2,1449262,0,2859,408,2860,568,0
20150106.142115,2860,2,1449264,-2,2859,408,2860,534,0
20150106.142116,2860,10,1449274,-2,2859,408,2860,597,0
20150106.142116,2860,1210,1450484,580,2860,458,2861,781,0
20150106.142117,2860,82,1450566,-16,2860,54,2861,636,0
20150106.142118,2860,14,1450580,0,2860,94,2861,638,0
20150106.142118,2860,212,1450792,-68,2859,507,2860,65,0
20150106.142119,2860,2,1450794,2,2859,463,2860,65,0
20150106.14212,2860,140,1450934,-58,2860,35,2861,774,0
20150106.14212,2861,2,1450936,-2,2860,90,2861,720,1
20150106.14212,2860,2,1450938,-2,2860,119,2861,754,0
20150106.142122,2861,56,1450994,-50,2860,200,2861,745,1
20150106.142123,2861,236,1451230,-86,2860,200,2861,627,1
20150106.142123,2861,12,1451242,0,2860,202,2861,621,1
20150106.142123,2861,4,1451246,2,2860,198,2861,622,1
20150106.142124,2861,16,1451262,12,2860,196,2861,615,1
20150106.142125,2860,412,1451674,-204,2859,551,2860,446,0
20150106.142125,2860,40,1451714,-26,2859,458,2860,433,0
20150106.142126,2860,94,1451808,20,2859,458,2860,66,0
20150106.142126,2860,156,1451964,82,2859,2458,2860,65,0
20150106.142127,2860,134,1452098,2,2860,1189,2861,630,0
20150106.142127,2860,24,1452122,14,2860,1217,2861,620,0
20150106.142128,2860,212,1452334,204,2860,1115,2861,609,0
20150106.142128,2860,4,1452338,0,2860,1115,2861,620,0
20150106.142129,2860,2,1452340,0,2860,1119,2861,623,0
20150106.14213,2861,8,1452348,2,2860,1117,2861,620,1
20150106.14213,2861,16,1452364,6,2860,1145,2861,613,1
20150106.14213,2860,14,1452378,-2,2860,1139,2861,612,0
20150106.142131,2861,18,1452396,-14,2860,1134,2861,613,1
20150106.142132,2860,10,1452406,-10,2860,1130,2861,573,0
20150106.142132,2860,2,1452408,-2,2860,1129,2861,773,0
20150106.142133,2860,12,1452420,-10,2860,1148,2861,837,0
20150106.142133,2861,14,1452434,0,2860,1150,2861,832,1
20150106.142133,2861,8,1452442,8,2860,1150,2861,828,1
20150106.142134,2861,1708,1454150,-1294,2861,210,2862,868,1
20150106.142135,2860,452,1454602,-402,2860,179,2861,65,0
20150106.142136,2860,64,1454666,-26,2860,206,2861,136,0
20150106.142136,2861,2,1454668,0,2860,210,2861,580,1
20150106.142137,2861,6,1454674,4,2860,255,2861,582,1
20150106.142137,2861,14,1454688,14,2860,255,2861,576,1
20150106.142138,2861,4,1454692,2,2860,255,2861,581,1
20150106.142138,2861,2,1454694,2,2860,255,2861,580,1
20150106.142139,2860,1038,1455732,-298,2860,1758,2861,733,0
20150106.14214,2861,20,1455752,10,2860,5795,2861,559,1
20150106.142141,2861,382,1456134,-288,2860,5803,2861,396,1
20150106.142141,2861,42,1456176,10,2860,84,2861,268,1
20150106.142142,2860,280,1456456,-140,2859,660,2860,2,0
20150106.142143,2860,12,1456468,-8,2860,28,2861,403,0
20150106.142143,2860,90,1456558,-40,2859,657,2860,3,0
20150106.142145,2860,10,1456568,0,2859,457,2860,2,0
20150106.142145,2860,4,1456572,2,2859,487,2860,101,0
20150106.142145,2860,14,1456586,14,2859,487,2860,147,0
20150106.142146,2860,4,1456590,0,2859,513,2860,168,0
20150106.142146,2860,10,1456600,0,2859,513,2860,163,0
20150106.142147,2860,42,1456642,2,2859,514,2860,191,0
20150106.142148,2860,68,1456710,4,2859,485,2860,188,0
20150106.142148,2860,270,1456980,-94,2859,3494,2860,54,0
20150106.142149,2860,110,1457090,34,2860,139,2861,401,0
20150106.142149,2860,8,1457098,6,2860,136,2861,401,0
20150106.14215,2860,284,1457382,-104,2859,5553,2860,382,0
20150106.142151,2860,126,1457508,12,2859,484,2861,425,0
20150106.142152,2861,26,1457534,4,2859,574,2861,595,1
20150106.142154,2860,2,1457536,0,2860,14,2861,552,0
20150106.142155,2860,4,1457540,2,2860,14,2861,553,0
20150106.142155,2860,6,1457546,4,2860,12,2861,553,0
20150106.142156,2860,2,1457548,0,2860,17,2861,654,0
20150106.142157,2860,4,1457552,0,2860,15,2861,728,0
20150106.142157,2861,18,1457570,-14,2860,14,2861,723,1
20150106.142158,2861,2,1457572,0,2860,15,2861,722,1
20150106.142158,2861,4,1457576,-2,2860,14,2861,722,1
20150106.142159,2860,6,1457582,2,2860,14,2861,724,0
20150106.142159,2860,4,1457586,2,2860,15,2861,725,0
20150106.1422,2860,6,1457592,-2,2860,33,2861,747,0
20150106.1422,2860,48,1457640,0,2860,11,2861,750,0
20150106.142201,2860,10,1457650,10,2860,18,2861,750,0
20150106.142201,2860,2,1457652,0,2860,26,2861,752,0
20150106.142202,2860,22,1457674,-14,2860,17,2861,753,0
20150106.142202,2860,14,1457688,-10,2860,11,2861,760,0
20150106.142203,2860,22,1457710,-4,2859,594,2860,2,0
20150106.142203,2860,66,1457776,58,2859,547,2860,20,0
20150106.142204,2860,38,1457814,10,2859,529,2860,8,0
20150106.142204,2860,10,1457824,2,2859,539,2860,3,0
20150106.142205,2860,10,1457834,-2,2860,56,2861,761,0
20150106.142205,2860,10,1457844,0,2860,53,2861,761,0
20150106.142206,2860,24,1457868,0,2860,78,2861,742,0
20150106.142206,2860,2,1457870,0,2860,97,2861,757,0
20150106.142207,2860,6,1457876,0,2860,94,2861,758,0
20150106.142208,2860,8,1457884,0,2860,134,2861,755,0
20150106.142208,2860,8,1457892,-6,2860,130,2861,755,0
20150106.142208,2860,16,1457908,-14,2860,130,2861,748,0
20150106.142209,2860,4,1457912,0,2860,128,2861,748,0
20150106.14221,2860,8,1457920,0,2860,158,2861,758,0
20150106.14221,2860,176,1458096,-114,2860,120,2861,747,0
20150106.142211,2860,2,1458098,2,2860,121,2861,754,0
20150106.142211,2860,2,1458100,0,2860,120,2861,756,0
20150106.142212,2860,2,1458102,2,2860,152,2861,757,0
20150106.142212,2860,6,1458108,6,2860,159,2861,757,0
20150106.142213,2860,12,1458120,0,2860,154,2861,764,0
20150106.142213,2860,18,1458138,4,2860,153,2861,764,0
20150106.142214,2860,2,1458140,2,2860,154,2861,764,0
20150106.142215,2860,22,1458162,2,2860,150,2861,764,0
20150106.142215,2860,2,1458164,2,2860,152,2861,766,0
20150106.142216,2860,26,1458190,-2,2860,143,2861,764,0
20150106.142216,2860,2,1458192,0,2860,142,2861,764,0
20150106.142217,2860,2,1458194,-2,2860,141,2861,764,0
20150106.142217,2860,2,1458196,0,2860,141,2861,764,0
20150106.142218,2860,6,1458202,2,2860,138,2861,765,0
20150106.142219,2860,4,1458206,2,2860,154,2861,761,0
20150106.142219,2861,2,1458208,-2,2860,179,2861,761,1
20150106.142219,2860,12,1458220,10,2860,173,2861,762,0
20150106.142221,2861,50,1458270,-20,2860,173,2861,753,1
20150106.142221,2860,4,1458274,0,2860,172,2861,753,0
20150106.142222,2860,124,1458398,4,2860,114,2861,753,0
20150106.142223,2861,2,1458400,2,2860,115,2861,748,1
20150106.142223,2860,2,1458402,2,2860,114,2861,749,0
20150106.142224,2861,4,1458406,2,2860,115,2861,748,1
20150106.142224,2860,4,1458410,0,2860,148,2861,748,0
20150106.142225,2860,16,1458426,0,2860,140,2861,747,0
20150106.142225,2860,16,1458442,0,2860,145,2861,741,0
20150106.142226,2860,6,1458448,0,2860,143,2861,741,0
20150106.142229,2860,2,1458450,0,2860,188,2861,719,0
20150106.142229,2860,2,1458452,0,2860,188,2861,720,0
20150106.14223,2860,4,1458456,0,2860,186,2861,722,0
20150106.142231,2860,2,1458458,2,2860,185,2861,690,0
20150106.142231,2861,6,1458464,0,2860,186,2861,690,1
20150106.142232,2860,60,1458524,60,2860,155,2861,680,0
20150106.142233,2861,40,1458564,18,2860,192,2861,660,1
20150106.142233,2860,60,1458624,-2,2860,162,2861,664,0
20150106.142233,2861,36,1458660,-8,2860,173,2861,646,1
20150106.142235,2860,26,1458686,2,2860,179,2861,645,0
20150106.142235,2861,46,1458732,2,2860,199,2861,622,1
20150106.142236,2861,2,1458734,0,2860,199,2861,617,1
20150106.142239,2861,6,1458740,2,2860,199,2861,674,1
20150106.14224,2861,2,1458742,2,2860,194,2861,721,1
20150106.142241,2861,4,1458746,4,2860,196,2861,719,1
20150106.142241,2861,138,1458884,72,2860,197,2861,651,1
20150106.142242,2861,20,1458904,0,2860,201,2861,654,1
20150106.142242,2861,4,1458908,4,2860,201,2861,652,1
20150106.142243,2861,16,1458924,16,2860,208,2861,644,1
20150106.142245,2861,84,1459008,-12,2860,411,2861,515,1
20150106.142245,2861,2,1459010,0,2860,411,2861,515,1
20150106.142246,2861,42,1459052,-26,2860,417,2861,491,1
20150106.142247,2861,6,1459058,4,2860,417,2861,488,1
20150106.142247,2861,22,1459080,22,2860,417,2861,477,1
20150106.142248,2861,10,1459090,10,2860,421,2861,474,1
20150106.142249,2861,4,1459094,0,2860,427,2861,475,1
20150106.14225,2861,200,1459294,-18,2860,333,2861,762,1
20150106.14225,2861,4,1459298,0,2860,332,2861,781,1
20150106.142251,2860,2,1459300,2,2860,367,2861,766,0
20150106.142252,2861,394,1459694,-172,2860,371,2861,569,1
20150106.142253,2860,2,1459696,2,2860,367,2861,523,0
20150106.142254,2861,2,1459698,-2,2860,416,2861,523,1
20150106.142254,2860,2,1459700,0,2860,414,2861,520,0
20150106.142255,2861,10,1459710,-4,2860,413,2861,519,1
20150106.142255,2860,4,1459714,4,2860,411,2861,522,0
20150106.142257,2860,2,1459716,0,2860,437,2861,527,0
20150106.142258,2861,4,1459720,2,2860,438,2861,524,1
20150106.142258,2861,416,1460136,-68,2860,493,2861,325,1
20150106.142259,2861,416,1460552,-18,2860,505,2861,47,1
20150106.142259,2861,140,1460692,22,2861,195,2862,963,1
20150106.1423,2862,10,1460702,0,2861,328,2862,821,1
20150106.142301,2861,104,1460806,-38,2861,312,2862,792,0
20150106.142302,2862,14,1460820,-2,2861,320,2862,789,1
20150106.142302,2862,2,1460822,0,2861,320,2862,788,1
20150106.142303,2862,286,1461108,-266,2861,268,2862,657,1
20150106.142304,2862,28,1461136,0,2861,278,2862,646,1
20150106.142304,2861,4,1461140,-4,2861,277,2862,647,0
20150106.142304,2861,10,1461150,-4,2861,281,2862,643,0
20150106.142305,2861,2,1461152,0,2861,316,2862,646,0
20150106.142306,2862,2,1461154,0,2861,316,2862,679,1
20150106.142307,2862,4,1461158,2,2861,324,2862,678,1
20150106.142308,2861,10,1461168,-4,2861,321,2862,679,0
20150106.142309,2862,4,1461172,-2,2861,321,2862,679,1
20150106.142309,2861,14,1461186,4,2861,318,2862,677,0
20150106.14231,2861,48,1461234,-4,2861,294,2862,682,0
20150106.142311,2861,2,1461236,-2,2861,294,2862,685,0
20150106.142311,2862,2,1461238,0,2861,294,2862,684,1
20150106.142312,2862,8,1461246,-2,2861,294,2862,682,1
20150106.142312,2862,4,1461250,0,2861,294,2862,680,1
20150106.142313,2861,26,1461276,-4,2861,281,2862,684,0
20150106.142313,2862,8,1461284,0,2861,281,2862,680,1
20150106.142314,2861,780,1462064,-296,2861,313,2862,280,0
20150106.142314,2861,4,1462068,0,2861,362,2862,279,0
20150106.142315,2862,4,1462072,-2,2861,362,2862,277,1
20150106.142315,2862,204,1462276,50,2861,363,2862,176,1
20150106.142316,2862,14,1462290,-6,2861,370,2862,174,1
20150106.142316,2862,4,1462294,4,2861,370,2862,177,1
20150106.142317,2862,64,1462358,-22,2861,371,2862,527,1
20150106.142317,2862,10,1462368,-2,2861,352,2862,606,1
20150106.142318,2862,4,1462372,2,2861,354,2862,614,1
20150106.142319,2862,2,1462374,-2,2861,354,2862,607,1
20150106.14232,2862,4,1462378,-4,2861,354,2862,644,1
20150106.14232,2862,8,1462386,0,2861,357,2862,640,1
20150106.142321,2861,82,1462468,4,2861,318,2862,622,0
20150106.142322,2862,4,1462472,-2,2861,298,2862,612,1
20150106.142322,2862,10,1462482,-8,2861,295,2862,613,1
20150106.142323,2861,4,1462486,-2,2861,1318,2862,640,0
20150106.142324,2862,26,1462512,-16,2861,4320,2862,631,1
20150106.142324,2862,16,1462528,0,2861,6320,2862,616,1
20150106.142325,2862,8,1462536,-8,2861,6318,2862,724,1
20150106.142326,2862,10,1462546,0,2861,6321,2862,789,1
20150106.142326,2862,8,1462554,-2,2861,6321,2862,784,1
20150106.142327,2862,4,1462558,0,2861,5321,2862,782,1
20150106.142327,2862,78,1462636,-76,2861,4321,2862,743,1
20150106.142328,2862,38,1462674,-30,2861,2257,2862,746,1
20150106.142329,2861,100,1462774,-100,2861,1207,2862,756,0
20150106.142329,2861,28,1462802,-16,2861,1194,2862,759,0
20150106.142329,2861,240,1463042,-134,2861,40,2862,820,0
20150106.14233,2861,2190,1465232,-854,2861,124,2862,189,0
20150106.142331,2862,86,1465318,52,2861,149,2862,195,1
20150106.142331,2861,12,1465330,12,2861,352,2862,315,0
20150106.142332,2861,6,1465336,4,2861,459,2862,325,0
20150106.142333,2861,30,1465366,30,2861,439,2862,324,0
20150106.142334,2861,30,1465396,8,2861,435,2862,368,0
20150106.142335,2862,2,1465398,2,2861,428,2862,423,1
20150106.142335,2862,2,1465400,2,2861,428,2862,430,1
20150106.142336,2862,62,1465462,2,2861,296,2862,432,1
20150106.142337,2861,2,1465464,2,2861,295,2862,436,0
20150106.142337,2861,8,1465472,2,2861,294,2862,433,0
20150106.142338,2861,10,1465482,8,2861,289,2862,443,0
20150106.142338,2861,2,1465484,0,2861,288,2862,445,0
20150106.142339,2861,2,1465486,0,2861,287,2862,447,0
20150106.142339,2862,2,1465488,0,2861,286,2862,475,1
20150106.14234,2862,2,1465490,0,2861,286,2862,474,1
20150106.14234,2861,6,1465496,4,2861,283,2862,474,0
20150106.142341,2862,4,1465500,4,2861,285,2862,479,1
20150106.142341,2862,2,1465502,2,2861,288,2862,502,1
20150106.142342,2862,2,1465504,2,2861,288,2862,512,1
20150106.142342,2861,14,1465518,2,2861,282,2862,515,0
20150106.142343,2862,106,1465624,72,2861,202,2862,510,1
20150106.142343,2862,2,1465626,2,2861,188,2862,511,1
20150106.142345,2861,22,1465648,-22,2861,166,2862,417,0
20150106.142345,2861,8,1465656,-8,2861,163,2862,460,0
20150106.142346,2862,2,1465658,2,2861,163,2862,459,1
20150106.142346,2861,4,1465662,0,2861,162,2862,458,0
20150106.142347,2861,4,1465666,-4,2861,160,2862,460,0
20150106.142347,2861,20,1465686,0,2861,150,2862,461,0
20150106.142349,2862,14,1465700,-10,2861,145,2862,496,1
20150106.14235,2861,4,1465704,0,2861,159,2862,487,0
20150106.14235,2861,2,1465706,-2,2861,161,2862,487,0
20150106.142351,2861,20,1465726,0,2861,182,2862,495,0
20150106.142351,2861,6,1465732,-2,2861,181,2862,541,0
20150106.142352,2861,4,1465736,0,2861,180,2862,541,0
20150106.142353,2861,14,1465750,-12,2861,174,2862,542,0
20150106.142354,2862,2,1465752,0,2861,175,2862,554,1
20150106.142354,2862,60,1465812,20,2861,165,2862,514,1
20150106.142355,2861,204,1466016,-88,2861,64,2862,547,0
20150106.142356,2861,4,1466020,4,2861,65,2862,546,0
20150106.142357,2861,2,1466022,0,2861,114,2862,547,0
20150106.142357,2861,10,1466032,4,2861,110,2862,548,0
20150106.142358,2861,20,1466052,-8,2861,100,2862,549,0
20150106.142358,2862,6,1466058,-4,2861,100,2862,546,1
20150106.142359,2862,12,1466070,-4,2861,99,2862,541,1
20150106.1424,2862,20,1466090,0,2861,100,2862,541,1
20150106.142401,2861,114,1466204,60,2861,43,2862,540,0
20150106.142401,2862,2,1466206,2,2861,68,2862,539,1
20150106.142402,2861,8,1466214,-2,2861,75,2862,553,0
20150106.142402,2861,4,1466218,0,2861,73,2862,558,0
20150106.142403,2861,26,1466244,0,2861,178,2862,549,0
20150106.142406,2861,4,1466248,-4,2861,213,2862,546,0
20150106.142407,2861,10,1466258,0,2861,209,2862,548,0
20150106.142408,2862,2,1466260,2,2861,209,2862,569,1
20150106.142408,2861,4,1466264,-4,2861,208,2862,569,0
20150106.142409,2861,2,1466266,-2,2861,197,2862,569,0
20150106.14241,2861,8,1466274,-8,2861,227,2862,583,0
20150106.142411,2862,484,1466758,-110,2861,226,2862,344,1
20150106.142412,2862,126,1466884,-102,2861,301,2862,284,1
20150106.142412,2862,6,1466890,0,2861,325,2862,277,1
20150106.142413,2862,66,1466956,-34,2861,326,2862,215,1
20150106.142413,2861,24,1466980,-2,2861,328,2862,227,0
20150106.142414,2862,24,1467004,-4,2861,343,2862,216,1
20150106.142414,2862,18,1467022,-18,2861,345,2862,209,1
20150106.142415,2862,2,1467024,-2,2861,345,2862,208,1
20150106.142416,2862,420,1467444,-162,2862,152,2863,1564,1
20150106.142416,2862,4,1467448,-4,2862,200,2863,1560,1
20150106.142418,2862,4,1467452,-2,2862,240,2863,1555,1
20150106.142419,2862,2,1467454,0,2862,241,2863,1597,1
20150106.142419,2862,2,1467456,-2,2862,241,2863,1602,1
20150106.14242,2862,2,1467458,-2,2862,244,2863,1603,1
20150106.14242,2862,10,1467468,-10,2862,239,2863,1603,1
20150106.142421,2863,12,1467480,-2,2862,241,2863,1610,1
20150106.142422,2863,36,1467516,-36,2862,233,2863,1605,1
20150106.142422,2863,92,1467608,-58,2862,231,2863,1564,1
20150106.142423,2862,36,1467644,-2,2862,230,2863,1549,0
20150106.142424,2863,8,1467652,0,2862,227,2863,1542,1
20150106.142425,2862,6,1467658,0,2862,225,2863,1542,0
20150106.142426,2862,10,1467668,2,2862,231,2863,1544,0
20150106.142427,2862,100,1467768,-100,2862,182,2863,1544,0
20150106.142428,2862,8,1467776,0,2862,181,2863,1542,0
20150106.142428,2862,10,1467786,-4,2862,176,2863,1542,0
20150106.142429,2863,14,1467800,2,2862,191,2863,1541,1
20150106.14243,2863,6,1467806,4,2862,192,2863,1537,1
20150106.14243,2862,20,1467826,-12,2862,182,2863,1539,0
20150106.142431,2862,46,1467872,-32,2862,169,2863,1535,0
20150106.142431,2862,14,1467886,-12,2862,163,2863,1535,0
20150106.142432,2863,72,1467958,-6,2862,147,2863,1536,1
20150106.142433,2862,2,1467960,-2,2862,147,2863,1548,0
20150106.142433,2862,106,1468066,2,2862,95,2863,1549,0
20150106.142434,2863,4,1468070,0,2862,95,2863,1548,1
20150106.142434,2862,106,1468176,96,2862,93,2863,1498,0
20150106.142435,2862,54,1468230,-40,2862,69,2863,1495,0
20150106.142435,2862,22,1468252,22,2862,60,2863,1495,0
20150106.142436,2862,18,1468270,2,2862,51,2863,1496,0
20150106.142437,2862,2,1468272,0,2862,78,2863,1501,0
20150106.142437,2863,20,1468292,-8,2862,71,2863,1499,1
20150106.142438,2863,6,1468298,4,2862,69,2863,1498,1
20150106.142438,2862,4,1468302,2,2862,147,2863,1499,0
20150106.142439,2863,26,1468328,14,2862,136,2863,1494,1
20150106.142439,2862,2,1468330,0,2862,145,2863,1494,0
20150106.14244,2862,6,1468336,-4,2862,142,2863,1495,0
20150106.14244,2862,2,1468338,-2,2862,141,2863,1495,0
20150106.142441,2862,4,1468342,0,2862,142,2863,1499,0
20150106.142441,2863,22,1468364,-18,2862,133,2863,1499,1
20150106.142442,2863,4,1468368,2,2862,133,2863,1597,1
20150106.142442,2862,266,1468634,96,2861,630,2862,54,0
20150106.142443,2862,4,1468638,-4,2861,580,2862,102,0
20150106.142444,2862,60,1468698,-16,2861,580,2862,78,0
20150106.142445,2862,2,1468700,0,2861,580,2862,82,0
20150106.142445,2862,2,1468702,-2,2861,580,2862,84,0
20150106.142445,2861,6,1468708,4,2861,577,2862,85,0
20150106.142446,2862,6,1468714,-4,2861,475,2862,101,1
20150106.142446,2862,92,1468806,14,2861,475,2862,56,1
20150106.142447,2862,2,1468808,2,2861,475,2862,107,1
20150106.142447,2862,2,1468810,2,2861,472,2862,141,1
20150106.142448,2862,6,1468816,2,2861,472,2862,153,1
20150106.142449,2862,8,1468824,6,2861,500,2862,167,1
20150106.142451,2862,22,1468846,-2,2861,481,2862,186,1
20150106.142452,2862,12,1468858,10,2861,481,2862,183,1
20150106.142452,2862,8,1468866,-6,2861,481,2862,195,1
20150106.142454,2861,22,1468888,-10,2861,505,2862,211,0
20150106.142456,2862,14,1468902,-14,2861,507,2862,280,1
20150106.142457,2861,68,1468970,-60,2861,507,2862,290,0
20150106.142458,2861,24,1468994,-24,2861,499,2862,292,0
20150106.1425,2861,8,1469002,2,2861,496,2862,300,0
20150106.142501,2861,4,1469006,4,2861,501,2862,302,0
20150106.142502,2862,6,1469012,-6,2861,503,2862,305,1
20150106.142503,2861,4,1469016,0,2861,503,2862,318,0
20150106.142505,2862,34,1469050,-30,2861,583,2862,348,1
20150106.142505,2861,2,1469052,2,2861,582,2862,348,0
20150106.142505,2861,2,1469054,0,2861,580,2862,348,0
20150106.142506,2861,2,1469056,0,2861,581,2862,352,0
20150106.142507,2861,2,1469058,2,2861,613,2862,359,0
20150106.142508,2861,82,1469140,16,2861,632,2862,316,0
20150106.142509,2861,2,1469142,0,2861,631,2862,317,0
20150106.142509,2861,2,1469144,2,2861,631,2862,317,0
20150106.14251,2862,4,1469148,0,2861,635,2862,315,1
20150106.142513,2862,46,1469194,20,2861,535,2862,385,1
20150106.142514,2861,8,1469202,0,2861,511,2862,387,0
20150106.142515,2862,40,1469242,34,2861,600,2862,411,1
20150106.142516,2862,4,1469246,2,2861,575,2862,410,1
20150106.142516,2861,6,1469252,0,2861,566,2862,462,0
20150106.142517,2862,20,1469272,16,2861,551,2862,452,1
20150106.142518,2862,42,1469314,4,2861,584,2862,437,1
20150106.142518,2862,44,1469358,0,2861,576,2862,416,1
20150106.142521,2862,8,1469366,6,2861,637,2862,375,1
20150106.142523,2862,2,1469368,2,2861,638,2862,376,1
20150106.142523,2862,40,1469408,14,2861,638,2862,365,1
20150106.142525,2861,2,1469410,2,2861,627,2862,377,0
20150106.142529,2862,16,1469426,16,2861,660,2862,376,1
20150106.14253,2862,40,1469466,32,2861,661,2862,366,1
20150106.142531,2861,2,1469468,2,2861,692,2862,366,0
20150106.142531,2862,2,1469470,-2,2861,692,2862,366,1
20150106.142533,2862,4,1469474,2,2861,700,2862,377,1
20150106.142537,2861,10,1469484,0,2861,697,2862,380,0
20150106.14254,2861,2,1469486,2,2861,696,2862,386,0
20150106.14254,2861,2,1469488,2,2861,695,2862,386,0
20150106.142541,2862,12,1469500,-12,2861,694,2862,390,1
20150106.142542,2862,6,1469506,-6,2861,694,2862,386,1
20150106.142542,2862,4,1469510,0,2861,694,2862,385,1
20150106.142545,2862,12,1469522,2,2861,695,2862,401,1
20150106.142546,2862,4,1469526,4,2861,695,2862,406,1
20150106.142548,2861,6,1469532,4,2861,699,2862,407,0
20150106.142551,2861,6,1469538,6,2861,696,2862,471,0
20150106.142551,2861,6,1469544,2,2861,694,2862,470,0
20150106.142552,2861,2,1469546,0,2861,693,2862,471,0
20150106.142553,2861,8,1469554,0,2861,691,2862,477,0
20150106.142555,2861,2,1469556,2,2861,690,2862,478,0
20150106.142555,2862,14,1469570,6,2861,690,2862,471,1
20150106.142557,2861,8,1469578,8,2861,686,2862,475,0
20150106.142557,2862,14,1469592,-2,2861,682,2862,469,1
20150106.142558,2861,40,1469632,0,2861,663,2862,470,0
20150106.142558,2862,2,1469634,2,2861,662,2862,473,1
20150106.1426,2862,2,1469636,2,2861,712,2862,467,1
20150106.142601,2861,2,1469638,0,2861,711,2862,468,0
20150106.142602,2862,18,1469656,0,2861,711,2862,459,1
20150106.142602,2862,16,1469672,0,2861,711,2862,474,1
20150106.142604,2862,966,1470638,450,2862,219,2863,1144,1
20150106.142604,2862,4,1470642,4,2862,217,2863,1144,1
20150106.142605,2863,8,1470650,8,2862,322,2863,1140,1
20150106.142606,2862,4,1470654,2,2862,324,2863,1139,0
20150106.142607,2862,4,1470658,2,2862,322,2863,1140,0
20150106.142607,2862,2,1470660,2,2862,322,2863,1150,0
20150106.14261,2862,20,1470680,20,2862,316,2863,1145,0
20150106.142611,2862,4,1470684,0,2862,316,2863,1145,0
20150106.142613,2862,8,1470692,4,2862,418,2863,1156,0
20150106.142614,2862,84,1470776,82,2862,382,2863,1150,0
20150106.142614,2862,16,1470792,14,2862,374,2863,1150,0
20150106.142616,2862,22,1470814,8,2862,489,2863,1150,0
20150106.142617,2862,2,1470816,0,2862,498,2863,1152,0
20150106.142618,2862,8,1470824,4,2862,510,2863,1149,0
20150106.142618,2862,2,1470826,2,2862,509,2863,1154,0
20150106.142619,2863,48,1470874,-24,2862,509,2863,1130,1
20150106.142621,2863,2002,1472876,-1364,2862,690,2864,1212,1
20150106.142621,2864,122,1472998,-52,2863,1084,2864,1106,1
20150106.142622,2863,836,1473834,52,2863,997,2864,790,0
20150106.142622,2863,32,1473866,0,2863,993,2864,800,0
20150106.142623,2863,482,1474348,228,2863,1003,2864,442,0
20150106.142623,2864,542,1474890,292,2863,998,2865,1968,1
20150106.142624,2864,36,1474926,12,2863,989,2865,1968,1
20150106.142625,2864,350,1475276,-200,2864,132,2865,2203,1
20150106.142625,2865,24,1475300,2,2864,125,2865,2186,1
20150106.142626,2865,34,1475334,-24,2864,136,2865,2146,1
20150106.142626,2865,134,1475468,-48,2864,136,2865,2198,1
20150106.142627,2864,60,1475528,-6,2864,157,2865,2170,0
20150106.142628,2864,330,1475858,-126,2864,5,2865,2184,0
20150106.142628,2864,12,1475870,-10,2863,991,2864,102,0
20150106.142629,2864,10,1475880,-2,2863,988,2864,225,0
20150106.142629,2864,2,1475882,0,2863,990,2864,273,0
20150106.14263,2863,2,1475884,2,2863,127,2864,324,0
20150106.142631,2864,12,1475896,0,2863,130,2864,298,1
20150106.142631,2864,36,1475932,-36,2863,142,2864,340,1
20150106.142632,2863,208,1476140,-196,2863,153,2864,209,0
20150106.142632,2863,12,1476152,0,2863,199,2864,211,0
20150106.142633,2864,4,1476156,0,2863,208,2864,212,1
20150106.142634,2864,372,1476528,-166,2863,421,2864,88,1
20150106.142635,2863,4,1476532,2,2863,474,2864,60,0
20150106.142636,2864,22,1476554,16,2863,476,2864,99,1
20150106.142636,2863,36,1476590,24,2863,466,2864,129,0
20150106.142637,2864,4,1476594,0,2863,469,2864,168,1
20150106.142638,2864,410,1477004,-16,2864,376,2865,2025,1
20150106.142638,2864,14,1477018,-10,2864,370,2865,2019,1
20150106.142639,2864,16,1477034,0,2864,366,2865,2001,1
20150106.142639,2864,10,1477044,0,2864,421,2865,2001,1
20150106.14264,2864,4,1477048,0,2864,461,2865,1997,1
20150106.14264,2864,30,1477078,-8,2864,457,2865,1996,1
20150106.142641,2864,32,1477110,12,2864,455,2865,1996,1
20150106.142642,2864,2,1477112,-2,2864,456,2865,2149,1
20150106.142642,2864,202,1477314,-200,2864,357,2865,2120,1
20150106.142643,2864,4,1477318,-4,2864,355,2865,2151,1
20150106.142643,2865,2,1477320,2,2864,356,2865,2153,1
20150106.142644,2864,2,1477322,0,2864,362,2865,2159,0
20150106.142644,2864,2,1477324,0,2864,366,2865,2160,0
20150106.142645,2864,24,1477348,8,2864,362,2865,2195,0
20150106.142645,2864,16,1477364,-4,2864,363,2865,2332,0
20150106.142646,2865,510,1477874,46,2864,111,2865,2346,1
20150106.142646,2864,244,1478118,-188,2863,471,2864,74,0
20150106.142647,2864,4,1478122,-4,2863,471,2864,76,0
20150106.142647,2864,4,1478126,-2,2863,472,2864,72,0
20150106.142648,2864,2,1478128,-2,2863,473,2864,71,0
20150106.142648,2864,138,1478266,-114,2864,272,2865,2325,0
20150106.142649,2864,22,1478288,0,2864,277,2865,2338,0
20150106.14265,2864,40,1478328,-22,2864,272,2865,2314,0
20150106.14265,2864,54,1478382,-42,2864,259,2865,2346,0
20150106.142651,2864,20,1478402,4,2864,258,2865,2340,0
20150106.142652,2865,52,1478454,10,2864,265,2865,2314,1
20150106.142652,2864,6,1478460,0,2864,266,2865,2314,0
20150106.142653,2864,2030,1480490,-520,2864,264,2865,1277,0
20150106.142653,2865,2,1480492,-2,2864,286,2865,1239,1
20150106.142653,2865,62,1480554,2,2864,285,2865,1208,1
20150106.142654,2865,2252,1482806,356,2864,367,2865,28,1
20150106.142655,2865,64,1482870,-54,2865,175,2866,1017,1
20150106.142655,2865,54,1482924,-16,2865,206,2866,993,1
20150106.142655,2865,12,1482936,0,2865,206,2866,989,1
20150106.142656,2866,22,1482958,0,2865,273,2866,978,1
20150106.142656,2866,258,1483216,-234,2865,273,2866,851,1
20150106.142657,2866,476,1483692,78,2865,5293,2866,609,1
20150106.142657,2865,192,1483884,168,2865,5290,2866,496,0
20150106.142658,2866,80,1483964,-60,2865,5293,2866,456,1
20150106.142658,2865,50,1484014,4,2865,5330,2866,624,0
20150106.142659,2866,132,1484146,66,2865,287,2866,824,1
20150106.1427,2865,600,1484746,-86,2864,424,2865,45,0
20150106.1427,2865,262,1485008,-208,2865,6,2866,962,0
20150106.142701,2865,20,1485028,2,2865,26,2866,931,0
20150106.142701,2866,22,1485050,16,2865,37,2866,938,1
20150106.142702,2865,10,1485060,0,2865,35,2866,985,0
20150106.142702,2865,24,1485084,0,2865,29,2866,979,0
20150106.142703,2866,4,1485088,0,2865,49,2866,976,1
20150106.142703,2865,16,1485104,-2,2865,42,2866,975,0
20150106.142704,2865,102,1485206,-12,2864,381,2865,51,0
20150106.142704,2865,292,1485498,-20,2865,69,2866,891,0
20150106.142705,2865,8,1485506,4,2865,75,2866,888,0
20150106.142705,2865,12,1485518,4,2865,85,2866,873,0
20150106.142706,2865,6,1485524,-2,2865,124,2866,874,0
20150106.142706,2865,20,1485544,6,2865,213,2866,941,0
20150106.142707,2865,8,1485552,8,2865,213,2866,945,0
20150106.142707,2865,14,1485566,2,2865,209,2866,946,0
20150106.142707,2866,12,1485578,-2,2865,216,2866,958,1
20150106.142708,2865,72,1485650,32,2865,259,2866,940,0
20150106.142709,2866,4,1485654,-4,2865,259,2866,938,1
20150106.142709,2866,60,1485714,32,2865,235,2866,938,1
20150106.14271,2866,12,1485726,-6,2865,234,2866,955,1
20150106.14271,2866,168,1485894,-78,2865,234,2866,793,1
20150106.142711,2865,50,1485944,-18,2865,413,2866,779,0
20150106.142711,2865,10,1485954,-8,2865,482,2866,673,0
20150106.142712,2866,2,1485956,0,2865,482,2866,694,1
20150106.142713,2865,2,1485958,-2,2865,488,2866,694,0
20150106.142713,2865,64,1486022,-30,2865,456,2866,699,0
20150106.142714,2865,310,1486332,-36,2865,370,2866,645,0
20150106.142714,2866,12,1486344,4,2865,382,2866,624,1
20150106.142715,2866,6,1486350,6,2865,383,2866,585,1
20150106.142716,2865,10,1486360,10,2865,435,2866,615,0
20150106.142716,2865,24,1486384,22,2865,434,2866,596,0
20150106.142717,2866,106,1486490,-18,2865,432,2866,545,1
20150106.142718,2866,1012,1487502,-662,2866,58,2867,1045,1
20150106.142718,2866,30,1487532,0,2866,58,2867,1087,1
20150106.142719,2866,32,1487564,2,2866,72,2867,1086,1
20150106.142719,2866,12,1487576,0,2866,111,2867,1103,1
20150106.14272,2867,10,1487586,4,2866,135,2867,1099,1
20150106.14272,2867,54,1487640,28,2866,119,2867,1102,1
20150106.142721,2867,282,1487922,-86,2866,212,2867,977,1
20150106.142722,2866,36,1487958,-8,2866,209,2867,967,0
20150106.142722,2866,6,1487964,4,2866,227,2867,827,0
20150106.142722,2867,4,1487968,-2,2866,264,2867,810,1
20150106.142723,2866,30,1487998,0,2866,280,2867,807,0
20150106.142724,2866,44,1488042,0,2866,259,2867,785,0
20150106.142724,2866,114,1488156,-4,2866,255,2867,735,0
20150106.142725,2866,12,1488168,-8,2866,261,2867,738,0
20150106.142725,2866,4,1488172,0,2866,260,2867,743,0
20150106.142726,2867,2,1488174,0,2866,260,2867,713,1
20150106.142726,2866,4,1488178,2,2866,258,2867,714,0
20150106.142727,2867,6,1488184,-2,2866,293,2867,737,1
20150106.142727,2867,20,1488204,-14,2866,293,2867,740,1
20150106.142728,2867,6,1488210,0,2866,293,2867,744,1
20150106.142728,2867,80,1488290,-42,2866,349,2867,656,1
20150106.142729,2866,122,1488412,84,2866,343,2867,560,0
20150106.142729,2867,418,1488830,-200,2866,358,2867,367,1
20150106.14273,2867,48,1488878,38,2866,337,2867,367,1
20150106.14273,2867,770,1489648,54,2867,174,2868,1343,1
20150106.142731,2867,202,1489850,50,2867,305,2868,1209,1
20150106.142731,2867,422,1490272,-28,2867,123,2868,1209,1
20150106.142732,2867,250,1490522,-202,2866,5368,2867,1071,1
20150106.142732,2867,16,1490538,-8,2866,5344,2867,1284,1
20150106.142733,2867,12,1490550,-12,2866,5328,2867,1306,1
20150106.142733,2867,64,1490614,0,2866,5324,2867,1287,1
20150106.142734,2866,6,1490620,-2,2866,5326,2867,1285,0
20150106.142734,2867,4,1490624,0,2866,5334,2867,1320,1
20150106.142735,2867,12,1490636,-12,2866,5337,2867,1374,1
20150106.142735,2867,2,1490638,0,2866,5337,2867,1386,1
20150106.142736,2867,6,1490644,2,2866,5337,2867,1372,1
20150106.142736,2866,334,1490978,-122,2866,5233,2867,1339,0
20150106.142737,2867,2,1490980,-2,2866,5234,2867,1338,1
20150106.142737,2867,2,1490982,-2,2866,5236,2867,1327,1
20150106.142738,2866,316,1491298,-288,2866,5226,2867,1187,0
20150106.142738,2866,4,1491302,-2,2866,5229,2867,1185,0
20150106.142739,2866,22,1491324,-22,2866,5227,2867,1196,0
20150106.142739,2866,6,1491330,0,2866,5204,2867,1221,0
20150106.14274,2866,2,1491332,-2,2866,5203,2867,1223,0
20150106.142741,2867,50,1491382,-48,2866,5208,2867,1202,1
20150106.142741,2867,10,1491392,-8,2866,5207,2867,1312,1
20150106.142741,2866,22,1491414,-2,2866,5196,2867,1313,0
20150106.142742,2867,50,1491464,-8,2866,5196,2867,1292,1
20150106.142743,2866,4,1491468,-2,2866,5194,2867,1309,0
20150106.142744,2867,1410,1492878,1288,2866,4491,2867,1356,1
20150106.142744,2867,44,1492922,20,2866,4476,2867,1376,1
20150106.142745,2866,90,1493012,18,2865,936,2866,27,0
20150106.142745,2866,108,1493120,12,2865,768,2866,45,0
20150106.142746,2865,16,1493136,-16,2865,773,2866,86,0
20150106.142746,2865,8,1493144,4,2865,774,2866,1080,0
20150106.142747,2866,56,1493200,-24,2865,742,2866,1067,1
20150106.142748,2866,8,1493208,6,2865,529,2866,65,1
20150106.142748,2866,18,1493226,2,2865,518,2866,57,1
20150106.142749,2866,2,1493228,0,2865,526,2866,64,1
20150106.14275,2867,142,1493370,108,2866,52,2867,920,1
20150106.14275,2866,230,1493600,104,2865,564,2866,36,0
20150106.142751,2865,12,1493612,-4,2865,561,2866,49,0
20150106.142751,2866,10,1493622,10,2865,561,2866,51,1
20150106.142752,2866,92,1493714,40,2865,564,2866,6,1
20150106.142752,2866,26,1493740,2,2866,990,2867,931,1
20150106.142753,2866,54,1493794,2,2865,615,2866,42,1
20150106.142753,2866,404,1494198,150,2866,25,2867,792,1
20150106.142754,2866,104,1494302,96,2866,49,2867,693,1
20150106.142754,2866,6,1494308,-2,2866,79,2867,695,1
20150106.142755,2866,166,1494474,-144,2865,651,2866,924,1
20150106.142755,2866,14,1494488,-4,2865,546,2866,978,1
20150106.142756,2866,8,1494496,0,2865,554,2866,973,1
20150106.142756,2866,2,1494498,0,2865,561,2866,973,1
20150106.142757,2866,22,1494520,0,2865,583,2866,975,1
20150106.142758,2866,8,1494528,0,2865,1605,2866,972,1
20150106.142758,2866,20,1494548,-8,2865,5611,2866,964,1
20150106.142759,2866,34,1494582,-12,2865,5635,2866,949,1
20150106.142759,2866,2,1494584,0,2865,5626,2866,962,1
20150106.1428,2865,4,1494588,-2,2865,5625,2866,962,0
20150106.1428,2866,4,1494592,-2,2865,5608,2866,965,1
20150106.142801,2866,4,1494596,-2,2865,5609,2866,970,1
20150106.142801,2865,2,1494598,-2,2865,4608,2866,971,0
20150106.142802,2865,42,1494640,-4,2865,3585,2866,958,0
20150106.142802,2866,24,1494664,-12,2865,2580,2866,952,1
20150106.142803,2866,18,1494682,-12,2865,1573,2866,955,1
20150106.142803,2866,2,1494684,0,2865,1619,2866,967,1
20150106.142804,2865,42,1494726,-22,2865,1608,2866,960,0
20150106.142805,2865,6,1494732,0,2865,605,2866,963,0
20150106.142806,2865,8,1494740,-4,2865,603,2866,975,0
20150106.142806,2865,10,1494750,-10,2865,628,2866,1509,0
20150106.142807,2865,6,1494756,0,2865,624,2866,1561,0
20150106.142807,2865,20,1494776,-20,2865,614,2866,1563,0
20150106.142808,2865,704,1495480,-96,2865,256,2866,1563,0
20150106.142808,2865,510,1495990,-344,2864,688,2865,107,0
20150106.142809,2864,8,1495998,0,2864,631,2865,150,0
20150106.14281,2864,2,1496000,2,2864,633,2865,205,0
20150106.14281,2864,2,1496002,2,2864,632,2865,206,0
20150106.142811,2865,2,1496004,-2,2864,632,2865,205,1
20150106.142812,2864,6,1496010,0,2864,641,2865,217,0
20150106.142812,2864,8,1496018,-2,2864,638,2865,247,0
20150106.142813,2865,4,1496022,-4,2864,638,2865,245,1
20150106.142813,2865,2,1496024,-2,2864,638,2865,267,1
20150106.142814,2864,98,1496122,4,2864,637,2865,222,0
20150106.142814,2864,20,1496142,20,2864,663,2865,222,0
20150106.142814,2864,2,1496144,2,2864,662,2865,222,0
20150106.142815,2865,2,1496146,0,2864,693,2865,223,1
20150106.142816,2864,10,1496156,0,2864,691,2865,223,0
20150106.142816,2864,2,1496158,2,2864,690,2865,225,0
20150106.142817,2865,2,1496160,0,2864,690,2865,225,1
20150106.142817,2864,26,1496186,0,2864,677,2865,726,0
20150106.142818,2864,2,1496188,0,2864,676,2865,732,0
20150106.142818,2865,2,1496190,2,2864,675,2865,734,1
20150106.142819,2864,2,1496192,2,2864,674,2865,736,0
20150106.14282,2864,4,1496196,0,2864,672,2865,736,0
20150106.14282,2864,18,1496214,0,2864,687,2865,746,0
20150106.142821,2864,6,1496220,2,2864,682,2865,746,0
20150106.142822,2865,2,1496222,2,2864,567,2865,748,1
20150106.142822,2865,28,1496250,0,2864,568,2865,735,1
20150106.142823,2865,10,1496260,10,2864,567,2865,736,1
20150106.142824,2864,2,1496262,0,2864,567,2865,742,0
20150106.142824,2864,20,1496282,-20,2864,557,2865,742,0
20150106.142825,2864,4,1496286,0,2864,555,2865,746,0
20150106.142825,2864,2,1496288,-2,2864,554,2865,746,0
20150106.142826,2864,6,1496294,0,2864,553,2865,745,0
20150106.142827,2864,62,1496356,-22,2864,554,2865,715,0
20150106.142828,2865,14,1496370,-4,2864,552,2865,740,1
20150106.142829,2865,16,1496386,-14,2864,554,2865,736,1
20150106.142829,2864,246,1496632,-24,2864,443,2865,617,0
20150106.14283,2864,2,1496634,2,2864,445,2865,617,0
20150106.142831,2865,1238,1497872,304,2865,53,2866,371,1
20150106.142831,2865,8,1497880,-2,2865,71,2866,320,1
20150106.142832,2865,126,1498006,-82,2865,140,2866,262,1
20150106.142833,2865,8,1498014,-6,2865,148,2866,259,1
20150106.142833,2865,2,1498016,-2,2865,158,2866,259,1
20150106.142834,2865,6,1498022,-4,2865,155,2866,258,1
20150106.142834,2866,6,1498028,0,2865,154,2866,256,1
20150106.142835,2865,20,1498048,0,2865,204,2866,262,0
20150106.142835,2865,2,1498050,0,2865,204,2866,262,0
20150106.142836,2866,34,1498084,0,2865,188,2866,261,1
20150106.142837,2865,2,1498086,-2,2865,187,2866,262,0
20150106.142837,2865,4,1498090,-2,2865,212,2866,262,0
20150106.142837,2866,4,1498094,0,2865,214,2866,261,1
20150106.142838,2865,4,1498098,0,2865,248,2866,260,0
20150106.142839,2866,8,1498106,-2,2865,249,2866,257,1
20150106.142839,2866,2,1498108,0,2865,250,2866,256,1
20150106.14284,2866,6,1498114,4,2865,250,2866,257,1
20150106.14284,2866,52,1498166,-20,2865,249,2866,270,1
20150106.142841,2866,2,1498168,2,2865,267,2866,269,1
20150106.142841,2866,278,1498446,24,2865,271,2866,132,1
20150106.142842,2866,8,1498454,4,2865,307,2866,129,1
20150106.142842,2866,16,1498470,12,2865,309,2866,125,1
20150106.142843,2866,8,1498478,6,2865,309,2866,124,1
20150106.142843,2866,14,1498492,6,2865,309,2866,117,1
20150106.142844,2866,2,1498494,0,2865,310,2866,121,1
20150106.142844,2866,32,1498526,-10,2865,310,2866,107,1
20150106.142845,2866,44,1498570,14,2865,322,2866,89,1
20150106.142845,2865,26,1498596,22,2865,321,2866,77,0
20150106.142846,2866,4,1498600,4,2865,336,2866,76,1
20150106.142846,2865,8,1498608,-4,2865,333,2866,159,0
20150106.142847,2866,2,1498610,2,2865,338,2866,178,1
20150106.142847,2866,22,1498632,-6,2865,338,2866,167,1
20150106.142848,2866,20,1498652,14,2865,339,2866,170,1
20150106.142848,2866,100,1498752,98,2865,339,2866,120,1
20150106.142848,2865,2,1498754,-2,2865,338,2866,121,0
20150106.142849,2866,2,1498756,2,2865,342,2866,126,1
20150106.142849,2866,8,1498764,4,2865,342,2866,123,1
20150106.14285,2865,8,1498772,-2,2865,341,2866,122,0
20150106.142851,2866,4,1498776,0,2865,341,2866,121,1
20150106.142851,2866,2,1498778,0,2865,341,2866,124,1
20150106.142852,2866,264,1499042,-210,2865,350,2866,101,1
20150106.142852,2866,2,1499044,2,2865,346,2866,107,1
20150106.142853,2866,20,1499064,16,2865,346,2866,101,1
20150106.142853,2866,6,1499070,6,2865,348,2866,99,1
20150106.142854,2866,70,1499140,36,2865,318,2866,94,1
20150106.142854,2866,110,1499250,-46,2865,334,2866,42,1
20150106.142855,2866,76,1499326,-62,2866,90,2867,696,1
20150106.142855,2867,12,1499338,10,2866,85,2867,417,1
20150106.142856,2866,4,1499342,4,2866,199,2867,417,0
20150106.142856,2866,10,1499352,4,2866,227,2867,417,0
20150106.142857,2867,8,1499360,8,2866,227,2867,421,1
20150106.142858,2866,4,1499364,4,2866,251,2867,420,0
20150106.142859,2866,12,1499376,12,2866,257,2867,420,0
20150106.142859,2866,10,1499386,2,2866,257,2867,422,0
20150106.1429,2866,200,1499586,100,2866,158,2867,421,0
20150106.142901,2866,30,1499616,0,2866,142,2867,472,0
20150106.142901,2867,4,1499620,2,2866,143,2867,472,1
20150106.142901,2867,6,1499626,4,2866,141,2867,473,1
20150106.142902,2866,4,1499630,4,2866,139,2867,473,0
20150106.142903,2866,8,1499638,4,2866,157,2867,474,0
20150106.142904,2866,6,1499644,4,2866,156,2867,479,0
20150106.142904,2866,4,1499648,4,2866,155,2867,482,0
20150106.142905,2866,8,1499656,4,2866,154,2867,493,0
20150106.142906,2866,4,1499660,0,2866,185,2867,512,0
20150106.142906,2867,4,1499664,4,2866,187,2867,510,1
20150106.142907,2866,10,1499674,6,2866,182,2867,511,0
20150106.142908,2866,468,1500142,-106,2865,465,2866,774,0
20150106.142909,2866,6,1500148,0,2865,300,2866,890,0
20150106.14291,2866,2,1500150,0,2865,261,2866,898,0
20150106.14291,2866,2,1500152,0,2865,217,2866,129,0
20150106.142911,2866,2,1500154,0,2865,240,2866,132,0
20150106.142912,2866,260,1500414,32,2866,200,2867,712,0
20150106.142912,2866,14,1500428,0,2866,193,2867,529,0
20150106.142913,2867,104,1500532,2,2866,185,2867,466,1
20150106.142913,2866,2,1500534,0,2866,184,2867,467,0
20150106.142915,2866,48,1500582,-14,2866,1,2867,502,0
20150106.142915,2866,4,1500586,-4,2865,329,2866,49,0
20150106.142916,2866,4,1500590,2,2865,333,2866,49,0
20150106.142917,2866,116,1500706,-8,2866,90,2867,507,0
20150106.142917,2866,2,1500708,-2,2866,2171,2867,517,0
20150106.142918,2867,132,1500840,120,2866,4174,2867,448,1
20150106.142918,2866,26,1500866,-2,2866,174,2867,437,0
20150106.142919,2866,20,1500886,-8,2866,164,2867,440,0
20150106.142919,2866,4,1500890,0,2866,180,2867,440,0
20150106.14292,2866,44,1500934,0,2866,170,2867,436,0
20150106.14292,2866,2,1500936,0,2866,173,2867,438,0
20150106.142921,2866,4,1500940,-4,2866,192,2867,441,0
20150106.142922,2867,8,1500948,0,2866,192,2867,436,1
20150106.142922,2866,2,1500950,-2,2866,191,2867,437,0
20150106.142922,2866,2,1500952,0,2866,191,2867,437,0
20150106.142923,2867,2,1500954,2,2866,192,2867,438,1
20150106.142923,2866,2,1500956,-2,2866,191,2867,439,0
20150106.142924,2867,58,1501014,0,2866,192,2867,411,1
20150106.142925,2866,2,1501016,2,2866,193,2867,414,0
20150106.142925,2866,488,1501504,206,2866,218,2867,200,0
20150106.142926,2866,20,1501524,0,2866,274,2867,211,0
20150106.142927,2866,2,1501526,0,2866,273,2867,267,0
20150106.142927,2866,10,1501536,0,2866,269,2867,269,0
20150106.142928,2867,12,1501548,-2,2866,2269,2867,369,1
20150106.142928,2867,18,1501566,-6,2866,4244,2867,361,1
20150106.142929,2866,2,1501568,-2,2866,4243,2867,361,0
20150106.142929,2867,40,1501608,-10,2866,233,2867,352,1
20150106.14293,2867,18,1501626,-16,2866,231,2867,369,1
20150106.14293,2867,66,1501692,8,2866,231,2867,339,1
20150106.142931,2867,2,1501694,0,2866,241,2867,343,1
20150106.142932,2866,4,1501698,0,2866,239,2867,350,0
20150106.142932,2866,12,1501710,-12,2866,233,2867,357,0
20150106.142933,2866,14,1501724,-12,2866,244,2867,355,0
20150106.142933,2867,6,1501730,0,2866,242,2867,354,1
20150106.142934,2866,52,1501782,18,2866,237,2867,344,0
20150106.142934,2866,6,1501788,2,2866,234,2867,345,0
20150106.142935,2866,18,1501806,4,2866,226,2867,344,0
20150106.142935,2866,6,1501812,2,2866,224,2867,344,0
20150106.142936,2866,8,1501820,0,2866,219,2867,349,0
20150106.142936,2866,10,1501830,2,2866,215,2867,443,0
20150106.142937,2866,4,1501834,0,2866,243,2867,450,0
20150106.142937,2866,18,1501852,10,2866,236,2867,451,0
20150106.142938,2867,8,1501860,8,2866,233,2867,470,1
20150106.142938,2866,8,1501868,8,2866,231,2867,473,0
20150106.14294,2867,20,1501888,-12,2866,231,2867,469,1
20150106.142942,2866,62,1501950,62,2866,188,2867,481,0
20150106.142942,2866,576,1502526,-44,2865,349,2866,782,0
20150106.142943,2866,8,1502534,0,2865,296,2866,829,0
20150106.142943,2866,6,1502540,0,2865,305,2866,908,0
20150106.142945,2866,2,1502542,0,2865,307,2866,914,0
20150106.142945,2865,10,1502552,-10,2865,302,2866,152,0
20150106.142946,2866,2,1502554,0,2865,327,2866,155,1
20150106.142947,2866,12,1502566,2,2865,3332,2866,152,1
20150106.142948,2865,12,1502578,4,2865,5360,2866,105,0
20150106.142948,2866,236,1502814,56,2866,50,2867,507,1
20150106.142948,2866,104,1502918,72,2865,422,2867,510,1
20150106.142949,2867,2,1502920,2,2865,422,2867,526,1
20150106.14295,2867,10,1502930,2,2865,396,2867,518,1
20150106.142951,2865,2,1502932,0,2865,396,2867,521,0
20150106.142951,2865,24,1502956,-6,2865,382,2866,101,0
20150106.142952,2865,206,1503162,-2,2865,330,2866,103,0
20150106.142952,2866,2,1503164,2,2865,334,2866,110,1
20150106.142953,2866,32,1503196,20,2865,326,2866,106,1
20150106.142953,2866,2,1503198,2,2865,326,2866,125,1
20150106.142954,2866,16,1503214,12,2865,4325,2866,120,1
20150106.142954,2865,2,1503216,2,2865,5324,2866,67,0
20150106.142955,2865,2,1503218,0,2865,5323,2866,67,0
20150106.142955,2865,2,1503220,2,2865,319,2866,93,0
20150106.142956,2866,22,1503242,20,2865,319,2866,98,1
20150106.142956,2866,534,1503776,470,2866,56,2867,348,1
20150106.142957,2866,114,1503890,-110,2865,388,2866,1,1
20150106.142957,2866,84,1503974,-80,2865,377,2866,13,1
20150106.142958,2865,24,1503998,12,2865,379,2866,45,0
20150106.142958,2865,22,1504020,20,2865,366,2866,50,0
20150106.142959,2866,110,1504130,26,2865,393,2866,5,1
20150106.143,2865,6,1504136,0,2865,315,2866,67,0
20150106.143,2866,24,1504160,-8,2865,320,2866,56,1
20150106.143001,2866,10,1504170,6,2865,320,2866,52,1
20150106.143001,2866,4,1504174,2,2865,334,2866,51,1
20150106.143001,2866,4,1504178,0,2865,334,2866,50,1
20150106.143002,2865,56,1504234,18,2865,320,2866,84,0
20150106.143003,2866,18,1504252,4,2865,320,2866,90,1
20150106.143003,2866,4,1504256,2,2865,319,2866,94,1
20150106.143004,2866,6,1504262,4,2865,320,2866,93,1
20150106.143005,2865,6,1504268,0,2865,318,2866,151,0
20150106.143005,2866,2,1504270,2,2865,318,2866,155,1
20150106.143006,2865,20,1504290,-12,2865,308,2866,162,0
20150106.143007,2866,20,1504310,-12,2865,308,2866,162,1
20150106.143008,2865,18,1504328,12,2865,301,2866,166,0
20150106.143008,2866,2,1504330,0,2865,306,2866,169,1
20150106.143009,2865,14,1504344,4,2865,303,2866,180,0
20150106.14301,2866,4,1504348,-2,2865,315,2866,181,1
20150106.14301,2865,10,1504358,-10,2865,310,2866,182,0
20150106.143011,2865,8,1504366,-6,2865,307,2866,193,0
20150106.143011,2866,20,1504386,0,2865,307,2866,184,1
20150106.143013,2866,8,1504394,-4,2865,1315,2866,222,1
20150106.143013,2866,126,1504520,-90,2865,5311,2866,164,1
20150106.143014,2865,120,1504640,62,2865,5313,2866,106,0
20150106.143014,2866,2,1504642,2,2865,5313,2866,106,1
20150106.143015,2865,4,1504646,-4,2865,311,2866,107,0
20150106.143015,2866,2,1504648,0,2865,383,2866,137,1
20150106.143016,2866,2,1504650,-2,2865,383,2866,156,1
20150106.143016,2865,12,1504662,-10,2865,379,2866,162,0
20150106.143017,2865,2,1504664,-2,2865,386,2866,165,0
20150106.143017,2866,18,1504682,0,2865,386,2866,153,1
20150106.143018,2866,4,1504686,4,2865,386,2866,153,1
20150106.143018,2865,10,1504696,0,2865,382,2866,152,0
20150106.143019,2865,6,1504702,0,2865,391,2866,152,0
20150106.14302,2865,2,1504704,2,2865,413,2866,152,0
20150106.143021,2865,20,1504724,16,2865,403,2866,172,0
20150106.143022,2865,16,1504740,2,2865,401,2866,182,0
20150106.143023,2866,2,1504742,2,2865,411,2866,182,1
20150106.143024,2865,30,1504772,8,2865,406,2866,175,0
20150106.143024,2865,4,1504776,4,2865,406,2866,196,0
20150106.143025,2866,14,1504790,10,2865,400,2866,195,1
20150106.143027,2866,122,1504912,48,2865,401,2866,136,1
20150106.143027,2866,2,1504914,2,2865,401,2866,137,1
20150106.143028,2865,2,1504916,0,2865,400,2866,138,0
20150106.143029,2865,20,1504936,-18,2865,390,2866,139,0
20150106.14303,2865,2,1504938,2,2865,395,2866,140,0
20150106.143031,2865,2,1504940,2,2865,394,2866,141,0
20150106.143033,2865,2,1504942,0,2865,396,2866,150,0
20150106.143034,2865,8,1504950,2,2865,392,2866,151,0
20150106.143035,2865,206,1505156,128,2865,383,2866,64,0
20150106.143035,2865,2,1505158,0,2865,377,2866,66,0
20150106.143036,2866,4,1505162,0,2865,376,2866,86,1
20150106.143037,2866,2,1505164,0,2865,376,2866,91,1
20150106.143037,2865,4,1505168,0,2865,374,2866,106,0
20150106.143038,2866,4,1505172,-2,2865,373,2866,226,1
20150106.14304,2865,2,1505174,2,2865,371,2866,382,0
20150106.143041,2865,2,1505176,0,2865,344,2866,392,0
20150106.143042,2865,14,1505190,0,2865,337,2866,392,0
20150106.143043,2865,32,1505222,10,2865,326,2866,387,0
20150106.143045,2865,2,1505224,2,2865,325,2866,405,0
20150106.143046,2865,2,1505226,0,2865,324,2866,406,0
20150106.143046,2865,4,1505230,2,2865,322,2866,426,0
20150106.143047,2865,2,1505232,0,2865,321,2866,426,0
20150106.143048,2865,642,1505874,-342,2864,621,2865,83,0
20150106.143048,2865,4,1505878,0,2864,471,2865,86,0
20150106.143049,2864,6,1505884,-4,2864,478,2865,84,0
20150106.14305,2865,2,1505886,0,2864,477,2865,94,1
20150106.14305,2865,4,1505890,0,2864,477,2865,97,1
20150106.143051,2865,10,1505900,-6,2864,475,2865,97,1
20150106.143051,2864,6,1505906,-4,2864,474,2865,119,0
20150106.143053,2864,88,1505994,-22,2864,4444,2865,98,0
20150106.143053,2864,8,1506002,8,2864,5440,2865,89,0
20150106.143054,2865,2,1506004,0,2864,440,2865,128,1
20150106.143054,2865,2,1506006,-2,2864,440,2865,133,1
20150106.143056,2865,4,1506010,-4,2864,443,2865,159,1
20150106.143057,2865,8,1506018,-2,2864,446,2865,160,1
20150106.143057,2864,14,1506032,0,2864,439,2865,165,0
20150106.143058,2864,8,1506040,0,2864,436,2865,164,0
20150106.143059,2864,10,1506050,0,2864,431,2865,170,0
20150106.143059,2864,4,1506054,2,2864,432,2865,171,0
20150106.1431,2865,30,1506084,6,2864,422,2865,176,1
20150106.1431,2864,2,1506086,0,2864,421,2865,176,0
20150106.143102,2864,6,1506092,2,2864,421,2865,314,0
20150106.143103,2864,642,1506734,428,2864,102,2865,317,0
20150106.143103,2864,206,1506940,-70,2863,789,2864,23,0
20150106.143104,2863,1478,1508418,-788,2862,1201,2863,86,0
20150106.143104,2862,190,1508608,-66,2862,542,2863,60,0
20150106.143105,2863,168,1508776,-58,2863,37,2864,238,1
20150106.143105,2863,238,1509014,-106,2862,535,2863,120,1
20150106.143106,2863,2,1509016,0,2862,538,2863,119,1
20150106.143107,2863,10,1509026,4,2862,537,2863,120,1
20150106.143107,2862,2,1509028,0,2862,538,2863,121,0
20150106.143108,2862,20,1509048,0,2862,529,2863,120,0
20150106.143108,2863,12,1509060,2,2862,524,2863,124,1
20150106.143109,2862,2,1509062,0,2862,525,2863,123,0
20150106.14311,2863,212,1509274,-206,2862,422,2863,121,1
20150106.14311,2862,12,1509286,-10,2862,417,2863,120,0
20150106.143111,2862,26,1509312,-24,2862,404,2863,111,0
20150106.143111,2863,16,1509328,-2,2862,399,2863,109,1
20150106.143112,2862,2,1509330,2,2862,407,2863,110,0
20150106.143112,2863,4,1509334,4,2862,409,2863,109,1
20150106.143113,2862,2,1509336,0,2862,418,2863,111,0
20150106.143113,2862,14,1509350,12,2862,434,2863,110,0
20150106.143114,2863,4,1509354,2,2862,451,2863,107,1
20150106.143114,2862,12,1509366,4,2862,471,2863,117,0
20150106.143115,2862,6,1509372,2,2862,491,2863,119,0
20150106.143115,2863,12,1509384,10,2862,522,2863,114,1
20150106.143116,2862,6,1509390,4,2862,520,2863,113,0
20150106.143116,2862,8,1509398,0,2862,516,2863,116,0
20150106.143117,2863,16,1509414,12,2862,512,2863,139,1
20150106.143117,2862,30,1509444,10,2862,505,2863,140,0
20150106.143119,2863,14,1509458,-2,2862,547,2863,165,1
20150106.143119,2862,102,1509560,-98,2862,502,2863,164,0
20150106.14312,2863,24,1509584,-4,2862,509,2863,155,1
20150106.14312,2862,4,1509588,-2,2862,508,2863,154,0
20150106.143121,2863,34,1509622,18,2862,547,2863,135,1
20150106.143122,2863,272,1509894,-16,2863,11,2864,356,1
20150106.143122,2864,8,1509902,4,2863,52,2864,344,1
20150106.143123,2863,252,1510154,-62,2862,587,2863,65,0
20150106.143123,2863,174,1510328,2,2863,36,2864,345,0
20150106.143123,2863,72,1510400,8,2862,758,2863,53,0
20150106.143124,2863,78,1510478,76,2862,643,2863,30,0
20150106.143125,2863,8,1510486,2,2862,644,2863,26,0
20150106.143125,2863,38,1510524,4,2862,645,2863,28,0
20150106.143126,2863,10,1510534,-8,2862,641,2863,24,0
20150106.143126,2863,6,1510540,-4,2862,642,2863,37,0
20150106.143127,2863,30,1510570,0,2862,722,2863,24,0
20150106.143127,2863,4,1510574,2,2862,721,2863,30,0
20150106.143128,2863,4,1510578,0,2862,728,2863,28,0
20150106.143128,2863,62,1510640,-2,2863,122,2864,398,0
20150106.14313,2863,260,1510900,-120,2862,733,2863,147,0
20150106.14313,2863,40,1510940,40,2862,679,2863,129,0
20150106.14313,2863,4,1510944,2,2862,699,2863,127,0
20150106.143131,2862,4,1510948,0,2862,698,2863,127,0
20150106.143131,2863,2,1510950,2,2862,698,2863,126,1
20150106.143132,2862,44,1510994,-10,2862,705,2863,110,0
20150106.143133,2862,4,1510998,2,2862,704,2863,109,0
20150106.143133,2862,10,1511008,0,2862,703,2863,105,0
20150106.143134,2863,8,1511016,-2,2862,695,2863,108,1
20150106.143135,2863,18,1511034,0,2862,702,2863,107,1
20150106.143135,2863,24,1511058,-4,2862,703,2863,109,1
20150106.143136,2862,4,1511062,-4,2862,710,2863,109,0
20150106.143137,2863,14,1511076,0,2862,704,2863,105,1
20150106.143137,2863,408,1511484,-334,2862,456,2863,105,1
20150106.143138,2863,4,1511488,-2,2862,457,2863,127,1
20150106.143139,2862,6,1511494,-6,2862,451,2863,137,0
20150106.143139,2863,8,1511502,-8,2862,451,2863,135,1
20150106.14314,2863,4,1511506,0,2862,441,2863,133,1
20150106.14314,2862,882,1512388,410,2861,1466,2862,561,0
20150106.143141,2863,28,1512416,0,2862,105,2863,181,1
20150106.143141,2862,114,1512530,-110,2862,59,2863,221,0
20150106.143142,2862,10,1512540,-8,2862,68,2863,231,0
20150106.143142,2862,18,1512558,-18,2862,68,2863,231,0
20150106.143143,2862,8,1512566,0,2862,97,2863,250,0
20150106.143143,2862,198,1512764,98,2861,1572,2862,954,0
20150106.143144,2862,12,1512776,6,2861,1477,2862,139,0
20150106.143144,2862,300,1513076,188,2862,236,2863,297,0
20150106.143145,2862,4,1513080,2,2862,259,2863,297,0
20150106.143146,2862,28,1513108,24,2862,273,2863,338,0
20150106.143148,2862,2,1513110,2,2862,274,2863,418,0
20150106.143149,2862,10,1513120,0,2862,275,2863,421,0
20150106.143149,2862,32,1513152,22,2862,261,2863,421,0
20150106.14315,2862,2,1513154,0,2862,270,2863,421,0
20150106.14315,2862,2,1513156,2,2862,277,2863,421,0
20150106.143151,2862,4,1513160,2,2862,276,2863,421,0
20150106.143151,2862,4,1513164,0,2862,274,2863,421,0
20150106.143152,2862,4,1513168,4,2862,275,2863,421,0
20150106.143152,2862,10,1513178,0,2862,270,2863,421,0
20150106.143154,2862,4,1513182,0,2862,289,2863,423,0
20150106.143154,2862,4,1513186,2,2862,288,2863,423,0
20150106.143155,2863,4,1513190,0,2862,289,2863,469,1
20150106.143155,2862,2,1513192,0,2862,288,2863,471,0
20150106.143156,2863,2,1513194,-2,2862,289,2863,470,1
20150106.143156,2862,582,1513776,184,2861,1670,2862,262,0
20150106.143157,2862,30,1513806,2,2861,1569,2862,2298,0
20150106.143158,2862,14,1513820,0,2861,1569,2862,5292,0
20150106.143158,2862,4,1513824,0,2861,1568,2862,331,0
20150106.143159,2861,1662,1515486,-476,2861,1246,2863,532,0
20150106.1432,2862,12,1515498,-10,2861,1144,2862,54,1
20150106.1432,2862,8,1515506,4,2861,1156,2862,77,1
20150106.143201,2861,2,1515508,-2,2861,1145,2862,111,0
20150106.143202,2861,10,1515518,8,2861,1140,2862,119,0
20150106.143202,2862,4,1515522,0,2861,1141,2862,120,1
20150106.143203,2862,4,1515526,-2,2861,1141,2862,120,1
20150106.143204,2862,14,1515540,0,2861,1137,2862,116,1
20150106.143205,2861,4,1515544,0,2861,1138,2862,121,0
20150106.143206,2862,10,1515554,2,2861,1153,2862,129,1
20150106.143206,2862,2,1515556,2,2861,1154,2862,136,1
20150106.143207,2862,4,1515560,0,2861,1166,2862,135,1
20150106.143208,2862,8,1515568,6,2861,1169,2862,133,1
20150106.143209,2861,12,1515580,0,2861,1163,2862,134,0
20150106.143209,2862,26,1515606,20,2861,1161,2862,122,1
20150106.14321,2862,2,1515608,2,2861,1161,2862,121,1
20150106.14321,2862,6,1515614,2,2861,1214,2862,119,1
20150106.143211,2862,2,1515616,0,2861,1214,2862,118,1
20150106.143211,2862,4,1515620,4,2861,1314,2862,117,1
20150106.143212,2862,102,1515722,-78,2861,1317,2862,70,1
20150106.143213,2862,2,1515724,-2,2861,1342,2862,69,1
20150106.143214,2861,4,1515728,-2,2861,1343,2862,68,0
20150106.143214,2862,2,1515730,-2,2861,1344,2862,68,1
20150106.143215,2862,4,1515734,0,2861,1344,2862,66,1
20150106.143216,2861,26,1515760,-6,2861,1337,2862,57,0
20150106.143217,2861,2,1515762,0,2861,1336,2862,57,0
20150106.143217,2861,34,1515796,-12,2861,1334,2862,42,0
20150106.143218,2862,10,1515806,0,2861,1334,2862,40,1
20150106.143218,2862,2,1515808,0,2861,1334,2862,42,1
20150106.143219,2862,104,1515912,58,2862,87,2863,647,1
20150106.14322,2863,212,1516124,-192,2862,132,2863,418,1
20150106.143221,2863,16,1516140,-12,2862,241,2863,409,1
20150106.143221,2863,2,1516142,0,2862,289,2863,405,1
20150106.143222,2862,2,1516144,-2,2862,347,2863,416,0
20150106.143223,2862,16,1516160,-12,2862,394,2863,381,0
20150106.143223,2862,8,1516168,0,2862,403,2863,381,0
20150106.143223,2863,2,1516170,0,2862,403,2863,380,1
20150106.143224,2862,2,1516172,-2,2862,402,2863,381,0
20150106.143224,2862,6,1516178,-2,2862,350,2863,380,0
20150106.143226,2862,2,1516180,-2,2862,347,2863,380,0
20150106.143226,2862,2,1516182,-2,2862,347,2863,380,0
20150106.143228,2862,46,1516228,-40,2862,274,2863,391,0
20150106.143228,2862,2,1516230,2,2862,271,2863,391,0
20150106.143231,2862,2,1516232,2,2862,323,2863,394,0
20150106.143232,2862,8,1516240,0,2862,305,2863,393,0
20150106.143233,2862,2,1516242,2,2862,214,2863,394,0
20150106.143233,2862,12,1516254,0,2862,209,2863,395,0
20150106.143234,2862,4,1516258,2,2862,207,2863,395,0
20150106.143235,2862,4,1516262,0,2862,213,2863,397,0
20150106.143236,2862,2,1516264,0,2862,213,2863,400,0
20150106.143238,2862,10,1516274,8,2862,296,2863,407,0
20150106.14324,2863,6,1516280,0,2862,336,2863,427,1
20150106.14324,2862,60,1516340,26,2862,307,2863,4426,0
20150106.143241,2862,612,1516952,-16,2861,1479,2862,540,0
20150106.143241,2862,8,1516960,6,2861,1479,2862,537,0
20150106.143243,2862,8,1516968,2,2861,1477,2862,534,0
20150106.143245,2862,2,1516970,2,2861,1477,2862,563,0
20150106.143245,2862,2,1516972,2,2861,1477,2862,563,0
20150106.143245,2862,8,1516980,0,2861,1478,2862,560,0
20150106.143246,2862,6,1516986,0,2861,1478,2862,558,0
20150106.143246,2862,2,1516988,0,2861,1478,2862,562,0
20150106.143247,2862,8,1516996,8,2861,1478,2862,558,0
20150106.143248,2862,4,1517000,2,2861,1479,2862,556,0
20150106.143249,2862,20,1517020,0,2861,1480,2862,546,0
20150106.14325,2862,10,1517030,10,2861,1481,2862,542,0
20150106.14325,2862,2,1517032,2,2861,1481,2862,541,0
20150106.143251,2862,2,1517034,2,2861,1481,2862,541,0
20150106.143252,2861,6,1517040,-2,2861,1483,2862,541,0
20150106.143253,2861,14,1517054,0,2861,1481,2862,541,0
20150106.143254,2861,6,1517060,6,2861,1479,2862,541,0
20150106.143254,2862,2,1517062,0,2861,1478,2862,540,1
20150106.143255,2862,16,1517078,12,2861,1475,2862,538,1
20150106.143257,2862,4,1517082,4,2861,1475,2862,546,1
20150106.143258,2862,8,1517090,8,2861,1477,2862,542,1
20150106.143258,2861,20,1517110,14,2861,1476,2862,533,0
20150106.143259,2862,2,1517112,0,2861,1476,2862,537,1
20150106.1433,2861,4,1517116,0,2861,1476,2862,537,0
20150106.1433,2862,20,1517136,2,2861,1480,2862,535,1
20150106.143301,2862,16,1517152,0,2861,1480,2862,312,1
20150106.143302,2862,16,1517168,0,2861,1520,2862,304,1
20150106.143302,2862,2,1517170,0,2861,1520,2862,303,1
20150106.143303,2861,4,1517174,0,2861,1520,2862,302,0
20150106.143303,2862,2,1517176,-2,2861,1520,2862,301,1
20150106.143305,2862,6,1517182,-6,2861,1520,2862,301,1
20150106.143305,2861,2,1517184,0,2861,1521,2862,303,0
20150106.143306,2862,2,1517186,0,2861,1521,2862,313,1
20150106.143307,2862,2,1517188,0,2861,1520,2862,312,1
20150106.143308,2862,2,1517190,-2,2861,1542,2862,311,1
20150106.143309,2862,2,1517192,-2,2861,1542,2862,315,1
20150106.14331,2862,110,1517302,68,2861,1497,2862,310,1
20150106.143311,2861,8,1517310,0,2861,1493,2862,310,0
20150106.143312,2862,2,1517312,0,2861,1494,2862,309,1
20150106.143314,2862,4,1517316,-4,2861,1494,2862,308,1
20150106.143314,2862,20,1517336,-20,2861,1494,2862,298,1
20150106.143315,2861,6,1517342,-2,2861,1492,2862,298,0
20150106.143317,2862,4,1517346,-4,2861,1491,2862,321,1
20150106.143319,2861,2,1517348,0,2861,1510,2862,336,0
20150106.143319,2862,4,1517352,-2,2861,1510,2862,342,1
20150106.143322,2862,4,1517356,0,2861,1512,2862,341,1
20150106.143323,2862,2,1517358,-2,2861,1512,2862,340,1
20150106.143323,2862,12,1517370,0,2861,1509,2862,359,1
20150106.143327,2862,20,1517390,-20,2861,1544,2862,346,1
20150106.143327,2862,2,1517392,-2,2861,1545,2862,346,1
20150106.143328,2861,24,1517416,-2,2861,1534,2862,338,0
20150106.14333,2861,2,1517418,0,2861,1524,2862,362,0
20150106.14333,2861,2,1517420,-2,2861,1526,2862,362,0
20150106.143331,2861,2,1517422,0,2861,1525,2862,362,0
20150106.143331,2862,2,1517424,0,2861,1527,2862,361,1
20150106.143333,2861,12,1517436,0,2861,1522,2862,362,0
20150106.143333,2861,24,1517460,0,2861,1515,2862,372,0
20150106.143334,2861,2,1517462,2,2861,1549,2862,373,0
20150106.143335,2861,2,1517464,2,2861,1549,2862,374,0
20150106.143337,2861,4,1517468,0,2861,1571,2862,375,0
20150106.143338,2862,2,1517470,-2,2861,1571,2862,374,1
20150106.143339,2862,22,1517492,-22,2861,1573,2862,363,1
20150106.14334,2862,20,1517512,-20,2861,1573,2862,352,1
20150106.14334,2862,2,1517514,0,2861,1573,2862,351,1
20150106.143341,2861,38,1517552,20,2861,1555,2862,351,0
20150106.143344,2861,2,1517554,2,2861,1554,2862,372,0
20150106.143345,2861,6,1517560,0,2861,1557,2862,373,0
20150106.143346,2862,2,1517562,0,2861,1557,2862,375,1
20150106.143349,2861,32,1517594,22,2861,1548,2862,373,0
20150106.14335,2862,14,1517608,10,2861,1548,2862,273,1
20150106.143351,2862,74,1517682,2,2861,1544,2862,225,1
20150106.143351,2862,174,1517856,-6,2861,1538,2862,138,1
20150106.143352,2862,278,1518134,-144,2862,594,2863,740,1
20150106.143352,2862,60,1518194,0,2862,554,2863,740,1
20150106.143353,2862,6,1518200,-2,2862,533,2863,752,1
20150106.143353,2862,2,1518202,-2,2862,532,2863,755,1
20150106.143354,2862,300,1518502,0,2862,341,2863,753,1
20150106.143354,2862,92,1518594,-92,2862,121,2863,758,1
20150106.143355,2862,344,1518938,90,2861,1504,2862,2,1
20150106.143355,2863,90,1519028,-70,2862,32,2863,757,1
20150106.143356,2862,26,1519054,-24,2862,48,2863,758,0
20150106.143357,2862,2,1519056,-2,2862,47,2863,769,0
20150106.143358,2863,2,1519058,0,2862,81,2863,768,1
20150106.143359,2863,20,1519078,-18,2862,86,2863,759,1
20150106.1434,2863,2,1519080,0,2862,86,2863,759,1
20150106.1434,2862,10,1519090,0,2862,87,2863,759,0
20150106.143401,2862,4,1519094,0,2862,92,2863,759,0
20150106.143402,2862,84,1519178,38,2862,55,2863,739,0
20150106.143402,2863,2,1519180,0,2862,56,2863,738,1
20150106.143403,2862,2,1519182,0,2862,55,2863,738,0
20150106.143404,2862,4,1519186,-4,2862,54,2863,740,0
20150106.143404,2862,4,1519190,-4,2862,54,2863,739,0
20150106.143406,2862,10,1519200,0,2862,52,2863,730,0
20150106.143407,2862,2,1519202,0,2862,53,2863,739,0
20150106.143407,2863,4,1519206,0,2862,55,2863,738,1
20150106.143408,2862,6,1519212,0,2862,58,2863,739,0
20150106.143409,2862,212,1519424,146,2861,1483,2862,46,0
20150106.143409,2862,94,1519518,0,2862,83,2863,742,0
20150106.14341,2862,4,1519522,-2,2862,82,2863,745,0
20150106.14341,2862,4,1519526,0,2862,96,2863,745,0
20150106.143411,2862,2,1519528,-2,2862,96,2863,745,0
20150106.143411,2863,6,1519534,-6,2862,99,2863,744,1
20150106.143412,2862,2,1519536,0,2862,98,2863,744,0
20150106.143413,2862,2,1519538,-2,2862,97,2863,744,0
20150106.143414,2862,354,1519892,122,2862,12,2863,853,0
20150106.143415,2862,8,1519900,-2,2862,60,2863,744,0
20150106.143415,2863,2,1519902,0,2862,60,2863,743,1
20150106.143417,2863,12,1519914,-10,2862,59,2863,741,1
20150106.143417,2862,10,1519924,-10,2862,54,2863,741,0
20150106.143418,2862,112,1520036,8,2861,1534,2862,956,0
20150106.143418,2862,122,1520158,122,2862,51,2863,740,0
20150106.143418,2862,2,1520160,0,2862,51,2863,740,0
20150106.143421,2862,8,1520168,-6,2862,48,2863,755,0
20150106.143421,2862,24,1520192,-22,2862,41,2863,753,0
20150106.143423,2862,40,1520232,-32,2862,26,2863,748,0
20150106.143424,2862,6,1520238,0,2862,23,2863,747,0
20150106.143427,2862,8,1520246,-8,2862,26,2863,747,0
20150106.143427,2863,2,1520248,2,2862,25,2863,746,1
20150106.143428,2862,2,1520250,-2,2862,30,2863,746,0
20150106.143428,2862,152,1520402,-34,2861,1486,2862,483,0
20150106.143428,2862,114,1520516,0,2861,1486,2862,426,0
20150106.14343,2862,2,1520518,-2,2861,1487,2862,425,0
20150106.143431,2862,4,1520522,0,2861,1487,2862,423,0
20150106.143432,2862,8,1520530,0,2861,1488,2862,422,0
20150106.143433,2862,6,1520536,0,2861,1489,2862,420,0
20150106.143434,2862,30,1520566,-30,2861,1489,2862,407,0
20150106.143435,2862,22,1520588,0,2861,1489,2862,397,0
20150106.143436,2862,2,1520590,0,2861,1489,2862,395,0
20150106.143436,2862,2,1520592,-2,2861,1489,2862,394,0
20150106.143437,2862,4,1520596,-4,2861,1488,2862,393,0
20150106.143437,2862,18,1520614,-12,2861,1478,2862,389,0
20150106.143438,2862,2,1520616,-2,2861,1478,2862,388,0
20150106.143439,2862,2,1520618,-2,2861,1481,2862,390,0
20150106.143442,2862,2,1520620,0,2861,1482,2862,391,0
20150106.143442,2862,2,1520622,0,2861,1482,2862,393,0
20150106.143443,2862,10,1520632,0,2861,1482,2862,390,0
20150106.143445,2861,60,1520692,36,2861,1453,2862,394,0
20150106.143446,2862,4,1520696,0,2861,1453,2862,393,1
20150106.143447,2862,4,1520700,-4,2861,1453,2862,391,1
20150106.143447,2861,2,1520702,0,2861,1452,2862,404,0
20150106.143448,2862,4,1520706,0,2861,1452,2862,401,1
20150106.143451,2861,26,1520732,26,2861,1438,2862,408,0
20150106.143452,2862,8,1520740,0,2861,1438,2862,405,1
20150106.143453,2861,20,1520760,0,2861,1428,2862,405,0
20150106.143454,2861,24,1520784,4,2861,1411,2862,405,0
20150106.143454,2862,8,1520792,-8,2861,1414,2862,401,1
20150106.143455,2861,92,1520884,-84,2861,1412,2862,358,0
20150106.143455,2861,400,1521284,-134,2861,1212,2862,375,0
20150106.143457,2861,400,1521684,188,2861,1012,2862,377,0
20150106.143457,2861,100,1521784,84,2861,948,2862,385,0
20150106.143458,2861,26,1521810,0,2861,935,2862,387,0
20150106.143459,2861,2,1521812,0,2861,934,2862,390,0
20150106.143459,2861,2,1521814,0,2861,933,2862,389,0
20150106.1435,2861,12,1521826,0,2861,928,2862,410,0
20150106.143501,2861,2,1521828,2,2861,925,2862,413,0
20150106.143502,2862,6,1521834,0,2861,925,2862,411,1
20150106.143503,2862,16,1521850,0,2861,925,2862,404,1
20150106.143503,2861,6,1521856,-4,2861,924,2862,402,0
20150106.143506,2861,10,1521866,2,2861,920,2862,413,0
20150106.143507,2861,2,1521868,0,2861,924,2862,416,0
20150106.14351,2861,4,1521872,0,2861,922,2862,418,0
20150106.14351,2861,20,1521892,20,2861,912,2862,428,0
20150106.143511,2861,2,1521894,2,2861,911,2862,458,0
20150106.143512,2862,202,1522096,-54,2861,861,2862,408,1
20150106.143513,2861,2,1522098,0,2861,860,2862,409,0
20150106.143514,2862,22,1522120,-20,2861,788,2862,379,1
20150106.143515,2861,6,1522126,-6,2860,1138,2862,412,0
20150106.143516,2861,2,1522128,0,2861,791,2862,412,0
20150106.143517,2862,16,1522144,0,2861,825,2862,379,1
20150106.143517,2861,2,1522146,0,2861,874,2862,381,0
20150106.143518,2862,2,1522148,0,2861,887,2862,379,1
20150106.143521,2861,10,1522158,-2,2861,885,2862,395,0
20150106.143522,2862,2,1522160,0,2861,886,2862,394,1
20150106.143526,2861,2,1522162,-2,2861,892,2862,389,0
20150106.143526,2861,2,1522164,0,2861,892,2862,389,0
20150106.143527,2861,2,1522166,0,2861,901,2862,376,0
20150106.143531,2861,2,1522168,0,2861,932,2862,363,0
20150106.143532,2862,16,1522184,0,2861,935,2862,356,1
20150106.143532,2862,20,1522204,-20,2861,935,2862,349,1
20150106.143535,2862,2,1522206,-2,2861,936,2862,355,1
20150106.143535,2861,208,1522414,-110,2861,836,2862,355,0
20150106.143536,2861,2,1522416,0,2861,841,2862,355,0
20150106.143538,2861,20,1522436,0,2861,845,2862,358,0
20150106.14354,2862,10,1522446,-10,2861,838,2862,356,1
20150106.143541,2861,4,1522450,-4,2861,836,2862,355,0
20150106.143542,2862,4,1522454,-4,2861,839,2862,378,1
20150106.143545,2861,2,1522456,-2,2861,840,2862,404,0
20150106.143546,2861,6,1522462,-6,2861,837,2862,405,0
20150106.143547,2862,16,1522478,0,2861,837,2862,397,1
20150106.14355,2862,6,1522484,-6,2861,838,2862,400,1
20150106.143551,2862,8,1522492,0,2861,836,2862,396,1
20150106.143551,2861,22,1522514,6,2861,833,2862,396,0
20150106.143553,2861,2,1522516,-2,2861,833,2862,379,0
20150106.143555,2861,4,1522520,0,2861,831,2862,377,0
20150106.143555,2861,2,1522522,0,2861,832,2862,378,0
20150106.143556,2862,2,1522524,-2,2861,833,2862,376,1
20150106.143556,2861,4,1522528,0,2861,831,2862,376,0
20150106.143557,2861,82,1522610,46,2860,1155,2862,377,0
20150106.143601,2861,106,1522716,-94,2860,1122,2862,377,0
20150106.143601,2862,18,1522734,0,2860,1125,2862,334,1
20150106.143603,2862,202,1522936,100,2860,1132,2862,333,1
20150106.143603,2861,2,1522938,-2,2860,1133,2862,335,0
20150106.143604,2861,10,1522948,-6,2861,513,2862,385,0
20150106.143606,2862,20,1522968,-20,2861,498,2862,376,1
20150106.143606,2861,4,1522972,4,2861,496,2862,376,0
20150106.143607,2861,4,1522976,0,2861,494,2862,374,0
20150106.143608,2862,4,1522980,-2,2861,491,2862,373,1
20150106.143609,2861,12,1522992,8,2861,489,2862,368,0
20150106.143611,2861,2,1522994,0,2861,548,2862,370,0
20150106.143613,2861,6,1523000,-2,2861,538,2862,472,0
20150106.143613,2862,2,1523002,-2,2861,538,2862,474,1
20150106.143615,2862,2,1523004,0,2861,63,2862,477,1
20150106.143615,2861,60,1523064,0,2861,34,2862,486,0
20150106.143617,2861,68,1523132,0,2860,1857,2861,126,0
20150106.143617,2861,2,1523134,-2,2860,1857,2861,160,0
20150106.143617,2861,50,1523184,0,2860,1861,2861,159,0
20150106.143619,2861,2,1523186,2,2860,1858,2861,168,0
20150106.143621,2860,50,1523236,26,2860,1832,2861,172,0
20150106.143621,2861,6,1523242,2,2860,1832,2861,176,1
20150106.143622,2860,244,1523486,-116,2860,1712,2861,266,0
20150106.143623,2860,10,1523496,-10,2860,1707,2861,347,0
20150106.143623,2860,116,1523612,-96,2860,1649,2861,362,0
20150106.143624,2860,16,1523628,2,2860,1642,2861,512,0
20150106.143624,2860,14,1523642,0,2860,1637,2861,554,0
20150106.143625,2860,4,1523646,0,2860,1656,2861,588,0
20150106.143626,2861,2,1523648,0,2860,1656,2861,587,1
20150106.143627,2860,2,1523650,0,2860,1655,2861,604,0
20150106.143628,2861,30,1523680,0,2860,1655,2861,593,1
20150106.143629,2860,2,1523682,2,2860,1654,2861,593,0
20150106.14363,2860,40,1523722,-2,2860,1638,2861,588,0
20150106.14363,2860,20,1523742,16,2860,1628,2861,588,0
20150106.143632,2860,48,1523790,18,2860,1612,2861,583,0
20150106.143632,2860,4,1523794,-4,2860,1610,2861,583,0
20150106.143633,2860,4,1523798,2,2860,1608,2861,583,0
20150106.143634,2860,62,1523860,12,2860,1583,2861,585,0
20150106.143635,2861,6,1523866,6,2860,1583,2861,582,1
20150106.143635,2861,40,1523906,0,2860,1583,2861,563,1
20150106.143638,2860,22,1523928,20,2860,1570,2861,570,0
20150106.143638,2860,2,1523930,0,2860,1568,2861,576,0
20150106.143639,2861,6,1523936,4,2860,1567,2861,577,1
20150106.143639,2861,2,1523938,2,2860,1577,2861,486,1
20150106.143641,2861,2,1523940,0,2860,1579,2861,473,1
20150106.143642,2860,2,1523942,0,2860,1579,2861,544,0
20150106.143643,2860,2,1523944,2,2860,1578,2861,545,0
20150106.143644,2861,2,1523946,0,2860,1584,2861,475,1
20150106.143646,2860,2,1523948,0,2860,1583,2861,476,0
20150106.143647,2861,12,1523960,2,2860,1584,2861,489,1
20150106.143647,2860,40,1524000,-2,2860,1564,2861,489,0
20150106.143651,2860,6,1524006,0,2860,1713,2861,450,0
20150106.143651,2860,2,1524008,-2,2860,1712,2861,450,0
20150106.143653,2861,4,1524012,0,2860,1572,2861,451,1
20150106.143653,2860,2,1524014,-2,2860,1571,2861,451,0
20150106.143656,2860,10,1524024,0,2860,1566,2861,451,0
20150106.143657,2860,2,1524026,-2,2860,1565,2861,487,0
20150106.143657,2860,48,1524074,12,2860,1541,2861,484,0
20150106.143658,2860,2,1524076,-2,2860,1551,2861,484,0
20150106.143659,2861,4,1524080,0,2860,1551,2861,528,1
20150106.143659,2860,4,1524084,-4,2860,1551,2861,528,0
20150106.1437,2860,10,1524094,0,2860,1591,2861,529,0
20150106.143701,2861,8,1524102,8,2860,1591,2861,524,1
20150106.143702,2861,140,1524242,64,2860,1590,2861,451,1
20150106.143703,2860,2,1524244,2,2860,1590,2861,451,0
20150106.143704,2860,4,1524248,-4,2860,1588,2861,534,0
20150106.143705,2860,12,1524260,-8,2860,1584,2861,534,0
20150106.143707,2860,20,1524280,0,2860,1574,2861,537,0
20150106.143709,2860,2,1524282,-2,2860,1574,2861,538,0
20150106.143711,2861,10,1524292,10,2860,1624,2861,536,1
20150106.143713,2860,8,1524300,0,2860,1624,2861,715,0
20150106.143713,2861,4,1524304,-4,2860,1624,2861,714,1
20150106.143714,2861,6,1524310,-6,2860,1625,2861,711,1
20150106.143716,2860,4,1524314,-4,2860,1625,2861,710,0
20150106.143716,2861,4,1524318,-4,2860,1625,2861,708,1
20150106.143717,2861,18,1524336,0,2860,1625,2861,749,1
20150106.143718,2860,2,1524338,-2,2860,1626,2861,749,0
20150106.14372,2860,4,1524342,0,2860,1614,2861,749,0
20150106.143721,2860,24,1524366,18,2860,1602,2861,749,0
20150106.143721,2861,10,1524376,8,2860,1603,2861,748,1
20150106.143722,2861,40,1524416,0,2860,1603,2861,728,1
20150106.143723,2861,2,1524418,0,2860,1613,2861,728,1
20150106.143724,2860,20,1524438,12,2860,1603,2861,728,0
20150106.143724,2860,4,1524442,4,2860,1601,2861,728,0
20150106.143725,2860,4,1524446,2,2860,1650,2861,727,0
20150106.143726,2860,20,1524466,-16,2860,1641,2861,727,0
20150106.143727,2860,100,1524566,12,2860,1593,2861,732,0
20150106.143727,2861,220,1524786,-220,2860,1594,2861,624,1
20150106.143728,2860,48,1524834,-48,2860,1582,2861,610,0
20150106.143729,2860,4,1524838,-2,2860,1580,2861,611,0
20150106.143733,2860,2,1524840,0,2860,1633,2861,612,0
20150106.143734,2861,2,1524842,0,2860,1631,2861,691,1
20150106.14374,2861,2,1524844,0,2860,1539,2861,798,1
20150106.143741,2861,4,1524848,-4,2860,1538,2861,796,1
20150106.143743,2861,2,1524850,-2,2860,1540,2861,799,1
20150106.143743,2860,100,1524950,-100,2860,1490,2861,799,0
20150106.143744,2861,56,1525006,-54,2860,1491,2861,772,1
20150106.143745,2860,2,1525008,0,2860,1488,2861,772,0
20150106.143748,2861,2,1525010,0,2860,1487,2861,771,1
20150106.143749,2860,2,1525012,0,2860,1506,2861,772,0
20150106.143751,2861,2,1525014,0,2860,1507,2861,772,1
20150106.143752,2861,40,1525054,0,2860,1507,2861,752,1
20150106.143753,2861,2,1525056,0,2860,1549,2861,801,1
20150106.143759,2861,4,1525060,-2,2860,1555,2861,801,1
20150106.143759,2861,24,1525084,-4,2860,1559,2861,791,1
20150106.1438,2860,2,1525086,0,2860,1559,2861,791,0
20150106.143801,2861,20,1525106,0,2860,1564,2861,912,1
20150106.143803,2860,2,1525108,0,2860,1569,2861,936,0
20150106.143804,2861,2,1525110,0,2860,1559,2861,935,1
20150106.143804,2861,4,1525114,-4,2860,1559,2861,933,1
20150106.143805,2860,22,1525136,-20,2860,1560,2861,924,0
20150106.143806,2860,2,1525138,0,2860,1559,2861,925,0
20150106.143807,2861,4,1525142,0,2860,1562,2861,923,1
20150106.143808,2861,2,1525144,0,2860,1567,2861,923,1
20150106.143809,2861,2,1525146,0,2860,1565,2861,922,1
20150106.14381,2860,2,1525148,0,2860,1564,2861,1187,0
20150106.143811,2861,2,1525150,-2,2860,1564,2861,1186,1
20150106.143812,2860,4,1525154,-4,2860,1562,2861,1188,0
20150106.143814,2860,4,1525158,-2,2860,1560,2861,1188,0
20150106.143816,2861,2,1525160,0,2860,1559,2861,1187,1
20150106.143817,2861,2,1525162,-2,2860,1560,2861,1196,1
20150106.143817,2860,80,1525242,-80,2860,1520,2861,1196,0
20150106.143818,2860,2,1525244,-2,2860,1519,2861,1299,0
20150106.143821,2861,26,1525270,-26,2860,1518,2861,1293,1
20150106.143822,2860,2,1525272,-2,2860,1518,2861,1293,0
20150106.143823,2861,2,1525274,-2,2860,1520,2861,1292,1
20150106.143824,2860,10,1525284,-10,2860,1515,2861,1261,0
20150106.143824,2860,4,1525288,-4,2860,1513,2861,1271,0
20150106.143825,2860,2,1525290,0,2860,1512,2861,1274,0
20150106.143826,2861,4,1525294,-2,2860,1512,2861,1273,1
20150106.143827,2860,56,1525350,0,2860,1484,2861,1273,0
20150106.143828,2860,4,1525354,-4,2860,1484,2861,1273,0
20150106.143829,2860,562,1525916,-562,2860,1163,2861,1274,0
20150106.14383,2860,32,1525948,-32,2860,1160,2861,1259,0
20150106.14383,2860,20,1525968,-20,2860,1170,2861,1259,0
20150106.143831,2860,22,1525990,0,2860,1159,2861,1289,0
20150106.143832,2860,8,1525998,-8,2860,1155,2861,1289,0
20150106.143833,2860,2,1526000,0,2860,1154,2861,1289,0
20150106.143834,2860,40,1526040,0,2860,1130,2861,1289,0
20150106.143835,2860,4,1526044,-4,2860,1130,2861,1288,0
20150106.143837,2861,2,1526046,-2,2860,1127,2861,1288,1
20150106.143838,2860,2,1526048,0,2860,1128,2861,1288,0
20150106.14384,2860,4,1526052,-2,2860,1141,2861,1188,0
20150106.143841,2860,4,1526056,-2,2860,1139,2861,1191,0
20150106.143843,2860,2,1526058,0,2860,1138,2861,1191,0
20150106.143843,2860,2,1526060,-2,2860,1136,2861,1191,0
20150106.143844,2860,4,1526064,-2,2860,1136,2861,1202,0
20150106.143845,2860,410,1526474,-294,2860,929,2861,1203,0
20150106.143846,2860,42,1526516,2,2860,908,2861,1203,0
20150106.143846,2860,402,1526918,-130,2860,707,2861,1204,0
20150106.143847,2860,656,1527574,-208,2859,422,2861,1306,0
20150106.143847,2860,400,1527974,-400,2859,695,2860,56,0
20150106.143848,2859,10,1527984,6,2859,691,2860,472,0
20150106.143848,2859,206,1528190,-18,2859,588,2860,600,0
20150106.143849,2859,654,1528844,404,2858,1245,2860,805,0
20150106.143849,2859,4,1528848,-4,2858,1245,2860,810,0
20150106.14385,2859,236,1529084,-16,2859,111,2860,856,0
20150106.14385,2860,6,1529090,0,2859,113,2860,872,1
20150106.143851,2859,2,1529092,0,2859,132,2860,873,0
20150106.143852,2860,6,1529098,0,2859,132,2860,870,1
20150106.143852,2859,4,1529102,0,2859,131,2860,920,0
20150106.143853,2859,106,1529208,-8,2859,98,2860,925,0
20150106.143854,2859,10,1529218,-10,2859,129,2860,925,0
20150106.143854,2859,40,1529258,-38,2859,114,2860,929,0
20150106.143855,2859,8,1529266,-4,2859,111,2860,940,0
20150106.143855,2860,6,1529272,-2,2859,104,2860,941,1
20150106.143856,2859,2,1529274,-2,2859,105,2860,941,0
20150106.143857,2860,46,1529320,-2,2859,116,2860,941,1
20150106.143858,2859,6,1529326,-4,2859,211,2860,940,0
20150106.143858,2859,2,1529328,-2,2859,222,2860,940,0
20150106.143859,2859,4,1529332,-2,2859,221,2860,940,0
20150106.143859,2859,512,1529844,-244,2858,1186,2859,882,0
20150106.1439,2859,70,1529914,-2,2858,1186,2859,896,0
20150106.143901,2858,22,1529936,-22,2858,1178,2859,894,0
20150106.143901,2859,12,1529948,-10,2858,1177,2859,920,1
20150106.143902,2859,34,1529982,-34,2858,1172,2859,939,1
20150106.143902,2859,4,1529986,-4,2858,1173,2859,938,1
20150106.143903,2859,2,1529988,-2,2858,1171,2859,947,1
20150106.143904,2858,4,1529992,0,2858,1169,2859,948,0
20150106.143904,2859,18,1530010,-14,2858,1163,2859,949,1
20150106.143905,2859,20,1530030,-8,2858,1160,2859,942,1
20150106.143905,2858,2,1530032,2,2858,1170,2859,946,0
20150106.143906,2859,18,1530050,0,2858,1171,2859,941,1
20150106.143906,2858,16,1530066,14,2858,1163,2859,942,0
20150106.143907,2858,2,1530068,0,2858,1162,2859,942,0
20150106.143907,2858,56,1530124,4,2858,1136,2859,942,0
20150106.143908,2858,2,1530126,0,2858,1138,2859,921,0
20150106.143908,2859,8,1530134,-2,2858,1136,2859,919,1
20150106.143909,2858,6,1530140,0,2858,1136,2859,919,0
20150106.14391,2858,22,1530162,20,2858,1126,2859,919,0
20150106.143911,2858,4,1530166,4,2858,1125,2859,936,0
20150106.143911,2859,100,1530266,-100,2858,1125,2859,886,1
20150106.143912,2859,2,1530268,0,2858,1125,2859,896,1
20150106.143913,2859,42,1530310,-2,2858,1120,2859,885,1
20150106.143913,2859,6,1530316,-4,2858,1121,2859,886,1
20150106.143914,2859,4,1530320,0,2858,1120,2859,885,1
20150106.143914,2858,8,1530328,2,2858,1116,2859,885,0
20150106.143915,2858,8,1530336,0,2858,1119,2859,894,0
20150106.143916,2859,42,1530378,-26,2858,1108,2859,887,1
20150106.143917,2858,22,1530400,-2,2858,1133,2859,896,0
20150106.14392,2858,2,1530402,-2,2858,1142,2859,1026,0
20150106.14392,2858,10,1530412,-10,2858,1137,2859,1026,0
20150106.143921,2858,1718,1532130,870,2858,282,2859,1027,0
20150106.143922,2857,568,1532698,246,2857,748,2858,256,0
20150106.143922,2857,294,1532992,88,2857,575,2858,511,0
20150106.143923,2857,62,1533054,0,2857,509,2858,578,0
20150106.143923,2858,4,1533058,4,2857,491,2858,579,1
20150106.143925,2858,38,1533096,32,2857,348,2858,601,1
20150106.143925,2857,14,1533110,12,2857,315,2858,597,0
20150106.143926,2857,6,1533116,4,2857,274,2858,597,0
20150106.143926,2858,108,1533224,6,2857,223,2858,596,1
20150106.143927,2857,120,1533344,20,2857,170,2858,583,0
20150106.143927,2858,4,1533348,2,2857,272,2858,585,1
20150106.143928,2857,22,1533370,22,2857,279,2858,585,0
20150106.143928,2857,222,1533592,-54,2857,173,2858,589,0
20150106.143929,2857,274,1533866,-152,2857,67,2858,568,0
20150106.143929,2857,20,1533886,-14,2857,59,2858,568,0
20150106.14393,2857,12,1533898,-8,2857,56,2858,581,0
20150106.14393,2857,154,1534052,-122,2857,308,2858,631,0
20150106.143931,2857,2,1534054,-2,2857,319,2858,631,0
20150106.143931,2857,408,1534462,-6,2857,117,2858,625,0
20150106.143932,2857,14,1534476,-10,2857,113,2858,656,0
20150106.143933,2857,18,1534494,-6,2857,110,2858,666,0
20150106.143934,2857,6,1534500,-2,2857,132,2858,666,0
20150106.143934,2857,16,1534516,-16,2857,134,2858,666,0
20150106.143935,2857,6,1534522,-4,2857,132,2858,667,0
20150106.143935,2857,20,1534542,0,2857,130,2858,667,0
20150106.143936,2858,46,1534588,0,2857,214,2858,647,1
20150106.143937,2857,2,1534590,0,2857,244,2858,647,0
20150106.143937,2858,20,1534610,0,2857,240,2858,642,1
20150106.143938,2857,20,1534630,0,2857,237,2858,642,0
20150106.143938,2857,14,1534644,-4,2857,235,2858,643,0
20150106.143939,2857,6,1534650,0,2857,254,2858,654,0
20150106.14394,2858,4,1534654,0,2857,258,2858,653,1
20150106.143941,2857,2,1534656,0,2857,259,2858,655,0
20150106.143942,2857,4,1534660,-4,2857,261,2858,657,0
20150106.143942,2857,4,1534664,-4,2857,259,2858,657,0
20150106.143943,2857,420,1535084,-108,2857,53,2858,657,0
20150106.143943,2858,4,1535088,2,2857,53,2858,656,1
20150106.143944,2857,42,1535130,-12,2857,70,2858,644,0
20150106.143944,2857,32,1535162,4,2857,54,2858,644,0
20150106.143945,2857,16,1535178,0,2857,46,2858,650,0
20150106.143946,2857,42,1535220,-12,2857,229,2858,650,0
20150106.143946,2857,2,1535222,0,2857,229,2858,649,0
20150106.143947,2857,478,1535700,66,2856,360,2857,531,0
20150106.143947,2857,32,1535732,8,2856,260,2857,533,0
20150106.143948,2857,8,1535740,2,2856,256,2857,530,0
20150106.143949,2857,12,1535752,4,2856,257,2857,559,0
20150106.14395,2856,46,1535798,-32,2856,237,2857,610,0
20150106.14395,2856,10,1535808,0,2856,233,2857,612,0
20150106.143951,2856,54,1535862,10,2856,209,2857,613,0
20150106.143951,2856,14,1535876,2,2856,205,2857,614,0
20150106.143952,2857,76,1535952,0,2856,206,2857,576,1
20150106.143952,2856,2,1535954,2,2856,210,2857,477,0
20150106.143953,2856,6,1535960,2,2856,239,2857,628,0
20150106.143953,2856,6,1535966,0,2856,237,2857,628,0
20150106.143954,2856,1086,1537052,-326,2856,243,2857,100,0
20150106.143954,2857,218,1537270,-162,2857,2,2858,614,1
20150106.143955,2857,10,1537280,-4,2857,29,2858,612,1
20150106.143955,2857,2,1537282,2,2857,33,2858,613,1
20150106.143955,2857,4,1537286,0,2857,34,2858,612,1
20150106.143956,2857,12,1537298,-2,2857,5,2858,651,1
20150106.143957,2857,24,1537322,-4,2857,51,2858,659,1
20150106.143958,2858,12,1537334,0,2857,46,2858,660,1
20150106.143958,2857,60,1537394,0,2857,16,2858,660,0
20150106.143959,2857,2,1537396,0,2857,19,2858,649,0
20150106.143959,2857,28,1537424,0,2857,6,2858,649,0
20150106.144,2857,2,1537426,0,2857,7,2858,649,0
20150106.144,2857,6,1537432,2,2857,24,2858,648,0
20150106.144001,2857,2,1537434,2,2857,24,2858,648,0
20150106.144001,2857,10,1537444,8,2857,70,2858,648,0
20150106.144002,2857,164,1537608,48,2856,408,2857,481,0
20150106.144002,2857,10,1537618,10,2856,367,2857,478,0
20150106.144003,2856,22,1537640,16,2856,365,2857,495,0
20150106.144003,2857,6,1537646,4,2856,356,2857,500,1
20150106.144004,2857,12,1537658,12,2856,355,2857,501,1
20150106.144005,2857,10,1537668,10,2856,356,2857,496,1
20150106.144005,2857,8,1537676,8,2856,357,2857,492,1
20150106.144005,2857,14,1537690,4,2856,357,2857,485,1
20150106.144006,2856,24,1537714,-16,2856,396,2857,483,0
20150106.144006,2856,6,1537720,2,2856,395,2857,481,0
20150106.144007,2857,4,1537724,4,2856,395,2857,479,1
20150106.144007,2857,14,1537738,10,2856,397,2857,474,1
20150106.144008,2856,676,1538414,246,2856,84,2857,473,0
20150106.144009,2856,6,1538420,0,2856,74,2857,475,0
20150106.144009,2856,2,1538422,0,2856,74,2857,475,0
20150106.14401,2857,30,1538452,-2,2856,44,2857,476,1
20150106.14401,2856,54,1538506,52,2856,27,2857,476,0
20150106.14401,2857,10,1538516,0,2856,40,2857,473,1
20150106.144012,2856,24,1538540,22,2856,46,2857,475,0
20150106.144012,2856,20,1538560,10,2856,49,2857,471,0
20150106.144012,2856,2,1538562,0,2856,51,2857,471,0
20150106.144013,2856,60,1538622,34,2856,35,2857,475,0
20150106.144014,2856,134,1538756,-6,2856,19,2857,498,0
20150106.144015,2856,2,1538758,0,2856,58,2857,500,0
20150106.144016,2857,22,1538780,12,2856,53,2857,502,1
20150106.144016,2856,30,1538810,-10,2856,41,2857,502,0
20150106.144016,2856,20,1538830,4,2856,37,2857,499,0
20150106.144017,2856,108,1538938,82,2856,65,2857,491,0
20150106.144018,2856,40,1538978,0,2856,66,2857,491,0
20150106.144018,2857,12,1538990,10,2856,63,2857,527,1
20150106.144019,2856,6,1538996,4,2856,60,2857,527,0
20150106.14402,2856,30,1539026,0,2856,48,2857,527,0
20150106.144021,2856,4,1539030,4,2856,46,2857,532,0
20150106.144021,2856,8,1539038,8,2856,50,2857,543,0
20150106.144022,2857,4,1539042,0,2856,62,2857,542,1
20150106.144023,2856,42,1539084,32,2856,44,2857,551,0
20150106.144024,2856,4,1539088,2,2856,45,2857,553,0
20150106.144025,2856,42,1539130,40,2856,32,2857,552,0
20150106.144026,2856,22,1539152,6,2856,28,2857,562,0
20150106.144026,2856,12,1539164,0,2856,24,2857,563,0
20150106.144027,2856,4,1539168,4,2856,46,2857,564,0
20150106.144027,2857,2,1539170,2,2856,46,2857,567,1
20150106.144028,2856,2,1539172,0,2856,47,2857,570,0
20150106.144028,2857,4,1539176,2,2856,50,2857,569,1
20150106.144029,2857,14,1539190,2,2856,54,2857,568,1
20150106.144029,2856,14,1539204,12,2856,47,2857,568,0
20150106.14403,2856,44,1539248,36,2856,41,2857,568,0
20150106.144032,2857,2,1539250,0,2856,57,2857,602,1
20150106.144032,2856,2,1539252,0,2856,56,2857,602,0
20150106.144033,2856,2,1539254,2,2856,68,2857,602,0
20150106.144034,2856,24,1539278,4,2856,82,2857,593,0
20150106.144035,2856,6,1539284,6,2856,101,2857,593,0
20150106.144035,2857,6,1539290,4,2856,95,2857,592,1
20150106.144035,2857,4,1539294,0,2856,98,2857,590,1
20150106.144036,2856,6,1539300,2,2856,122,2857,588,0
20150106.144037,2856,506,1539806,-234,2856,52,2857,605,0
20150106.144037,2856,4,1539810,0,2856,61,2857,606,0
20150106.144038,2856,10,1539820,0,2856,62,2857,605,0
20150106.144038,2856,4,1539824,0,2856,64,2857,605,0
20150106.144039,2856,42,1539866,0,2856,64,2857,606,0
20150106.14404,2856,2,1539868,0,2856,63,2857,606,0
20150106.144041,2856,6,1539874,-2,2856,61,2857,606,0
20150106.144041,2856,2,1539876,0,2856,61,2857,608,0
20150106.144043,2856,10,1539886,0,2856,57,2857,608,0
20150106.144043,2857,10,1539896,-6,2856,53,2857,607,1
20150106.144044,2856,42,1539938,-26,2856,33,2857,607,0
20150106.144044,2856,2,1539940,-2,2856,37,2857,607,0
20150106.144045,2856,2,1539942,-2,2856,36,2857,607,0
20150106.144046,2856,28,1539970,-24,2856,35,2857,601,0
20150106.144047,2856,8,1539978,2,2856,31,2857,601,0
20150106.144047,2856,46,1540024,28,2856,36,2857,601,0
20150106.144048,2856,20,1540044,-10,2856,26,2857,601,0
20150106.144048,2856,2,1540046,0,2856,25,2857,603,0
20150106.144049,2857,4,1540050,4,2856,26,2857,601,1
20150106.144049,2856,2,1540052,2,2856,30,2857,601,0
20150106.14405,2857,30,1540082,30,2856,35,2857,586,1
20150106.144051,2856,6,1540088,0,2856,33,2857,586,0
20150106.144052,2856,20,1540108,20,2856,51,2857,589,0
20150106.144053,2856,2,1540110,2,2856,73,2857,591,0
20150106.144054,2856,42,1540152,26,2856,53,2857,591,0
20150106.144054,2856,2,1540154,0,2856,93,2857,591,0
20150106.144055,2857,2,1540156,2,2856,93,2857,589,1
20150106.144055,2857,10,1540166,10,2856,101,2857,585,1
20150106.144056,2856,10,1540176,-10,2856,96,2857,585,0
20150106.144057,2856,2,1540178,-2,2856,106,2857,585,0
20150106.144059,2857,10,1540188,0,2856,117,2857,579,1
20150106.144059,2856,2,1540190,0,2856,127,2857,579,0
20150106.144059,2857,2,1540192,0,2856,129,2857,578,1
20150106.144102,2857,4,1540196,0,2856,136,2857,580,1
20150106.144103,2857,2,1540198,0,2856,141,2857,580,1
20150106.144104,2857,6,1540204,0,2856,217,2857,577,1
20150106.144105,2856,2,1540206,-2,2856,226,2857,577,0
20150106.144106,2856,2,1540208,0,2856,233,2857,577,0
20150106.144106,2857,4,1540212,2,2856,232,2857,576,1
20150106.144107,2857,26,1540238,0,2856,222,2857,574,1
20150106.144108,2857,2,1540240,2,2856,228,2857,573,1
20150106.144108,2856,16,1540256,4,2856,222,2857,571,0
20150106.144109,2856,2,1540258,2,2856,233,2857,571,0
20150106.14411,2856,10,1540268,10,2856,228,2857,571,0
20150106.14411,2857,2,1540270,2,2856,228,2857,571,1
20150106.144111,2856,138,1540408,0,2856,159,2857,571,0
20150106.144111,2856,14,1540422,-2,2856,153,2857,566,0
20150106.144112,2856,2,1540424,0,2856,156,2857,568,0
20150106.144113,2856,2,1540426,0,2856,155,2857,568,0
20150106.144115,2856,2,1540428,0,2856,165,2857,576,0
20150106.144116,2857,6,1540434,6,2856,195,2857,573,1
20150106.144116,2857,16,1540450,16,2856,195,2857,566,1
20150106.144117,2857,10,1540460,10,2856,195,2857,561,1
20150106.144118,2856,4,1540464,2,2856,204,2857,561,0
20150106.144119,2856,402,1540866,-226,2856,5,2857,561,0
20150106.144119,2856,116,1540982,34,2855,1277,2856,1,0
20150106.14412,2856,76,1541058,0,2855,1280,2856,1,0
20150106.14412,2856,178,1541236,0,2856,2,2857,508,0
20150106.144121,2856,4,1541240,2,2856,103,2857,507,0
20150106.144122,2856,10,1541250,-10,2856,99,2857,506,0
20150106.144122,2857,2,1541252,0,2856,100,2857,505,1
20150106.144123,2856,2,1541254,0,2856,100,2857,505,0
20150106.144124,2856,8,1541262,0,2856,672,2857,505,0
20150106.144125,2857,20,1541282,20,2856,681,2857,495,1
20150106.144127,2856,2,1541284,0,2856,693,2857,505,0
20150106.144127,2856,2,1541286,0,2856,694,2857,507,0
20150106.144128,2856,72,1541358,0,2856,664,2857,508,0
20150106.14413,2856,2,1541360,0,2856,668,2857,504,0
20150106.14413,2857,308,1541668,0,2856,668,2857,351,1
20150106.144131,2857,4,1541672,0,2856,668,2857,348,1
20150106.144132,2857,4,1541676,-2,2856,886,2857,345,1
20150106.144134,2857,2,1541678,0,2856,1001,2857,345,1
20150106.144134,2857,2,1541680,0,2856,1048,2857,344,1
20150106.144135,2857,298,1541978,36,2856,1053,2857,195,1
20150106.144135,2857,326,1542304,-64,2856,1058,2857,31,1
20150106.144136,2857,64,1542368,-26,2857,339,2858,716,1
20150106.144137,2857,14,1542382,-12,2857,368,2858,716,1
20150106.144141,2857,4,1542386,0,2857,157,2858,734,1
20150106.144142,2858,250,1542636,134,2857,19,2858,733,1
20150106.144143,2857,40,1542676,-20,2856,1072,2857,104,0
20150106.144144,2857,2,1542678,0,2856,1067,2857,103,0
20150106.144145,2857,2,1542680,0,2856,1057,2857,106,0
20150106.144146,2856,2,1542682,0,2856,1053,2857,136,0
20150106.144146,2857,18,1542700,4,2856,1056,2857,127,1
20150106.144147,2857,102,1542802,86,2856,1059,2857,97,1
20150106.144148,2857,202,1543004,-170,2857,51,2858,686,1
20150106.144149,2857,10,1543014,0,2857,100,2858,686,1
20150106.144151,2858,14,1543028,-8,2857,147,2858,679,1
20150106.144151,2858,6,1543034,6,2857,218,2858,676,1
20150106.144152,2858,4,1543038,2,2857,218,2858,674,1
20150106.144153,2857,6,1543044,0,2857,216,2858,674,0
20150106.144153,2857,6,1543050,-6,2857,220,2858,674,0
20150106.144154,2858,2,1543052,2,2857,248,2858,673,1
20150106.144159,2857,6,1543058,-6,2857,269,2858,674,0
20150106.144201,2857,2,1543060,0,2857,311,2858,677,0
20150106.144201,2858,124,1543184,0,2857,309,2858,619,1
20150106.144202,2858,16,1543200,16,2857,309,2858,611,1
20150106.144203,2857,2,1543202,0,2857,308,2858,611,0
20150106.144204,2857,2,1543204,0,2857,307,2858,622,0
20150106.144205,2858,308,1543512,-240,2857,307,2858,418,1
20150106.144206,2857,4,1543516,-4,2857,330,2858,426,0
20150106.144209,2857,6,1543522,0,2857,335,2858,427,0
20150106.144209,2857,10,1543532,-8,2857,344,2858,511,0
20150106.14421,2858,2,1543534,-2,2857,351,2858,510,1
20150106.14421,2858,20,1543554,0,2857,351,2858,500,1
20150106.144212,2857,4,1543558,-4,2857,359,2858,510,0
20150106.144214,2858,2,1543560,0,2857,358,2858,510,1
20150106.144216,2857,2,1543562,0,2857,309,2858,514,0
20150106.144217,2858,4,1543566,-4,2857,309,2858,512,1
20150106.144219,2857,8,1543574,-4,2857,297,2858,777,0
20150106.144221,2858,2,1543576,0,2857,317,2858,766,1
20150106.144222,2857,4,1543580,0,2857,317,2858,756,0
20150106.144222,2857,20,1543600,-20,2857,324,2858,756,0
20150106.144224,2858,36,1543636,-36,2857,308,2858,755,1
20150106.144225,2857,624,1544260,336,2856,896,2857,690,0
20150106.144225,2857,2,1544262,0,2856,896,2857,1,0
20150106.144226,2857,4,1544266,2,2856,909,2857,70,0
20150106.144226,2857,8,1544274,6,2856,891,2857,100,0
20150106.144227,2857,44,1544318,0,2856,891,2857,113,0
20150106.144228,2857,6,1544324,0,2856,892,2857,131,0
20150106.144228,2856,2,1544326,2,2856,891,2857,131,0
20150106.144229,2857,6,1544332,0,2856,891,2857,128,1
20150106.14423,2857,20,1544352,-20,2856,891,2857,119,1
20150106.144232,2857,22,1544374,-20,2856,892,2857,93,1
20150106.144232,2857,2,1544376,0,2856,893,2857,124,1
20150106.144234,2857,4,1544380,0,2856,892,2857,123,1
20150106.144234,2857,6,1544386,0,2856,898,2857,120,1
20150106.144235,2857,16,1544402,-14,2856,902,2857,116,1
20150106.144236,2856,2,1544404,0,2856,902,2857,117,0
20150106.144236,2856,50,1544454,-28,2856,898,2857,99,0
20150106.144237,2857,4,1544458,-2,2856,899,2857,118,1
20150106.144238,2857,12,1544470,2,2856,947,2857,113,1
20150106.14424,2857,4,1544474,0,2856,993,2857,146,1
20150106.14424,2857,6,1544480,4,2856,992,2857,139,1
20150106.144241,2857,10,1544490,-10,2856,992,2857,134,1
20150106.144244,2857,2,1544492,-2,2856,1005,2857,140,1
20150106.144244,2856,2,1544494,0,2856,1007,2857,160,0
20150106.144246,2856,6,1544500,0,2856,1004,2857,160,0
20150106.144247,2857,22,1544522,-20,2856,1004,2857,149,1
20150106.144248,2857,2,1544524,-2,2856,1006,2857,161,1
20150106.144249,2857,2,1544526,-2,2856,1006,2857,211,1
20150106.144252,2857,2,1544528,-2,2856,1005,2857,265,1
20150106.144252,2857,10,1544538,-10,2856,1005,2857,261,1
20150106.144253,2856,2,1544540,0,2856,1004,2857,261,0
20150106.144254,2857,2,1544542,-2,2856,1014,2857,261,1
20150106.144255,2857,2,1544544,0,2856,1013,2857,261,1
20150106.144258,2857,10,1544554,0,2856,1004,2857,259,1
20150106.144259,2856,2,1544556,0,2856,1003,2857,259,0
20150106.144259,2856,10,1544566,-10,2856,998,2857,259,0
20150106.1443,2857,20,1544586,2,2856,999,2857,249,1
20150106.1443,2857,2,1544588,-2,2856,999,2857,248,1
20150106.144302,2856,2,1544590,-2,2856,999,2857,273,0
20150106.144303,2857,2,1544592,0,2856,999,2857,323,1
20150106.144305,2856,2,1544594,0,2856,1004,2857,324,0
20150106.144305,2856,2010,1546604,340,2855,1271,2856,28,0
20150106.144306,2856,254,1546858,-56,2855,1271,2856,32,0
20150106.144306,2856,168,1547026,-98,2856,117,2857,414,0
20150106.144307,2857,118,1547144,-14,2856,167,2857,357,1
20150106.144307,2856,8,1547152,0,2856,164,2857,357,0
20150106.14431,2856,22,1547174,-22,2856,174,2857,374,0
20150106.144311,2856,24,1547198,-22,2856,163,2857,384,0
20150106.144312,2856,4,1547202,0,2856,171,2857,384,0
20150106.144313,2857,2,1547204,0,2856,173,2857,384,1
20150106.144313,2856,2,1547206,-2,2856,172,2857,397,0
20150106.144314,2856,2,1547208,-2,2856,193,2857,404,0
20150106.144315,2857,10,1547218,0,2856,194,2857,400,1
20150106.144315,2857,2,1547220,0,2856,194,2857,400,1
20150106.144317,2856,202,1547422,30,2856,104,2857,422,0
20150106.144317,2856,6,1547428,0,2856,101,2857,422,0
20150106.144319,2856,6,1547434,6,2856,100,2857,562,0
20150106.144319,2856,38,1547472,36,2856,82,2857,578,0
20150106.14432,2856,8,1547480,4,2856,78,2857,577,0
20150106.144321,2856,4,1547484,4,2856,385,2857,578,0
20150106.144321,2856,6,1547490,4,2856,422,2857,554,0
20150106.144322,2856,2,1547492,2,2856,421,2857,1554,0
20150106.144322,2856,2,1547494,0,2856,421,2857,3559,0
20150106.144323,2856,108,1547602,4,2856,387,2857,5560,0
20150106.144323,2856,782,1548384,-334,2856,6,2857,6608,0
20150106.144324,2856,14,1548398,-2,2855,879,2856,17,0
20150106.144325,2856,36,1548434,0,2856,1,2857,596,0
20150106.144325,2856,6,1548440,-2,2855,929,2857,596,0
20150106.144327,2856,2,1548442,0,2855,879,2856,84,0
20150106.144327,2856,2,1548444,-2,2855,879,2856,86,0
20150106.144328,2856,6,1548450,4,2855,879,2856,153,0
20150106.144328,2856,4,1548454,2,2855,880,2856,159,0
20150106.144329,2855,2,1548456,0,2855,887,2856,169,0
20150106.14433,2855,20,1548476,-12,2855,881,2856,165,0
20150106.14433,2855,18,1548494,-14,2855,873,2856,165,0
20150106.144331,2855,10,1548504,-10,2855,868,2856,165,0
20150106.144332,2856,6,1548510,6,2855,869,2856,162,1
20150106.144332,2856,2,1548512,2,2855,869,2856,162,1
20150106.144333,2855,8,1548520,6,2855,874,2856,160,0
20150106.144334,2856,2,1548522,2,2855,873,2856,282,1
20150106.144335,2855,4,1548526,4,2855,877,2856,298,0
20150106.144336,2855,6,1548532,0,2855,874,2856,298,0
20150106.144337,2856,2,1548534,2,2855,854,2856,298,1
20150106.144339,2855,2,1548536,2,2855,854,2856,300,0
20150106.144339,2856,2,1548538,0,2855,854,2856,301,1
20150106.14434,2856,40,1548578,38,2855,839,2856,297,1
20150106.144342,2855,2,1548580,2,2855,838,2856,336,0
20150106.144343,2856,20,1548600,20,2855,844,2856,326,1
20150106.144344,2855,4,1548604,2,2855,844,2856,325,0
20150106.144344,2855,2,1548606,0,2855,843,2856,325,0
20150106.144346,2856,6,1548612,0,2855,852,2856,322,1
20150106.144347,2856,4,1548616,0,2855,857,2856,351,1
20150106.144348,2855,4,1548620,4,2855,855,2856,353,0
20150106.144349,2855,34,1548654,0,2855,842,2856,368,0
20150106.144349,2855,4,1548658,0,2855,841,2856,369,0
20150106.14435,2855,12,1548670,4,2855,839,2856,369,0
20150106.14435,2855,4,1548674,0,2855,837,2856,369,0
20150106.144352,2856,12,1548686,0,2855,846,2856,365,1
20150106.144353,2856,40,1548726,-32,2855,846,2856,346,1
20150106.144354,2855,2,1548728,2,2855,845,2856,346,0
20150106.144356,2855,64,1548792,56,2855,870,2856,361,0
20150106.144357,2855,112,1548904,60,2855,815,2856,361,0
20150106.144357,2855,80,1548984,0,2855,780,2856,365,0
20150106.144358,2856,172,1549156,-30,2855,780,2856,280,1
20150106.144358,2855,6,1549162,6,2855,767,2856,279,0
20150106.144359,2855,4,1549166,4,2855,761,2856,279,0
20150106.144359,2855,8,1549174,8,2855,759,2856,277,0
20150106.1444,2855,2,1549176,2,2855,758,2856,277,0
20150106.144401,2856,2,1549178,0,2855,758,2856,277,1
20150106.144401,2855,2,1549180,0,2855,758,2856,277,0
20150106.144403,2856,8,1549188,0,2855,766,2856,282,1
20150106.144403,2855,34,1549222,-24,2855,753,2856,422,0
20150106.144406,2856,6,1549228,2,2855,752,2856,423,1
20150106.144407,2855,2,1549230,0,2855,752,2856,423,0
20150106.144407,2856,2,1549232,2,2855,754,2856,420,1
20150106.144408,2855,18,1549250,18,2855,754,2856,412,0
20150106.144411,2856,4,1549254,4,2855,804,2856,410,1
20150106.144411,2855,400,1549654,-252,2855,605,2856,410,0
20150106.144412,2855,2,1549656,0,2855,604,2856,411,0
20150106.144412,2855,8,1549664,-8,2855,599,2856,411,0
20150106.144413,2856,2,1549666,0,2855,599,2856,1411,1
20150106.144413,2855,2,1549668,0,2855,598,2856,1411,0
20150106.144413,2855,4,1549672,-2,2855,597,2856,1410,0
20150106.144414,2855,24,1549696,-24,2855,585,2856,1410,0
20150106.144415,2855,12,1549708,-8,2855,581,2856,1409,0
20150106.144415,2855,400,1550108,-352,2855,380,2856,1409,0
20150106.144416,2856,38,1550146,34,2855,361,2856,1412,1
20150106.144416,2855,12,1550158,8,2855,353,2856,1402,0
20150106.144417,2855,46,1550204,18,2855,332,2856,1402,0
20150106.144417,2855,2,1550206,2,2855,333,2856,1402,0
20150106.144418,2855,402,1550608,-212,2855,132,2856,1402,0
20150106.144418,2856,10,1550618,2,2855,138,2856,1400,1
20150106.144419,2855,276,1550894,-176,2854,1102,2855,119,0
20150106.144419,2855,254,1551148,-232,2854,1143,2855,203,0
20150106.14442,2855,2,1551150,-2,2854,1103,2855,202,0
20150106.14442,2855,6,1551156,0,2854,1101,2855,416,0
20150106.144421,2855,4,1551160,-2,2854,1100,2855,425,0
20150106.144422,2854,10,1551170,-8,2854,1096,2855,424,0
20150106.144422,2854,52,1551222,2,2854,1071,2855,426,0
20150106.144423,2854,10,1551232,0,2854,1066,2855,426,0
20150106.144424,2854,16,1551248,2,2854,1069,2855,427,0
20150106.144424,2854,10,1551258,2,2854,1064,2855,427,0
20150106.144425,2854,100,1551358,0,2854,1013,2855,461,0
20150106.144425,2854,2,1551360,0,2854,1012,2855,466,0
20150106.144426,2855,2,1551362,-2,2854,1012,2855,478,1
20150106.144426,2854,2,1551364,0,2854,1013,2855,478,0
20150106.144429,2855,82,1551446,0,2854,990,2855,552,1
20150106.144429,2854,36,1551482,36,2854,973,2855,551,0
20150106.14443,2854,2,1551484,2,2854,979,2855,564,0
20150106.144431,2854,12,1551496,0,2854,978,2855,567,0
20150106.144432,2855,2,1551498,-2,2854,978,2855,566,1
20150106.144432,2854,14,1551512,-2,2854,974,2855,565,0
20150106.144433,2854,2,1551514,2,2854,1056,2855,565,0
20150106.144433,2854,26,1551540,-6,2854,1061,2855,565,0
20150106.144433,2854,2,1551542,0,2854,1066,2855,555,0
20150106.144434,2854,8,1551550,2,2854,1062,2855,556,0
20150106.144435,2855,18,1551568,0,2854,1054,2855,553,1
20150106.144435,2855,6,1551574,0,2854,1055,2855,554,1
20150106.144436,2854,40,1551614,2,2854,1045,2855,544,0
20150106.144437,2855,2,1551616,0,2854,1045,2855,545,1
20150106.144437,2854,16,1551632,-16,2854,1039,2855,545,0
20150106.144437,2855,6,1551638,0,2854,1039,2855,542,1
20150106.144439,2855,36,1551674,-26,2854,1043,2855,531,1
20150106.14444,2855,40,1551714,-40,2854,1045,2855,563,1
20150106.144441,2854,4,1551718,-4,2854,1054,2855,565,0
20150106.144442,2854,12,1551730,-4,2854,1052,2855,563,0
20150106.144442,2855,4,1551734,0,2854,1053,2855,564,1
20150106.144443,2854,8,1551742,-4,2854,1068,2855,573,0
20150106.144444,2854,10,1551752,0,2854,1063,2855,573,0
20150106.144444,2855,8,1551760,-2,2854,1112,2855,575,1
20150106.144445,2854,6,1551766,0,2854,1111,2855,574,0
20150106.144445,2854,4,1551770,0,2854,1109,2855,574,0
20150106.144446,2854,2,1551772,0,2854,1108,2855,571,0
20150106.144447,2854,80,1551852,-64,2854,1066,2855,575,0
20150106.144447,2854,4,1551856,-4,2854,1064,2855,575,0
20150106.144448,2855,18,1551874,-6,2854,1062,2855,578,1
20150106.144448,2855,10,1551884,-8,2854,1067,2855,574,1
20150106.144449,2854,34,1551918,-34,2854,1065,2855,557,0
20150106.14445,2855,4,1551922,-2,2854,1065,2855,558,1
20150106.144452,2855,26,1551948,-18,2854,1065,2855,548,1
20150106.144452,2855,4,1551952,2,2854,1064,2855,547,1
20150106.144452,2854,8,1551960,8,2854,1060,2855,547,0
20150106.144453,2855,6,1551966,-6,2854,1110,2855,545,1
20150106.144455,2855,2,1551968,0,2854,1125,2855,544,1
20150106.144455,2855,2,1551970,0,2854,1112,2855,543,1
20150106.144455,2855,2,1551972,0,2854,1112,2855,542,1
20150106.144456,2854,2,1551974,0,2854,1114,2855,542,0
20150106.144456,2855,4,1551978,-2,2854,1114,2855,548,1
20150106.144457,2855,4,1551982,0,2854,1114,2855,546,1
20150106.144457,2854,2,1551984,2,2854,1114,2855,548,0
20150106.144458,2854,32,1552016,-2,2854,1097,2855,542,0
20150106.144458,2855,2,1552018,0,2854,1097,2855,541,1
20150106.144459,2854,400,1552418,-162,2854,898,2855,543,0
20150106.1445,2854,422,1552840,-250,2854,696,2855,535,0
20150106.144501,2854,46,1552886,4,2854,684,2855,537,0
20150106.144501,2854,48,1552934,-46,2854,658,2855,537,0
20150106.144502,2854,64,1552998,10,2854,628,2855,536,0
20150106.144502,2854,6,1553004,2,2854,627,2855,560,0
20150106.144503,2855,12,1553016,0,2854,641,2855,582,1
20150106.144503,2855,4,1553020,0,2854,676,2855,668,1
20150106.144504,2854,468,1553488,-184,2853,1060,2855,661,0
20150106.144505,2854,24,1553512,22,2854,278,2855,661,0
20150106.144505,2854,408,1553920,-98,2854,70,2855,741,0
20150106.144506,2853,146,1554066,14,2853,1511,2854,1115,0
20150106.144506,2854,96,1554162,-26,2853,1448,2854,1386,1
20150106.144507,2854,32,1554194,-4,2853,1447,2854,398,1
20150106.144507,2854,8,1554202,0,2853,1489,2854,403,1
20150106.144508,2854,12,1554214,0,2853,1498,2854,397,1
20150106.144508,2854,10,1554224,0,2853,1497,2854,394,1
20150106.144509,2854,8,1554232,0,2853,1507,2854,392,1
20150106.144509,2854,18,1554250,-12,2853,1508,2854,387,1
20150106.14451,2854,18,1554268,-6,2853,1505,2854,381,1
20150106.14451,2854,2,1554270,-2,2853,1503,2854,382,1
20150106.144511,2854,4,1554274,0,2853,1502,2854,380,1
20150106.144511,2854,38,1554312,-26,2853,1489,2854,379,1
20150106.144512,2854,36,1554348,-8,2853,1473,2854,376,1
20150106.144512,2854,8,1554356,-2,2853,1456,2854,376,1
20150106.144513,2854,12,1554368,-4,2853,1469,2854,377,1
20150106.144513,2854,10,1554378,0,2853,1469,2854,373,1
20150106.144514,2854,6,1554384,2,2853,1476,2854,370,1
20150106.144515,2853,2,1554386,0,2853,1488,2854,370,0
20150106.144515,2854,116,1554502,116,2853,1488,2854,316,1
20150106.144516,2853,24,1554526,-2,2853,1488,2854,306,0
20150106.144516,2854,14,1554540,10,2853,1486,2854,306,1
20150106.144517,2853,18,1554558,0,2853,1479,2854,306,0
20150106.144519,2853,4,1554562,-2,2853,1477,2854,356,0
20150106.144519,2853,14,1554576,10,2853,1476,2854,353,0
20150106.144519,2853,12,1554588,-8,2853,1470,2854,343,0
20150106.14452,2854,2,1554590,0,2853,1474,2854,342,1
20150106.144521,2854,6,1554596,-6,2853,1480,2854,352,1
20150106.144522,2854,4,1554600,-4,2853,1485,2854,351,1
20150106.144523,2854,2,1554602,-2,2853,1486,2854,362,1
20150106.144523,2853,10,1554612,-10,2853,1481,2854,363,0
20150106.144524,2854,52,1554664,0,2853,1481,2854,437,1
20150106.144525,2854,4,1554668,0,2853,1481,2854,449,1
20150106.144526,2854,4,1554672,-2,2853,1482,2854,547,1
20150106.144526,2853,4,1554676,-4,2853,1480,2854,548,0
20150106.144527,2853,20,1554696,-2,2853,1472,2854,547,0
20150106.144527,2853,4,1554700,0,2853,1469,2854,547,0
20150106.144528,2853,2,1554702,-2,2853,1479,2854,548,0
20150106.144528,2853,2,1554704,0,2853,1480,2854,548,0
20150106.144528,2853,2,1554706,0,2853,1479,2854,549,0
20150106.144529,2853,4,1554710,-2,2853,1478,2854,576,0
20150106.14453,2853,26,1554736,-24,2853,1469,2854,576,0
20150106.14453,2854,2,1554738,-2,2853,1469,2854,581,1
20150106.144531,2853,18,1554756,-10,2853,1474,2854,580,0
20150106.144532,2854,2,1554758,-2,2853,1474,2854,589,1
20150106.144532,2853,4,1554762,-4,2853,1476,2854,588,0
20150106.144533,2853,4,1554766,0,2853,1474,2854,589,0
20150106.144534,2853,4,1554770,0,2853,1482,2854,591,0
20150106.144534,2853,4,1554774,0,2853,1480,2854,591,0
20150106.144537,2854,2,1554776,-2,2853,1500,2854,595,1
20150106.144537,2853,2,1554778,2,2853,1500,2854,595,0
20150106.144538,2853,4,1554782,4,2853,1499,2854,598,0
20150106.144538,2854,6,1554788,-2,2853,1496,2854,595,1
20150106.144539,2853,8,1554796,0,2853,1493,2854,594,0
20150106.14454,2853,4,1554800,4,2853,1491,2854,594,0
20150106.144541,2854,6,1554806,-6,2853,1493,2854,592,1
20150106.144542,2854,12,1554818,0,2853,1496,2854,594,1
20150106.144542,2854,6,1554824,-2,2853,1496,2854,606,1
20150106.144543,2853,4,1554828,4,2853,1551,2854,607,0
20150106.144544,2853,38,1554866,-6,2853,1542,2854,598,0
20150106.144545,2854,32,1554898,0,2853,1539,2854,582,1
20150106.144546,2854,68,1554966,-68,2853,1543,2854,548,1
20150106.144547,2854,4,1554970,2,2853,1551,2854,550,1
20150106.144548,2853,2,1554972,2,2853,1550,2854,550,0
20150106.144549,2854,2,1554974,-2,2853,1550,2854,550,1
20150106.144549,2853,2,1554976,2,2853,1549,2854,552,0
20150106.14455,2854,6,1554982,0,2853,1549,2854,549,1
20150106.144551,2854,10,1554992,-6,2853,1551,2854,549,1
20150106.144553,2854,4,1554996,-4,2853,1576,2854,550,1
20150106.144553,2853,8,1555004,-8,2853,1572,2854,550,0
20150106.144554,2854,10,1555014,0,2853,1577,2854,545,1
20150106.144555,2853,2,1555016,0,2853,1577,2854,549,0
20150106.144556,2854,4,1555020,0,2853,1596,2854,546,1
20150106.144557,2853,8,1555028,-8,2853,1581,2854,545,0
20150106.144558,2854,2,1555030,0,2853,1593,2854,545,1
20150106.144559,2853,12,1555042,-2,2853,1593,2854,541,0
20150106.1446,2854,18,1555060,-12,2853,1602,2854,539,1
20150106.144601,2853,82,1555142,-42,2853,1560,2854,549,0
20150106.144601,2853,22,1555164,-20,2853,1548,2854,549,0
20150106.144602,2854,6,1555170,-4,2853,1547,2854,548,1
20150106.144603,2853,2,1555172,0,2853,1546,2854,544,0
20150106.144604,2854,86,1555258,-80,2853,1549,2854,508,1
20150106.144605,2853,40,1555298,-20,2853,1529,2854,510,0
20150106.144606,2853,2,1555300,-2,2853,1528,2854,510,0
20150106.144607,2854,26,1555326,-16,2853,1527,2854,497,1
20150106.144607,2853,4,1555330,-4,2853,1525,2854,497,0
20150106.144608,2854,4,1555334,0,2853,1528,2854,496,1
20150106.144608,2854,24,1555358,-24,2853,1529,2854,487,1
20150106.144609,2854,8,1555366,-6,2853,1528,2854,483,1
20150106.144609,2854,106,1555472,-70,2853,1532,2854,630,1
20150106.14461,2853,112,1555584,-104,2853,1529,2854,587,0
20150106.144611,2854,4,1555588,0,2853,1529,2854,585,1
20150106.144612,2854,4,1555592,-2,2853,1529,2854,583,1
20150106.144612,2854,4,1555596,0,2853,1534,2854,581,1
20150106.144612,2854,2,1555598,0,2853,1535,2854,581,1
20150106.144614,2853,6,1555604,0,2853,1532,2854,582,0
20150106.144614,2854,14,1555618,-14,2853,1526,2854,581,1
20150106.144616,2854,104,1555722,22,2853,1528,2854,540,1
20150106.144616,2854,2,1555724,0,2853,1528,2854,540,1
20150106.144617,2854,66,1555790,-62,2853,1545,2854,509,1
20150106.144618,2854,222,1556012,-8,2853,1547,2854,415,1
20150106.144618,2853,26,1556038,0,2853,1536,2854,415,0
20150106.144618,2854,378,1556416,-42,2853,1537,2854,226,1
20150106.144619,2854,456,1556872,-274,2854,461,2855,586,1
20150106.14462,2855,404,1557276,-402,2854,399,2855,605,1
20150106.14462,2855,4,1557280,-2,2854,506,2855,602,1
20150106.144621,2854,416,1557696,-208,2854,318,2855,602,0
20150106.144621,2854,10,1557706,-8,2854,367,2855,598,0
20150106.144622,2854,400,1558106,-38,2854,206,2855,598,0
20150106.144622,2854,406,1558512,-228,2853,997,2855,589,0
20150106.144623,2855,4,1558516,-4,2854,243,2855,587,1
20150106.144624,2854,492,1559008,-2,2853,1556,2854,120,0
20150106.144624,2853,6,1559014,-4,2853,1472,2854,169,0
20150106.144625,2854,2,1559016,-2,2853,1477,2854,198,1
20150106.144625,2854,4,1559020,-4,2853,1477,2854,147,1
20150106.144626,2854,8,1559028,-2,2853,1476,2854,143,1
20150106.144627,2854,192,1559220,-2,2853,1474,2854,51,1
20150106.144627,2854,256,1559476,-240,2853,1543,2854,193,1
20150106.144628,2854,2,1559478,-2,2853,1443,2854,192,1
20150106.144628,2854,30,1559508,0,2853,1448,2854,178,1
20150106.144629,2854,10,1559518,-8,2853,1464,2854,177,1
20150106.144629,2854,220,1559738,0,2853,1464,2854,70,1
20150106.14463,2854,140,1559878,-28,2854,77,2855,600,1
20150106.14463,2854,202,1560080,-140,2853,1462,2854,162,1
20150106.144631,2854,46,1560126,-28,2853,1459,2854,140,1
20150106.144631,2854,4,1560130,-2,2853,1459,2854,348,1
20150106.144632,2854,4,1560134,-2,2853,1458,2854,352,1
20150106.144632,2854,10,1560144,-4,2853,1437,2854,348,1
20150106.144633,2853,240,1560384,44,2853,1438,2854,234,0
20150106.144634,2854,4,1560388,2,2853,1445,2854,232,1
20150106.144635,2854,20,1560408,-4,2853,1443,2854,227,1
20150106.144635,2854,10,1560418,0,2853,1443,2854,222,1
20150106.144636,2854,18,1560436,16,2853,1444,2854,214,1
20150106.144636,2854,2,1560438,2,2853,1449,2854,213,1
20150106.144637,2853,8,1560446,0,2853,1446,2854,213,0
20150106.144638,2854,16,1560462,2,2853,1446,2854,205,1
20150106.144638,2854,10,1560472,0,2853,1455,2854,201,1
20150106.144639,2853,8,1560480,-6,2853,1452,2854,200,0
20150106.14464,2854,44,1560524,0,2853,1453,2854,178,1
20150106.14464,2854,22,1560546,0,2853,1444,2854,208,1
20150106.144641,2854,16,1560562,-16,2853,1445,2854,201,1
20150106.144641,2853,16,1560578,0,2853,1436,2854,206,0
20150106.144642,2853,20,1560598,-20,2853,1427,2854,206,0
20150106.144643,2853,4,1560602,-2,2853,1426,2854,205,0
20150106.144643,2854,6,1560608,-6,2853,1451,2854,202,1
20150106.144645,2854,18,1560626,-6,2853,1453,2854,204,1
20150106.144645,2854,4,1560630,-2,2853,1453,2854,207,1
20150106.144646,2854,6,1560636,0,2853,1452,2854,206,1
20150106.144647,2854,2,1560638,0,2853,1452,2854,206,1
20150106.144648,2854,6,1560644,-4,2853,1452,2854,206,1
20150106.144648,2853,4,1560648,-4,2853,1456,2854,205,0
20150106.144649,2854,28,1560676,-26,2853,1456,2854,191,1
20150106.144649,2854,18,1560694,-6,2853,1456,2854,182,1
20150106.144651,2854,2,1560696,0,2853,1457,2854,256,1
20150106.144651,2854,46,1560742,-46,2853,1457,2854,284,1
20150106.144652,2854,6,1560748,-4,2853,1456,2854,283,1
20150106.144652,2854,2,1560750,-2,2853,1457,2854,282,1
20150106.144653,2854,44,1560794,-20,2853,1498,2854,260,1
20150106.144653,2854,10,1560804,-2,2853,1498,2854,255,1
20150106.144654,2854,12,1560816,-2,2853,1499,2854,251,1
20150106.144655,2854,2,1560818,0,2853,1499,2854,250,1
20150106.144655,2853,4,1560822,-4,2853,1497,2854,253,0
20150106.144656,2854,4,1560826,-2,2853,1497,2854,261,1
20150106.144657,2854,2,1560828,0,2853,1497,2854,261,1
20150106.144658,2853,2,1560830,0,2853,1496,2854,261,0
20150106.144658,2853,2,1560832,-2,2853,1495,2854,263,0
20150106.144659,2854,2,1560834,0,2853,1494,2854,274,1
20150106.144659,2854,2,1560836,0,2853,1497,2854,273,1
20150106.1447,2854,2,1560838,0,2853,1497,2854,272,1
20150106.144702,2854,202,1561040,-26,2853,1497,2854,171,1
20150106.144703,2854,18,1561058,-10,2853,1477,2854,365,1
20150106.144704,2854,12,1561070,4,2853,1477,2854,359,1
20150106.144706,2854,2,1561072,2,2853,1477,2854,369,1
20150106.144708,2853,4,1561076,-4,2853,1474,2854,380,0
20150106.144709,2854,2,1561078,2,2853,1473,2854,379,1
20150106.14471,2854,10,1561088,-2,2853,1474,2854,377,1
20150106.144711,2854,10,1561098,6,2853,1505,2854,373,1
20150106.144712,2854,2,1561100,2,2853,1498,2854,372,1
20150106.144713,2854,2,1561102,0,2853,1500,2854,371,1
20150106.144714,2854,6,1561108,0,2853,1505,2854,370,1
20150106.144714,2854,18,1561126,0,2853,1504,2854,373,1
20150106.144715,2854,10,1561136,10,2853,1535,2854,368,1
20150106.144715,2854,2,1561138,2,2853,1537,2854,367,1
20150106.144716,2854,28,1561166,8,2853,1559,2854,354,1
20150106.144716,2854,2,1561168,0,2853,1559,2854,353,1
20150106.144718,2854,2,1561170,2,2853,1559,2854,364,1
20150106.144718,2854,6,1561176,2,2853,1559,2854,361,1
20150106.14472,2854,24,1561200,4,2853,1573,2854,560,1
20150106.144721,2854,2,1561202,2,2853,1573,2854,559,1
20150106.144721,2853,10,1561212,0,2853,1568,2854,559,0
20150106.144722,2853,2,1561214,0,2853,1567,2854,559,0
20150106.144723,2854,10,1561224,6,2853,1567,2854,559,1
20150106.144724,2854,2,1561226,2,2853,1589,2854,559,1
20150106.144725,2854,20,1561246,0,2853,1590,2854,550,1
20150106.144726,2854,2,1561248,2,2853,1590,2854,549,1
20150106.144727,2853,2,1561250,-2,2853,1589,2854,555,0
20150106.144727,2854,22,1561272,-20,2853,1590,2854,544,1
20150106.144728,2853,6,1561278,-2,2853,1594,2854,542,0
20150106.144729,2854,10,1561288,-6,2853,1595,2854,537,1
20150106.14473,2853,2,1561290,0,2853,1594,2854,537,0
20150106.144732,2854,120,1561410,6,2853,1594,2854,478,1
20150106.144733,2854,60,1561470,-58,2853,1594,2854,448,1
20150106.144733,2854,2,1561472,0,2853,1594,2854,447,1
20150106.144734,2854,4,1561476,-2,2853,1594,2854,445,1
20150106.144734,2854,14,1561490,0,2853,1594,2854,438,1
20150106.144735,2854,4,1561494,0,2853,1594,2854,436,1
20150106.144736,2854,2,1561496,-2,2853,1597,2854,435,1
20150106.144736,2853,2,1561498,-2,2853,1595,2854,435,0
20150106.144737,2853,32,1561530,-12,2853,1587,2854,433,0
20150106.144738,2853,2,1561532,0,2853,1584,2854,435,0
20150106.144738,2854,4,1561536,-2,2853,1584,2854,433,1
20150106.144739,2854,4,1561540,-4,2853,1585,2854,431,1
20150106.14474,2854,4,1561544,-4,2853,1586,2854,432,1
20150106.14474,2854,4,1561548,0,2853,1586,2854,460,1
20150106.14474,2854,2,1561550,0,2853,1586,2854,459,1
20150106.144741,2854,4,1561554,-2,2853,1585,2854,458,1
20150106.144742,2854,50,1561604,0,2853,1585,2854,433,1
20150106.144742,2854,40,1561644,0,2853,1585,2854,413,1
20150106.144742,2854,4,1561648,0,2853,1585,2854,411,1
20150106.144744,2854,6,1561654,0,2853,1585,2854,409,1
20150106.144745,2853,2,1561656,0,2853,1586,2854,411,0
20150106.144745,2854,2,1561658,-2,2853,1586,2854,410,1
20150106.144746,2854,100,1561758,0,2853,1586,2854,360,1
20150106.144747,2854,2,1561760,0,2853,1588,2854,359,1
20150106.144747,2854,192,1561952,-48,2853,1492,2854,263,1
20150106.144748,2854,88,1562040,62,2853,1492,2854,420,1
20150106.144748,2854,210,1562250,204,2853,1452,2854,317,1
20150106.144749,2854,48,1562298,40,2853,1429,2854,293,1
20150106.144749,2854,210,1562508,150,2853,1430,2854,188,1
20150106.14475,2854,376,1562884,-54,2854,275,2855,703,1
20150106.14475,2854,400,1563284,0,2854,148,2855,651,1
20150106.144751,2854,342,1563626,124,2853,1442,2855,702,1
20150106.144752,2854,20,1563646,-8,2853,1320,2854,343,1
20150106.144753,2854,12,1563658,-2,2853,1323,2854,337,1
20150106.144754,2854,34,1563692,-12,2853,1324,2854,320,1
20150106.144755,2854,102,1563794,-100,2853,1325,2854,277,1
20150106.144755,2854,20,1563814,-20,2853,1325,2854,222,1
20150106.144756,2854,26,1563840,0,2853,1324,2854,209,1
20150106.144756,2854,4,1563844,0,2853,1324,2854,207,1
20150106.144757,2854,24,1563868,0,2853,1324,2854,195,1
20150106.144757,2854,2,1563870,0,2853,1327,2854,195,1
20150106.144758,2854,208,1564078,0,2853,1327,2854,92,1
20150106.144758,2854,42,1564120,0,2853,1308,2854,70,1
20150106.144759,2854,14,1564134,-2,2853,1307,2854,63,1
20150106.144759,2854,16,1564150,0,2853,1307,2854,56,1
20150106.1448,2854,30,1564180,2,2853,1297,2854,41,1
20150106.1448,2854,6,1564186,-4,2853,1286,2854,38,1
20150106.144801,2854,24,1564210,-6,2853,1285,2854,27,1
20150106.144801,2854,4,1564214,0,2853,1255,2854,37,1
20150106.144802,2854,2,1564216,0,2853,1254,2854,36,1
20150106.144803,2854,22,1564238,-22,2853,1254,2854,38,1
20150106.144803,2854,16,1564254,6,2853,1254,2854,30,1
20150106.144804,2854,42,1564296,26,2853,1254,2854,10,1
20150106.144805,2854,2,1564298,-2,2853,1254,2854,232,1
20150106.144805,2854,14,1564312,-10,2853,1254,2854,225,1
20150106.144805,2854,10,1564322,-4,2853,1252,2854,221,1
20150106.144806,2854,6,1564328,-4,2853,1262,2854,215,1
20150106.144806,2854,4,1564332,0,2853,1262,2854,213,1
20150106.144807,2854,66,1564398,-60,2853,1262,2854,184,1
20150106.144808,2854,12,1564410,-2,2853,1258,2854,178,1
20150106.144808,2854,4,1564414,0,2853,1258,2854,177,1
20150106.144809,2854,46,1564460,-4,2853,1258,2854,159,1
20150106.144809,2854,2,1564462,0,2853,1258,2854,158,1
20150106.14481,2854,4,1564466,-4,2853,1258,2854,156,1
20150106.144811,2854,2,1564468,0,2853,1267,2854,162,1
20150106.144811,2854,6,1564474,0,2853,1267,2854,160,1
20150106.144812,2854,12,1564486,0,2853,1265,2854,154,1
20150106.144813,2854,2,1564488,0,2853,1266,2854,154,1
20150106.144813,2853,2,1564490,0,2853,1265,2854,354,0
20150106.144814,2853,18,1564508,-18,2853,1256,2854,370,0
20150106.144815,2853,6,1564514,-6,2853,1255,2854,368,0
20150106.144815,2853,2,1564516,0,2853,1255,2854,368,0
20150106.144817,2853,20,1564536,-20,2853,1282,2854,432,0
20150106.144819,2854,2,1564538,-2,2853,1282,2854,432,1
20150106.144819,2854,10,1564548,0,2853,1282,2854,427,1
20150106.144821,2854,4,1564552,0,2853,1288,2854,426,1
20150106.144821,2853,2,1564554,0,2853,1288,2854,426,0
20150106.144822,2854,40,1564594,0,2853,1270,2854,403,1
20150106.144823,2854,24,1564618,-2,2853,1253,2854,442,1
20150106.144826,2854,4,1564622,0,2853,1253,2854,446,1
20150106.144827,2853,82,1564704,-82,2853,1212,2854,445,0
20150106.144828,2854,22,1564726,-22,2853,1211,2854,438,1
20150106.144828,2853,2,1564728,-2,2853,1210,2854,438,0
20150106.144829,2854,2,1564730,0,2853,1220,2854,437,1
20150106.14483,2854,10,1564740,-10,2853,1220,2854,432,1
20150106.144831,2853,36,1564776,0,2853,1205,2854,432,0
20150106.144831,2854,2,1564778,0,2853,1205,2854,431,1
20150106.144834,2854,4,1564782,0,2853,1205,2854,432,1
20150106.144835,2854,14,1564796,0,2853,1205,2854,425,1
20150106.144837,2853,2,1564798,0,2853,1223,2854,425,0
20150106.144839,2854,4,1564802,0,2853,1224,2854,424,1
20150106.14484,2854,10,1564812,0,2853,1225,2854,381,1
20150106.144841,2854,10,1564822,-6,2853,1225,2854,376,1
20150106.144842,2854,2,1564824,0,2853,1226,2854,375,1
20150106.144843,2853,10,1564834,-8,2853,1275,2854,374,0
20150106.144845,2854,8,1564842,-8,2853,1276,2854,571,1
20150106.144846,2853,6,1564848,-2,2853,1275,2854,569,0
20150106.144848,2853,4,1564852,-4,2853,1292,2854,569,0
20150106.144849,2854,18,1564870,-2,2853,1290,2854,562,1
20150106.144849,2854,4,1564874,0,2853,1289,2854,561,1
20150106.144851,2853,2,1564876,0,2853,1290,2854,561,0
20150106.144852,2853,2,1564878,-2,2853,1291,2854,562,0
20150106.144853,2854,2,1564880,0,2853,1291,2854,561,1
20150106.144854,2854,2,1564882,0,2853,1295,2854,560,1
20150106.144856,2853,2,1564884,0,2853,1294,2854,560,0
20150106.144857,2853,2,1564886,-2,2853,1293,2854,926,0
20150106.144858,2853,2,1564888,0,2853,1296,2854,926,0
20150106.1449,2853,4,1564892,-4,2853,1289,2854,926,0
20150106.1449,2853,10,1564902,-10,2853,1284,2854,925,0
20150106.1449,2853,2,1564904,0,2853,1283,2854,925,0
20150106.144901,2853,2,1564906,0,2853,1287,2854,925,0
20150106.144902,2853,46,1564952,-40,2853,1287,2854,904,0
20150106.144904,2853,22,1564974,0,2853,1277,2854,905,0
20150106.144906,2853,4,1564978,0,2853,1287,2854,919,0
20150106.144907,2854,2,1564980,0,2853,1287,2854,918,1
20150106.144908,2854,4,1564984,0,2853,1286,2854,916,1
20150106.144909,2854,2,1564986,0,2853,1291,2854,915,1
20150106.144911,2853,2,1564988,0,2853,1290,2854,916,0
20150106.144911,2854,22,1565010,0,2853,1290,2854,908,1
20150106.144912,2853,2,1565012,0,2853,1289,2854,918,0
20150106.144912,2853,4,1565016,-2,2853,1288,2854,917,0
20150106.144913,2853,4,1565020,2,2853,1289,2854,916,0
20150106.144913,2853,400,1565420,90,2853,1090,2854,921,0
20150106.144914,2853,22,1565442,-10,2853,1077,2854,923,0
20150106.144915,2853,2160,1567602,1080,2852,1729,2854,922,0
20150106.144916,2853,12,1567614,12,2852,1705,2853,307,0
20150106.144916,2853,206,1567820,92,2852,1703,2853,707,0
20150106.144917,2853,10,1567830,6,2852,1624,2853,716,0
20150106.144917,2853,6,1567836,6,2852,1624,2853,737,0
20150106.144918,2853,20,1567856,10,2852,1620,2853,740,0
20150106.144918,2853,4,1567860,4,2852,1611,2853,740,0
20150106.144919,2853,16,1567876,10,2852,1609,2853,733,0
20150106.144919,2853,6,1567882,6,2852,1614,2853,756,0
20150106.14492,2852,10,1567892,8,2852,1613,2853,752,0
20150106.14492,2852,26,1567918,-8,2852,1603,2853,749,0
20150106.144921,2852,34,1567952,-6,2852,1593,2853,753,0
20150106.144921,2853,6,1567958,4,2852,1592,2853,754,1
20150106.144922,2853,112,1568070,100,2852,1623,2853,751,1
20150106.144923,2853,30,1568100,16,2852,1624,2853,737,1
20150106.144923,2853,10,1568110,0,2852,1622,2853,741,1
20150106.144924,2853,4,1568114,4,2852,1626,2853,740,1
20150106.144924,2853,4,1568118,2,2852,1625,2853,743,1
20150106.144925,2852,2,1568120,0,2852,1634,2853,743,0
20150106.144925,2852,14,1568134,-2,2852,1633,2853,743,0
20150106.144926,2853,26,1568160,4,2852,1631,2853,730,1
20150106.144927,2852,14,1568174,0,2852,1624,2853,732,0
20150106.144927,2852,4,1568178,4,2852,1637,2853,731,0
20150106.144928,2853,4,1568182,2,2852,1636,2853,731,1
20150106.144928,2853,6,1568188,6,2852,1639,2853,729,1
20150106.144928,2852,2,1568190,2,2852,1629,2853,730,0
20150106.144929,2853,6,1568196,4,2852,1606,2853,729,1
20150106.14493,2853,6,1568202,6,2852,1608,2853,728,1
20150106.144931,2853,18,1568220,4,2852,1605,2853,727,1
20150106.144932,2852,2,1568222,2,2852,1605,2853,774,0
20150106.144932,2853,12,1568234,12,2852,1605,2853,769,1
20150106.144933,2853,8,1568242,2,2852,1602,2853,765,1
20150106.144933,2852,16,1568258,14,2852,1599,2853,760,0
20150106.144934,2853,16,1568274,14,2852,1597,2853,756,1
20150106.144934,2853,2,1568276,2,2852,1597,2853,755,1
20150106.144935,2852,50,1568326,40,2852,1562,2853,735,0
20150106.144936,2852,4,1568330,0,2852,1562,2853,735,0
20150106.144936,2852,12,1568342,12,2852,1556,2853,735,0
20150106.144938,2852,14,1568356,14,2852,1555,2853,728,0
20150106.144938,2852,42,1568398,42,2852,1553,2853,711,0
20150106.144939,2852,2,1568400,2,2852,1555,2853,711,0
20150106.14494,2853,2,1568402,0,2852,1557,2853,710,1
20150106.144941,2853,86,1568488,2,2852,1556,2853,668,1
20150106.144941,2853,24,1568512,16,2852,1596,2853,656,1
20150106.144942,2853,46,1568558,6,2852,1588,2853,643,1
20150106.144942,2852,8,1568566,-6,2852,1584,2853,643,0
20150106.144943,2853,12,1568578,2,2852,1581,2853,639,1
20150106.144943,2852,2,1568580,0,2852,1580,2853,644,0
20150106.144945,2852,2,1568582,0,2852,1574,2853,654,0
20150106.144946,2852,2,1568584,-2,2852,1572,2853,654,0
20150106.144947,2852,4,1568588,-4,2852,1576,2853,657,0
20150106.144948,2852,2,1568590,2,2852,1578,2853,657,0
20150106.144948,2852,26,1568616,-4,2852,1571,2853,753,0
20150106.144949,2852,4,1568620,-2,2852,1568,2853,753,0
20150106.144949,2852,22,1568642,10,2852,1569,2853,753,0
20150106.144951,2853,40,1568682,0,2852,1565,2853,784,1
20150106.144951,2853,10,1568692,0,2852,1564,2853,779,1
20150106.144952,2852,4,1568696,4,2852,1562,2853,779,0
20150106.144953,2852,4,1568700,0,2852,1582,2853,781,0
20150106.144954,2853,20,1568720,0,2852,1606,2853,771,1
20150106.144954,2852,74,1568794,32,2852,1591,2853,759,0
20150106.144954,2853,6,1568800,-2,2852,1589,2853,758,1
20150106.144955,2852,30,1568830,6,2852,1593,2853,748,0
20150106.144956,2853,12,1568842,0,2852,1682,2853,766,1
20150106.144957,2852,10,1568852,8,2852,1677,2853,767,0
20150106.144957,2852,2,1568854,2,2852,1676,2853,767,0
20150106.144958,2852,4,1568858,2,2852,1675,2853,767,0
20150106.144959,2853,4,1568862,-4,2852,1675,2853,765,1
20150106.144959,2852,8,1568870,2,2852,1684,2853,762,0
20150106.145,2852,12,1568882,0,2852,1683,2853,757,0
20150106.145,2852,120,1569002,104,2852,1614,2853,757,0
20150106.145001,2852,10,1569012,4,2852,1609,2853,757,0
20150106.145002,2852,6,1569018,0,2852,1607,2853,756,0
20150106.145002,2852,2,1569020,2,2852,1606,2853,756,0
20150106.145003,2853,22,1569042,18,2852,1603,2853,775,1
20150106.145004,2852,198,1569240,-96,2852,1522,2853,756,0
20150106.145005,2853,2,1569242,0,2852,1523,2853,765,1
20150106.145006,2853,10,1569252,-10,2852,1540,2853,760,1
20150106.145006,2853,2,1569254,-2,2852,1541,2853,759,1
20150106.145007,2853,6,1569260,-6,2852,1541,2853,756,1
20150106.14501,2853,6,1569266,-4,2852,1574,2853,752,1
20150106.145011,2852,2,1569268,-2,2852,1535,2853,751,0
20150106.145011,2852,4,1569272,-2,2852,1534,2853,750,0
20150106.145012,2852,4,1569276,2,2852,1531,2853,751,0
20150106.145013,2853,14,1569290,0,2852,1530,2853,750,1
20150106.145013,2853,8,1569298,0,2852,1529,2853,747,1
20150106.145014,2853,14,1569312,-14,2852,1529,2853,1750,1
20150106.145016,2852,16,1569328,-2,2852,1642,2853,5748,0
20150106.145016,2852,4,1569332,0,2852,1640,2853,5738,0
20150106.145017,2852,58,1569390,-4,2852,1673,2853,716,0
20150106.145017,2852,70,1569460,-64,2852,1656,2853,690,0
20150106.145018,2853,26,1569486,-10,2852,1621,2853,682,1
20150106.145018,2852,46,1569532,-4,2852,1607,2853,672,0
20150106.145019,2852,34,1569566,-4,2852,1582,2853,632,0
20150106.145019,2852,12,1569578,0,2852,1576,2853,632,0
20150106.14502,2853,26,1569604,0,2852,1578,2853,619,1
20150106.14502,2853,4,1569608,-4,2852,1577,2853,617,1
20150106.145022,2853,2,1569610,0,2852,1578,2853,621,1
20150106.145022,2853,6,1569616,-2,2852,1492,2853,618,1
20150106.145023,2852,6,1569622,-6,2852,1496,2853,616,0
20150106.145023,2853,4,1569626,0,2852,1495,2853,534,1
20150106.145024,2853,1074,1570700,-526,2853,467,2854,858,1
20150106.145025,2853,122,1570822,0,2853,855,2854,798,1
20150106.145025,2853,2,1570824,0,2853,884,2854,798,1
20150106.145026,2854,8,1570832,0,2853,900,2854,782,1
20150106.145027,2854,14,1570846,-2,2853,900,2854,775,1
20150106.145029,2854,2,1570848,0,2853,873,2854,771,1
20150106.14503,2854,2,1570850,0,2853,873,2854,830,1
20150106.14503,2854,2,1570852,0,2853,875,2854,830,1
20150106.145031,2854,8,1570860,-8,2853,874,2854,827,1
20150106.145032,2854,22,1570882,0,2853,873,2854,816,1
20150106.145033,2854,2,1570884,0,2853,874,2854,816,1
20150106.145034,2853,12,1570896,-12,2853,868,2854,814,0
20150106.145034,2854,2,1570898,-2,2853,868,2854,813,1
20150106.145036,2854,10,1570908,-10,2853,868,2854,811,1
20150106.145036,2853,2,1570910,0,2853,870,2854,811,0
20150106.145037,2853,58,1570968,-14,2853,865,2854,787,0
20150106.145037,2854,2,1570970,-2,2853,867,2854,786,1
20150106.145038,2854,4,1570974,-2,2853,877,2854,786,1
20150106.145039,2854,200,1571174,-200,2853,877,2854,686,1
20150106.14504,2854,2,1571176,-2,2853,960,2854,685,1
20150106.145041,2854,2,1571178,0,2853,961,2854,684,1
20150106.145041,2853,22,1571200,-22,2853,960,2854,686,0
20150106.145044,2854,24,1571224,0,2853,964,2854,724,1
20150106.145045,2853,2,1571226,0,2853,962,2854,726,0
20150106.145046,2854,42,1571268,-2,2853,1024,2854,705,1
20150106.145047,2854,1410,1572678,-814,2854,319,2855,574,1
20150106.145048,2854,10,1572688,-10,2854,581,2855,519,1
20150106.145049,2854,400,1573088,-400,2854,387,2855,519,1
20150106.145049,2854,28,1573116,-26,2854,384,2855,508,1
20150106.14505,2855,430,1573546,-272,2854,181,2855,496,1
20150106.14505,2855,100,1573646,-80,2854,278,2855,446,1
20150106.145051,2854,484,1574130,-104,2854,89,2855,411,0
20150106.145052,2854,4,1574134,0,2854,109,2855,424,0
20150106.145053,2854,2,1574136,-2,2854,108,2855,424,0
20150106.145053,2854,32,1574168,6,2854,100,2855,421,0
20150106.145054,2855,2,1574170,2,2854,119,2855,422,1
20150106.145056,2854,6,1574176,-6,2854,118,2855,424,0
20150106.145058,2855,4,1574180,2,2854,125,2855,424,1
20150106.145058,2855,4,1574184,4,2854,125,2855,422,1
20150106.145059,2854,10,1574194,-2,2854,124,2855,425,0
20150106.145059,2854,4,1574198,-4,2854,122,2855,425,0
20150106.1451,2855,6,1574204,4,2854,222,2855,422,1
20150106.1451,2855,2,1574206,0,2854,224,2855,421,1
20150106.145102,2855,2,1574208,2,2854,248,2855,420,1
20150106.145103,2855,24,1574232,20,2854,248,2855,428,1
20150106.145103,2854,2,1574234,0,2854,250,2855,443,0
20150106.145103,2855,102,1574336,100,2854,250,2855,392,1
20150106.145105,2854,22,1574358,0,2854,240,2855,396,0
20150106.145105,2855,2,1574360,2,2854,250,2855,395,1
20150106.145105,2855,2,1574362,0,2854,251,2855,394,1
20150106.145106,2854,6,1574368,0,2854,248,2855,396,0
20150106.145108,2855,2,1574370,0,2854,284,2855,396,1
20150106.145112,2855,122,1574492,-116,2854,358,2855,313,1
20150106.145112,2855,2,1574494,0,2854,358,2855,319,1
20150106.145113,2855,32,1574526,-30,2854,361,2855,306,1
20150106.145113,2855,52,1574578,-6,2854,361,2855,287,1
20150106.145114,2855,2,1574580,-2,2854,362,2855,296,1
20150106.145115,2855,4,1574584,-4,2854,362,2855,294,1
20150106.145115,2855,68,1574652,-44,2854,362,2855,260,1
20150106.145117,2854,12,1574664,0,2854,362,2855,278,0
20150106.145117,2854,20,1574684,-20,2854,367,2855,278,0
20150106.145118,2855,16,1574700,-4,2854,388,2855,291,1
20150106.145118,2855,2,1574702,-2,2854,389,2855,290,1
20150106.145119,2855,10,1574712,-10,2854,395,2855,288,1
20150106.14512,2855,4,1574716,0,2854,395,2855,292,1
20150106.14512,2854,22,1574738,0,2854,385,2855,291,0
20150106.145121,2855,156,1574894,-120,2854,384,2855,214,1
20150106.145122,2855,40,1574934,0,2854,384,2855,194,1
20150106.145122,2855,20,1574954,6,2854,387,2855,184,1
20150106.145123,2854,4,1574958,0,2854,386,2855,183,0
20150106.145124,2855,4,1574962,4,2854,387,2855,181,1
20150106.145124,2855,2,1574964,0,2854,387,2855,180,1
20150106.145126,2855,2,1574966,0,2854,433,2855,189,1
20150106.145126,2855,10,1574976,8,2854,446,2855,184,1
20150106.145127,2855,4,1574980,-2,2854,388,2855,182,1
20150106.145127,2855,4,1574984,2,2854,388,2855,180,1
20150106.145128,2855,20,1575004,16,2854,388,2855,170,1
20150106.145129,2854,6,1575010,2,2854,387,2855,209,0
20150106.145129,2854,44,1575054,34,2854,383,2855,189,0
20150106.145129,2855,22,1575076,-20,2854,382,2855,179,1
20150106.14513,2855,2,1575078,-2,2854,385,2855,178,1
20150106.145131,2855,6,1575084,0,2854,390,2855,184,1
20150106.145132,2855,2,1575086,-2,2854,395,2855,185,1
20150106.145133,2855,2,1575088,0,2854,396,2855,185,1
20150106.145134,2855,2,1575090,-2,2854,397,2855,188,1
20150106.145134,2855,22,1575112,-4,2854,397,2855,177,1
20150106.145135,2855,2,1575114,0,2854,413,2855,177,1
20150106.145136,2855,4,1575118,2,2854,424,2855,176,1
20150106.145137,2854,400,1575518,-86,2854,236,2855,176,0
20150106.145138,2855,2,1575520,2,2854,264,2855,319,1
20150106.145139,2854,530,1576050,-90,2853,1782,2854,49,0
20150106.14514,2854,164,1576214,-98,2854,21,2855,448,0
20150106.14514,2855,110,1576324,-82,2854,19,2855,395,1
20150106.145141,2854,504,1576828,-500,2854,52,2855,445,0
20150106.145141,2853,402,1577230,-298,2853,1544,2854,102,0
20150106.145142,2853,402,1577632,-394,2853,1345,2854,62,0
20150106.145143,2854,4,1577636,0,2853,1346,2854,111,1
20150106.145143,2853,400,1578036,-326,2853,1155,2854,111,0
20150106.145144,2854,44,1578080,-40,2853,1155,2854,89,1
20150106.145144,2854,4,1578084,0,2853,1153,2854,87,1
20150106.145145,2854,414,1578498,-326,2853,952,2854,80,1
20150106.145145,2854,20,1578518,-20,2853,920,2854,102,1
20150106.145146,2854,404,1578922,-260,2853,732,2854,101,1
20150106.145147,2853,420,1579342,-188,2852,1165,2854,309,0
20150106.145147,2854,2,1579344,0,2852,1554,2854,343,1
20150106.145148,2854,56,1579400,-56,2853,52,2854,330,1
20150106.145148,2853,410,1579810,-158,2852,1486,2853,18,0
20150106.145149,2853,214,1580024,22,2852,1486,2853,197,0
20150106.145149,2853,74,1580098,-2,2852,1486,2853,161,0
20150106.14515,2853,2,1580100,-2,2852,1485,2853,405,0
20150106.145152,2853,6,1580106,-6,2852,1484,2853,503,0
20150106.145152,2853,8,1580114,0,2852,1484,2853,499,0
20150106.145153,2853,8,1580122,-6,2852,1481,2853,498,0
20150106.145154,2853,4,1580126,0,2852,1498,2853,497,0
20150106.145155,2853,4,1580130,0,2852,1507,2853,498,0
20150106.145155,2853,18,1580148,-10,2852,1508,2853,499,0
20150106.145156,2852,18,1580166,0,2852,1522,2853,497,0
20150106.145157,2853,2,1580168,0,2852,1527,2853,496,1
20150106.145159,2853,8,1580176,-8,2852,1531,2853,492,1
20150106.1452,2853,60,1580236,-60,2852,1531,2853,461,1
20150106.1452,2853,520,1580756,-508,2852,1532,2853,201,1
20150106.145201,2853,402,1581158,6,2853,33,2854,315,1
20150106.145201,2853,76,1581234,-44,2852,1658,2853,170,1
20150106.145202,2853,14,1581248,-2,2852,1757,2853,163,1
20150106.145202,2853,66,1581314,0,2852,1758,2853,330,1
20150106.145202,2853,2,1581316,0,2852,1765,2853,330,1
20150106.145203,2853,2,1581318,0,2852,1766,2853,387,1
20150106.145204,2853,60,1581378,-60,2852,1767,2853,357,1
20150106.145205,2853,4,1581382,-2,2852,1757,2853,365,1
20150106.145206,2853,94,1581476,-60,2852,1764,2853,319,1
20150106.145207,2852,2,1581478,-2,2852,1762,2853,319,0
20150106.145208,2852,2,1581480,0,2852,1756,2853,319,0
20150106.145209,2852,62,1581542,-60,2852,1733,2853,308,0
20150106.14521,2853,6,1581548,-6,2852,1736,2853,305,1
20150106.145211,2853,42,1581590,-40,2852,1736,2853,284,1
20150106.145212,2853,80,1581670,-74,2852,1739,2853,249,1
20150106.145212,2852,4,1581674,-2,2852,1724,2853,449,0
20150106.145213,2853,6,1581680,-2,2852,1723,2853,447,1
20150106.145213,2852,10,1581690,-4,2852,1721,2853,443,0
20150106.145214,2852,18,1581708,-18,2852,1733,2853,443,0
20150106.145215,2853,4,1581712,0,2852,1736,2853,441,1
20150106.145215,2852,4,1581716,-4,2852,1727,2853,441,0
20150106.145216,2852,6,1581722,-6,2852,1724,2853,440,0
20150106.145216,2853,8,1581730,-4,2852,1733,2853,436,1
20150106.145217,2853,24,1581754,-8,2852,1734,2853,451,1
20150106.145219,2853,6,1581760,-4,2852,1727,2853,468,1
20150106.14522,2853,2,1581762,-2,2852,1732,2853,481,1
20150106.145221,2853,22,1581784,0,2852,1732,2853,473,1
20150106.145222,2853,64,1581848,-60,2852,1710,2853,441,1
20150106.145223,2853,2,1581850,0,2852,1712,2853,440,1
20150106.145226,2853,130,1581980,0,2852,1712,2853,385,1
20150106.145226,2852,2,1581982,0,2852,1711,2853,388,0
20150106.145227,2853,8,1581990,-6,2852,1713,2853,419,1
20150106.145228,2853,50,1582040,-50,2852,1725,2853,399,1
20150106.145228,2852,60,1582100,-20,2852,1716,2853,379,0
20150106.145228,2852,4,1582104,-4,2852,1714,2853,379,0
20150106.145229,2853,10,1582114,2,2852,1713,2853,374,1
20150106.14523,2853,2,1582116,0,2852,1713,2853,373,1
20150106.14523,2853,658,1582774,-566,2852,1721,2853,42,1
20150106.145231,2853,10,1582784,8,2852,1728,2853,37,1
20150106.145231,2853,22,1582806,0,2852,1730,2853,26,1
20150106.145232,2853,2,1582808,0,2852,1731,2853,27,1
20150106.145232,2853,4,1582812,0,2852,1725,2853,28,1
20150106.145233,2853,6,1582818,-2,2852,1722,2853,26,1
20150106.145233,2853,26,1582844,-14,2852,1722,2853,13,1
20150106.145234,2853,26,1582870,4,2853,2,2854,344,1
20150106.145234,2853,16,1582886,4,2852,1743,2853,57,1
20150106.145235,2853,4,1582890,4,2852,1739,2853,55,1
20150106.145235,2853,2,1582892,2,2852,1739,2853,59,1
20150106.145236,2853,4,1582896,2,2852,1738,2853,58,1
20150106.145236,2853,2,1582898,2,2852,1739,2853,57,1
20150106.145237,2853,2,1582900,2,2852,1740,2853,56,1
20150106.145237,2853,42,1582942,2,2852,1730,2853,235,1
20150106.145238,2852,6,1582948,4,2852,1729,2853,494,0
20150106.145238,2852,4,1582952,2,2852,1718,2853,512,0
20150106.14524,2853,2,1582954,0,2852,1744,2853,519,1
20150106.145241,2853,20,1582974,20,2852,1729,2853,582,1
20150106.145242,2853,24,1582998,-16,2852,1728,2853,580,1
20150106.145243,2853,2,1583000,0,2852,1728,2853,579,1
20150106.145243,2853,20,1583020,0,2852,1728,2853,569,1
20150106.145244,2852,16,1583036,2,2852,1726,2853,563,0
20150106.145245,2853,14,1583050,2,2852,1727,2853,551,1
20150106.145246,2853,600,1583650,-398,2852,1734,2853,251,1
20150106.145247,2852,58,1583708,4,2852,1725,2853,427,0
20150106.145248,2853,2,1583710,0,2852,1758,2853,421,1
20150106.145249,2853,938,1584648,266,2853,184,2854,254,1
20150106.145249,2853,2,1584650,2,2853,184,2854,255,1
20150106.14525,2853,412,1585062,-94,2853,24,2854,305,1
20150106.14525,2853,2,1585064,2,2853,22,2854,310,1
20150106.145251,2853,188,1585252,0,2852,1771,2853,161,1
20150106.145251,2853,2,1585254,-2,2852,1769,2853,160,1
20150106.145252,2853,2,1585256,0,2852,1769,2853,360,1
20150106.145253,2853,124,1585380,0,2852,1773,2853,301,1
20150106.145253,2853,8,1585388,0,2852,1772,2853,297,1
20150106.145254,2852,60,1585448,-60,2852,1732,2853,297,0
20150106.145255,2852,6,1585454,-6,2852,1728,2853,309,0
20150106.145257,2852,4,1585458,-2,2852,1741,2853,310,0
20150106.145257,2852,30,1585488,-20,2852,1726,2853,311,0
20150106.145258,2853,170,1585658,82,2852,1725,2853,226,1
20150106.145258,2853,4,1585662,4,2852,1716,2853,229,1
20150106.145259,2852,42,1585704,-24,2852,1821,2853,344,0
20150106.1453,2853,82,1585786,-68,2852,1821,2853,307,1
20150106.145301,2853,12,1585798,-12,2852,1821,2853,304,1
20150106.145301,2853,608,1586406,-356,2853,89,2854,435,1
20150106.145302,2853,2,1586408,0,2853,238,2854,364,1
20150106.145303,2853,4,1586412,0,2853,344,2854,495,1
20150106.145303,2853,2,1586414,0,2853,343,2854,471,1
20150106.145304,2853,2,1586416,0,2853,342,2854,477,1
20150106.145304,2853,2,1586418,0,2853,342,2854,477,1
20150106.145305,2853,250,1586668,-250,2853,161,2854,477,1
20150106.145305,2853,322,1586990,-156,2852,1842,2853,68,1
20150106.145306,2853,4,1586994,-2,2852,1837,2853,264,1
20150106.145307,2853,2,1586996,-2,2852,1817,2853,264,1
20150106.145307,2853,38,1587034,-32,2852,1819,2853,245,1
20150106.145308,2852,6,1587040,0,2852,1818,2853,245,0
20150106.145308,2853,204,1587244,-166,2852,1812,2853,170,1
20150106.145309,2853,6,1587250,0,2852,1812,2853,169,1
20150106.14531,2853,8,1587258,-6,2852,1817,2853,275,1
20150106.145311,2853,14,1587272,-14,2852,1819,2853,270,1
20150106.145312,2853,2,1587274,0,2852,1849,2853,340,1
20150106.145313,2852,2,1587276,-2,2852,1821,2853,342,0
20150106.145313,2853,20,1587296,-20,2852,1821,2853,342,1
20150106.145314,2853,10,1587306,-10,2852,1821,2853,357,1
20150106.145314,2852,2,1587308,0,2852,1820,2853,370,0
20150106.145315,2852,20,1587328,-20,2852,1808,2853,380,0
20150106.145316,2852,2,1587330,0,2852,1807,2853,380,0
20150106.145317,2852,2,1587332,0,2852,1811,2853,391,0
20150106.145317,2853,20,1587352,-16,2852,1804,2853,398,1
20150106.145317,2852,4,1587356,-2,2852,1803,2853,398,0
20150106.145319,2852,2,1587358,-2,2852,1803,2853,600,0
20150106.145319,2852,2,1587360,0,2852,1803,2853,600,0
20150106.14532,2853,188,1587548,0,2852,1818,2853,506,1
20150106.145321,2853,132,1587680,48,2852,1820,2853,440,1
20150106.145322,2853,26,1587706,6,2852,1820,2853,431,1
20150106.145322,2853,6,1587712,4,2852,1821,2853,429,1
20150106.145323,2853,2,1587714,2,2852,1822,2853,429,1
20150106.145323,2852,2,1587716,0,2852,1821,2853,429,0
20150106.145325,2853,68,1587784,12,2852,1808,2853,406,1
20150106.145326,2853,832,1588616,-84,2853,1,2854,427,1
20150106.145327,2853,4,1588620,-4,2853,86,2854,386,1
20150106.145328,2853,4,1588624,0,2853,228,2854,386,1
20150106.145328,2853,2,1588626,0,2853,231,2854,386,1
20150106.145329,2853,102,1588728,4,2853,182,2854,386,1
20150106.14533,2854,404,1589132,-346,2853,202,2854,204,1
20150106.145331,2853,116,1589248,66,2853,489,2854,152,0
20150106.145332,2854,298,1589546,188,2854,158,2855,493,1
20150106.145332,2854,10,1589556,-2,2853,301,2855,481,1
20150106.145333,2854,2,1589558,2,2854,154,2855,471,1
20150106.145334,2854,4,1589562,4,2854,263,2855,471,1
20150106.145335,2854,4,1589566,-4,2854,463,2855,471,1
20150106.145336,2854,2,1589568,0,2854,463,2855,472,1
20150106.145336,2854,2,1589570,-2,2854,462,2855,471,1
20150106.145337,2854,4,1589574,-4,2854,460,2855,473,1
20150106.145339,2854,2,1589576,-2,2854,459,2855,432,1
20150106.14534,2855,2,1589578,-2,2854,459,2855,431,1
20150106.145341,2855,8,1589586,-8,2854,471,2855,432,1
20150106.145341,2854,100,1589686,0,2854,421,2855,440,0
20150106.145342,2854,6,1589692,-6,2854,422,2855,439,0
20150106.145343,2855,12,1589704,0,2854,423,2855,433,1
20150106.145343,2854,2,1589706,-2,2854,423,2855,434,0
20150106.145343,2854,4,1589710,0,2854,421,2855,429,0
20150106.145344,2855,2,1589712,-2,2854,421,2855,428,1
20150106.145344,2854,22,1589734,-2,2854,411,2855,427,0
20150106.145345,2854,2,1589736,0,2854,410,2855,427,0
20150106.145346,2854,2,1589738,-2,2854,411,2855,433,0
20150106.145348,2854,2,1589740,0,2854,411,2855,454,0
20150106.145351,2854,2,1589742,0,2854,415,2855,543,0
20150106.145351,2854,2,1589744,0,2854,414,2855,543,0
20150106.145352,2854,4,1589748,0,2854,418,2855,565,0
20150106.145353,2854,2,1589750,-2,2854,418,2855,563,0
20150106.145354,2854,104,1589854,26,2854,387,2855,562,0
20150106.145355,2855,4,1589858,-4,2854,387,2855,564,1
20150106.145355,2855,2,1589860,0,2854,392,2855,563,1
20150106.145357,2854,4,1589864,4,2854,468,2855,562,0
20150106.145359,2854,2,1589866,2,2854,491,2855,559,0
20150106.1454,2855,12,1589878,-2,2854,486,2855,558,1
20150106.145401,2855,10,1589888,-10,2854,486,2855,554,1
20150106.145402,2854,4,1589892,0,2854,282,2855,549,0
20150106.145403,2854,20,1589912,18,2854,272,2855,570,0
20150106.145403,2854,10,1589922,0,2854,267,2855,683,0
20150106.145404,2854,2,1589924,2,2854,268,2855,683,0
20150106.145404,2855,34,1589958,-30,2854,267,2855,667,1
20150106.145405,2854,2,1589960,0,2854,266,2855,667,0
20150106.145406,2854,30,1589990,-20,2854,263,2855,666,0
20150106.145407,2854,22,1590012,0,2854,281,2855,657,0
20150106.145408,2855,2,1590014,-2,2854,281,2855,656,1
20150106.145409,2854,2,1590016,0,2854,305,2855,658,0
20150106.14541,2855,52,1590068,16,2854,279,2855,637,1
20150106.145411,2855,120,1590188,120,2854,254,2855,578,1
20150106.145411,2855,2,1590190,2,2854,253,2855,577,1
20150106.145412,2854,62,1590252,60,2854,247,2855,547,0
20150106.145413,2855,8,1590260,8,2854,244,2855,548,1
20150106.145415,2855,8,1590268,2,2854,250,2855,544,1
20150106.145415,2854,16,1590284,-16,2854,247,2855,544,0
20150106.145416,2854,2,1590286,-2,2854,248,2855,546,0
20150106.145417,2854,4,1590290,-4,2854,247,2855,546,0
20150106.145418,2855,4,1590294,-4,2854,255,2855,545,1
20150106.145419,2855,2,1590296,0,2854,261,2855,543,1
20150106.14542,2855,2,1590298,-2,2854,263,2855,544,1
20150106.145421,2854,2,1590300,0,2854,263,2855,550,0
20150106.145425,2855,366,1590666,46,2854,225,2855,376,1
20150106.145425,2855,14,1590680,0,2854,225,2855,381,1
20150106.145427,2855,32,1590712,0,2854,225,2855,366,1
20150106.145427,2854,2,1590714,0,2854,224,2855,368,0
20150106.145428,2854,8,1590722,0,2854,221,2855,364,0
20150106.145429,2855,934,1591656,334,2854,405,2855,43,1
20150106.14543,2855,176,1591832,32,2855,2,2856,533,1
20150106.14543,2855,108,1591940,98,2854,346,2856,585,1
20150106.145431,2855,50,1591990,50,2854,381,2855,2,1
20150106.145431,2854,52,1592042,0,2854,389,2855,87,0
20150106.145432,2855,2,1592044,2,2854,389,2855,89,1
20150106.145433,2854,10,1592054,-4,2854,386,2855,99,0
20150106.145433,2855,4,1592058,2,2854,386,2855,97,1
20150106.145434,2855,200,1592258,10,2855,180,2856,549,1
20150106.145435,2855,26,1592284,-26,2855,244,2856,450,1
20150106.145435,2855,16,1592300,-14,2855,57,2856,451,1
20150106.145436,2855,128,1592428,64,2854,541,2855,6,1
20150106.145436,2855,10,1592438,-10,2854,541,2855,3,1
20150106.145437,2855,6,1592444,-4,2854,430,2855,7,1
20150106.145437,2855,102,1592546,68,2855,241,2856,540,1
20150106.145438,2855,2,1592548,0,2855,282,2856,439,1
20150106.145438,2855,18,1592566,-14,2855,404,2856,439,1
20150106.145439,2855,204,1592770,-168,2855,354,2856,439,1
20150106.14544,2855,2,1592772,0,2855,353,2856,449,1
20150106.14544,2856,2,1592774,0,2855,353,2856,450,1
20150106.145441,2856,10,1592784,0,2855,163,2856,452,1
20150106.145442,2856,10,1592794,-2,2855,207,2856,454,1
20150106.145442,2855,2,1592796,0,2855,206,2856,453,0
20150106.145445,2856,14,1592810,0,2855,553,2856,448,1
20150106.145446,2855,10,1592820,-10,2855,561,2856,449,0
20150106.145447,2855,2,1592822,0,2855,574,2856,449,0
20150106.145448,2855,2,1592824,0,2855,575,2856,455,0
20150106.145451,2856,2,1592826,0,2855,585,2856,471,1
20150106.145453,2856,2,1592828,0,2855,600,2856,472,1
20150106.145454,2856,76,1592904,-40,2855,578,2856,499,1
20150106.145456,2855,4,1592908,0,2855,586,2856,512,0
20150106.145456,2856,2,1592910,0,2855,587,2856,511,1
20150106.145456,2856,2,1592912,2,2855,587,2856,513,1
20150106.145458,2856,4,1592916,0,2855,588,2856,511,1
20150106.145459,2855,6,1592922,0,2855,585,2856,512,0
20150106.145459,2855,6,1592928,2,2855,582,2856,512,0
20150106.1455,2855,10,1592938,10,2855,577,2856,513,0
20150106.1455,2855,130,1593068,-22,2855,526,2856,507,0
20150106.145501,2855,18,1593086,10,2855,517,2856,509,0
20150106.145501,2854,1384,1594470,-590,2854,188,2855,52,0
20150106.145503,2855,4,1594474,-4,2854,219,2855,225,1
20150106.145503,2854,60,1594534,60,2854,189,2855,434,0
20150106.145504,2854,378,1594912,-182,2853,628,2854,52,0
20150106.145504,2854,2,1594914,-2,2853,623,2854,206,0
20150106.145505,2854,12,1594926,-8,2853,623,2854,203,0
20150106.145506,2853,2,1594928,0,2853,622,2854,241,0
20150106.145506,2854,16,1594944,0,2853,610,2854,236,1
20150106.145507,2853,8,1594952,6,2853,639,2854,236,0
20150106.145508,2854,40,1594992,-6,2853,619,2854,424,1
20150106.145508,2853,2,1594994,0,2853,618,2854,425,0
20150106.14551,2853,2,1594996,2,2853,617,2854,425,0
20150106.145511,2853,4,1595000,4,2853,615,2854,425,0
20150106.145511,2853,4,1595004,0,2853,614,2854,425,0
20150106.145512,2854,20,1595024,0,2853,619,2854,415,1
20150106.145513,2854,186,1595210,-64,2853,620,2854,322,1
20150106.145514,2854,10,1595220,-10,2853,672,2854,321,1
20150106.145516,2854,12,1595232,6,2853,670,2854,458,1
20150106.145516,2854,234,1595466,-134,2853,671,2854,341,1
20150106.145517,2854,296,1595762,-50,2854,53,2855,447,1
20150106.145517,2854,18,1595780,-4,2854,45,2855,445,1
20150106.145518,2854,46,1595826,2,2854,144,2855,425,1
20150106.145519,2855,6,1595832,2,2854,142,2855,424,1
20150106.145519,2855,46,1595878,40,2854,336,2855,425,1
20150106.14552,2854,28,1595906,2,2854,353,2855,426,0
20150106.145521,2855,26,1595932,8,2854,341,2855,424,1
20150106.145521,2854,18,1595950,8,2854,351,2855,424,0
20150106.145522,2854,4,1595954,0,2854,143,2855,439,0
20150106.145522,2855,8,1595962,4,2854,141,2855,437,1
20150106.145523,2854,6,1595968,2,2854,140,2855,438,0
20150106.145523,2854,22,1595990,0,2854,129,2855,444,0
20150106.145524,2854,98,1596088,0,2854,80,2855,445,0
20150106.145524,2854,18,1596106,0,2854,71,2855,445,0
20150106.145525,2854,14,1596120,0,2854,68,2855,445,0
20150106.145525,2854,4,1596124,0,2854,252,2855,446,0
20150106.145526,2854,8,1596132,-2,2854,246,2855,446,0
20150106.145526,2854,6,1596138,2,2854,243,2855,467,0
20150106.145527,2855,14,1596152,10,2854,267,2855,465,1
20150106.145527,2855,10,1596162,10,2854,254,2855,462,1
20150106.145528,2855,2,1596164,2,2854,254,2855,501,1
20150106.14553,2854,2,1596166,2,2854,249,2855,516,0
20150106.14553,2855,104,1596270,-78,2854,243,2855,464,1
20150106.145531,2854,10,1596280,10,2854,238,2855,464,0
20150106.145532,2855,2,1596282,-2,2854,239,2855,464,1
20150106.145533,2854,202,1596484,30,2854,100,2855,364,0
20150106.145534,2855,2,1596486,0,2854,100,2855,375,1
20150106.145535,2854,2,1596488,2,2854,106,2855,375,0
20150106.145535,2854,2,1596490,2,2854,105,2855,385,0
20150106.145536,2854,12,1596502,2,2854,100,2855,384,0
20150106.145536,2855,42,1596544,38,2854,80,2855,382,1
20150106.145537,2855,2,1596546,0,2854,80,2855,381,1
20150106.145537,2855,202,1596748,-14,2854,80,2855,280,1
20150106.145538,2855,40,1596788,0,2854,210,2855,260,1
20150106.145539,2855,2,1596790,0,2854,308,2855,259,1
20150106.14554,2854,2,1596792,-2,2854,519,2855,279,0
20150106.145542,2855,6,1596798,-6,2854,544,2855,276,1
20150106.145542,2855,4,1596802,0,2854,544,2855,276,1
20150106.145543,2855,2,1596804,0,2854,544,2855,275,1
20150106.145545,2855,10,1596814,-10,2854,545,2855,272,1
20150106.145545,2855,42,1596856,36,2854,529,2855,252,1
20150106.145546,2855,2,1596858,2,2854,529,2855,251,1
20150106.145546,2855,4,1596862,0,2854,488,2855,351,1
20150106.145547,2855,1010,1597872,204,2853,1130,2855,403,1
20150106.145548,2855,2,1597874,0,2854,1,2855,403,1
20150106.145548,2854,2,1597876,2,2854,77,2855,385,0
20150106.145549,2854,2,1597878,0,2854,76,2855,386,0
20150106.145549,2854,6,1597884,-4,2854,74,2855,386,0
20150106.145551,2854,2,1597886,0,2854,234,2855,608,0
20150106.145553,2855,4,1597890,0,2854,260,2855,513,1
20150106.145554,2854,22,1597912,-22,2854,248,2855,515,0
20150106.145554,2855,56,1597968,-24,2854,248,2855,488,1
20150106.145559,2854,6,1597974,0,2854,286,2855,491,0
20150106.1456,2855,2,1597976,0,2854,174,2855,490,1
20150106.145602,2854,2,1597978,0,2854,556,2855,500,0
20150106.145603,2854,2,1597980,0,2854,555,2855,629,0
20150106.145604,2855,2,1597982,-2,2854,555,2855,628,1
20150106.145605,2854,14,1597996,-14,2854,548,2855,666,0
20150106.145606,2855,12,1598008,-10,2854,467,2855,662,1
20150106.145606,2854,638,1598646,-234,2853,1115,2854,53,0
20150106.145607,2853,400,1599046,-94,2853,921,2854,178,0
20150106.145608,2854,332,1599378,0,2853,883,2854,65,1
20150106.145609,2853,400,1599778,-16,2853,693,2854,75,0
20150106.14561,2853,400,1600178,-208,2853,480,2854,291,0
20150106.145611,2854,388,1600566,42,2853,456,2854,210,1
20150106.145611,2853,402,1600968,-176,2852,1127,2854,215,0
20150106.145612,2854,2,1600970,0,2853,213,2854,248,1
20150106.145612,2853,62,1601032,50,2852,1126,2854,250,0
20150106.145613,2853,508,1601540,-178,2853,1,2854,309,0
20150106.145613,2853,28,1601568,-2,2852,1341,2853,70,0
20150106.145614,2853,148,1601716,-140,2852,1363,2853,199,0
20150106.145614,2853,2,1601718,-2,2852,1263,2853,218,0
20150106.145615,2853,404,1602122,-2,2852,1261,2853,24,0
20150106.145615,2853,50,1602172,-26,2853,2,2854,380,0
20150106.145616,2853,4,1602176,-4,2852,1362,2853,198,0
20150106.145616,2852,32,1602208,-30,2852,1260,2853,1236,0
20150106.145617,2853,656,1602864,240,2852,1063,2853,1,1
20150106.145617,2852,116,1602980,-112,2852,1160,2853,182,0
20150106.145618,2853,220,1603200,-2,2852,1059,2853,72,1
20150106.145619,2853,8,1603208,0,2852,1058,2853,345,1
20150106.145619,2853,116,1603324,8,2852,1023,2853,297,1
20150106.14562,2853,8,1603332,2,2852,1023,2853,294,1
20150106.14562,2853,2,1603334,0,2852,1023,2853,495,1
20150106.145621,2853,2,1603336,2,2852,1023,2853,494,1
20150106.145621,2853,4,1603340,0,2852,1053,2853,503,1
20150106.145622,2853,10,1603350,0,2852,1051,2853,501,1
20150106.145622,2853,32,1603382,-30,2852,1051,2853,487,1
20150106.145623,2853,2,1603384,0,2852,1058,2853,486,1
20150106.145623,2852,10,1603394,-10,2852,1053,2853,486,0
20150106.145624,2853,60,1603454,-38,2852,1041,2853,469,1
20150106.145625,2853,20,1603474,-20,2852,1032,2853,513,1
20150106.145626,2853,202,1603676,-200,2852,1031,2853,419,1
20150106.145626,2853,4,1603680,-4,2852,1032,2853,417,1
20150106.145627,2853,22,1603702,0,2852,1037,2853,412,1
20150106.145628,2852,2,1603704,2,2852,1040,2853,477,0
20150106.145629,2852,2084,1605788,494,2851,1140,2852,92,0
20150106.145629,2851,4,1605792,-2,2851,1121,2852,93,0
20150106.14563,2851,108,1605900,-26,2851,1064,2852,116,0
20150106.145631,2851,10,1605910,-6,2851,1061,2852,136,0
20150106.145631,2852,12,1605922,-8,2851,1058,2852,156,1
20150106.145632,2851,6,1605928,-6,2851,1055,2852,156,0
20150106.145632,2852,62,1605990,-60,2851,1055,2852,199,1
20150106.145633,2852,6,1605996,-4,2851,1042,2852,200,1
20150106.145633,2851,50,1606046,2,2851,1042,2852,181,0
20150106.145634,2852,22,1606068,0,2851,1032,2852,175,1
20150106.145634,2851,44,1606112,0,2851,1009,2852,199,0
20150106.145635,2852,6,1606118,0,2851,1017,2852,214,1
20150106.145635,2851,2,1606120,-2,2851,1008,2852,215,0
20150106.145636,2851,6,1606126,0,2851,1012,2852,223,0
20150106.145636,2851,2,1606128,-2,2851,1013,2852,223,0
20150106.145637,2851,132,1606260,48,2851,999,2852,202,0
20150106.145638,2851,12,1606272,-6,2851,1012,2852,199,0
20150106.145638,2851,4,1606276,-2,2851,1010,2852,200,0
20150106.145639,2851,36,1606312,-36,2851,979,2852,201,0
20150106.145639,2851,2,1606314,0,2851,978,2852,201,0
20150106.145639,2852,32,1606346,6,2851,960,2852,255,1
20150106.14564,2851,56,1606402,-32,2851,922,2852,252,0
20150106.145641,2851,148,1606550,-102,2851,896,2852,231,0
20150106.145641,2852,4,1606554,0,2851,895,2852,232,1
20150106.145643,2851,4,1606558,2,2851,890,2852,263,0
20150106.145643,2851,140,1606698,-54,2851,824,2852,266,0
20150106.145644,2852,6,1606704,0,2851,827,2852,286,1
20150106.145644,2851,54,1606758,-26,2851,802,2852,286,0
20150106.145645,2852,2,1606760,0,2851,804,2852,285,1
20150106.145645,2852,130,1606890,-124,2851,775,2852,258,1
20150106.145646,2851,18,1606908,-16,2851,776,2852,257,0
20150106.145646,2852,2,1606910,2,2851,777,2852,256,1
20150106.145647,2851,2,1606912,-2,2851,776,2852,257,0
20150106.145647,2852,4,1606916,-4,2851,782,2852,273,1
20150106.145648,2852,12,1606928,-12,2851,777,2852,318,1
20150106.145649,2851,2,1606930,-2,2851,778,2852,321,0
20150106.145649,2851,20,1606950,0,2851,777,2852,323,0
20150106.14565,2852,16,1606966,-4,2851,780,2852,441,1
20150106.14565,2851,122,1607088,-112,2851,719,2852,442,0
20150106.145651,2852,2,1607090,0,2851,740,2852,444,1
20150106.145652,2851,12,1607102,-2,2851,727,2852,419,0
20150106.145653,2851,6,1607108,-2,2851,724,2852,419,0
20150106.145653,2851,2,1607110,0,2851,723,2852,420,0
20150106.145654,2851,6,1607116,-6,2851,721,2852,422,0
20150106.145654,2851,62,1607178,-60,2851,692,2852,426,0
20150106.145655,2852,6,1607184,-4,2851,691,2852,424,1
20150106.145655,2852,10,1607194,-2,2851,700,2852,420,1
20150106.145656,2851,1400,1608594,-910,2850,1732,2851,324,0
20150106.145656,2851,26,1608620,-24,2850,1698,2851,312,0
20150106.145657,2850,6,1608626,0,2850,1679,2851,314,0
20150106.145657,2850,210,1608836,82,2850,1578,2851,431,0
20150106.145658,2850,334,1609170,-114,2850,1427,2851,435,0
20150106.145658,2850,108,1609278,-106,2850,1375,2851,434,0
20150106.145659,2850,18,1609296,-8,2850,1353,2851,437,0
20150106.145659,2850,18,1609314,16,2850,1371,2851,496,0
20150106.1457,2851,2,1609316,0,2850,1387,2851,596,1
20150106.1457,2850,54,1609370,2,2850,1356,2851,593,0
20150106.145701,2851,20,1609390,14,2850,1347,2851,592,1
20150106.145701,2851,52,1609442,-38,2850,1321,2851,581,1
20150106.145702,2851,32,1609474,0,2850,1320,2851,576,1
20150106.145702,2851,36,1609510,0,2850,1306,2851,572,1
20150106.145703,2850,34,1609544,-4,2850,1428,2851,707,0
20150106.145703,2850,100,1609644,-6,2850,1597,2851,704,0
20150106.145704,2850,2,1609646,0,2850,1596,2851,704,0
20150106.145704,2850,78,1609724,-6,2850,1566,2851,696,0
20150106.145705,2851,1394,1611118,-758,2851,361,2852,381,1
20150106.145705,2852,14,1611132,-6,2851,362,2852,329,1
20150106.145706,2851,10,1611142,-10,2851,366,2852,329,0
20150106.145707,2851,432,1611574,-10,2851,148,2852,327,0
20150106.145707,2852,4,1611578,0,2851,150,2852,351,1
20150106.145708,2851,2,1611580,0,2851,149,2852,351,0
20150106.145709,2851,4,1611584,-4,2851,113,2852,347,0
20150106.145709,2851,8,1611592,-8,2851,109,2852,347,0
20150106.14571,2851,56,1611648,-14,2851,132,2852,358,0
20150106.145711,2851,20,1611668,-10,2851,125,2852,412,0
20150106.145711,2851,2,1611670,0,2851,149,2852,413,0
20150106.145712,2851,404,1612074,-336,2851,212,2852,226,0
20150106.145712,2851,312,1612386,28,2851,58,2852,199,0
20150106.145714,2851,6,1612392,6,2851,384,2852,210,0
20150106.145714,2851,2,1612394,0,2851,413,2852,220,0
20150106.145715,2851,10,1612404,6,2851,417,2852,369,0
20150106.145715,2851,4,1612408,0,2851,410,2852,371,0
20150106.145716,2851,126,1612534,102,2851,372,2852,350,0
20150106.145716,2851,212,1612746,-98,2851,274,2852,348,0
20150106.145717,2851,100,1612846,2,2851,136,2852,411,0
20150106.145717,2851,22,1612868,8,2851,127,2852,411,0
20150106.145718,2851,6,1612874,-6,2851,159,2852,415,0
20150106.145718,2851,28,1612902,-26,2851,166,2852,425,0
20150106.145719,2851,4,1612906,-4,2851,165,2852,540,0
20150106.145719,2851,6,1612912,-2,2851,165,2852,538,0
20150106.14572,2851,14,1612926,4,2851,160,2852,537,0
20150106.145721,2851,12,1612938,-12,2851,156,2852,552,0
20150106.145721,2851,322,1613260,-212,2850,1615,2852,563,0
20150106.145722,2851,14,1613274,-12,2850,1617,2851,4,0
20150106.145723,2851,14,1613288,-2,2850,1618,2851,7,0
20150106.145724,2851,30,1613318,16,2850,1616,2851,5,0
20150106.145724,2851,8,1613326,4,2850,1617,2851,10,0
20150106.145725,2851,14,1613340,10,2850,1638,2851,15,0
20150106.145725,2851,14,1613354,-4,2850,1639,2851,8,0
20150106.145726,2851,24,1613378,-8,2850,1663,2851,18,0
20150106.145726,2850,4,1613382,2,2850,1665,2851,25,0
20150106.145727,2851,12,1613394,6,2850,1672,2851,24,1
20150106.145728,2851,24,1613418,-24,2850,1677,2851,158,1
20150106.145728,2851,6,1613424,2,2850,1677,2851,156,1
20150106.145729,2850,2,1613426,0,2850,1676,2851,166,0
20150106.145729,2851,22,1613448,16,2850,1676,2851,356,1
20150106.14573,2850,30,1613478,0,2850,1681,2851,357,0
20150106.145731,2850,12,1613490,-8,2850,1681,2851,352,0
20150106.145731,2850,402,1613892,-118,2850,1488,2851,363,0
20150106.145732,2850,6,1613898,0,2850,1486,2851,375,0
20150106.145732,2850,404,1614302,-234,2850,1292,2851,375,0
20150106.145733,2851,426,1614728,-260,2850,1092,2851,369,1
20150106.145733,2851,16,1614744,0,2850,1094,2851,392,1
20150106.145734,2851,2236,1616980,498,2849,876,2850,200,1
20150106.145734,2850,82,1617062,-10,2849,848,2850,264,0
20150106.145735,2849,42,1617104,2,2849,834,2850,463,0
20150106.145736,2849,124,1617228,-24,2849,799,2850,438,0
20150106.145736,2849,80,1617308,0,2849,761,2850,439,0
20150106.145737,2850,32,1617340,-10,2849,771,2850,433,1
20150106.145737,2849,14,1617354,10,2849,769,2850,456,0
20150106.145738,2849,46,1617400,-12,2849,755,2850,447,0
20150106.145738,2850,4,1617404,-2,2849,756,2850,465,1
20150106.145739,2849,72,1617476,14,2849,730,2850,452,0
20150106.145739,2849,22,1617498,20,2849,722,2850,451,0
20150106.14574,2849,64,1617562,0,2849,695,2850,450,0
20150106.14574,2850,6,1617568,0,2849,695,2850,447,1
20150106.145741,2851,1000,1618568,228,2850,1,2851,306,1
20150106.145741,2850,292,1618860,-116,2849,737,2850,56,0
20150106.145742,2850,514,1619374,-352,2850,825,2851,317,0
20150106.145743,2850,46,1619420,-6,2850,815,2851,317,0
20150106.145744,2850,446,1619866,-444,2850,599,2851,486,0
20150106.145744,2850,40,1619906,-4,2850,594,2851,481,0
20150106.145745,2850,2,1619908,0,2850,596,2851,352,0
20150106.145746,2850,88,1619996,-60,2849,712,2850,195,0
20150106.145747,2849,58,1620054,2,2849,696,2850,378,0
20150106.145747,2849,2,1620056,2,2849,696,2850,388,0
20150106.145748,2849,10,1620066,2,2849,694,2850,409,0
20150106.145748,2849,58,1620124,-10,2849,684,2850,391,0
20150106.145749,2850,12,1620136,-2,2849,685,2850,392,1
20150106.145749,2850,16,1620152,0,2849,685,2850,387,1
20150106.14575,2850,18,1620170,0,2849,686,2850,378,1
20150106.14575,2850,126,1620296,0,2849,626,2850,379,1
20150106.145751,2849,44,1620340,0,2849,607,2850,379,0
20150106.145751,2849,16,1620356,0,2849,601,2850,386,0
20150106.145752,2850,14,1620370,-2,2849,608,2850,385,1
20150106.145752,2850,10,1620380,0,2849,615,2850,580,1
20150106.145753,2850,40,1620420,0,2849,615,2850,564,1
20150106.145753,2850,20,1620440,-18,2849,620,2850,553,1
20150106.145754,2849,134,1620574,-112,2849,620,2850,490,0
20150106.145754,2850,22,1620596,0,2849,621,2850,483,1
20150106.145755,2849,66,1620662,16,2849,590,2850,481,0
20150106.145756,2849,206,1620868,-168,2849,489,2850,5563,0
20150106.145756,2850,168,1621036,166,2849,410,2850,6561,1
20150106.145757,2850,4,1621040,-4,2849,462,2850,6559,1
20150106.145757,2850,82,1621122,-58,2849,487,2850,547,1
20150106.145758,2850,64,1621186,-12,2849,489,2850,526,1
20150106.145758,2849,12,1621198,8,2849,584,2850,527,0
20150106.145759,2849,44,1621242,16,2849,574,2850,539,0
20150106.145759,2850,320,1621562,280,2849,455,2850,575,1
20150106.1458,2849,28,1621590,8,2849,448,2850,569,0
20150106.145801,2849,102,1621692,-74,2849,496,2850,530,0
20150106.145802,2850,68,1621760,-26,2849,478,2850,547,1
20150106.145802,2850,66,1621826,-66,2849,486,2850,514,1
20150106.145803,2850,18,1621844,-8,2849,504,2850,507,1
20150106.145803,2850,8,1621852,-6,2849,524,2850,503,1
20150106.145803,2850,6,1621858,-6,2849,527,2850,500,1
20150106.145804,2850,46,1621904,14,2849,513,2850,512,1
20150106.145805,2849,4,1621908,2,2849,544,2850,522,0
20150106.145805,2850,2,1621910,-2,2849,552,2850,521,1
20150106.145806,2850,4,1621914,0,2849,560,2850,521,1
20150106.145806,2849,124,1622038,-36,2849,562,2850,472,0
20150106.145807,2850,944,1622982,-900,2850,325,2851,352,1
20150106.145807,2850,30,1623012,-28,2850,405,2851,352,1
20150106.145808,2850,32,1623044,-16,2850,1037,2851,402,1
20150106.145808,2850,10,1623054,-10,2850,1073,2851,288,1
20150106.145809,2851,42,1623096,-40,2850,1057,2851,287,1
20150106.145809,2850,32,1623128,-24,2850,1065,2851,286,0
20150106.14581,2851,10,1623138,10,2850,1066,2851,280,1
20150106.14581,2851,296,1623434,-202,2850,1066,2851,102,1
20150106.145811,2850,12,1623446,-12,2850,1022,2851,102,0
20150106.145811,2850,28,1623474,-28,2850,1007,2851,102,0
20150106.145812,2851,132,1623606,-130,2850,951,2851,104,1
20150106.145813,2851,18,1623624,-10,2850,946,2851,100,1
20150106.145814,2850,6,1623630,0,2850,949,2851,112,0
20150106.145814,2851,112,1623742,-112,2850,941,2851,102,1
20150106.145815,2851,2,1623744,0,2850,962,2851,103,1
20150106.145815,2850,12,1623756,0,2850,1075,2851,116,0
20150106.145816,2851,14,1623770,-6,2850,1066,2851,128,1
20150106.145816,2850,10,1623780,-8,2850,1073,2851,130,0
20150106.145817,2850,10,1623790,-10,2850,1061,2851,129,0
20150106.145817,2851,4,1623794,-2,2850,1061,2851,127,1
20150106.145818,2851,4,1623798,-2,2850,1060,2851,130,1
20150106.145818,2851,14,1623812,-12,2850,512,2851,132,1
20150106.145819,2850,8,1623820,-4,2850,511,2851,135,0
20150106.145819,2850,8,1623828,-8,2850,507,2851,135,0
20150106.14582,2850,4,1623832,-2,2850,526,2851,140,0
20150106.14582,2851,66,1623898,-66,2850,445,2851,116,1
20150106.145821,2851,4,1623902,-2,2850,445,2851,115,1
20150106.145821,2850,8,1623910,-6,2850,442,2851,107,0
20150106.145822,2851,214,1624124,-150,2851,93,2852,427,1
20150106.145822,2850,188,1624312,-186,2850,465,2851,1104,0
20150106.145823,2850,32,1624344,-26,2850,447,2851,5099,0
20150106.145823,2850,440,1624784,-52,2850,226,2851,6138,0
20150106.145824,2851,50,1624834,-8,2850,221,2851,52,1
20150106.145824,2850,14,1624848,0,2850,217,2851,72,0
20150106.145825,2851,124,1624972,60,2850,315,2851,197,1
20150106.145825,2851,20,1624992,0,2850,316,2851,212,1
20150106.145826,2850,14,1625006,-10,2850,319,2851,207,0
20150106.145826,2851,6,1625012,-6,2850,322,2851,216,1
20150106.145827,2851,50,1625062,-2,2850,306,2851,222,1
20150106.145827,2851,6,1625068,-2,2850,321,2851,356,1
20150106.145828,2851,2,1625070,-2,2850,323,2851,352,1
20150106.145829,2851,150,1625220,138,2850,315,2851,344,1
20150106.14583,2850,10,1625230,0,2850,311,2851,356,0
20150106.14583,2851,46,1625276,-12,2850,302,2851,348,1
20150106.145831,2850,66,1625342,-56,2850,303,2851,385,0
20150106.145831,2850,8,1625350,0,2850,356,2851,340,0
20150106.145832,2850,412,1625762,-120,2850,138,2851,340,0
20150106.145832,2851,20,1625782,-2,2850,97,2851,339,1
20150106.145833,2850,278,1626060,-126,2849,857,2850,102,0
20150106.145833,2850,142,1626202,-48,2849,789,2850,107,0
20150106.145834,2850,24,1626226,0,2849,789,2850,295,0
20150106.145835,2850,24,1626250,-10,2849,778,2850,330,0
20150106.145836,2849,460,1626710,142,2849,586,2850,318,0
20150106.145837,2850,52,1626762,0,2849,602,2850,343,1
20150106.145837,2850,2,1626764,0,2849,467,2850,420,1
20150106.145838,2850,122,1626886,0,2849,400,2850,408,1
20150106.145838,2850,60,1626946,-60,2849,400,2850,457,1
20150106.145838,2849,2,1626948,0,2849,399,2850,418,0
20150106.145839,2849,104,1627052,10,2849,384,2850,419,0
20150106.14584,2849,84,1627136,-42,2849,364,2850,445,0
20150106.14584,2850,64,1627200,-56,2849,365,2850,620,1
20150106.145841,2850,10,1627210,-10,2849,366,2850,621,1
20150106.145842,2849,44,1627254,-20,2849,337,2850,608,0
20150106.145842,2850,8,1627262,0,2849,337,2850,604,1
20150106.145843,2850,18,1627280,0,2849,343,2850,595,1
20150106.145844,2849,82,1627362,-68,2849,366,2850,597,0
20150106.145844,2850,30,1627392,-30,2849,373,2850,621,1
20150106.145845,2849,240,1627632,64,2849,253,2850,621,0
20150106.145845,2849,12,1627644,-10,2849,248,2850,620,0
20150106.145846,2849,8,1627652,-8,2849,247,2850,613,0
20150106.145847,2849,18,1627670,-10,2849,806,2850,610,0
20150106.145847,2849,2,1627672,-2,2849,806,2850,611,0
20150106.145848,2849,402,1628074,-256,2849,808,2850,411,0
20150106.145849,2850,22,1628096,2,2849,918,2850,406,1
20150106.145849,2850,818,1628914,-12,2849,988,2850,15,1
20150106.14585,2850,14,1628928,-6,2849,1004,2850,8,1
20150106.14585,2849,170,1629098,-148,2849,988,2850,84,0
20150106.145851,2850,34,1629132,2,2849,976,2850,157,1
20150106.145851,2849,14,1629146,-10,2849,965,2850,352,0
20150106.145852,2850,16,1629162,-16,2849,968,2850,435,1
20150106.145853,2849,48,1629210,4,2849,952,2850,441,0
20150106.145853,2849,10,1629220,10,2849,947,2850,443,0
20150106.145854,2850,80,1629300,-74,2849,954,2850,403,1
20150106.145854,2849,28,1629328,-2,2849,951,2850,453,0
20150106.145855,2849,46,1629374,0,2849,930,2850,462,0
20150106.145855,2849,24,1629398,22,2849,916,2850,461,0
20150106.145857,2850,2,1629400,0,2849,925,2850,539,1
20150106.145857,2849,2,1629402,2,2849,963,2850,539,0
20150106.145857,2850,20,1629422,-20,2849,963,2850,530,1
20150106.145858,2849,46,1629468,22,2849,953,2850,519,0
20150106.145859,2850,2,1629470,0,2849,950,2850,522,1
20150106.145859,2850,4,1629474,2,2849,942,2850,521,1
20150106.1459,2849,6,1629480,2,2849,952,2850,519,0
20150106.1459,2849,18,1629498,8,2849,943,2850,519,0
20150106.1459,2850,12,1629510,6,2849,942,2850,514,1
20150106.145901,2850,42,1629552,-8,2849,848,2850,525,1
20150106.145902,2850,94,1629646,-70,2849,809,2850,535,1
20150106.145902,2849,132,1629778,-120,2849,738,2850,536,0
20150106.145903,2850,30,1629808,-20,2849,731,2850,573,1
20150106.145903,2849,118,1629926,-118,2849,672,2850,573,0
20150106.145904,2850,56,1629982,2,2849,662,2850,565,1
20150106.145904,2850,20,1630002,-4,2849,654,2850,563,1
20150106.145905,2849,50,1630052,-46,2849,683,2850,561,0
20150106.145905,2849,16,1630068,4,2849,733,2850,676,0
20150106.145906,2849,14,1630082,-2,2849,828,2850,670,0
20150106.145906,2850,60,1630142,-30,2849,819,2850,650,1
20150106.145907,2849,2,1630144,0,2849,828,2850,680,0
20150106.145907,2849,36,1630180,0,2849,811,2850,679,0
20150106.145908,2849,24,1630204,-4,2849,807,2850,677,0
20150106.145908,2850,6,1630210,-6,2849,807,2850,678,1
20150106.145909,2849,12,1630222,-10,2849,805,2850,680,0
20150106.145909,2849,2,1630224,0,2849,804,2850,680,0
20150106.14591,2849,4,1630228,0,2849,803,2850,681,0
20150106.14591,2850,74,1630302,-74,2849,787,2850,681,1
20150106.145911,2850,96,1630398,-92,2849,786,2850,635,1
20150106.145911,2850,10,1630408,0,2849,786,2850,639,1
20150106.145912,2850,96,1630504,-94,2849,750,2850,632,1
20150106.145913,2849,2,1630506,0,2849,752,2850,632,0
20150106.145913,2850,12,1630518,-4,2849,751,2850,629,1
20150106.145914,2850,22,1630540,-6,2849,761,2850,620,1
20150106.145914,2850,8,1630548,-6,2849,760,2850,617,1
20150106.145915,2849,14,1630562,-4,2849,754,2850,615,0
20150106.145915,2850,6,1630568,-6,2849,755,2850,612,1
20150106.145916,2850,646,1631214,-20,2849,537,2850,509,1
20150106.145916,2849,4,1631218,0,2849,535,2850,511,0
20150106.145917,2850,86,1631304,18,2849,535,2850,673,1
20150106.145917,2850,406,1631710,-292,2849,613,2850,495,1
20150106.145918,2849,82,1631792,-16,2849,728,2850,455,0
20150106.145918,2849,20,1631812,-20,2849,822,2850,457,0
20150106.145919,2850,20,1631832,-18,2849,820,2850,451,1
20150106.145919,2850,84,1631916,-8,2849,789,2850,425,1
20150106.14592,2850,38,1631954,-8,2849,787,2850,450,1
20150106.14592,2850,184,1632138,88,2849,776,2850,383,1
20150106.145921,2850,2,1632140,0,2849,777,2850,387,1
20150106.145922,2850,10,1632150,0,2849,787,2850,384,1
20150106.145923,2849,416,1632566,-316,2849,804,2850,195,0
20150106.145923,2849,32,1632598,2,2849,788,2850,199,0
20150106.145924,2849,242,1632840,168,2849,691,2850,275,0
20150106.145924,2850,50,1632890,-42,2849,693,2850,351,1
20150106.145925,2850,222,1633112,-126,2849,689,2850,250,1
20150106.145925,2850,46,1633158,18,2849,688,2850,229,1
20150106.145926,2850,16,1633174,-4,2849,685,2850,428,1
20150106.145926,2849,34,1633208,18,2849,677,2850,431,0
20150106.145927,2850,946,1634154,674,2849,274,2850,436,1
20150106.145927,2850,2,1634156,0,2849,274,2850,719,1
20150106.145928,2850,98,1634254,2,2848,1324,2850,710,1
20150106.145928,2849,12,1634266,-6,2849,433,2850,823,0
20150106.145929,2850,4,1634270,2,2849,433,2850,842,1
20150106.145929,2849,14,1634284,-10,2849,448,2850,874,0
20150106.14593,2850,26,1634310,-12,2849,441,2850,882,1
20150106.14593,2850,2,1634312,2,2849,441,2850,881,1
20150106.145931,2850,24,1634336,-14,2849,431,2850,882,1
20150106.145931,2850,38,1634374,24,2849,426,2850,870,1
20150106.145932,2849,128,1634502,-114,2849,414,2850,818,0
20150106.145932,2849,6,1634508,0,2849,414,2850,822,0
20150106.145933,2849,4,1634512,-2,2849,422,2850,821,0
20150106.145934,2849,28,1634540,-4,2849,420,2850,813,0
20150106.145935,2849,26,1634566,-10,2849,439,2850,858,0
20150106.145935,2850,20,1634586,-20,2849,639,2850,849,1
20150106.145936,2849,6,1634592,-6,2849,641,2850,849,0
20150106.145936,2850,2,1634594,0,2849,743,2850,879,1
20150106.145937,2849,20,1634614,-16,2849,738,2850,874,0
20150106.145938,2850,166,1634780,-164,2849,688,2850,862,1
20150106.145938,2849,68,1634848,-34,2849,655,2850,861,0
20150106.145939,2849,18,1634866,-8,2849,645,2850,864,0
20150106.145939,2849,202,1635068,-198,2849,644,2850,765,0
20150106.14594,2850,36,1635104,-12,2849,639,2850,756,1
20150106.14594,2850,10,1635114,-6,2849,655,2850,764,1
20150106.145941,2849,74,1635188,-64,2849,646,2850,821,0
20150106.145941,2850,208,1635396,-188,2849,644,2850,917,1
20150106.145942,2850,4,1635400,-2,2849,645,2850,916,1
20150106.145942,2849,50,1635450,-36,2849,623,2850,899,0
20150106.145943,2850,4,1635454,0,2849,629,2850,898,1
20150106.145944,2849,176,1635630,14,2849,546,2850,894,0
20150106.145944,2850,56,1635686,-24,2849,528,2850,895,1
20150106.145945,2849,80,1635766,-70,2849,520,2850,863,0
20150106.145946,2849,156,1635922,-122,2849,479,2850,814,0
20150106.145946,2850,6,1635928,-2,2849,478,2850,813,1
20150106.145947,2850,222,1636150,-2,2849,468,2850,713,1
20150106.145948,2849,34,1636184,-12,2849,468,2850,704,0
20150106.145948,2849,30,1636214,-26,2849,453,2850,705,0
20150106.145949,2849,78,1636292,-2,2849,444,2850,672,0
20150106.145949,2849,14,1636306,-12,2849,440,2850,669,0
20150106.14595,2849,28,1636334,-26,2849,440,2850,674,0
20150106.14595,2849,60,1636394,-24,2849,415,2850,671,0
20150106.145951,2849,248,1636642,-84,2849,321,2850,617,0
20150106.145951,2849,282,1636924,-22,2849,217,2850,681,0
20150106.145951,2850,20,1636944,10,2849,208,2850,680,1
20150106.145952,2849,300,1637244,34,2848,1653,2850,620,0
20150106.145953,2849,62,1637306,-22,2848,1655,2850,621,0
20150106.145953,2849,48,1637354,4,2849,84,2850,605,0
20150106.145954,2849,482,1637836,-324,2848,1655,2850,377,0
20150106.145954,2850,18,1637854,-10,2849,71,2850,378,1
20150106.145955,2849,6,1637860,0,2849,156,2850,378,0
20150106.145955,2849,14,1637874,-10,2849,151,2850,378,0
20150106.145956,2850,202,1638076,-58,2849,106,2850,295,1
20150106.145956,2849,4,1638080,4,2849,104,2850,295,0
20150106.145956,2849,2,1638082,2,2849,103,2850,295,0
20150106.145957,2849,4,1638086,0,2849,154,2850,294,0
20150106.145958,2850,212,1638298,-8,2848,1653,2850,190,1
20150106.145958,2849,110,1638408,10,2848,1746,2849,34,0
20150106.145959,2848,86,1638494,-6,2848,1738,2849,231,0
20150106.15,2848,190,1638684,148,2848,1647,2849,318,0
20150106.15,2849,4,1638688,2,2848,1647,2849,316,1
