20150105.21,2804.26,2862,17332,3209058,0,0,0,0,0
20150105.210001,2804.19,7782,25114,5138,0,0,0,0,0
20150105.210002,2807.02,11404,36518,5902,0,0,0,0,0
20150105.210003,2802.94,2980,39498,962,0,0,0,0,0
20150105.210004,2803.79,2738,42236,-326,0,0,0,0,0
20150105.210005,2805.94,1040,43276,624,0,0,0,0,0
20150105.210006,2806.64,1006,44282,128,0,0,0,0,0
20150105.210007,2805.89,694,44976,152,0,0,0,0,0
20150105.210008,2804.54,1192,46168,368,0,0,0,0,0
20150105.210009,2803.66,624,46792,104,0,0,0,0,0
20150105.21001,2804.52,986,47778,536,0,0,0,0,0
20150105.210011,2804.75,950,48728,-614,0,0,0,0,0
20150105.210012,2803.27,746,49474,378,0,0,0,0,0
20150105.210013,2804.51,252,49726,24,0,0,0,0,0
20150105.210014,2803.27,636,50362,96,0,0,0,0,0
20150105.210015,2803.88,394,50756,210,0,0,0,0,0
20150105.210016,2802.89,746,51502,64,0,0,0,0,0
20150105.210017,2804.51,640,52142,108,0,0,0,0,0
20150105.210018,2804.51,1344,53486,-160,0,0,0,0,0
20150105.210019,2804.63,572,54058,346,0,0,0,0,0
20150105.21002,2804.28,564,54622,104,0,0,0,0,0
20150105.210021,2803.97,556,55178,-102,0,0,0,0,0
20150105.210022,2804.62,526,55704,-166,0,0,0,0,0
20150105.210023,2804.96,446,56150,-68,0,0,0,0,0
20150105.210024,2804.98,416,56566,-132,0,0,0,0,0
20150105.210025,2805.58,264,56830,132,0,0,0,0,0
20150105.210026,2805.51,110,56940,44,0,0,0,0,0
20150105.210027,2805.89,602,57542,226,0,0,0,0,0
20150105.210028,2805.89,662,58204,-62,0,0,0,0,0
20150105.210029,2806.5,404,58608,102,0,0,0,0,0
20150105.21003,2806.5,202,58810,68,0,0,0,0,0
20150105.210031,2806.49,344,59154,-74,0,0,0,0,0
20150105.210032,2807.1,498,59652,118,0,0,0,0,0
20150105.210033,2807.1,584,60236,246,0,0,0,0,0
20150105.210034,2805.85,894,61130,670,0,0,0,0,0
20150105.210035,2805.85,760,61890,476,0,0,0,0,0
20150105.210036,2806.48,452,62342,46,0,0,0,0,0
20150105.210037,2806.48,474,62816,14,0,0,0,0,0
20150105.210038,2806.48,672,63488,-498,0,0,0,0,0
20150105.210039,2806.11,402,63890,-160,0,0,0,0,0
20150105.21004,2805.24,484,64374,238,0,0,0,0,0
20150105.210041,2805.86,314,64688,226,0,0,0,0,0
20150105.210042,2805.49,1044,65732,300,0,0,0,0,0
20150105.210043,2805.87,1116,66848,786,0,0,0,0,0
20150105.210044,2805.87,994,67842,286,0,0,0,0,0
20150105.210045,2805.87,220,68062,40,0,0,0,0,0
20150105.210046,2805.86,924,68986,434,0,0,0,0,0
20150105.210047,2806.23,312,69298,74,0,0,0,0,0
20150105.210048,2806.23,378,69676,64,0,0,0,0,0
20150105.210049,2806.85,642,70318,34,0,0,0,0,0
20150105.21005,2806.6,214,70532,48,0,0,0,0,0
20150105.210051,2805.85,1094,71626,910,0,0,0,0,0
20150105.210052,2806.22,446,72072,36,0,0,0,0,0
20150105.210053,2806.22,1010,73082,704,0,0,0,0,0
20150105.210054,2805.58,1954,75036,854,0,0,0,0,0
20150105.210055,2805.95,568,75604,-126,0,0,0,0,0
20150105.210056,2805.57,470,76074,54,0,0,0,0,0
20150105.210057,2803.95,1220,77294,568,0,0,0,0,0
20150105.210058,2804.95,1052,78346,346,0,0,0,0,0
20150105.210059,2805.56,776,79122,158,0,0,0,0,0
20150105.2101,2804.94,160,79282,-8,0,0,0,0,0
20150105.210101,2805.68,1038,80320,6,0,0,0,0,0
20150105.210102,2804.97,204,80524,26,0,0,0,0,0
20150105.210103,2804.6,322,80846,-102,0,0,0,0,0
20150105.210104,2804.97,530,81376,-232,0,0,0,0,0
20150105.210105,2805.22,292,81668,-2,0,0,0,0,0
20150105.210106,2804.6,262,81930,-32,0,0,0,0,0
20150105.210107,2805.59,334,82264,178,0,0,0,0,0
20150105.210108,2805.61,1060,83324,328,0,0,0,0,0
20150105.210109,2805.6,408,83732,-42,0,0,0,0,0
20150105.21011,2805.97,1552,85284,-556,0,0,0,0,0
20150105.210111,2805.95,332,85616,-198,0,0,0,0,0
20150105.210112,2805.57,430,86046,-98,0,0,0,0,0
20150105.210113,2805.56,540,86586,-262,0,0,0,0,0
20150105.210114,2806.55,576,87162,198,0,0,0,0,0
20150105.210115,2806.16,1072,88234,-788,0,0,0,0,0
20150105.210116,2806.53,1712,89946,518,0,0,0,0,0
20150105.210117,2806.53,484,90430,-140,0,0,0,0,0
20150105.210118,2806.15,288,90718,30,0,0,0,0,0
20150105.210119,2806.53,356,91074,-32,0,0,0,0,0
20150105.21012,2806.53,206,91280,-142,0,0,0,0,0
20150105.210121,2806.53,132,91412,-12,0,0,0,0,0
20150105.210122,2807.15,62,91474,16,0,0,0,0,0
20150105.210123,2806.9,212,91686,8,0,0,0,0,0
20150105.210124,2807.15,194,91880,28,0,0,0,0,0
20150105.210125,2806.53,1136,93016,-98,0,0,0,0,0
20150105.210126,2807.15,632,93648,-234,0,0,0,0,0
20150105.210127,2808.14,354,94002,-102,0,0,0,0,0
20150105.210128,2807.89,1778,95780,38,0,0,0,0,0
20150105.210129,2809.13,1324,97104,-136,0,0,0,0,0
20150105.21013,2808.76,240,97344,-10,0,0,0,0,0
20150105.210131,2809.75,78,97422,8,0,0,0,0,0
20150105.210132,2809.75,168,97590,20,0,0,0,0,0
20150105.210133,2809.14,348,97938,26,0,0,0,0,0
20150105.210134,2809.75,336,98274,2,0,0,0,0,0
20150105.210135,2809.37,948,99222,-682,0,0,0,0,0
20150105.210136,2809.75,726,99948,90,0,0,0,0,0
20150105.210137,2808.5,542,100490,-64,0,0,0,0,0
20150105.210138,2808.13,448,100938,-238,0,0,0,0,0
20150105.210139,2809.12,1840,102778,-180,0,0,0,0,0
20150105.21014,2809.74,358,103136,-240,0,0,0,0,0
20150105.210141,2808.8,258,103394,-2,0,0,0,0,0
20150105.210142,2810.11,302,103696,28,0,0,0,0,0
20150105.210143,2810.36,224,103920,-76,0,0,0,0,0
20150105.210144,2810.11,114,104034,-30,0,0,0,0,0
20150105.210145,2810.36,48,104082,24,0,0,0,0,0
20150105.210146,2810.73,564,104646,-216,0,0,0,0,0
20150105.210147,2811.35,230,104876,-102,0,0,0,0,0
20150105.210148,2810.73,54,104930,26,0,0,0,0,0
20150105.210149,2810.36,358,105288,-134,0,0,0,0,0
20150105.21015,2811.35,726,106014,-436,0,0,0,0,0
20150105.210151,2811.35,640,106654,-316,0,0,0,0,0
20150105.210152,2810.73,214,106868,-116,0,0,0,0,0
20150105.210153,2810.98,520,107388,-64,0,0,0,0,0
20150105.210154,2810.98,110,107498,26,0,0,0,0,0
20150105.210155,2810.73,426,107924,40,0,0,0,0,0
20150105.210156,2811.35,58,107982,28,0,0,0,0,0
20150105.210157,2811.1,334,108316,-126,0,0,0,0,0
20150105.210158,2811.72,776,109092,-328,0,0,0,0,0
20150105.210159,2811.1,528,109620,228,0,0,0,0,0
20150105.2102,2811.1,574,110194,-60,0,0,0,0,0
20150105.210201,2811.97,196,110390,126,0,0,0,0,0
20150105.210202,2811.72,194,110584,-40,0,0,0,0,0
20150105.210203,2811.72,98,110682,62,0,0,0,0,0
20150105.210204,2811.72,40,110722,36,0,0,0,0,0
20150105.210205,2811.72,384,111106,18,0,0,0,0,0
20150105.210206,2811.97,48,111154,10,0,0,0,0,0
20150105.210207,2811.72,264,111418,152,0,0,0,0,0
20150105.210208,2812.34,36,111454,32,0,0,0,0,0
20150105.210209,2811.35,418,111872,94,0,0,0,0,0
20150105.21021,2812.34,164,112036,46,0,0,0,0,0
20150105.210211,2811.1,2442,114478,454,0,0,0,0,0
20150105.210212,2812.34,2766,117244,-1506,0,0,0,0,0
20150105.210213,2812.71,908,118152,24,0,0,0,0,0
20150105.210214,2812.34,128,118280,18,0,0,0,0,0
20150105.210215,2813.33,112,118392,74,0,0,0,0,0
20150105.210216,2813.33,716,119108,-220,0,0,0,0,0
20150105.210217,2812.71,764,119872,-636,0,0,0,0,0
20150105.210218,2813.33,90,119962,-36,0,0,0,0,0
20150105.210219,2812.96,376,120338,-318,0,0,0,0,0
20150105.21022,2813.71,60,120398,46,0,0,0,0,0
20150105.210221,2812.96,582,120980,58,0,0,0,0,0
20150105.210222,2812.71,202,121182,44,0,0,0,0,0
20150105.210223,2812.71,222,121404,188,0,0,0,0,0
20150105.210224,2812.71,80,121484,6,0,0,0,0,0
20150105.210225,2812.34,326,121810,250,0,0,0,0,0
20150105.210226,2811.72,92,121902,0,0,0,0,0,0
20150105.210227,2812.09,170,122072,-30,0,0,0,0,0
20150105.210228,2811.72,514,122586,-230,0,0,0,0,0
20150105.210229,2811.47,512,123098,-56,0,0,0,0,0
20150105.21023,2811.72,174,123272,78,0,0,0,0,0
20150105.210231,2812.09,438,123710,-90,0,0,0,0,0
20150105.210232,2812.71,136,123846,74,0,0,0,0,0
20150105.210233,2812.71,50,123896,34,0,0,0,0,0
20150105.210234,2812.71,668,124564,110,0,0,0,0,0
20150105.210235,2813.09,234,124798,48,0,0,0,0,0
20150105.210236,2812.71,158,124956,112,0,0,0,0,0
20150105.210237,2813.71,110,125066,54,0,0,0,0,0
20150105.210238,2813.33,896,125962,-180,0,0,0,0,0
20150105.210239,2813.7,330,126292,-26,0,0,0,0,0
20150105.21024,2813.33,330,126622,-256,0,0,0,0,0
20150105.210241,2813.7,96,126718,26,0,0,0,0,0
20150105.210242,2813.7,336,127054,-94,0,0,0,0,0
20150105.210243,2813.7,844,127898,-442,0,0,0,0,0
20150105.210244,2813.33,596,128494,340,0,0,0,0,0
20150105.210245,2813.95,272,128766,50,0,0,0,0,0
20150105.210246,2813.7,284,129050,70,0,0,0,0,0
20150105.210247,2813.7,2558,131608,596,0,0,0,0,0
20150105.210248,2813.09,240,131848,-2,0,0,0,0,0
20150105.210249,2813.46,412,132260,-36,0,0,0,0,0
20150105.21025,2813.7,506,132766,-70,0,0,0,0,0
20150105.210251,2813.71,972,133738,750,0,0,0,0,0
20150105.210252,2814.33,1200,134938,606,0,0,0,0,0
20150105.210253,2815.32,24,134962,10,0,0,0,0,0
20150105.210254,2814.7,736,135698,8,0,0,0,0,0
20150105.210255,2814.94,556,136254,-302,0,0,0,0,0
20150105.210256,2815.32,88,136342,8,0,0,0,0,0
20150105.210257,2815.32,848,137190,-504,0,0,0,0,0
20150105.210258,2815.32,118,137308,16,0,0,0,0,0
20150105.210259,2814.94,96,137404,52,0,0,0,0,0
20150105.2103,2815.32,94,137498,-2,0,0,0,0,0
20150105.210301,2815.32,356,137854,132,0,0,0,0,0
20150105.210302,2815.32,542,138396,-330,0,0,0,0,0
20150105.210303,2814.7,202,138598,-80,0,0,0,0,0
20150105.210304,2815.32,92,138690,52,0,0,0,0,0
20150105.210305,2815.32,474,139164,-428,0,0,0,0,0
20150105.210306,2815.32,180,139344,-8,0,0,0,0,0
20150105.210307,2815.32,122,139466,32,0,0,0,0,0
20150105.210308,2815.32,632,140098,-352,0,0,0,0,0
20150105.210309,2815.31,508,140606,-340,0,0,0,0,0
20150105.21031,2815.32,42,140648,-14,0,0,0,0,0
20150105.210311,2815.31,66,140714,22,0,0,0,0,0
20150105.210312,2815.31,386,141100,-232,0,0,0,0,0
20150105.210313,2815.93,220,141320,-14,0,0,0,0,0
20150105.210314,2815.93,64,141384,18,0,0,0,0,0
20150105.210315,2815.93,180,141564,66,0,0,0,0,0
20150105.210316,2815.31,254,141818,192,0,0,0,0,0
20150105.210317,2815.31,98,141916,66,0,0,0,0,0
20150105.210318,2814.94,190,142106,78,0,0,0,0,0
20150105.210319,2815.31,168,142274,8,0,0,0,0,0
20150105.21032,2815.31,110,142384,50,0,0,0,0,0
20150105.210321,2815.31,94,142478,-6,0,0,0,0,0
20150105.210322,2815.31,1318,143796,296,0,0,0,0,0
20150105.210323,2814.94,424,144220,168,0,0,0,0,0
20150105.210324,2814.94,468,144688,2,0,0,0,0,0
20150105.210325,2814.94,226,144914,108,0,0,0,0,0
20150105.210326,2814.69,14,144928,2,0,0,0,0,0
20150105.210327,2814.69,148,145076,-38,0,0,0,0,0
20150105.210328,2814.94,528,145604,206,0,0,0,0,0
20150105.210329,2814.69,286,145890,92,0,0,0,0,0
20150105.21033,2815.31,308,146198,52,0,0,0,0,0
20150105.210331,2814.94,738,146936,-82,0,0,0,0,0
20150105.210332,2815.31,532,147468,-340,0,0,0,0,0
20150105.210333,2815.31,1040,148508,-562,0,0,0,0,0
20150105.210334,2815.56,540,149048,-166,0,0,0,0,0
20150105.210335,2815.56,70,149118,58,0,0,0,0,0
20150105.210336,2815.31,498,149616,64,0,0,0,0,0
20150105.210337,2815.31,720,150336,-200,0,0,0,0,0
20150105.210338,2815.56,242,150578,-2,0,0,0,0,0
20150105.210339,2815.31,712,151290,-108,0,0,0,0,0
20150105.21034,2815.93,138,151428,-8,0,0,0,0,0
20150105.210341,2815.31,32,151460,6,0,0,0,0,0
20150105.210342,2815.93,808,152268,134,0,0,0,0,0
20150105.210343,2815.69,12,152280,10,0,0,0,0,0
20150105.210344,2815.69,46,152326,12,0,0,0,0,0
20150105.210345,2815.69,224,152550,26,0,0,0,0,0
20150105.210346,2815.69,98,152648,50,0,0,0,0,0
20150105.210347,2816.3,220,152868,30,0,0,0,0,0
20150105.210348,2815.93,100,152968,12,0,0,0,0,0
20150105.210349,2815.69,116,153084,-4,0,0,0,0,0
20150105.21035,2816.3,46,153130,8,0,0,0,0,0
20150105.210351,2815.69,262,153392,168,0,0,0,0,0
20150105.210352,2815.69,74,153466,0,0,0,0,0,0
20150105.210353,2815.31,94,153560,0,0,0,0,0,0
20150105.210354,2815.69,148,153708,96,0,0,0,0,0
20150105.210355,2815.69,276,153984,94,0,0,0,0,0
20150105.210356,2815.69,532,154516,84,0,0,0,0,0
20150105.210357,2815.69,40,154556,-8,0,0,0,0,0
20150105.210358,2815.31,556,155112,220,0,0,0,0,0
20150105.210359,2815.69,610,155722,170,0,0,0,0,0
20150105.2104,2815.93,412,156134,84,0,0,0,0,0
20150105.210401,2815.31,740,156874,-702,0,0,0,0,0
20150105.210402,2815.31,170,157044,-16,0,0,0,0,0
20150105.210403,2815.31,220,157264,34,0,0,0,0,0
20150105.210404,2815.31,204,157468,-84,0,0,0,0,0
20150105.210405,2815.31,978,158446,156,0,0,0,0,0
20150105.210406,2815.31,300,158746,-14,0,0,0,0,0
20150105.210407,2814.69,282,159028,-32,0,0,0,0,0
20150105.210408,2815.31,18,159046,4,0,0,0,0,0
20150105.210409,2815.31,450,159496,-18,0,0,0,0,0
20150105.21041,2815.31,548,160044,-108,0,0,0,0,0
20150105.210411,2815.68,292,160336,-146,0,0,0,0,0
20150105.210412,2815.31,142,160478,120,0,0,0,0,0
20150105.210413,2814.69,88,160566,-62,0,0,0,0,0
20150105.210414,2814.69,86,160652,16,0,0,0,0,0
20150105.210415,2815.31,446,161098,316,0,0,0,0,0
20150105.210416,2814.69,168,161266,4,0,0,0,0,0
20150105.210417,2814.69,22,161288,14,0,0,0,0,0
20150105.210418,2814.69,80,161368,6,0,0,0,0,0
20150105.210419,2815.31,78,161446,-12,0,0,0,0,0
20150105.21042,2814.69,100,161546,18,0,0,0,0,0
20150105.210421,2814.94,278,161824,60,0,0,0,0,0
20150105.210422,2815.31,88,161912,-54,0,0,0,0,0
20150105.210423,2814.69,1192,163104,180,0,0,0,0,0
20150105.210424,2814.69,484,163588,-46,0,0,0,0,0
20150105.210425,2814.69,18,163606,0,0,0,0,0,0
20150105.210426,2814.07,70,163676,-28,0,0,0,0,0
20150105.210427,2814.69,218,163894,158,0,0,0,0,0
20150105.210428,2813.7,944,164838,310,0,0,0,0,0
20150105.210429,2814.69,98,164936,-44,0,0,0,0,0
20150105.21043,2814.07,68,165004,-16,0,0,0,0,0
20150105.210431,2814.07,394,165398,-216,0,0,0,0,0
20150105.210432,2814.07,72,165470,-6,0,0,0,0,0
20150105.210433,2814.07,308,165778,-62,0,0,0,0,0
20150105.210434,2814.69,212,165990,14,0,0,0,0,0
20150105.210435,2814.07,8,165998,-6,0,0,0,0,0
20150105.210436,2814.07,228,166226,-168,0,0,0,0,0
20150105.210437,2814.07,192,166418,-44,0,0,0,0,0
20150105.210438,2814.07,378,166796,-208,0,0,0,0,0
20150105.210439,2814.69,102,166898,-6,0,0,0,0,0
20150105.21044,2813.7,84,166982,-14,0,0,0,0,0
20150105.210441,2814.07,548,167530,398,0,0,0,0,0
20150105.210442,2814.07,172,167702,-54,0,0,0,0,0
20150105.210443,2814.69,34,167736,-22,0,0,0,0,0
20150105.210444,2814.07,118,167854,12,0,0,0,0,0
20150105.210445,2814.07,46,167900,0,0,0,0,0,0
20150105.210446,2814.69,508,168408,10,0,0,0,0,0
20150105.210447,2814.69,146,168554,16,0,0,0,0,0
20150105.210448,2814.32,38,168592,16,0,0,0,0,0
20150105.210449,2814.07,186,168778,78,0,0,0,0,0
20150105.21045,2814.07,124,168902,42,0,0,0,0,0
20150105.210451,2813.08,462,169364,-36,0,0,0,0,0
20150105.210452,2813.7,272,169636,98,0,0,0,0,0
20150105.210453,2813.7,388,170024,-16,0,0,0,0,0
20150105.210454,2813.7,230,170254,6,0,0,0,0,0
20150105.210455,2813.7,228,170482,124,0,0,0,0,0
20150105.210456,2813.45,410,170892,146,0,0,0,0,0
20150105.210457,2813.7,290,171182,26,0,0,0,0,0
20150105.210458,2813.7,114,171296,100,0,0,0,0,0
20150105.210459,2813.7,14,171310,4,0,0,0,0,0
20150105.2105,2813.7,92,171402,6,0,0,0,0,0
20150105.210501,2813.32,756,172158,30,0,0,0,0,0
20150105.210502,2813.08,394,172552,-86,0,0,0,0,0
20150105.210503,2813.08,158,172710,2,0,0,0,0,0
20150105.210504,2812.46,992,173702,526,0,0,0,0,0
20150105.210505,2813.33,420,174122,400,0,0,0,0,0
20150105.210506,2811.71,190,174312,72,0,0,0,0,0
20150105.210507,2812.71,52,174364,-28,0,0,0,0,0
20150105.210508,2813.32,156,174520,-30,0,0,0,0,0
20150105.210509,2813.7,144,174664,-74,0,0,0,0,0
20150105.21051,2812.71,60,174724,0,0,0,0,0,0
20150105.210511,2812.71,462,175186,-10,0,0,0,0,0
20150105.210512,2813.33,322,175508,4,0,0,0,0,0
20150105.210513,2812.09,110,175618,74,0,0,0,0,0
20150105.210514,2812.71,42,175660,16,0,0,0,0,0
20150105.210515,2812.71,116,175776,14,0,0,0,0,0
20150105.210516,2811.71,226,176002,28,0,0,0,0,0
20150105.210517,2812.46,168,176170,18,0,0,0,0,0
20150105.210518,2812.09,124,176294,-8,0,0,0,0,0
20150105.210519,2811.71,24,176318,18,0,0,0,0,0
20150105.21052,2811.71,242,176560,202,0,0,0,0,0
20150105.210521,2812.33,84,176644,64,0,0,0,0,0
20150105.210522,2812.71,118,176762,26,0,0,0,0,0
20150105.210523,2811.71,1414,178176,-174,0,0,0,0,0
20150105.210524,2812.71,76,178252,28,0,0,0,0,0
20150105.210525,2812.71,242,178494,10,0,0,0,0,0
20150105.210526,2812.71,144,178638,2,0,0,0,0,0
20150105.210527,2812.09,1068,179706,20,0,0,0,0,0
20150105.210528,2812.71,66,179772,40,0,0,0,0,0
20150105.210529,2813.08,1220,180992,-18,0,0,0,0,0
20150105.21053,2813.08,140,181132,-126,0,0,0,0,0
20150105.210531,2812.09,466,181598,-304,0,0,0,0,0
20150105.210532,2812.46,118,181716,-100,0,0,0,0,0
20150105.210533,2812.46,1046,182762,-128,0,0,0,0,0
20150105.210534,2812.71,154,182916,38,0,0,0,0,0
20150105.210535,2812.71,50,182966,-12,0,0,0,0,0
20150105.210536,2812.71,216,183182,12,0,0,0,0,0
20150105.210537,2812.46,16,183198,6,0,0,0,0,0
20150105.210538,2813.08,90,183288,46,0,0,0,0,0
20150105.210539,2812.09,1046,184334,26,0,0,0,0,0
20150105.21054,2812.46,94,184428,52,0,0,0,0,0
20150105.210541,2812.09,114,184542,-48,0,0,0,0,0
20150105.210542,2812.71,38,184580,10,0,0,0,0,0
20150105.210543,2812.09,290,184870,224,0,0,0,0,0
20150105.210544,2812.09,1298,186168,-356,0,0,0,0,0
20150105.210545,2813.08,432,186600,120,0,0,0,0,0
20150105.210546,2812.71,536,187136,214,0,0,0,0,0
20150105.210547,2813.08,36,187172,-4,0,0,0,0,0
20150105.210548,2813.08,238,187410,180,0,0,0,0,0
20150105.210549,2813.32,94,187504,6,0,0,0,0,0
20150105.21055,2813.08,374,187878,-2,0,0,0,0,0
20150105.210551,2813.7,70,187948,48,0,0,0,0,0
20150105.210552,2812.71,30,187978,4,0,0,0,0,0
20150105.210553,2813.08,170,188148,6,0,0,0,0,0
20150105.210554,2813.08,44,188192,6,0,0,0,0,0
20150105.210555,2813.08,54,188246,-2,0,0,0,0,0
20150105.210556,2813.08,80,188326,-68,0,0,0,0,0
20150105.210557,2812.33,50,188376,14,0,0,0,0,0
20150105.210558,2813.7,136,188512,-68,0,0,0,0,0
20150105.210559,2813.7,64,188576,64,0,0,0,0,0
20150105.2106,2813.7,14,188590,10,0,0,0,0,0
20150105.210601,2813.32,238,188828,110,0,0,0,0,0
20150105.210602,2813.32,102,188930,22,0,0,0,0,0
20150105.210603,2813.7,40,188970,10,0,0,0,0,0
20150105.210604,2813.7,54,189024,50,0,0,0,0,0
20150105.210605,2813.7,176,189200,6,0,0,0,0,0
20150105.210606,2813.7,430,189630,-124,0,0,0,0,0
20150105.210607,2813.7,64,189694,48,0,0,0,0,0
20150105.210608,2813.08,368,190062,104,0,0,0,0,0
20150105.210609,2813.7,80,190142,24,0,0,0,0,0
20150105.21061,2813.08,442,190584,250,0,0,0,0,0
20150105.210611,2813.7,62,190646,12,0,0,0,0,0
20150105.210612,2813.7,40,190686,30,0,0,0,0,0
20150105.210613,2813.7,174,190860,142,0,0,0,0,0
20150105.210614,2814.07,126,190986,90,0,0,0,0,0
20150105.210615,2813.32,42,191028,42,0,0,0,0,0
20150105.210616,2813.08,874,191902,342,0,0,0,0,0
20150105.210617,2813.7,148,192050,-10,0,0,0,0,0
20150105.210618,2814.07,110,192160,110,0,0,0,0,0
20150105.210619,2813.45,222,192382,146,0,0,0,0,0
20150105.21062,2813.45,40,192422,38,0,0,0,0,0
20150105.210621,2812.71,14,192436,10,0,0,0,0,0
20150105.210622,2813.08,36,192472,24,0,0,0,0,0
20150105.210623,2813.08,170,192642,16,0,0,0,0,0
20150105.210624,2813.7,6,192648,2,0,0,0,0,0
20150105.210625,2813.08,826,193474,238,0,0,0,0,0
20150105.210626,2813.08,184,193658,58,0,0,0,0,0
20150105.210627,2813.08,278,193936,58,0,0,0,0,0
20150105.210628,2813.08,48,193984,-22,0,0,0,0,0
20150105.210629,2813.08,22,194006,-12,0,0,0,0,0
20150105.21063,2813.08,22,194028,0,0,0,0,0,0
20150105.210631,2813.08,46,194074,0,0,0,0,0,0
20150105.210632,2813.7,12,194086,0,0,0,0,0,0
20150105.210633,2813.08,72,194158,-28,0,0,0,0,0
20150105.210634,2813.08,20,194178,-12,0,0,0,0,0
20150105.210635,2813.7,8,194186,0,0,0,0,0,0
20150105.210636,2813.32,44,194230,12,0,0,0,0,0
20150105.210637,2813.32,152,194382,0,0,0,0,0,0
20150105.210638,2812.71,234,194616,-26,0,0,0,0,0
20150105.210639,2812.33,154,194770,-38,0,0,0,0,0
20150105.21064,2812.71,26,194796,-14,0,0,0,0,0
20150105.210641,2812.33,20,194816,6,0,0,0,0,0
20150105.210642,2812.95,24,194840,20,0,0,0,0,0
20150105.210643,2812.71,176,195016,-4,0,0,0,0,0
20150105.210644,2813.32,30,195046,10,0,0,0,0,0
20150105.210645,2812.33,18,195064,10,0,0,0,0,0
20150105.210646,2813.32,20,195084,2,0,0,0,0,0
20150105.210647,2812.71,256,195340,12,0,0,0,0,0
20150105.210648,2813.32,16,195356,4,0,0,0,0,0
20150105.210649,2813.32,8,195364,0,0,0,0,0,0
20150105.21065,2813.32,240,195604,206,0,0,0,0,0
20150105.210651,2813.32,28,195632,-14,0,0,0,0,0
20150105.210652,2812.71,80,195712,60,0,0,0,0,0
20150105.210653,2813.32,108,195820,-46,0,0,0,0,0
20150105.210654,2812.71,714,196534,224,0,0,0,0,0
20150105.210655,2812.71,32,196566,26,0,0,0,0,0
20150105.210656,2812.09,58,196624,-4,0,0,0,0,0
20150105.210657,2812.71,64,196688,6,0,0,0,0,0
20150105.210658,2813.08,58,196746,2,0,0,0,0,0
20150105.210659,2812.46,26,196772,8,0,0,0,0,0
20150105.2107,2812.09,4,196776,0,0,0,0,0,0
20150105.210701,2812.09,6,196782,-6,0,0,0,0,0
20150105.210702,2813.08,66,196848,20,0,0,0,0,0
20150105.210703,2812.46,42,196890,4,0,0,0,0,0
20150105.210704,2812.7,1078,197968,-734,0,0,0,0,0
20150105.210705,2812.7,618,198586,60,0,0,0,0,0
20150105.210706,2812.46,188,198774,-46,0,0,0,0,0
20150105.210707,2811.47,584,199358,244,0,0,0,0,0
20150105.210708,2811.47,80,199438,20,0,0,0,0,0
20150105.210709,2812.46,434,199872,-386,0,0,0,0,0
20150105.21071,2812.46,486,200358,-222,0,0,0,0,0
20150105.210711,2812.09,256,200614,150,0,0,0,0,0
20150105.210712,2812.09,134,200748,24,0,0,0,0,0
20150105.210713,2812.09,114,200862,-6,0,0,0,0,0
20150105.210714,2812.46,46,200908,34,0,0,0,0,0
20150105.210715,2811.84,42,200950,0,0,0,0,0,0
20150105.210716,2812.46,34,200984,16,0,0,0,0,0
20150105.210717,2812.09,20,201004,14,0,0,0,0,0
20150105.210718,2812.46,62,201066,34,0,0,0,0,0
20150105.210719,2812.46,10,201076,0,0,0,0,0,0
20150105.21072,2812.46,130,201206,122,0,0,0,0,0
20150105.210721,2812.09,210,201416,188,0,0,0,0,0
20150105.210722,2812.46,38,201454,34,0,0,0,0,0
20150105.210723,2811.47,18,201472,-10,0,0,0,0,0
20150105.210724,2812.09,116,201588,-20,0,0,0,0,0
20150105.210725,2811.84,62,201650,22,0,0,0,0,0
20150105.210726,2813.08,44,201694,2,0,0,0,0,0
20150105.210727,2812.46,30,201724,22,0,0,0,0,0
20150105.210728,2812.46,14,201738,0,0,0,0,0,0
20150105.210729,2812.09,432,202170,-56,0,0,0,0,0
20150105.21073,2812.09,50,202220,-6,0,0,0,0,0
20150105.210731,2812.71,422,202642,10,0,0,0,0,0
20150105.210732,2812.09,130,202772,-6,0,0,0,0,0
20150105.210733,2812.71,222,202994,0,0,0,0,0,0
20150105.210734,2812.09,20,203014,-4,0,0,0,0,0
20150105.210735,2812.09,30,203044,4,0,0,0,0,0
20150105.210736,2812.09,114,203158,-4,0,0,0,0,0
20150105.210737,2811.71,1086,204244,-536,0,0,0,0,0
20150105.210738,2811.71,216,204460,154,0,0,0,0,0
20150105.210739,2811.71,50,204510,14,0,0,0,0,0
20150105.21074,2811.71,14,204524,0,0,0,0,0,0
20150105.210741,2811.71,352,204876,160,0,0,0,0,0
20150105.210742,2811.71,240,205116,26,0,0,0,0,0
20150105.210743,2811.71,394,205510,4,0,0,0,0,0
20150105.210744,2811.34,686,206196,190,0,0,0,0,0
20150105.210745,2811.71,34,206230,2,0,0,0,0,0
20150105.210746,2811.71,46,206276,-18,0,0,0,0,0
20150105.210747,2811.34,96,206372,32,0,0,0,0,0
20150105.210748,2811.96,46,206418,-38,0,0,0,0,0
20150105.210749,2812.33,102,206520,-30,0,0,0,0,0
20150105.21075,2811.71,44,206564,-8,0,0,0,0,0
20150105.210751,2811.96,50,206614,18,0,0,0,0,0
20150105.210752,2811.34,38,206652,-4,0,0,0,0,0
20150105.210753,2812.33,32,206684,2,0,0,0,0,0
20150105.210754,2811.71,570,207254,-58,0,0,0,0,0
20150105.210755,2811.34,48,207302,-8,0,0,0,0,0
20150105.210756,2812.33,238,207540,14,0,0,0,0,0
20150105.210757,2812.09,64,207604,-10,0,0,0,0,0
20150105.210758,2812.09,16,207620,0,0,0,0,0,0
20150105.210759,2812.33,16,207636,-6,0,0,0,0,0
20150105.2108,2811.71,84,207720,26,0,0,0,0,0
20150105.210801,2812.71,60,207780,-18,0,0,0,0,0
20150105.210802,2812.71,32,207812,-2,0,0,0,0,0
20150105.210803,2812.09,26,207838,-2,0,0,0,0,0
20150105.210804,2811.71,14,207852,2,0,0,0,0,0
20150105.210805,2812.09,294,208146,2,0,0,0,0,0
20150105.210806,2812.09,92,208238,6,0,0,0,0,0
20150105.210807,2812.71,160,208398,8,0,0,0,0,0
20150105.210808,2812.46,680,209078,182,0,0,0,0,0
20150105.210809,2813.08,46,209124,2,0,0,0,0,0
20150105.21081,2813.08,18,209142,4,0,0,0,0,0
20150105.210811,2813.08,44,209186,8,0,0,0,0,0
20150105.210812,2812.46,36,209222,32,0,0,0,0,0
20150105.210813,2812.46,26,209248,0,0,0,0,0,0
20150105.210814,2812.71,134,209382,-42,0,0,0,0,0
20150105.210815,2812.71,254,209636,-64,0,0,0,0,0
20150105.210816,2812.09,122,209758,-2,0,0,0,0,0
20150105.210817,2812.71,402,210160,-102,0,0,0,0,0
20150105.210818,2812.09,1728,211888,-80,0,0,0,0,0
20150105.210819,2812.46,174,212062,18,0,0,0,0,0
20150105.21082,2812.71,118,212180,-34,0,0,0,0,0
20150105.210821,2813.08,150,212330,20,0,0,0,0,0
20150105.210822,2812.46,80,212410,-22,0,0,0,0,0
20150105.210823,2812.46,214,212624,44,0,0,0,0,0
20150105.210824,2812.83,112,212736,42,0,0,0,0,0
20150105.210825,2812.84,152,212888,26,0,0,0,0,0
20150105.210826,2812.83,38,212926,2,0,0,0,0,0
20150105.210827,2813.45,62,212988,28,0,0,0,0,0
20150105.210828,2812.46,684,213672,662,0,0,0,0,0
20150105.210829,2812.83,68,213740,44,0,0,0,0,0
20150105.21083,2812.46,96,213836,22,0,0,0,0,0
20150105.210831,2812.46,110,213946,26,0,0,0,0,0
20150105.210832,2812.83,1044,214990,-642,0,0,0,0,0
20150105.210833,2812.46,38,215028,8,0,0,0,0,0
20150105.210834,2813.45,128,215156,-12,0,0,0,0,0
20150105.210835,2813.45,232,215388,114,0,0,0,0,0
20150105.210836,2812.83,108,215496,26,0,0,0,0,0
20150105.210837,2812.83,42,215538,34,0,0,0,0,0
20150105.210838,2813.21,1898,217436,1252,0,0,0,0,0
20150105.210839,2813.45,110,217546,104,0,0,0,0,0
20150105.21084,2813.21,20,217566,14,0,0,0,0,0
20150105.210841,2813.83,120,217686,2,0,0,0,0,0
20150105.210842,2813.21,50,217736,6,0,0,0,0,0
20150105.210843,2813.21,152,217888,66,0,0,0,0,0
20150105.210844,2813.83,114,218002,-52,0,0,0,0,0
20150105.210845,2813.58,14,218016,12,0,0,0,0,0
20150105.210846,2813.21,62,218078,42,0,0,0,0,0
20150105.210847,2813.83,150,218228,50,0,0,0,0,0
20150105.210848,2813.83,38,218266,14,0,0,0,0,0
20150105.210849,2813.21,30,218296,20,0,0,0,0,0
20150105.21085,2813.83,390,218686,70,0,0,0,0,0
20150105.210851,2812.83,70,218756,16,0,0,0,0,0
20150105.210852,2813.45,24,218780,4,0,0,0,0,0
20150105.210853,2813.45,178,218958,30,0,0,0,0,0
20150105.210854,2812.83,42,219000,20,0,0,0,0,0
20150105.210855,2813.45,146,219146,2,0,0,0,0,0
20150105.210856,2813.08,188,219334,92,0,0,0,0,0
20150105.210857,2813.08,680,220014,-412,0,0,0,0,0
20150105.210858,2813.08,24,220038,6,0,0,0,0,0
20150105.210859,2813.08,194,220232,8,0,0,0,0,0
20150105.2109,2813.7,88,220320,16,0,0,0,0,0
20150105.210901,2813.45,18,220338,2,0,0,0,0,0
20150105.210902,2813.45,152,220490,100,0,0,0,0,0
20150105.210903,2814.07,34,220524,14,0,0,0,0,0
20150105.210904,2813.45,136,220660,-28,0,0,0,0,0
20150105.210905,2813.45,142,220802,16,0,0,0,0,0
20150105.210906,2814.07,60,220862,6,0,0,0,0,0
20150105.210907,2814.44,58,220920,-26,0,0,0,0,0
20150105.210908,2813.45,46,220966,6,0,0,0,0,0
20150105.210909,2814.07,1252,222218,846,0,0,0,0,0
20150105.21091,2814.07,20,222238,4,0,0,0,0,0
20150105.210911,2814.07,18,222256,4,0,0,0,0,0
20150105.210912,2813.45,248,222504,8,0,0,0,0,0
20150105.210913,2814.07,36,222540,34,0,0,0,0,0
20150105.210914,2813.45,30,222570,28,0,0,0,0,0
20150105.210915,2813.45,26,222596,22,0,0,0,0,0
20150105.210916,2814.07,86,222682,74,0,0,0,0,0
20150105.210917,2813.45,64,222746,12,0,0,0,0,0
20150105.210918,2813.45,832,223578,130,0,0,0,0,0
20150105.210919,2814.07,238,223816,128,0,0,0,0,0
20150105.21092,2814.07,158,223974,-66,0,0,0,0,0
20150105.210921,2815.06,50,224024,16,0,0,0,0,0
20150105.210922,2814.45,222,224246,138,0,0,0,0,0
20150105.210923,2815.06,48,224294,32,0,0,0,0,0
20150105.210924,2814.45,50,224344,8,0,0,0,0,0
20150105.210925,2815.06,156,224500,146,0,0,0,0,0
20150105.210926,2815.44,236,224736,112,0,0,0,0,0
20150105.210927,2816.06,274,225010,6,0,0,0,0,0
20150105.210928,2815.44,374,225384,188,0,0,0,0,0
20150105.210929,2815.44,110,225494,-26,0,0,0,0,0
20150105.21093,2815.81,30,225524,12,0,0,0,0,0
20150105.210931,2816.43,140,225664,-50,0,0,0,0,0
20150105.210932,2815.81,170,225834,82,0,0,0,0,0
20150105.210933,2816.06,52,225886,16,0,0,0,0,0
20150105.210934,2815.44,1812,227698,720,0,0,0,0,0
20150105.210935,2815.81,248,227946,174,0,0,0,0,0
20150105.210936,2815.44,188,228134,50,0,0,0,0,0
20150105.210937,2814.2,250,228384,-44,0,0,0,0,0
20150105.210938,2814.82,598,228982,376,0,0,0,0,0
20150105.210939,2814.82,380,229362,28,0,0,0,0,0
20150105.21094,2813.58,388,229750,152,0,0,0,0,0
20150105.210941,2814.57,190,229940,82,0,0,0,0,0
20150105.210942,2814.57,172,230112,124,0,0,0,0,0
20150105.210943,2814.57,288,230400,-66,0,0,0,0,0
20150105.210944,2815.19,70,230470,58,0,0,0,0,0
20150105.210945,2814.2,262,230732,46,0,0,0,0,0
20150105.210946,2814.57,22,230754,16,0,0,0,0,0
20150105.210947,2815.57,322,231076,102,0,0,0,0,0
20150105.210948,2815.57,116,231192,16,0,0,0,0,0
20150105.210949,2815.94,290,231482,192,0,0,0,0,0
20150105.21095,2814.95,42,231524,-20,0,0,0,0,0
20150105.210951,2814.95,564,232088,-106,0,0,0,0,0
20150105.210952,2815.32,16,232104,-4,0,0,0,0,0
20150105.210953,2815.94,214,232318,88,0,0,0,0,0
20150105.210954,2815.94,16,232334,-10,0,0,0,0,0
20150105.210955,2815.94,572,232906,12,0,0,0,0,0
20150105.210956,2815.94,100,233006,-40,0,0,0,0,0
20150105.210957,2815.94,16,233022,6,0,0,0,0,0
20150105.210958,2815.32,74,233096,-12,0,0,0,0,0
20150105.210959,2815.32,366,233462,240,0,0,0,0,0
20150105.211,2815.57,362,233824,8,0,0,0,0,0
20150105.211001,2815.32,272,234096,20,0,0,0,0,0
20150105.211002,2815.57,688,234784,572,0,0,0,0,0
20150105.211003,2815.94,70,234854,8,0,0,0,0,0
20150105.211004,2815.94,40,234894,30,0,0,0,0,0
20150105.211005,2816.56,706,235600,-450,0,0,0,0,0
20150105.211006,2816.56,46,235646,6,0,0,0,0,0
20150105.211007,2816.19,10,235656,-2,0,0,0,0,0
20150105.211008,2817.18,506,236162,-10,0,0,0,0,0
20150105.211009,2817.18,184,236346,6,0,0,0,0,0
20150105.21101,2817.8,1206,237552,-160,0,0,0,0,0
20150105.211011,2816.8,484,238036,214,0,0,0,0,0
20150105.211012,2817.42,258,238294,228,0,0,0,0,0
20150105.211013,2817.05,776,239070,2,0,0,0,0,0
20150105.211014,2816.8,122,239192,14,0,0,0,0,0
20150105.211015,2816.8,26,239218,18,0,0,0,0,0
20150105.211016,2816.43,222,239440,52,0,0,0,0,0
20150105.211017,2816.43,66,239506,2,0,0,0,0,0
20150105.211018,2816.43,526,240032,-120,0,0,0,0,0
20150105.211019,2816.8,840,240872,674,0,0,0,0,0
20150105.21102,2816.8,904,241776,-184,0,0,0,0,0
20150105.211021,2816.8,144,241920,70,0,0,0,0,0
20150105.211022,2816.8,266,242186,38,0,0,0,0,0
20150105.211023,2816.43,730,242916,58,0,0,0,0,0
20150105.211024,2816.8,28,242944,-2,0,0,0,0,0
20150105.211025,2817.42,158,243102,-12,0,0,0,0,0
20150105.211026,2816.81,984,244086,390,0,0,0,0,0
20150105.211027,2818.04,680,244766,370,0,0,0,0,0
20150105.211028,2818.42,10,244776,4,0,0,0,0,0
20150105.211029,2818.04,884,245660,674,0,0,0,0,0
20150105.21103,2818.42,20,245680,20,0,0,0,0,0
20150105.211031,2818.05,2804,248484,2384,0,0,0,0,0
20150105.211032,2818.67,818,249302,66,0,0,0,0,0
20150105.211033,2819.04,1896,251198,786,0,0,0,0,0
20150105.211034,2819.04,258,251456,-224,0,0,0,0,0
20150105.211035,2819.04,440,251896,-52,0,0,0,0,0
20150105.211036,2818.67,848,252744,-364,0,0,0,0,0
20150105.211037,2819.04,110,252854,28,0,0,0,0,0
20150105.211038,2819.04,142,252996,36,0,0,0,0,0
20150105.211039,2819.66,268,253264,-206,0,0,0,0,0
20150105.21104,2819.66,630,253894,12,0,0,0,0,0
20150105.211041,2820.03,246,254140,142,0,0,0,0,0
20150105.211042,2819.66,92,254232,-18,0,0,0,0,0
20150105.211043,2819.41,1642,255874,-760,0,0,0,0,0
20150105.211044,2819.41,928,256802,-452,0,0,0,0,0
20150105.211045,2819.41,318,257120,78,0,0,0,0,0
20150105.211046,2819.04,1268,258388,92,0,0,0,0,0
20150105.211047,2819.41,268,258656,-132,0,0,0,0,0
20150105.211048,2820.03,606,259262,148,0,0,0,0,0
20150105.211049,2818.79,262,259524,166,0,0,0,0,0
20150105.21105,2819.41,52,259576,4,0,0,0,0,0
20150105.211051,2819.04,58,259634,-12,0,0,0,0,0
20150105.211052,2819.41,174,259808,92,0,0,0,0,0
20150105.211053,2819.04,270,260078,150,0,0,0,0,0
20150105.211054,2819.04,648,260726,78,0,0,0,0,0
20150105.211055,2818.79,822,261548,182,0,0,0,0,0
20150105.211056,2818.79,238,261786,-50,0,0,0,0,0
20150105.211057,2818.17,1378,263164,988,0,0,0,0,0
20150105.211058,2818.17,1476,264640,494,0,0,0,0,0
20150105.211059,2818.17,276,264916,-30,0,0,0,0,0
20150105.2111,2817.18,110,265026,-30,0,0,0,0,0
20150105.211101,2818.79,140,265166,8,0,0,0,0,0
20150105.211102,2818.42,726,265892,276,0,0,0,0,0
20150105.211103,2819.04,170,266062,-76,0,0,0,0,0
20150105.211104,2818.42,56,266118,42,0,0,0,0,0
20150105.211105,2819.41,148,266266,-16,0,0,0,0,0
20150105.211106,2818.79,50,266316,14,0,0,0,0,0
20150105.211107,2818.79,738,267054,466,0,0,0,0,0
20150105.211108,2818.79,42,267096,0,0,0,0,0,0
20150105.211109,2819.41,96,267192,4,0,0,0,0,0
20150105.21111,2819.41,524,267716,200,0,0,0,0,0
20150105.211111,2819.41,750,268466,120,0,0,0,0,0
20150105.211112,2818.79,38,268504,-20,0,0,0,0,0
20150105.211113,2819.17,86,268590,-34,0,0,0,0,0
20150105.211114,2819.78,1522,270112,584,0,0,0,0,0
20150105.211115,2820.16,476,270588,-36,0,0,0,0,0
20150105.211116,2818.79,108,270696,46,0,0,0,0,0
20150105.211117,2819.78,94,270790,86,0,0,0,0,0
20150105.211118,2820.16,34,270824,16,0,0,0,0,0
20150105.211119,2820.16,20,270844,14,0,0,0,0,0
20150105.21112,2819.54,16,270860,16,0,0,0,0,0
20150105.211121,2820.16,180,271040,150,0,0,0,0,0
20150105.211122,2820.16,716,271756,544,0,0,0,0,0
20150105.211123,2820.16,366,272122,106,0,0,0,0,0
20150105.211124,2819.79,148,272270,-42,0,0,0,0,0
20150105.211125,2820.16,336,272606,52,0,0,0,0,0
20150105.211126,2820.78,122,272728,-2,0,0,0,0,0
20150105.211127,2820.16,74,272802,58,0,0,0,0,0
20150105.211128,2820.53,20,272822,12,0,0,0,0,0
20150105.211129,2821.15,500,273322,344,0,0,0,0,0
20150105.21113,2820.78,296,273618,-104,0,0,0,0,0
20150105.211131,2821.15,314,273932,-54,0,0,0,0,0
20150105.211132,2821.77,38,273970,8,0,0,0,0,0
20150105.211133,2821.4,36,274006,0,0,0,0,0,0
20150105.211134,2821.4,384,274390,-220,0,0,0,0,0
20150105.211135,2821.4,444,274834,-164,0,0,0,0,0
20150105.211136,2821.77,336,275170,-210,0,0,0,0,0
20150105.211137,2821.4,136,275306,6,0,0,0,0,0
20150105.211138,2821.4,30,275336,-4,0,0,0,0,0
20150105.211139,2821.4,164,275500,58,0,0,0,0,0
20150105.21114,2820.78,30,275530,8,0,0,0,0,0
20150105.211141,2821.77,70,275600,28,0,0,0,0,0
20150105.211142,2821.4,510,276110,346,0,0,0,0,0
20150105.211143,2821.4,292,276402,48,0,0,0,0,0
20150105.211144,2821.4,1962,278364,-192,0,0,0,0,0
20150105.211145,2821.77,6,278370,4,0,0,0,0,0
20150105.211146,2821.77,140,278510,30,0,0,0,0,0
20150105.211147,2821.77,158,278668,-108,0,0,0,0,0
20150105.211148,2820.78,86,278754,26,0,0,0,0,0
20150105.211149,2821.77,100,278854,6,0,0,0,0,0
20150105.21115,2821.52,180,279034,126,0,0,0,0,0
20150105.211151,2822.14,548,279582,-238,0,0,0,0,0
20150105.211152,2822.14,372,279954,156,0,0,0,0,0
20150105.211153,2822.14,398,280352,268,0,0,0,0,0
20150105.211154,2822.52,230,280582,-120,0,0,0,0,0
20150105.211155,2822.14,366,280948,2,0,0,0,0,0
20150105.211156,2822.52,80,281028,-40,0,0,0,0,0
20150105.211157,2822.52,106,281134,20,0,0,0,0,0
20150105.211158,2821.15,24,281158,6,0,0,0,0,0
20150105.211159,2822.14,26,281184,24,0,0,0,0,0
20150105.2112,2822.14,18,281202,12,0,0,0,0,0
20150105.211201,2821.77,182,281384,10,0,0,0,0,0
20150105.211202,2822.14,216,281600,100,0,0,0,0,0
20150105.211203,2822.14,188,281788,186,0,0,0,0,0
20150105.211204,2821.77,76,281864,18,0,0,0,0,0
20150105.211205,2822.14,158,282022,2,0,0,0,0,0
20150105.211206,2822.14,854,282876,512,0,0,0,0,0
20150105.211207,2822.14,84,282960,8,0,0,0,0,0
20150105.211208,2821.77,38,282998,12,0,0,0,0,0
20150105.211209,2822.14,510,283508,326,0,0,0,0,0
20150105.21121,2822.14,364,283872,132,0,0,0,0,0
20150105.211211,2822.14,1086,284958,-210,0,0,0,0,0
20150105.211212,2822.14,22,284980,10,0,0,0,0,0
20150105.211213,2822.39,10,284990,4,0,0,0,0,0
20150105.211214,2822.76,48,285038,40,0,0,0,0,0
20150105.211215,2822.14,56,285094,28,0,0,0,0,0
20150105.211216,2822.76,198,285292,158,0,0,0,0,0
20150105.211217,2822.76,134,285426,24,0,0,0,0,0
20150105.211218,2823.38,2910,288336,2474,0,0,0,0,0
20150105.211219,2823.14,138,288474,16,0,0,0,0,0
20150105.21122,2823.38,1362,289836,-30,0,0,0,0,0
20150105.211221,2824,1132,290968,62,0,0,0,0,0
20150105.211222,2823.38,628,291596,-82,0,0,0,0,0
20150105.211223,2824.38,24,291620,20,0,0,0,0,0
20150105.211224,2824.38,44,291664,12,0,0,0,0,0
20150105.211225,2824.38,224,291888,-152,0,0,0,0,0
20150105.211226,2824,584,292472,130,0,0,0,0,0
20150105.211227,2823.38,84,292556,66,0,0,0,0,0
20150105.211228,2823.38,238,292794,172,0,0,0,0,0
20150105.211229,2823.38,136,292930,10,0,0,0,0,0
20150105.21123,2823.38,174,293104,-10,0,0,0,0,0
20150105.211231,2823.01,102,293206,62,0,0,0,0,0
20150105.211232,2823.01,118,293324,-52,0,0,0,0,0
20150105.211233,2823.01,200,293524,-2,0,0,0,0,0
20150105.211234,2823.38,210,293734,14,0,0,0,0,0
20150105.211235,2822.39,1538,295272,1398,0,0,0,0,0
20150105.211236,2823.38,120,295392,0,0,0,0,0,0
20150105.211237,2823.38,100,295492,0,0,0,0,0,0
20150105.211238,2823.38,720,296212,-48,0,0,0,0,0
20150105.211239,2823.38,1378,297590,806,0,0,0,0,0
20150105.21124,2823.38,620,298210,-176,0,0,0,0,0
20150105.211241,2823.01,24,298234,-8,0,0,0,0,0
20150105.211242,2823.38,158,298392,-62,0,0,0,0,0
20150105.211243,2822.76,38,298430,-10,0,0,0,0,0
20150105.211244,2823.38,124,298554,-36,0,0,0,0,0
20150105.211245,2823.39,896,299450,414,0,0,0,0,0
20150105.211246,2823.39,126,299576,26,0,0,0,0,0
20150105.211247,2824.01,154,299730,18,0,0,0,0,0
20150105.211248,2824.25,100,299830,48,0,0,0,0,0
20150105.211249,2823.63,168,299998,114,0,0,0,0,0
20150105.21125,2824.87,354,300352,74,0,0,0,0,0
20150105.211251,2825.24,816,301168,638,0,0,0,0,0
20150105.211252,2824.38,1802,302970,-342,0,0,0,0,0
20150105.211253,2824.62,8,302978,-2,0,0,0,0,0
20150105.211254,2824.62,94,303072,0,0,0,0,0,0
20150105.211255,2824.62,234,303306,-56,0,0,0,0,0
20150105.211256,2824.62,50,303356,-16,0,0,0,0,0
20150105.211257,2824.62,418,303774,-346,0,0,0,0,0
20150105.211258,2824.62,28,303802,24,0,0,0,0,0
20150105.211259,2824.62,228,304030,-214,0,0,0,0,0
20150105.2113,2824.62,70,304100,-16,0,0,0,0,0
20150105.211301,2824.62,176,304276,-46,0,0,0,0,0
20150105.211302,2825,80,304356,-22,0,0,0,0,0
20150105.211303,2824,48,304404,0,0,0,0,0,0
20150105.211304,2824.62,38,304442,10,0,0,0,0,0
20150105.211305,2824,64,304506,-6,0,0,0,0,0
20150105.211306,2824,44,304550,-28,0,0,0,0,0
20150105.211307,2824.62,1172,305722,766,0,0,0,0,0
20150105.211308,2824.25,252,305974,74,0,0,0,0,0
20150105.211309,2824,676,306650,114,0,0,0,0,0
20150105.21131,2824.25,444,307094,22,0,0,0,0,0
20150105.211311,2823.63,34,307128,2,0,0,0,0,0
20150105.211312,2824,98,307226,68,0,0,0,0,0
20150105.211313,2824.62,278,307504,46,0,0,0,0,0
20150105.211314,2824.25,84,307588,34,0,0,0,0,0
20150105.211315,2824.62,148,307736,10,0,0,0,0,0
20150105.211316,2823.63,116,307852,40,0,0,0,0,0
20150105.211317,2823.63,28,307880,-4,0,0,0,0,0
20150105.211318,2824,384,308264,104,0,0,0,0,0
20150105.211319,2824.62,724,308988,-368,0,0,0,0,0
20150105.21132,2824.62,282,309270,0,0,0,0,0,0
20150105.211321,2824.62,172,309442,-32,0,0,0,0,0
20150105.211322,2824.62,68,309510,-8,0,0,0,0,0
20150105.211323,2824.62,60,309570,-16,0,0,0,0,0
20150105.211324,2824.62,36,309606,-4,0,0,0,0,0
20150105.211325,2824.62,1080,310686,454,0,0,0,0,0
20150105.211326,2824.62,226,310912,-52,0,0,0,0,0
20150105.211327,2824.62,264,311176,-198,0,0,0,0,0
20150105.211328,2824.62,230,311406,-60,0,0,0,0,0
20150105.211329,2824.62,296,311702,102,0,0,0,0,0
20150105.21133,2824.99,158,311860,2,0,0,0,0,0
20150105.211331,2824.99,54,311914,48,0,0,0,0,0
20150105.211332,2824,70,311984,2,0,0,0,0,0
20150105.211333,2824.62,28,312012,16,0,0,0,0,0
20150105.211334,2824.62,112,312124,88,0,0,0,0,0
20150105.211335,2824.62,730,312854,556,0,0,0,0,0
20150105.211336,2824.62,24,312878,4,0,0,0,0,0
20150105.211337,2824.99,1000,313878,178,0,0,0,0,0
20150105.211338,2824.62,40,313918,-8,0,0,0,0,0
20150105.211339,2824.62,548,314466,-68,0,0,0,0,0
20150105.21134,2824.62,368,314834,78,0,0,0,0,0
20150105.211341,2824.62,40,314874,-2,0,0,0,0,0
20150105.211342,2824.62,296,315170,0,0,0,0,0,0
20150105.211343,2824.62,122,315292,48,0,0,0,0,0
20150105.211344,2824.99,20,315312,18,0,0,0,0,0
20150105.211345,2825.24,36,315348,26,0,0,0,0,0
20150105.211346,2825.24,528,315876,-156,0,0,0,0,0
20150105.211347,2824.62,26,315902,0,0,0,0,0,0
20150105.211348,2824.25,112,316014,20,0,0,0,0,0
20150105.211349,2824.87,2052,318066,648,0,0,0,0,0
20150105.21135,2824.25,328,318394,304,0,0,0,0,0
20150105.211351,2824.62,104,318498,102,0,0,0,0,0
20150105.211352,2824.62,60,318558,2,0,0,0,0,0
20150105.211353,2824.62,230,318788,180,0,0,0,0,0
20150105.211354,2824.62,24,318812,14,0,0,0,0,0
20150105.211355,2824.62,56,318868,12,0,0,0,0,0
20150105.211356,2824.62,784,319652,312,0,0,0,0,0
20150105.211357,2824.62,232,319884,208,0,0,0,0,0
20150105.211358,2825.24,28,319912,-2,0,0,0,0,0
20150105.211359,2825.24,118,320030,-4,0,0,0,0,0
20150105.2114,2825.24,6,320036,0,0,0,0,0,0
20150105.211401,2825.24,586,320622,-280,0,0,0,0,0
20150105.211402,2824.62,240,320862,28,0,0,0,0,0
20150105.211403,2824.62,16,320878,12,0,0,0,0,0
20150105.211404,2824.62,38,320916,36,0,0,0,0,0
20150105.211405,2824.62,1108,322024,1008,0,0,0,0,0
20150105.211406,2824.62,10,322034,6,0,0,0,0,0
20150105.211407,2824.62,16,322050,4,0,0,0,0,0
20150105.211408,2824,22,322072,10,0,0,0,0,0
20150105.211409,2823.63,124,322196,20,0,0,0,0,0
20150105.21141,2824.62,50,322246,14,0,0,0,0,0
20150105.211411,2823.63,18,322264,2,0,0,0,0,0
20150105.211412,2824.62,1722,323986,1262,0,0,0,0,0
20150105.211413,2823.63,48,324034,44,0,0,0,0,0
20150105.211414,2824,20,324054,20,0,0,0,0,0
20150105.211415,2824,36,324090,8,0,0,0,0,0
20150105.211416,2823.38,1068,325158,228,0,0,0,0,0
20150105.211417,2823.38,98,325256,86,0,0,0,0,0
20150105.211418,2823.01,696,325952,-266,0,0,0,0,0
20150105.211419,2823.38,336,326288,-114,0,0,0,0,0
20150105.21142,2824,66,326354,-50,0,0,0,0,0
20150105.211421,2823.38,32,326386,6,0,0,0,0,0
20150105.211422,2823.38,86,326472,-22,0,0,0,0,0
20150105.211423,2823.38,68,326540,-10,0,0,0,0,0
20150105.211424,2823.01,78,326618,-26,0,0,0,0,0
20150105.211425,2823.38,26,326644,-10,0,0,0,0,0
20150105.211426,2823.38,24,326668,-2,0,0,0,0,0
20150105.211427,2823.01,224,326892,-190,0,0,0,0,0
20150105.211428,2823.38,42,326934,-14,0,0,0,0,0
20150105.211429,2823.01,4,326938,-2,0,0,0,0,0
20150105.21143,2823.38,46,326984,-42,0,0,0,0,0
20150105.211431,2823.01,20,327004,-4,0,0,0,0,0
20150105.211432,2823.01,62,327066,14,0,0,0,0,0
20150105.211433,2823.01,26,327092,-14,0,0,0,0,0
20150105.211434,2823.01,500,327592,-468,0,0,0,0,0
20150105.211435,2823.01,104,327696,52,0,0,0,0,0
20150105.211436,2823.01,218,327914,38,0,0,0,0,0
20150105.211437,2823.38,234,328148,142,0,0,0,0,0
20150105.211438,2823.38,88,328236,66,0,0,0,0,0
20150105.211439,2823.38,374,328610,278,0,0,0,0,0
20150105.21144,2823.38,18,328628,8,0,0,0,0,0
20150105.211441,2823.38,180,328808,102,0,0,0,0,0
20150105.211442,2823.38,230,329038,60,0,0,0,0,0
20150105.211443,2823.38,648,329686,14,0,0,0,0,0
20150105.211444,2823.38,58,329744,-16,0,0,0,0,0
20150105.211445,2823.38,50,329794,-34,0,0,0,0,0
20150105.211446,2823.38,38,329832,-4,0,0,0,0,0
20150105.211447,2823.38,62,329894,-52,0,0,0,0,0
20150105.211448,2823.38,32,329926,-14,0,0,0,0,0
20150105.211449,2823.38,14,329940,12,0,0,0,0,0
20150105.21145,2824,88,330028,68,0,0,0,0,0
20150105.211451,2823.38,406,330434,242,0,0,0,0,0
20150105.211452,2823.38,290,330724,-10,0,0,0,0,0
20150105.211453,2823.38,438,331162,26,0,0,0,0,0
20150105.211454,2823.01,184,331346,-4,0,0,0,0,0
20150105.211455,2823.01,6,331352,-2,0,0,0,0,0
20150105.211456,2823.63,24,331376,-10,0,0,0,0,0
20150105.211457,2823.01,316,331692,30,0,0,0,0,0
20150105.211458,2823.63,318,332010,148,0,0,0,0,0
20150105.211459,2822.64,8,332018,2,0,0,0,0,0
20150105.2115,2823.01,30,332048,0,0,0,0,0,0
20150105.211501,2822.64,12,332060,2,0,0,0,0,0
20150105.211502,2823.63,158,332218,-22,0,0,0,0,0
20150105.211503,2823.01,114,332332,-72,0,0,0,0,0
20150105.211504,2823.01,28,332360,-20,0,0,0,0,0
20150105.211505,2823.01,24,332384,20,0,0,0,0,0
20150105.211506,2823.63,822,333206,-44,0,0,0,0,0
20150105.211507,2824.62,114,333320,102,0,0,0,0,0
20150105.211508,2823.63,14,333334,2,0,0,0,0,0
20150105.211509,2823.63,178,333512,158,0,0,0,0,0
20150105.21151,2823.63,10,333522,0,0,0,0,0,0
20150105.211511,2823.63,462,333984,58,0,0,0,0,0
20150105.211512,2824,28,334012,-24,0,0,0,0,0
20150105.211513,2823.63,106,334118,-10,0,0,0,0,0
20150105.211514,2823.63,6,334124,4,0,0,0,0,0
20150105.211515,2823.63,240,334364,124,0,0,0,0,0
20150105.211516,2824,6,334370,0,0,0,0,0,0
20150105.211517,2823.63,8,334378,2,0,0,0,0,0
20150105.211518,2824,120,334498,8,0,0,0,0,0
20150105.211519,2823.63,74,334572,-4,0,0,0,0,0
20150105.21152,2824,168,334740,74,0,0,0,0,0
20150105.211521,2823.63,102,334842,0,0,0,0,0,0
20150105.211522,2823.01,318,335160,-40,0,0,0,0,0
20150105.211523,2823.38,112,335272,-10,0,0,0,0,0
20150105.211524,2824,28,335300,0,0,0,0,0,0
20150105.211525,2823.01,34,335334,16,0,0,0,0,0
20150105.211526,2823.01,252,335586,28,0,0,0,0,0
20150105.211527,2824,84,335670,18,0,0,0,0,0
20150105.211528,2824,70,335740,-36,0,0,0,0,0
20150105.211529,2823.01,104,335844,-44,0,0,0,0,0
20150105.21153,2823.63,124,335968,18,0,0,0,0,0
20150105.211531,2823.63,4,335972,0,0,0,0,0,0
20150105.211532,2824,28,336000,8,0,0,0,0,0
20150105.211533,2823.63,12,336012,-6,0,0,0,0,0
20150105.211534,2823.01,20,336032,-20,0,0,0,0,0
20150105.211535,2823.63,34,336066,-6,0,0,0,0,0
20150105.211536,2823.63,110,336176,14,0,0,0,0,0
20150105.211537,2823.63,6,336182,4,0,0,0,0,0
20150105.211538,2823.38,436,336618,254,0,0,0,0,0
20150105.211539,2824,22,336640,4,0,0,0,0,0
20150105.21154,2824,6,336646,4,0,0,0,0,0
20150105.211541,2823.38,42,336688,14,0,0,0,0,0
20150105.211542,2823.63,254,336942,104,0,0,0,0,0
20150105.211543,2823.01,238,337180,238,0,0,0,0,0
20150105.211544,2823.01,94,337274,40,0,0,0,0,0
20150105.211545,2823.01,18,337292,0,0,0,0,0,0
20150105.211546,2823.63,96,337388,-60,0,0,0,0,0
20150105.211547,2823.01,100,337488,74,0,0,0,0,0
20150105.211548,2823.63,42,337530,38,0,0,0,0,0
20150105.211549,2823.01,222,337752,80,0,0,0,0,0
20150105.21155,2822.64,366,338118,296,0,0,0,0,0
20150105.211551,2823.01,26,338144,6,0,0,0,0,0
20150105.211552,2823.63,1406,339550,132,0,0,0,0,0
20150105.211553,2822.64,20,339570,16,0,0,0,0,0
20150105.211554,2823.01,6,339576,2,0,0,0,0,0
20150105.211555,2823.26,104,339680,102,0,0,0,0,0
20150105.211556,2823.01,6,339686,6,0,0,0,0,0
20150105.211557,2822.64,72,339758,10,0,0,0,0,0
20150105.211558,2822.64,10,339768,0,0,0,0,0,0
20150105.211559,2822.64,42,339810,38,0,0,0,0,0
20150105.2116,2822.64,52,339862,42,0,0,0,0,0
20150105.211601,2822.64,26,339888,26,0,0,0,0,0
20150105.211602,2823.26,22,339910,2,0,0,0,0,0
20150105.211603,2823.01,1006,340916,-170,0,0,0,0,0
20150105.211604,2823.26,1260,342176,72,0,0,0,0,0
20150105.211605,2823.26,472,342648,370,0,0,0,0,0
20150105.211606,2823.63,100,342748,-42,0,0,0,0,0
20150105.211607,2823.63,238,342986,108,0,0,0,0,0
20150105.211608,2823.26,216,343202,42,0,0,0,0,0
20150105.211609,2823.63,122,343324,10,0,0,0,0,0
20150105.21161,2823.63,24,343348,-6,0,0,0,0,0
20150105.211611,2822.89,54,343402,-2,0,0,0,0,0
20150105.211612,2823.51,10,343412,-6,0,0,0,0,0
20150105.211613,2822.89,192,343604,38,0,0,0,0,0
20150105.211614,2823.26,214,343818,-82,0,0,0,0,0
20150105.211615,2823.26,14,343832,10,0,0,0,0,0
20150105.211616,2822.64,450,344282,-432,0,0,0,0,0
20150105.211617,2822.64,86,344368,0,0,0,0,0,0
20150105.211618,2823.26,12,344380,-4,0,0,0,0,0
20150105.211619,2823.63,10,344390,0,0,0,0,0,0
20150105.21162,2823.26,156,344546,18,0,0,0,0,0
20150105.211621,2822.26,42,344588,0,0,0,0,0,0
20150105.211622,2823.26,4,344592,-2,0,0,0,0,0
20150105.211623,2822.64,460,345052,-84,0,0,0,0,0
20150105.211624,2822.64,226,345278,-22,0,0,0,0,0
20150105.211625,2822.02,1818,347096,614,0,0,0,0,0
20150105.211626,2822.02,10,347106,0,0,0,0,0,0
20150105.211627,2823.01,46,347152,-4,0,0,0,0,0
20150105.211628,2822.02,6,347158,-4,0,0,0,0,0
20150105.211629,2822.64,248,347406,10,0,0,0,0,0
20150105.21163,2822.64,46,347452,-24,0,0,0,0,0
20150105.211631,2822.64,20,347472,16,0,0,0,0,0
20150105.211632,2822.02,188,347660,96,0,0,0,0,0
20150105.211633,2822.39,32,347692,2,0,0,0,0,0
20150105.211634,2822.64,44,347736,-2,0,0,0,0,0
20150105.211635,2823.26,804,348540,228,0,0,0,0,0
20150105.211636,2822.02,26,348566,20,0,0,0,0,0
20150105.211637,2823.01,20,348586,-2,0,0,0,0,0
20150105.211638,2822.64,308,348894,-222,0,0,0,0,0
20150105.211639,2823.26,724,349618,-310,0,0,0,0,0
20150105.21164,2823.26,76,349694,-12,0,0,0,0,0
20150105.211641,2823.26,22,349716,8,0,0,0,0,0
20150105.211642,2823.26,170,349886,-4,0,0,0,0,0
20150105.211643,2823.26,196,350082,-88,0,0,0,0,0
20150105.211644,2823.26,414,350496,402,0,0,0,0,0
20150105.211645,2822.64,40,350536,26,0,0,0,0,0
20150105.211646,2822.88,14,350550,0,0,0,0,0,0
20150105.211647,2823.26,18,350568,4,0,0,0,0,0
20150105.211648,2822.26,584,351152,130,0,0,0,0,0
20150105.211649,2822.64,104,351256,-18,0,0,0,0,0
20150105.21165,2822.64,604,351860,-276,0,0,0,0,0
20150105.211651,2822.64,38,351898,16,0,0,0,0,0
20150105.211652,2822.26,42,351940,40,0,0,0,0,0
20150105.211653,2822.26,22,351962,-16,0,0,0,0,0
20150105.211654,2822.64,102,352064,-38,0,0,0,0,0
20150105.211655,2822.26,54,352118,4,0,0,0,0,0
20150105.211656,2822.64,6,352124,2,0,0,0,0,0
20150105.211657,2822.26,118,352242,-44,0,0,0,0,0
20150105.211658,2822.26,8,352250,4,0,0,0,0,0
20150105.211659,2822.26,22,352272,0,0,0,0,0,0
20150105.2117,2822.26,320,352592,-54,0,0,0,0,0
20150105.211701,2821.64,102,352694,-72,0,0,0,0,0
20150105.211702,2822.64,336,353030,-306,0,0,0,0,0
20150105.211703,2822.64,274,353304,60,0,0,0,0,0
20150105.211704,2822.26,22,353326,0,0,0,0,0,0
20150105.211705,2822.26,200,353526,-170,0,0,0,0,0
20150105.211706,2822.64,32,353558,10,0,0,0,0,0
20150105.211707,2822.64,12,353570,-2,0,0,0,0,0
20150105.211708,2822.88,202,353772,-138,0,0,0,0,0
20150105.211709,2822.26,108,353880,24,0,0,0,0,0
20150105.21171,2822.26,330,354210,58,0,0,0,0,0
20150105.211711,2822.88,42,354252,16,0,0,0,0,0
20150105.211712,2822.26,212,354464,-202,0,0,0,0,0
20150105.211713,2822.26,182,354646,8,0,0,0,0,0
20150105.211714,2822.26,260,354906,110,0,0,0,0,0
20150105.211715,2822.26,64,354970,40,0,0,0,0,0
20150105.211716,2822.64,156,355126,92,0,0,0,0,0
20150105.211717,2821.89,1286,356412,1026,0,0,0,0,0
20150105.211718,2822.63,352,356764,250,0,0,0,0,0
20150105.211719,2822.26,32,356796,0,0,0,0,0,0
20150105.21172,2821.64,64,356860,10,0,0,0,0,0
20150105.211721,2821.64,110,356970,24,0,0,0,0,0
20150105.211722,2821.64,132,357102,-72,0,0,0,0,0
20150105.211723,2822.26,16,357118,0,0,0,0,0,0
20150105.211724,2821.64,18,357136,-4,0,0,0,0,0
20150105.211725,2822.26,18,357154,-16,0,0,0,0,0
20150105.211726,2822.01,620,357774,224,0,0,0,0,0
20150105.211727,2821.64,4,357778,2,0,0,0,0,0
20150105.211728,2822.26,80,357858,-4,0,0,0,0,0
20150105.211729,2822.01,112,357970,12,0,0,0,0,0
20150105.21173,2822.01,266,358236,4,0,0,0,0,0
20150105.211731,2822.39,112,358348,44,0,0,0,0,0
20150105.211732,2821.77,72,358420,10,0,0,0,0,0
20150105.211733,2822.39,794,359214,352,0,0,0,0,0
20150105.211734,2822.76,102,359316,-14,0,0,0,0,0
20150105.211735,2822.63,120,359436,-34,0,0,0,0,0
20150105.211736,2822.01,98,359534,-84,0,0,0,0,0
20150105.211737,2822.76,96,359630,-38,0,0,0,0,0
20150105.211738,2822.39,268,359898,-212,0,0,0,0,0
20150105.211739,2821.77,124,360022,14,0,0,0,0,0
20150105.21174,2822.39,12,360034,8,0,0,0,0,0
20150105.211741,2822.39,12,360046,12,0,0,0,0,0
20150105.211742,2821.77,132,360178,22,0,0,0,0,0
20150105.211743,2821.77,14,360192,6,0,0,0,0,0
20150105.211744,2821.77,86,360278,-4,0,0,0,0,0
20150105.211745,2822.39,48,360326,20,0,0,0,0,0
20150105.211746,2822.76,28,360354,18,0,0,0,0,0
20150105.211747,2821.77,4,360358,0,0,0,0,0,0
20150105.211748,2821.39,402,360760,208,0,0,0,0,0
20150105.211749,2822.01,192,360952,162,0,0,0,0,0
20150105.21175,2822.01,152,361104,136,0,0,0,0,0
20150105.211751,2822.01,172,361276,52,0,0,0,0,0
20150105.211752,2822.01,14,361290,-2,0,0,0,0,0
20150105.211753,2821.39,50,361340,-36,0,0,0,0,0
20150105.211754,2822.01,28,361368,8,0,0,0,0,0
20150105.211755,2822.39,150,361518,-138,0,0,0,0,0
20150105.211756,2821.64,82,361600,4,0,0,0,0,0
20150105.211757,2821.39,28,361628,24,0,0,0,0,0
20150105.211758,2822.01,204,361832,4,0,0,0,0,0
20150105.211759,2821.39,140,361972,8,0,0,0,0,0
20150105.2118,2822.01,48,362020,20,0,0,0,0,0
20150105.211801,2821.77,22,362042,0,0,0,0,0,0
20150105.211802,2821.39,24,362066,16,0,0,0,0,0
20150105.211803,2822.39,218,362284,210,0,0,0,0,0
20150105.211804,2821.39,122,362406,22,0,0,0,0,0
20150105.211805,2821.77,108,362514,-100,0,0,0,0,0
20150105.211806,2822.01,100,362614,8,0,0,0,0,0
20150105.211807,2821.39,96,362710,-74,0,0,0,0,0
20150105.211808,2821.77,14,362724,0,0,0,0,0,0
20150105.211809,2821.39,120,362844,26,0,0,0,0,0
20150105.21181,2821.39,236,363080,-66,0,0,0,0,0
20150105.211811,2821.77,332,363412,40,0,0,0,0,0
20150105.211812,2822.01,242,363654,-10,0,0,0,0,0
20150105.211813,2821.77,60,363714,36,0,0,0,0,0
20150105.211814,2821.77,182,363896,-102,0,0,0,0,0
20150105.211815,2821.77,312,364208,-242,0,0,0,0,0
20150105.211816,2822.39,54,364262,2,0,0,0,0,0
20150105.211817,2821.77,34,364296,0,0,0,0,0,0
20150105.211818,2821.77,32,364328,2,0,0,0,0,0
20150105.211819,2822.39,26,364354,0,0,0,0,0,0
20150105.21182,2822.39,208,364562,-50,0,0,0,0,0
20150105.211821,2821.77,4,364566,0,0,0,0,0,0
20150105.211822,2822.39,84,364650,18,0,0,0,0,0
20150105.211823,2822.14,204,364854,86,0,0,0,0,0
20150105.211824,2821.77,466,365320,194,0,0,0,0,0
20150105.211825,2822.39,10,365330,-6,0,0,0,0,0
20150105.211826,2822.39,412,365742,146,0,0,0,0,0
20150105.211827,2822.14,634,366376,554,0,0,0,0,0
20150105.211828,2821.77,222,366598,-36,0,0,0,0,0
20150105.211829,2821.77,382,366980,96,0,0,0,0,0
20150105.21183,2822.14,130,367110,4,0,0,0,0,0
20150105.211831,2822.39,40,367150,6,0,0,0,0,0
20150105.211832,2821.77,518,367668,76,0,0,0,0,0
20150105.211833,2822.39,326,367994,6,0,0,0,0,0
20150105.211834,2821.77,8,368002,0,0,0,0,0,0
20150105.211835,2822.39,800,368802,-268,0,0,0,0,0
20150105.211836,2821.77,74,368876,10,0,0,0,0,0
20150105.211837,2821.77,24,368900,2,0,0,0,0,0
20150105.211838,2821.77,60,368960,-4,0,0,0,0,0
20150105.211839,2822.01,70,369030,-56,0,0,0,0,0
20150105.21184,2821.77,232,369262,28,0,0,0,0,0
20150105.211841,2822.01,504,369766,-168,0,0,0,0,0
20150105.211842,2822.39,12,369778,-2,0,0,0,0,0
20150105.211843,2821.77,352,370130,12,0,0,0,0,0
20150105.211844,2821.39,12,370142,10,0,0,0,0,0
20150105.211845,2822.01,44,370186,34,0,0,0,0,0
20150105.211846,2822.39,504,370690,-128,0,0,0,0,0
20150105.211847,2821.39,126,370816,12,0,0,0,0,0
20150105.211848,2822.39,506,371322,214,0,0,0,0,0
20150105.211849,2822.63,164,371486,40,0,0,0,0,0
20150105.21185,2822.39,20,371506,-20,0,0,0,0,0
20150105.211851,2822.39,312,371818,10,0,0,0,0,0
20150105.211852,2822.01,30,371848,24,0,0,0,0,0
20150105.211853,2822.01,634,372482,144,0,0,0,0,0
20150105.211854,2821.39,166,372648,122,0,0,0,0,0
20150105.211855,2822.01,34,372682,26,0,0,0,0,0
20150105.211856,2821.39,6,372688,6,0,0,0,0,0
20150105.211857,2822.01,16,372704,14,0,0,0,0,0
20150105.211858,2822.01,6,372710,4,0,0,0,0,0
20150105.211859,2822.01,106,372816,0,0,0,0,0,0
20150105.2119,2822.01,60,372876,-50,0,0,0,0,0
20150105.211901,2821.39,14,372890,0,0,0,0,0,0
20150105.211902,2821.02,604,373494,282,0,0,0,0,0
20150105.211903,2821.02,76,373570,74,0,0,0,0,0
20150105.211904,2821.64,8,373578,8,0,0,0,0,0
20150105.211905,2821.64,28,373606,6,0,0,0,0,0
20150105.211906,2821.27,678,374284,-280,0,0,0,0,0
20150105.211907,2821.02,948,375232,492,0,0,0,0,0
20150105.211908,2821.02,180,375412,-40,0,0,0,0,0
20150105.211909,2821.02,14,375426,2,0,0,0,0,0
20150105.21191,2820.65,270,375696,-196,0,0,0,0,0
20150105.211911,2821.02,116,375812,52,0,0,0,0,0
20150105.211912,2820.03,86,375898,-10,0,0,0,0,0
20150105.211913,2821.64,148,376046,-20,0,0,0,0,0
20150105.211914,2821.27,30,376076,-16,0,0,0,0,0
20150105.211915,2821.02,10,376086,-4,0,0,0,0,0
20150105.211916,2821.27,28,376114,0,0,0,0,0,0
20150105.211917,2820.65,14,376128,-10,0,0,0,0,0
20150105.211918,2821.02,4,376132,0,0,0,0,0,0
20150105.211919,2820.65,124,376256,58,0,0,0,0,0
20150105.21192,2820.65,12,376268,6,0,0,0,0,0
20150105.211921,2820.65,20,376288,16,0,0,0,0,0
20150105.211922,2820.03,14,376302,12,0,0,0,0,0
20150105.211923,2820.4,4,376306,2,0,0,0,0,0
20150105.211924,2820.65,16,376322,10,0,0,0,0,0
20150105.211925,2821.02,106,376428,4,0,0,0,0,0
20150105.211926,2820.4,142,376570,120,0,0,0,0,0
20150105.211927,2820.65,24,376594,10,0,0,0,0,0
20150105.211928,2820.4,16,376610,4,0,0,0,0,0
20150105.211929,2820.03,224,376834,76,0,0,0,0,0
20150105.21193,2820.4,36,376870,0,0,0,0,0,0
20150105.211931,2820.65,220,377090,206,0,0,0,0,0
20150105.211932,2820.03,274,377364,214,0,0,0,0,0
20150105.211933,2820.03,246,377610,164,0,0,0,0,0
20150105.211934,2820.03,102,377712,58,0,0,0,0,0
20150105.211935,2820.65,126,377838,80,0,0,0,0,0
20150105.211936,2820.03,54,377892,-30,0,0,0,0,0
20150105.211937,2820.03,8,377900,-2,0,0,0,0,0
20150105.211938,2820.65,8,377908,2,0,0,0,0,0
20150105.211939,2820.65,42,377950,26,0,0,0,0,0
20150105.21194,2820.65,22,377972,18,0,0,0,0,0
20150105.211941,2820.03,624,378596,536,0,0,0,0,0
20150105.211942,2820.03,368,378964,310,0,0,0,0,0
20150105.211943,2820.03,222,379186,198,0,0,0,0,0
20150105.211944,2820.03,24,379210,24,0,0,0,0,0
20150105.211945,2820.03,10,379220,4,0,0,0,0,0
20150105.211946,2820.03,50,379270,4,0,0,0,0,0
20150105.211947,2820.03,34,379304,-4,0,0,0,0,0
20150105.211948,2820.65,262,379566,46,0,0,0,0,0
20150105.211949,2821.02,10,379576,-2,0,0,0,0,0
20150105.21195,2820.4,38,379614,2,0,0,0,0,0
20150105.211951,2821.02,1686,381300,242,0,0,0,0,0
20150105.211952,2821.02,10,381310,2,0,0,0,0,0
20150105.211953,2820.65,10,381320,0,0,0,0,0,0
20150105.211954,2821.27,36,381356,2,0,0,0,0,0
20150105.211955,2821.02,374,381730,150,0,0,0,0,0
20150105.211956,2821.02,60,381790,48,0,0,0,0,0
20150105.211957,2821.02,62,381852,-10,0,0,0,0,0
20150105.211958,2821.64,88,381940,0,0,0,0,0,0
20150105.211959,2821.64,584,382524,-72,0,0,0,0,0
20150105.212,2821.64,30,382554,-10,0,0,0,0,0
20150105.212001,2821.64,24,382578,-16,0,0,0,0,0
20150105.212002,2821.64,12,382590,-6,0,0,0,0,0
20150105.212003,2821.64,34,382624,12,0,0,0,0,0
20150105.212004,2821.27,4,382628,-2,0,0,0,0,0
20150105.212005,2821.64,78,382706,14,0,0,0,0,0
20150105.212006,2821.64,126,382832,2,0,0,0,0,0
20150105.212007,2822.26,36,382868,12,0,0,0,0,0
20150105.212008,2822.26,10,382878,4,0,0,0,0,0
20150105.212009,2821.64,6,382884,2,0,0,0,0,0
20150105.21201,2821.89,26,382910,12,0,0,0,0,0
20150105.212011,2822.26,14,382924,2,0,0,0,0,0
20150105.212012,2821.27,44,382968,4,0,0,0,0,0
20150105.212013,2821.27,144,383112,-2,0,0,0,0,0
20150105.212014,2821.64,26,383138,2,0,0,0,0,0
20150105.212015,2822.26,28,383166,2,0,0,0,0,0
20150105.212016,2821.26,748,383914,440,0,0,0,0,0
20150105.212017,2821.02,12,383926,4,0,0,0,0,0
20150105.212018,2821.26,296,384222,-14,0,0,0,0,0
20150105.212019,2821.64,6,384228,6,0,0,0,0,0
20150105.21202,2821.26,834,385062,834,0,0,0,0,0
20150105.212021,2821.26,502,385564,460,0,0,0,0,0
20150105.212022,2821.64,74,385638,56,0,0,0,0,0
20150105.212023,2821.64,54,385692,54,0,0,0,0,0
20150105.212024,2821.26,16,385708,10,0,0,0,0,0
20150105.212025,2822.26,66,385774,66,0,0,0,0,0
20150105.212026,2821.64,6,385780,2,0,0,0,0,0
20150105.212027,2821.26,262,386042,104,0,0,0,0,0
20150105.212028,2821.26,1298,387340,-318,0,0,0,0,0
20150105.212029,2821.26,208,387548,50,0,0,0,0,0
20150105.21203,2821.64,42,387590,42,0,0,0,0,0
20150105.212031,2821.26,24,387614,20,0,0,0,0,0
20150105.212032,2821.26,48,387662,10,0,0,0,0,0
20150105.212033,2821.26,120,387782,82,0,0,0,0,0
20150105.212034,2820.89,18,387800,6,0,0,0,0,0
20150105.212035,2821.64,22,387822,22,0,0,0,0,0
20150105.212036,2821.64,246,388068,2,0,0,0,0,0
20150105.212037,2821.02,660,388728,230,0,0,0,0,0
20150105.212038,2821.64,6,388734,2,0,0,0,0,0
20150105.212039,2821.02,254,388988,152,0,0,0,0,0
20150105.21204,2821.02,54,389042,46,0,0,0,0,0
20150105.212041,2821.64,6,389048,0,0,0,0,0,0
20150105.212042,2821.26,592,389640,-10,0,0,0,0,0
20150105.212043,2820.64,662,390302,-186,0,0,0,0,0
20150105.212044,2821.26,22,390324,10,0,0,0,0,0
20150105.212045,2820.64,6,390330,6,0,0,0,0,0
20150105.212046,2821.26,32,390362,4,0,0,0,0,0
20150105.212047,2821.26,50,390412,48,0,0,0,0,0
20150105.212048,2820.64,70,390482,28,0,0,0,0,0
20150105.212049,2821.02,240,390722,190,0,0,0,0,0
20150105.21205,2821.26,38,390760,-4,0,0,0,0,0
20150105.212051,2820.64,6,390766,2,0,0,0,0,0
20150105.212052,2820.64,4,390770,2,0,0,0,0,0
20150105.212053,2821.26,28,390798,20,0,0,0,0,0
20150105.212054,2821.26,120,390918,-100,0,0,0,0,0
20150105.212055,2821.26,78,390996,4,0,0,0,0,0
20150105.212056,2820.64,16,391012,4,0,0,0,0,0
20150105.212057,2821.26,150,391162,22,0,0,0,0,0
20150105.212058,2821.64,156,391318,28,0,0,0,0,0
20150105.212059,2821.26,32,391350,32,0,0,0,0,0
20150105.2121,2821.64,12,391362,4,0,0,0,0,0
20150105.212101,2821.64,34,391396,16,0,0,0,0,0
20150105.212102,2821.64,116,391512,76,0,0,0,0,0
20150105.212103,2821.64,14,391526,0,0,0,0,0,0
20150105.212104,2821.64,220,391746,30,0,0,0,0,0
20150105.212105,2821.64,8,391754,8,0,0,0,0,0
20150105.212106,2821.26,10,391764,8,0,0,0,0,0
20150105.212107,2821.64,24,391788,18,0,0,0,0,0
20150105.212108,2821.26,102,391890,92,0,0,0,0,0
20150105.212109,2821.64,340,392230,312,0,0,0,0,0
20150105.21211,2821.26,32,392262,22,0,0,0,0,0
20150105.212111,2821.88,78,392340,30,0,0,0,0,0
20150105.212112,2821.26,54,392394,2,0,0,0,0,0
20150105.212113,2822.26,14,392408,0,0,0,0,0,0
20150105.212114,2821.26,104,392512,-36,0,0,0,0,0
20150105.212115,2821.26,96,392608,20,0,0,0,0,0
20150105.212116,2821.26,40,392648,8,0,0,0,0,0
20150105.212117,2821.26,4,392652,4,0,0,0,0,0
20150105.212118,2821.88,26,392678,26,0,0,0,0,0
20150105.212119,2822.26,16,392694,4,0,0,0,0,0
20150105.21212,2821.88,32,392726,14,0,0,0,0,0
20150105.212121,2821.64,8,392734,2,0,0,0,0,0
20150105.212122,2821.26,66,392800,-46,0,0,0,0,0
20150105.212123,2821.88,304,393104,180,0,0,0,0,0
20150105.212124,2821.88,202,393306,134,0,0,0,0,0
20150105.212125,2821.88,248,393554,198,0,0,0,0,0
20150105.212126,2821.26,576,394130,142,0,0,0,0,0
20150105.212127,2821.26,8,394138,4,0,0,0,0,0
20150105.212128,2821.64,84,394222,80,0,0,0,0,0
20150105.212129,2821.26,122,394344,114,0,0,0,0,0
20150105.21213,2821.26,122,394466,22,0,0,0,0,0
20150105.212131,2821.26,34,394500,22,0,0,0,0,0
20150105.212132,2821.26,6,394506,4,0,0,0,0,0
20150105.212133,2820.89,32,394538,12,0,0,0,0,0
20150105.212134,2821.26,6,394544,2,0,0,0,0,0
20150105.212135,2821.64,20,394564,10,0,0,0,0,0
20150105.212136,2821.64,20,394584,14,0,0,0,0,0
20150105.212137,2821.26,128,394712,2,0,0,0,0,0
20150105.212138,2821.26,32,394744,22,0,0,0,0,0
20150105.212139,2820.64,116,394860,100,0,0,0,0,0
20150105.21214,2821.26,8,394868,6,0,0,0,0,0
20150105.212141,2821.26,26,394894,26,0,0,0,0,0
20150105.212142,2821.26,12,394906,12,0,0,0,0,0
20150105.212143,2821.26,26,394932,0,0,0,0,0,0
20150105.212144,2821.64,64,394996,8,0,0,0,0,0
20150105.212145,2821.02,50,395046,-20,0,0,0,0,0
20150105.212146,2821.26,10,395056,-6,0,0,0,0,0
20150105.212147,2820.64,74,395130,0,0,0,0,0,0
20150105.212148,2821.64,4,395134,0,0,0,0,0,0
20150105.212149,2821.02,24,395158,20,0,0,0,0,0
20150105.21215,2821.26,180,395338,128,0,0,0,0,0
20150105.212151,2821.26,18,395356,8,0,0,0,0,0
20150105.212152,2821.26,46,395402,6,0,0,0,0,0
20150105.212153,2821.26,18,395420,0,0,0,0,0,0
20150105.212154,2821.26,12,395432,-2,0,0,0,0,0
20150105.212155,2821.26,58,395490,-54,0,0,0,0,0
20150105.212156,2821.26,408,395898,-340,0,0,0,0,0
20150105.212157,2821.26,14,395912,0,0,0,0,0,0
20150105.212158,2821.26,16,395928,0,0,0,0,0,0
20150105.212159,2821.88,4,395932,2,0,0,0,0,0
20150105.2122,2821.26,6,395938,-2,0,0,0,0,0
20150105.212201,2821.26,438,396376,158,0,0,0,0,0
20150105.212202,2820.89,92,396468,52,0,0,0,0,0
20150105.212203,2821.26,638,397106,230,0,0,0,0,0
20150105.212204,2821.26,94,397200,30,0,0,0,0,0
20150105.212205,2820.64,128,397328,-4,0,0,0,0,0
20150105.212206,2821.26,8,397336,-2,0,0,0,0,0
20150105.212207,2821.26,54,397390,4,0,0,0,0,0
20150105.212208,2821.26,18,397408,0,0,0,0,0,0
20150105.212209,2821.26,12,397420,-2,0,0,0,0,0
20150105.21221,2820.89,82,397502,-74,0,0,0,0,0
20150105.212211,2820.64,214,397716,68,0,0,0,0,0
20150105.212212,2821.26,8,397724,0,0,0,0,0,0
20150105.212213,2821.26,30,397754,-16,0,0,0,0,0
20150105.212214,2821.26,104,397858,30,0,0,0,0,0
20150105.212215,2821.26,88,397946,-14,0,0,0,0,0
20150105.212216,2820.89,290,398236,164,0,0,0,0,0
20150105.212217,2821.26,6,398242,0,0,0,0,0,0
20150105.212218,2821.26,78,398320,24,0,0,0,0,0
20150105.212219,2820.89,244,398564,168,0,0,0,0,0
20150105.21222,2821.26,256,398820,-10,0,0,0,0,0
20150105.212221,2821.26,4,398824,0,0,0,0,0,0
20150105.212222,2820.52,18,398842,2,0,0,0,0,0
20150105.212223,2820.52,38,398880,30,0,0,0,0,0
20150105.212224,2819.9,330,399210,196,0,0,0,0,0
20150105.212225,2820.27,464,399674,22,0,0,0,0,0
20150105.212226,2820.27,28,399702,2,0,0,0,0,0
20150105.212227,2820.27,6,399708,0,0,0,0,0,0
20150105.212228,2820.64,26,399734,-4,0,0,0,0,0
20150105.212229,2819.28,74,399808,56,0,0,0,0,0
20150105.21223,2819.9,34,399842,-4,0,0,0,0,0
20150105.212231,2819.65,16,399858,14,0,0,0,0,0
20150105.212232,2820.27,4,399862,2,0,0,0,0,0
20150105.212233,2819.28,50,399912,4,0,0,0,0,0
20150105.212234,2820.27,32,399944,-28,0,0,0,0,0
20150105.212235,2819.28,20,399964,18,0,0,0,0,0
20150105.212236,2819.65,20,399984,4,0,0,0,0,0
20150105.212237,2819.65,20,400004,4,0,0,0,0,0
20150105.212238,2819.65,20,400024,20,0,0,0,0,0
20150105.212239,2820.27,38,400062,12,0,0,0,0,0
20150105.21224,2819.9,38,400100,0,0,0,0,0,0
20150105.212241,2819.65,10,400110,6,0,0,0,0,0
20150105.212242,2820.27,82,400192,60,0,0,0,0,0
20150105.212243,2819.9,130,400322,-58,0,0,0,0,0
20150105.212244,2819.28,4,400326,0,0,0,0,0,0
20150105.212245,2820.27,26,400352,24,0,0,0,0,0
20150105.212246,2819.28,470,400822,396,0,0,0,0,0
20150105.212247,2819.65,110,400932,64,0,0,0,0,0
20150105.212248,2819.65,376,401308,126,0,0,0,0,0
20150105.212249,2820.52,1028,402336,648,0,0,0,0,0
20150105.21225,2819.9,568,402904,324,0,0,0,0,0
20150105.212251,2819.28,268,403172,-88,0,0,0,0,0
20150105.212252,2819.65,78,403250,40,0,0,0,0,0
20150105.212253,2819.28,292,403542,244,0,0,0,0,0
20150105.212254,2819.9,16,403558,16,0,0,0,0,0
20150105.212255,2819.9,146,403704,68,0,0,0,0,0
20150105.212256,2820.27,34,403738,-2,0,0,0,0,0
20150105.212257,2819.9,54,403792,22,0,0,0,0,0
20150105.212258,2819.9,14,403806,0,0,0,0,0,0
20150105.212259,2819.9,10,403816,2,0,0,0,0,0
20150105.2123,2820.27,122,403938,22,0,0,0,0,0
20150105.212301,2820.27,78,404016,22,0,0,0,0,0
20150105.212302,2819.9,76,404092,16,0,0,0,0,0
20150105.212303,2819.9,196,404288,196,0,0,0,0,0
20150105.212304,2819.28,32,404320,20,0,0,0,0,0
20150105.212305,2819.9,90,404410,0,0,0,0,0,0
20150105.212306,2819.9,18,404428,18,0,0,0,0,0
20150105.212307,2819.28,214,404642,132,0,0,0,0,0
20150105.212308,2819.9,66,404708,66,0,0,0,0,0
20150105.212309,2819.28,212,404920,184,0,0,0,0,0
20150105.21231,2819.28,30,404950,6,0,0,0,0,0
20150105.212311,2819.9,4,404954,4,0,0,0,0,0
20150105.212312,2818.9,452,405406,220,0,0,0,0,0
20150105.212313,2819.52,20,405426,0,0,0,0,0,0
20150105.212314,2819.9,246,405672,130,0,0,0,0,0
20150105.212315,2819.28,32,405704,28,0,0,0,0,0
20150105.212316,2819.28,36,405740,6,0,0,0,0,0
20150105.212317,2819.28,36,405776,26,0,0,0,0,0
20150105.212318,2819.28,8,405784,4,0,0,0,0,0
20150105.212319,2819.52,8,405792,2,0,0,0,0,0
20150105.21232,2819.28,220,406012,14,0,0,0,0,0
20150105.212321,2819.52,52,406064,50,0,0,0,0,0
20150105.212322,2819.28,82,406146,76,0,0,0,0,0
20150105.212323,2819.52,24,406170,6,0,0,0,0,0
20150105.212324,2818.9,8,406178,-4,0,0,0,0,0
20150105.212325,2819.9,46,406224,14,0,0,0,0,0
20150105.212326,2819.9,12,406236,10,0,0,0,0,0
20150105.212327,2819.28,84,406320,4,0,0,0,0,0
20150105.212328,2819.28,22,406342,22,0,0,0,0,0
20150105.212329,2819.28,10,406352,10,0,0,0,0,0
20150105.21233,2819.9,4,406356,4,0,0,0,0,0
20150105.212331,2819.28,4,406360,2,0,0,0,0,0
20150105.212332,2819.52,14,406374,4,0,0,0,0,0
20150105.212333,2819.28,16,406390,14,0,0,0,0,0
20150105.212334,2819.52,20,406410,2,0,0,0,0,0
20150105.212335,2819.9,596,407006,506,0,0,0,0,0
20150105.212336,2819.9,8,407014,4,0,0,0,0,0
20150105.212337,2819.9,56,407070,-38,0,0,0,0,0
20150105.212338,2819.9,14,407084,-4,0,0,0,0,0
20150105.212339,2820.52,106,407190,96,0,0,0,0,0
20150105.21234,2819.52,26,407216,4,0,0,0,0,0
20150105.212341,2820.52,6,407222,0,0,0,0,0,0
20150105.212342,2820.52,294,407516,30,0,0,0,0,0
20150105.212343,2820.52,356,407872,76,0,0,0,0,0
20150105.212344,2819.9,422,408294,302,0,0,0,0,0
20150105.212345,2820.27,180,408474,-134,0,0,0,0,0
20150105.212346,2820.27,614,409088,290,0,0,0,0,0
20150105.212347,2820.27,30,409118,-28,0,0,0,0,0
20150105.212348,2820.27,16,409134,4,0,0,0,0,0
20150105.212349,2820.27,178,409312,-56,0,0,0,0,0
20150105.21235,2820.89,36,409348,-4,0,0,0,0,0
20150105.212351,2820.64,54,409402,4,0,0,0,0,0
20150105.212352,2820.64,8,409410,0,0,0,0,0,0
20150105.212353,2820.64,54,409464,2,0,0,0,0,0
20150105.212354,2821.26,26,409490,-12,0,0,0,0,0
20150105.212355,2820.64,38,409528,-34,0,0,0,0,0
20150105.212356,2820.27,16,409544,-8,0,0,0,0,0
20150105.212357,2820.89,22,409566,20,0,0,0,0,0
20150105.212358,2820.27,56,409622,24,0,0,0,0,0
20150105.212359,2821.26,10,409632,-2,0,0,0,0,0
20150105.2124,2820.27,10,409642,2,0,0,0,0,0
20150105.212401,2820.27,38,409680,28,0,0,0,0,0
20150105.212402,2820.64,14,409694,0,0,0,0,0,0
20150105.212403,2820.64,24,409718,-16,0,0,0,0,0
20150105.212404,2821.26,24,409742,14,0,0,0,0,0
20150105.212405,2820.64,6,409748,0,0,0,0,0,0
20150105.212406,2820.64,120,409868,-90,0,0,0,0,0
20150105.212407,2820.27,118,409986,-8,0,0,0,0,0
20150105.212408,2820.89,76,410062,-4,0,0,0,0,0
20150105.212409,2820.64,20,410082,-2,0,0,0,0,0
20150105.21241,2820.89,10,410092,8,0,0,0,0,0
20150105.212411,2821.26,12,410104,-4,0,0,0,0,0
20150105.212412,2820.64,64,410168,2,0,0,0,0,0
20150105.212413,2821.26,1024,411192,392,0,0,0,0,0
20150105.212414,2821.26,180,411372,2,0,0,0,0,0
20150105.212415,2820.64,232,411604,12,0,0,0,0,0
20150105.212416,2820.64,12,411616,0,0,0,0,0,0
20150105.212417,2820.64,44,411660,0,0,0,0,0,0
20150105.212418,2820.64,12,411672,8,0,0,0,0,0
20150105.212419,2820.64,1158,412830,594,0,0,0,0,0
20150105.21242,2820.64,6,412836,2,0,0,0,0,0
20150105.212421,2820.64,108,412944,96,0,0,0,0,0
20150105.212422,2820.64,32,412976,24,0,0,0,0,0
20150105.212423,2820.65,498,413474,472,0,0,0,0,0
20150105.212424,2820.03,1580,415054,1156,0,0,0,0,0
20150105.212425,2820.65,64,415118,2,0,0,0,0,0
20150105.212426,2820.65,40,415158,-2,0,0,0,0,0
20150105.212427,2820.03,26,415184,12,0,0,0,0,0
20150105.212428,2820.65,284,415468,22,0,0,0,0,0
20150105.212429,2820.03,236,415704,166,0,0,0,0,0
20150105.21243,2819.65,130,415834,68,0,0,0,0,0
20150105.212431,2820.03,32,415866,6,0,0,0,0,0
20150105.212432,2820.03,14,415880,-12,0,0,0,0,0
20150105.212433,2820.03,4,415884,2,0,0,0,0,0
20150105.212434,2819.65,14,415898,10,0,0,0,0,0
20150105.212435,2820.65,118,416016,8,0,0,0,0,0
20150105.212436,2820.65,16,416032,12,0,0,0,0,0
20150105.212437,2820.65,124,416156,60,0,0,0,0,0
20150105.212438,2820.03,12,416168,-6,0,0,0,0,0
20150105.212439,2820.65,6,416174,2,0,0,0,0,0
20150105.21244,2821.02,26,416200,2,0,0,0,0,0
20150105.212441,2820.4,28,416228,-6,0,0,0,0,0
20150105.212442,2821.02,8,416236,0,0,0,0,0,0
20150105.212443,2820.65,124,416360,24,0,0,0,0,0
20150105.212444,2820.4,48,416408,8,0,0,0,0,0
20150105.212445,2820.65,124,416532,104,0,0,0,0,0
20150105.212446,2821.02,446,416978,396,0,0,0,0,0
20150105.212447,2821.02,14,416992,2,0,0,0,0,0
20150105.212448,2821.02,8,417000,-4,0,0,0,0,0
20150105.212449,2821.02,24,417024,-12,0,0,0,0,0
20150105.21245,2821.02,556,417580,456,0,0,0,0,0
20150105.212451,2821.02,84,417664,80,0,0,0,0,0
20150105.212452,2820.4,1178,418842,1036,0,0,0,0,0
20150105.212453,2820.4,66,418908,-8,0,0,0,0,0
20150105.212454,2819.78,4,418912,-2,0,0,0,0,0
20150105.212455,2819.78,26,418938,16,0,0,0,0,0
20150105.212456,2820.03,496,419434,-200,0,0,0,0,0
20150105.212457,2820.03,94,419528,-72,0,0,0,0,0
20150105.212458,2819.78,16,419544,14,0,0,0,0,0
20150105.212459,2819.41,122,419666,-96,0,0,0,0,0
20150105.2125,2820.03,130,419796,-22,0,0,0,0,0
20150105.212501,2819.41,56,419852,52,0,0,0,0,0
20150105.212502,2820.03,36,419888,4,0,0,0,0,0
20150105.212503,2819.41,30,419918,-26,0,0,0,0,0
20150105.212504,2820.03,54,419972,46,0,0,0,0,0
20150105.212505,2820.03,32,420004,-2,0,0,0,0,0
20150105.212506,2820.03,78,420082,-2,0,0,0,0,0
20150105.212507,2819.78,130,420212,12,0,0,0,0,0
20150105.212508,2820.4,16,420228,0,0,0,0,0,0
20150105.212509,2820.4,8,420236,2,0,0,0,0,0
20150105.21251,2820.03,346,420582,-120,0,0,0,0,0
20150105.212511,2820.4,76,420658,-34,0,0,0,0,0
20150105.212512,2820.4,14,420672,-2,0,0,0,0,0
20150105.212513,2820.4,4,420676,0,0,0,0,0,0
20150105.212514,2820.65,138,420814,34,0,0,0,0,0
20150105.212515,2820.4,4,420818,-2,0,0,0,0,0
20150105.212516,2820.4,44,420862,-26,0,0,0,0,0
20150105.212517,2820.4,318,421180,92,0,0,0,0,0
20150105.212518,2820.03,154,421334,112,0,0,0,0,0
20150105.212519,2820.4,16,421350,6,0,0,0,0,0
20150105.21252,2820.03,16,421366,-6,0,0,0,0,0
20150105.212521,2820.4,54,421420,0,0,0,0,0,0
20150105.212522,2820.65,22,421442,-2,0,0,0,0,0
20150105.212523,2820.4,50,421492,-44,0,0,0,0,0
20150105.212524,2820.4,10,421502,-2,0,0,0,0,0
20150105.212525,2820.65,34,421536,2,0,0,0,0,0
20150105.212526,2820.03,106,421642,-82,0,0,0,0,0
20150105.212527,2820.4,196,421838,-38,0,0,0,0,0
20150105.212528,2820.4,98,421936,50,0,0,0,0,0
20150105.212529,2821.02,14,421950,8,0,0,0,0,0
20150105.21253,2820.4,10,421960,6,0,0,0,0,0
20150105.212531,2820.4,210,422170,172,0,0,0,0,0
20150105.212532,2820.4,52,422222,50,0,0,0,0,0
20150105.212533,2820.4,24,422246,24,0,0,0,0,0
20150105.212534,2820.4,22,422268,6,0,0,0,0,0
20150105.212535,2820.4,118,422386,10,0,0,0,0,0
20150105.212536,2820.4,70,422456,0,0,0,0,0,0
20150105.212537,2820.03,564,423020,356,0,0,0,0,0
20150105.212538,2819.41,60,423080,-12,0,0,0,0,0
20150105.212539,2820.03,32,423112,10,0,0,0,0,0
20150105.21254,2820.03,94,423206,-30,0,0,0,0,0
20150105.212541,2819.04,458,423664,0,0,0,0,0,0
20150105.212542,2820.03,10,423674,8,0,0,0,0,0
20150105.212543,2820.03,14,423688,12,0,0,0,0,0
20150105.212544,2819.66,20,423708,10,0,0,0,0,0
20150105.212545,2820.03,20,423728,10,0,0,0,0,0
20150105.212546,2820.03,22,423750,12,0,0,0,0,0
20150105.212547,2820.03,74,423824,52,0,0,0,0,0
20150105.212548,2820.03,12,423836,0,0,0,0,0,0
20150105.212549,2820.03,6,423842,2,0,0,0,0,0
20150105.21255,2820.03,12,423854,4,0,0,0,0,0
20150105.212551,2820.03,42,423896,22,0,0,0,0,0
20150105.212552,2819.41,218,424114,178,0,0,0,0,0
20150105.212553,2819.41,78,424192,-4,0,0,0,0,0
20150105.212554,2819.66,16,424208,10,0,0,0,0,0
20150105.212555,2820.03,330,424538,106,0,0,0,0,0
20150105.212556,2820.03,24,424562,-4,0,0,0,0,0
20150105.212557,2820.03,26,424588,18,0,0,0,0,0
20150105.212558,2820.03,406,424994,170,0,0,0,0,0
20150105.212559,2820.03,76,425070,36,0,0,0,0,0
20150105.2126,2820.03,100,425170,20,0,0,0,0,0
20150105.212601,2820.65,104,425274,104,0,0,0,0,0
20150105.212602,2820.65,34,425308,24,0,0,0,0,0
20150105.212603,2820.03,24,425332,-14,0,0,0,0,0
20150105.212604,2820.03,194,425526,156,0,0,0,0,0
20150105.212605,2820.03,126,425652,112,0,0,0,0,0
20150105.212606,2820.03,518,426170,398,0,0,0,0,0
20150105.212607,2820.03,198,426368,138,0,0,0,0,0
20150105.212608,2820.03,134,426502,68,0,0,0,0,0
20150105.212609,2820.03,4,426506,2,0,0,0,0,0
20150105.21261,2820.03,24,426530,2,0,0,0,0,0
20150105.212611,2820.03,24,426554,24,0,0,0,0,0
20150105.212612,2819.41,66,426620,60,0,0,0,0,0
20150105.212613,2819.41,44,426664,-16,0,0,0,0,0
20150105.212614,2820.03,10,426674,2,0,0,0,0,0
20150105.212615,2819.66,22,426696,18,0,0,0,0,0
20150105.212616,2820.03,6,426702,6,0,0,0,0,0
20150105.212617,2819.41,62,426764,56,0,0,0,0,0
20150105.212618,2819.41,4,426768,2,0,0,0,0,0
20150105.212619,2819.41,4,426772,4,0,0,0,0,0
20150105.21262,2820.03,192,426964,62,0,0,0,0,0
20150105.212621,2820.03,38,427002,16,0,0,0,0,0
20150105.212622,2820.03,80,427082,8,0,0,0,0,0
20150105.212623,2819.04,46,427128,-6,0,0,0,0,0
20150105.212624,2820.03,14,427142,0,0,0,0,0,0
20150105.212625,2819.41,14,427156,8,0,0,0,0,0
20150105.212626,2819.41,282,427438,64,0,0,0,0,0
20150105.212627,2819.78,70,427508,40,0,0,0,0,0
20150105.212628,2819.41,234,427742,70,0,0,0,0,0
20150105.212629,2820.03,74,427816,72,0,0,0,0,0
20150105.21263,2820.03,10,427826,10,0,0,0,0,0
20150105.212631,2820.03,146,427972,142,0,0,0,0,0
20150105.212632,2819.41,750,428722,2,0,0,0,0,0
20150105.212633,2819.78,38,428760,6,0,0,0,0,0
20150105.212634,2820.4,38,428798,34,0,0,0,0,0
20150105.212635,2820.4,38,428836,6,0,0,0,0,0
20150105.212636,2820.4,72,428908,30,0,0,0,0,0
20150105.212637,2819.78,54,428962,-30,0,0,0,0,0
20150105.212638,2820.4,116,429078,16,0,0,0,0,0
20150105.212639,2820.4,1134,430212,-40,0,0,0,0,0
20150105.21264,2820.4,152,430364,82,0,0,0,0,0
20150105.212641,2820.4,4,430368,2,0,0,0,0,0
20150105.212642,2820.03,98,430466,20,0,0,0,0,0
20150105.212643,2820.03,46,430512,0,0,0,0,0,0
20150105.212644,2820.03,290,430802,-36,0,0,0,0,0
20150105.212645,2820.03,306,431108,-100,0,0,0,0,0
20150105.212646,2819.78,40,431148,18,0,0,0,0,0
20150105.212647,2819.78,32,431180,24,0,0,0,0,0
20150105.212648,2820.03,244,431424,30,0,0,0,0,0
20150105.212649,2819.78,148,431572,-36,0,0,0,0,0
20150105.21265,2820.4,154,431726,-48,0,0,0,0,0
20150105.212651,2820.4,434,432160,326,0,0,0,0,0
20150105.212652,2819.78,32,432192,4,0,0,0,0,0
20150105.212653,2819.78,540,432732,-58,0,0,0,0,0
20150105.212654,2819.78,70,432802,10,0,0,0,0,0
20150105.212655,2820.4,18,432820,0,0,0,0,0,0
20150105.212656,2820.4,530,433350,-350,0,0,0,0,0
20150105.212657,2820.03,64,433414,40,0,0,0,0,0
20150105.212658,2819.78,20,433434,10,0,0,0,0,0
20150105.212659,2820.03,6,433440,0,0,0,0,0,0
20150105.2127,2820.4,4,433444,2,0,0,0,0,0
20150105.212701,2820.4,24,433468,4,0,0,0,0,0
20150105.212702,2820.4,6,433474,4,0,0,0,0,0
20150105.212703,2820.4,40,433514,22,0,0,0,0,0
20150105.212704,2819.41,506,434020,200,0,0,0,0,0
20150105.212705,2819.78,636,434656,-8,0,0,0,0,0
20150105.212706,2819.41,410,435066,138,0,0,0,0,0
20150105.212707,2820.03,414,435480,228,0,0,0,0,0
20150105.212708,2819.41,78,435558,38,0,0,0,0,0
20150105.212709,2819.41,164,435722,4,0,0,0,0,0
20150105.21271,2819.41,20,435742,8,0,0,0,0,0
20150105.212711,2820.03,14,435756,-10,0,0,0,0,0
20150105.212712,2820.03,26,435782,-16,0,0,0,0,0
20150105.212713,2819.66,30,435812,22,0,0,0,0,0
20150105.212714,2819.41,308,436120,178,0,0,0,0,0
20150105.212715,2819.41,66,436186,28,0,0,0,0,0
20150105.212716,2819.66,366,436552,40,0,0,0,0,0
20150105.212717,2819.41,186,436738,4,0,0,0,0,0
20150105.212718,2819.03,184,436922,-8,0,0,0,0,0
20150105.212719,2819.41,220,437142,94,0,0,0,0,0
20150105.21272,2819.41,214,437356,4,0,0,0,0,0
20150105.212721,2818.79,122,437478,18,0,0,0,0,0
20150105.212722,2819.03,378,437856,-70,0,0,0,0,0
20150105.212723,2819.41,94,437950,6,0,0,0,0,0
20150105.212724,2819.41,42,437992,28,0,0,0,0,0
20150105.212725,2819.41,14,438006,8,0,0,0,0,0
20150105.212726,2820.03,76,438082,10,0,0,0,0,0
20150105.212727,2819.41,120,438202,-38,0,0,0,0,0
20150105.212728,2819.41,44,438246,18,0,0,0,0,0
20150105.212729,2819.41,32,438278,24,0,0,0,0,0
20150105.21273,2820.03,10,438288,4,0,0,0,0,0
20150105.212731,2819.41,6,438294,4,0,0,0,0,0
20150105.212732,2819.65,6,438300,4,0,0,0,0,0
20150105.212733,2819.41,48,438348,12,0,0,0,0,0
20150105.212734,2820.03,110,438458,110,0,0,0,0,0
20150105.212735,2819.41,36,438494,12,0,0,0,0,0
20150105.212736,2820.03,18,438512,8,0,0,0,0,0
20150105.212737,2820.03,70,438582,18,0,0,0,0,0
20150105.212738,2820.03,406,438988,358,0,0,0,0,0
20150105.212739,2819.41,330,439318,226,0,0,0,0,0
20150105.21274,2819.41,376,439694,-142,0,0,0,0,0
20150105.212741,2819.41,224,439918,-20,0,0,0,0,0
20150105.212742,2819.41,28,439946,-2,0,0,0,0,0
20150105.212743,2818.79,34,439980,6,0,0,0,0,0
20150105.212744,2819.41,16,439996,-2,0,0,0,0,0
20150105.212745,2819.41,8,440004,2,0,0,0,0,0
20150105.212746,2820.4,386,440390,62,0,0,0,0,0
20150105.212747,2819.03,244,440634,196,0,0,0,0,0
20150105.212748,2819.41,90,440724,2,0,0,0,0,0
20150105.212749,2818.79,24,440748,-10,0,0,0,0,0
20150105.21275,2819.16,8,440756,4,0,0,0,0,0
20150105.212751,2819.78,202,440958,58,0,0,0,0,0
20150105.212752,2819.41,114,441072,104,0,0,0,0,0
20150105.212753,2819.41,16,441088,16,0,0,0,0,0
20150105.212754,2819.41,62,441150,60,0,0,0,0,0
20150105.212755,2819.41,8,441158,8,0,0,0,0,0
20150105.212756,2820.03,14,441172,14,0,0,0,0,0
20150105.212757,2819.41,30,441202,16,0,0,0,0,0
20150105.212758,2819.41,18,441220,16,0,0,0,0,0
20150105.212759,2819.41,172,441392,8,0,0,0,0,0
20150105.2128,2819.41,30,441422,-24,0,0,0,0,0
20150105.212801,2819.41,98,441520,66,0,0,0,0,0
20150105.212802,2819.41,24,441544,-12,0,0,0,0,0
20150105.212803,2820.03,218,441762,-26,0,0,0,0,0
20150105.212804,2819.78,22,441784,12,0,0,0,0,0
20150105.212805,2820.4,12,441796,6,0,0,0,0,0
20150105.212806,2819.78,90,441886,6,0,0,0,0,0
20150105.212807,2819.78,50,441936,50,0,0,0,0,0
20150105.212808,2819.78,10,441946,10,0,0,0,0,0
20150105.212809,2819.78,22,441968,22,0,0,0,0,0
20150105.21281,2820.03,76,442044,62,0,0,0,0,0
20150105.212811,2819.78,50,442094,44,0,0,0,0,0
20150105.212812,2820.4,50,442144,32,0,0,0,0,0
20150105.212813,2819.78,108,442252,104,0,0,0,0,0
20150105.212814,2820.4,22,442274,22,0,0,0,0,0
20150105.212815,2819.41,40,442314,28,0,0,0,0,0
20150105.212816,2820.4,32,442346,28,0,0,0,0,0
20150105.212817,2819.78,56,442402,-32,0,0,0,0,0
20150105.212818,2820.4,16,442418,-10,0,0,0,0,0
20150105.212819,2820.4,20,442438,18,0,0,0,0,0
20150105.21282,2819.78,6,442444,0,0,0,0,0,0
20150105.212821,2819.78,482,442926,134,0,0,0,0,0
20150105.212822,2819.78,68,442994,0,0,0,0,0,0
20150105.212823,2819.78,60,443054,60,0,0,0,0,0
20150105.212824,2819.78,24,443078,20,0,0,0,0,0
20150105.212825,2819.78,148,443226,30,0,0,0,0,0
20150105.212826,2819.78,80,443306,44,0,0,0,0,0
20150105.212827,2819.53,14,443320,12,0,0,0,0,0
20150105.212828,2819.16,8,443328,6,0,0,0,0,0
20150105.212829,2819.78,54,443382,24,0,0,0,0,0
20150105.21283,2819.16,10,443392,8,0,0,0,0,0
20150105.212831,2819.16,210,443602,2,0,0,0,0,0
20150105.212832,2819.16,24,443626,0,0,0,0,0,0
20150105.212833,2819.16,4,443630,2,0,0,0,0,0
20150105.212834,2819.78,44,443674,6,0,0,0,0,0
20150105.212835,2819.78,68,443742,68,0,0,0,0,0
20150105.212836,2819.78,414,444156,398,0,0,0,0,0
20150105.212837,2819.16,18,444174,18,0,0,0,0,0
20150105.212838,2819.78,8,444182,8,0,0,0,0,0
20150105.212839,2819.16,6,444188,4,0,0,0,0,0
20150105.21284,2819.16,8,444196,8,0,0,0,0,0
20150105.212841,2819.78,34,444230,34,0,0,0,0,0
20150105.212842,2819.78,128,444358,24,0,0,0,0,0
20150105.212843,2819.78,46,444404,44,0,0,0,0,0
20150105.212844,2819.16,12,444416,12,0,0,0,0,0
20150105.212845,2819.16,60,444476,38,0,0,0,0,0
20150105.212846,2819.16,10,444486,10,0,0,0,0,0
20150105.212847,2819.41,18,444504,14,0,0,0,0,0
20150105.212848,2819.78,90,444594,88,0,0,0,0,0
20150105.212849,2819.78,6,444600,4,0,0,0,0,0
20150105.21285,2819.78,14,444614,2,0,0,0,0,0
20150105.212851,2819.78,30,444644,30,0,0,0,0,0
20150105.212852,2819.78,94,444738,52,0,0,0,0,0
20150105.212853,2819.78,18,444756,18,0,0,0,0,0
20150105.212854,2819.78,238,444994,156,0,0,0,0,0
20150105.212855,2819.78,36,445030,4,0,0,0,0,0
20150105.212856,2818.79,272,445302,62,0,0,0,0,0
20150105.212857,2819.16,4,445306,0,0,0,0,0,0
20150105.212858,2819.16,6,445312,-4,0,0,0,0,0
20150105.212859,2819.78,160,445472,-100,0,0,0,0,0
20150105.2129,2819.16,180,445652,54,0,0,0,0,0
20150105.212901,2819.16,32,445684,6,0,0,0,0,0
20150105.212902,2819.78,18,445702,0,0,0,0,0,0
20150105.212903,2819.41,208,445910,0,0,0,0,0,0
20150105.212904,2819.16,52,445962,10,0,0,0,0,0
20150105.212905,2819.16,12,445974,0,0,0,0,0,0
20150105.212906,2819.16,6,445980,2,0,0,0,0,0
20150105.212907,2819.78,24,446004,4,0,0,0,0,0
20150105.212908,2819.16,26,446030,4,0,0,0,0,0
20150105.212909,2819.78,12,446042,10,0,0,0,0,0
20150105.21291,2819.78,6,446048,0,0,0,0,0,0
20150105.212911,2819.16,28,446076,6,0,0,0,0,0
20150105.212912,2819.78,516,446592,334,0,0,0,0,0
20150105.212913,2819.16,78,446670,44,0,0,0,0,0
20150105.212914,2819.16,22,446692,16,0,0,0,0,0
20150105.212915,2819.78,46,446738,24,0,0,0,0,0
20150105.212916,2819.78,6,446744,2,0,0,0,0,0
20150105.212917,2819.78,50,446794,30,0,0,0,0,0
20150105.212918,2819.16,56,446850,50,0,0,0,0,0
20150105.212919,2819.78,8,446858,0,0,0,0,0,0
20150105.21292,2820.15,36,446894,16,0,0,0,0,0
20150105.212921,2819.78,8,446902,0,0,0,0,0,0
20150105.212922,2819.16,8,446910,0,0,0,0,0,0
20150105.212923,2819.53,12,446922,0,0,0,0,0,0
20150105.212924,2819.16,244,447166,126,0,0,0,0,0
20150105.212925,2819.16,318,447484,292,0,0,0,0,0
20150105.212926,2819.16,14,447498,2,0,0,0,0,0
20150105.212927,2819.78,36,447534,18,0,0,0,0,0
20150105.212928,2819.16,16,447550,2,0,0,0,0,0
20150105.212929,2819.78,6,447556,4,0,0,0,0,0
20150105.21293,2819.16,36,447592,18,0,0,0,0,0
20150105.212931,2819.78,24,447616,14,0,0,0,0,0
20150105.212932,2819.78,444,448060,-62,0,0,0,0,0
20150105.212933,2819.78,100,448160,2,0,0,0,0,0
20150105.212934,2819.41,70,448230,48,0,0,0,0,0
20150105.212935,2819.78,4,448234,2,0,0,0,0,0
20150105.212936,2819.78,12,448246,2,0,0,0,0,0
20150105.212937,2819.16,22,448268,2,0,0,0,0,0
20150105.212938,2819.78,74,448342,34,0,0,0,0,0
20150105.212939,2820.15,12,448354,-6,0,0,0,0,0
20150105.21294,2819.78,12,448366,-2,0,0,0,0,0
20150105.212941,2820.15,82,448448,2,0,0,0,0,0
20150105.212942,2819.78,34,448482,12,0,0,0,0,0
20150105.212943,2819.53,42,448524,8,0,0,0,0,0
20150105.212944,2820.15,16,448540,-4,0,0,0,0,0
20150105.212945,2819.78,48,448588,-36,0,0,0,0,0
20150105.212946,2819.53,22,448610,-16,0,0,0,0,0
20150105.212947,2820.15,140,448750,32,0,0,0,0,0
20150105.212948,2819.53,4,448754,2,0,0,0,0,0
20150105.212949,2820.15,54,448808,50,0,0,0,0,0
20150105.21295,2819.53,432,449240,94,0,0,0,0,0
20150105.212951,2819.16,20,449260,2,0,0,0,0,0
20150105.212952,2819.16,50,449310,-20,0,0,0,0,0
20150105.212953,2819.16,14,449324,-8,0,0,0,0,0
20150105.212954,2819.16,66,449390,14,0,0,0,0,0
20150105.212955,2819.53,16,449406,4,0,0,0,0,0
20150105.212956,2819.78,128,449534,4,0,0,0,0,0
20150105.212957,2819.78,514,450048,400,0,0,0,0,0
20150105.212958,2819.53,226,450274,-6,0,0,0,0,0
20150105.212959,2820.15,146,450420,132,0,0,0,0,0
20150105.213,2819.16,26,450446,-8,0,0,0,0,0
20150105.213001,2820.15,6,450452,6,0,0,0,0,0
20150105.213002,2819.53,46,450498,22,0,0,0,0,0
20150105.213003,2819.53,136,450634,66,0,0,0,0,0
20150105.213004,2819.53,154,450788,-12,0,0,0,0,0
20150105.213005,2820.15,104,450892,102,0,0,0,0,0
20150105.213006,2819.9,56,450948,6,0,0,0,0,0
20150105.213007,2820.52,8,450956,2,0,0,0,0,0
20150105.213008,2820.52,20,450976,6,0,0,0,0,0
20150105.213009,2819.9,10,450986,2,0,0,0,0,0
20150105.21301,2820.15,8,450994,2,0,0,0,0,0
20150105.213011,2819.53,6,451000,-4,0,0,0,0,0
20150105.213012,2819.78,16,451016,6,0,0,0,0,0
20150105.213013,2819.53,34,451050,-2,0,0,0,0,0
20150105.213014,2819.53,12,451062,0,0,0,0,0,0
20150105.213015,2820.15,86,451148,-60,0,0,0,0,0
20150105.213016,2820.15,70,451218,2,0,0,0,0,0
20150105.213017,2819.53,60,451278,-6,0,0,0,0,0
20150105.213018,2820.15,590,451868,-94,0,0,0,0,0
20150105.213019,2820.15,24,451892,18,0,0,0,0,0
20150105.21302,2820.52,4,451896,2,0,0,0,0,0
20150105.213021,2819.53,206,452102,164,0,0,0,0,0
20150105.213022,2819.53,6,452108,-4,0,0,0,0,0
20150105.213023,2820.15,8,452116,-2,0,0,0,0,0
20150105.213024,2820.15,38,452154,-28,0,0,0,0,0
20150105.213025,2819.53,12,452166,10,0,0,0,0,0
20150105.213026,2820.15,64,452230,0,0,0,0,0,0
20150105.213027,2820.15,6,452236,-4,0,0,0,0,0
20150105.213028,2820.15,22,452258,-2,0,0,0,0,0
20150105.213029,2819.16,18,452276,14,0,0,0,0,0
20150105.21303,2819.53,6,452282,-2,0,0,0,0,0
20150105.213031,2819.78,24,452306,-2,0,0,0,0,0
20150105.213032,2820.15,36,452342,0,0,0,0,0,0
20150105.213033,2819.53,120,452462,70,0,0,0,0,0
20150105.213034,2820.15,112,452574,-48,0,0,0,0,0
20150105.213035,2819.16,638,453212,398,0,0,0,0,0
20150105.213036,2820.15,208,453420,134,0,0,0,0,0
20150105.213037,2820.15,6,453426,0,0,0,0,0,0
20150105.213038,2820.15,40,453466,-14,0,0,0,0,0
20150105.213039,2819.53,16,453482,-8,0,0,0,0,0
20150105.21304,2820.15,30,453512,2,0,0,0,0,0
20150105.213041,2819.53,1398,454910,426,0,0,0,0,0
20150105.213042,2819.9,8,454918,2,0,0,0,0,0
20150105.213043,2819.53,678,455596,586,0,0,0,0,0
20150105.213044,2819.53,104,455700,98,0,0,0,0,0
20150105.213045,2819.53,128,455828,34,0,0,0,0,0
20150105.213046,2820.15,26,455854,24,0,0,0,0,0
20150105.213047,2819.53,46,455900,40,0,0,0,0,0
20150105.213048,2820.15,80,455980,64,0,0,0,0,0
20150105.213049,2820.15,750,456730,-318,0,0,0,0,0
20150105.21305,2820.15,104,456834,104,0,0,0,0,0
20150105.213051,2821.14,8,456842,2,0,0,0,0,0
20150105.213052,2820.52,18,456860,6,0,0,0,0,0
20150105.213053,2820.15,4,456864,2,0,0,0,0,0
20150105.213054,2820.52,46,456910,38,0,0,0,0,0
20150105.213055,2820.52,46,456956,6,0,0,0,0,0
20150105.213056,2820.52,18,456974,8,0,0,0,0,0
20150105.213057,2820.52,4,456978,4,0,0,0,0,0
20150105.213058,2820.15,12,456990,10,0,0,0,0,0
20150105.213059,2820.52,48,457038,30,0,0,0,0,0
20150105.2131,2821.14,6,457044,2,0,0,0,0,0
20150105.213101,2820.52,44,457088,24,0,0,0,0,0
20150105.213102,2820.52,14,457102,-2,0,0,0,0,0
20150105.213103,2820.77,174,457276,58,0,0,0,0,0
20150105.213104,2821.14,146,457422,-62,0,0,0,0,0
20150105.213105,2820.15,190,457612,178,0,0,0,0,0
20150105.213106,2820.77,504,458116,224,0,0,0,0,0
20150105.213107,2820.77,226,458342,72,0,0,0,0,0
20150105.213108,2820.77,340,458682,110,0,0,0,0,0
20150105.213109,2820.4,48,458730,38,0,0,0,0,0
20150105.21311,2820.77,82,458812,-2,0,0,0,0,0
20150105.213111,2820.15,22,458834,8,0,0,0,0,0
20150105.213112,2820.77,12,458846,-2,0,0,0,0,0
20150105.213113,2820.4,222,459068,108,0,0,0,0,0
20150105.213114,2820.77,26,459094,-20,0,0,0,0,0
20150105.213115,2820.4,204,459298,72,0,0,0,0,0
20150105.213116,2820.77,22,459320,2,0,0,0,0,0
20150105.213117,2820.77,14,459334,10,0,0,0,0,0
20150105.213118,2820.4,28,459362,8,0,0,0,0,0
20150105.213119,2820.77,10,459372,8,0,0,0,0,0
20150105.21312,2820.4,4,459376,0,0,0,0,0,0
20150105.213121,2820.4,50,459426,2,0,0,0,0,0
20150105.213122,2820.77,132,459558,40,0,0,0,0,0
20150105.213123,2820.77,120,459678,-26,0,0,0,0,0
20150105.213124,2820.4,6,459684,4,0,0,0,0,0
20150105.213125,2820.4,428,460112,26,0,0,0,0,0
20150105.213126,2820.4,22,460134,20,0,0,0,0,0
20150105.213127,2820.4,72,460206,70,0,0,0,0,0
20150105.213128,2820.77,14,460220,10,0,0,0,0,0
20150105.213129,2820.4,56,460276,34,0,0,0,0,0
20150105.21313,2820.77,20,460296,8,0,0,0,0,0
20150105.213131,2820.77,22,460318,18,0,0,0,0,0
20150105.213132,2820.4,272,460590,78,0,0,0,0,0
20150105.213133,2820.77,558,461148,262,0,0,0,0,0
20150105.213134,2820.77,26,461174,-2,0,0,0,0,0
20150105.213135,2821.02,34,461208,0,0,0,0,0,0
20150105.213136,2820.77,12,461220,-4,0,0,0,0,0
20150105.213137,2820.4,4,461224,-2,0,0,0,0,0
20150105.213138,2821.39,28,461252,24,0,0,0,0,0
20150105.213139,2821.39,14,461266,10,0,0,0,0,0
20150105.21314,2820.4,182,461448,-4,0,0,0,0,0
20150105.213141,2821.02,236,461684,-28,0,0,0,0,0
20150105.213142,2821.02,4,461688,0,0,0,0,0,0
20150105.213143,2821.02,26,461714,12,0,0,0,0,0
20150105.213144,2821.02,144,461858,106,0,0,0,0,0
20150105.213145,2821.39,202,462060,-2,0,0,0,0,0
20150105.213146,2821.39,20,462080,4,0,0,0,0,0
20150105.213147,2821.39,44,462124,14,0,0,0,0,0
20150105.213148,2821.39,54,462178,48,0,0,0,0,0
20150105.213149,2821.02,94,462272,74,0,0,0,0,0
20150105.21315,2821.39,86,462358,-14,0,0,0,0,0
20150105.213151,2820.77,18,462376,4,0,0,0,0,0
20150105.213152,2821.02,22,462398,-2,0,0,0,0,0
20150105.213153,2821.39,68,462466,0,0,0,0,0,0
20150105.213154,2821.39,22,462488,-2,0,0,0,0,0
20150105.213155,2820.77,10,462498,0,0,0,0,0,0
20150105.213156,2821.02,20,462518,4,0,0,0,0,0
20150105.213157,2821.39,6,462524,-2,0,0,0,0,0
20150105.213158,2821.02,518,463042,146,0,0,0,0,0
20150105.213159,2821.39,76,463118,6,0,0,0,0,0
20150105.2132,2821.02,38,463156,32,0,0,0,0,0
20150105.213201,2821.02,18,463174,6,0,0,0,0,0
20150105.213202,2821.39,38,463212,16,0,0,0,0,0
20150105.213203,2821.02,250,463462,242,0,0,0,0,0
20150105.213204,2821.02,660,464122,298,0,0,0,0,0
20150105.213205,2821.02,126,464248,84,0,0,0,0,0
20150105.213206,2821.02,4,464252,4,0,0,0,0,0
20150105.213207,2821.64,24,464276,16,0,0,0,0,0
20150105.213208,2820.64,6,464282,0,0,0,0,0,0
20150105.213209,2821.64,106,464388,30,0,0,0,0,0
20150105.21321,2820.64,24,464412,8,0,0,0,0,0
20150105.213211,2821.26,4,464416,0,0,0,0,0,0
20150105.213212,2820.64,36,464452,36,0,0,0,0,0
20150105.213213,2821.02,8,464460,8,0,0,0,0,0
20150105.213214,2821.26,8,464468,4,0,0,0,0,0
20150105.213215,2821.64,10,464478,10,0,0,0,0,0
20150105.213216,2820.64,20,464498,10,0,0,0,0,0
20150105.213217,2821.64,4,464502,2,0,0,0,0,0
20150105.213218,2821.26,404,464906,100,0,0,0,0,0
20150105.213219,2820.64,208,465114,170,0,0,0,0,0
20150105.21322,2821.26,74,465188,44,0,0,0,0,0
20150105.213221,2820.64,4,465192,2,0,0,0,0,0
20150105.213222,2821.26,24,465216,14,0,0,0,0,0
20150105.213223,2821.26,102,465318,8,0,0,0,0,0
20150105.213224,2820.64,24,465342,18,0,0,0,0,0
20150105.213225,2821.26,16,465358,0,0,0,0,0,0
20150105.213226,2820.89,10,465368,4,0,0,0,0,0
20150105.213227,2820.89,64,465432,-14,0,0,0,0,0
20150105.213228,2821.26,940,466372,20,0,0,0,0,0
20150105.213229,2821.26,62,466434,10,0,0,0,0,0
20150105.21323,2821.26,26,466460,18,0,0,0,0,0
20150105.213231,2820.89,462,466922,380,0,0,0,0,0
20150105.213232,2821.26,8,466930,-4,0,0,0,0,0
20150105.213233,2821.26,18,466948,-4,0,0,0,0,0
20150105.213234,2821.26,6,466954,-2,0,0,0,0,0
20150105.213235,2821.26,12,466966,0,0,0,0,0,0
20150105.213236,2821.26,10,466976,0,0,0,0,0,0
20150105.213237,2821.26,112,467088,0,0,0,0,0,0
20150105.213238,2820.64,8,467096,0,0,0,0,0,0
20150105.213239,2821.26,12,467108,0,0,0,0,0,0
20150105.21324,2821.26,6,467114,-4,0,0,0,0,0
20150105.213241,2821.26,6,467120,-4,0,0,0,0,0
20150105.213242,2820.89,8,467128,0,0,0,0,0,0
20150105.213243,2820.89,12,467140,0,0,0,0,0,0
20150105.213244,2821.26,120,467260,-42,0,0,0,0,0
20150105.213245,2820.27,974,468234,-102,0,0,0,0,0
20150105.213246,2820.27,220,468454,136,0,0,0,0,0
20150105.213247,2820.89,88,468542,-4,0,0,0,0,0
20150105.213248,2820.89,128,468670,-86,0,0,0,0,0
20150105.213249,2820.89,64,468734,4,0,0,0,0,0
20150105.21325,2820.89,10,468744,0,0,0,0,0,0
20150105.213251,2820.27,56,468800,-14,0,0,0,0,0
20150105.213252,2820.89,90,468890,-70,0,0,0,0,0
20150105.213253,2820.27,988,469878,-40,0,0,0,0,0
20150105.213254,2820.27,12,469890,-4,0,0,0,0,0
20150105.213255,2820.52,320,470210,192,0,0,0,0,0
20150105.213256,2820.89,24,470234,12,0,0,0,0,0
20150105.213257,2819.9,10,470244,2,0,0,0,0,0
20150105.213258,2820.27,4,470248,0,0,0,0,0,0
20150105.213259,2819.9,10,470258,8,0,0,0,0,0
20150105.2133,2819.9,510,470768,344,0,0,0,0,0
20150105.213301,2819.9,30,470798,2,0,0,0,0,0
20150105.213302,2820.89,34,470832,22,0,0,0,0,0
20150105.213303,2819.9,44,470876,40,0,0,0,0,0
20150105.213304,2819.9,82,470958,22,0,0,0,0,0
20150105.213305,2820.27,12,470970,10,0,0,0,0,0
20150105.213306,2820.27,22,470992,-2,0,0,0,0,0
20150105.213307,2820.27,24,471016,4,0,0,0,0,0
20150105.213308,2819.9,8,471024,2,0,0,0,0,0
20150105.213309,2820.52,22,471046,18,0,0,0,0,0
20150105.21331,2819.9,6,471052,4,0,0,0,0,0
20150105.213311,2820.27,8,471060,2,0,0,0,0,0
20150105.213312,2820.89,16,471076,12,0,0,0,0,0
20150105.213313,2820.52,40,471116,-10,0,0,0,0,0
20150105.213314,2819.9,192,471308,112,0,0,0,0,0
20150105.213315,2820.27,288,471596,18,0,0,0,0,0
20150105.213316,2820.89,14,471610,6,0,0,0,0,0
20150105.213317,2820.89,4,471614,2,0,0,0,0,0
20150105.213318,2819.9,14,471628,10,0,0,0,0,0
20150105.213319,2820.89,6,471634,2,0,0,0,0,0
20150105.21332,2820.89,8,471642,2,0,0,0,0,0
20150105.213321,2820.27,82,471724,40,0,0,0,0,0
20150105.213322,2820.89,632,472356,-462,0,0,0,0,0
20150105.213323,2821.26,14,472370,-4,0,0,0,0,0
20150105.213324,2820.89,12,472382,12,0,0,0,0,0
20150105.213325,2820.89,14,472396,14,0,0,0,0,0
20150105.213326,2820.89,266,472662,226,0,0,0,0,0
20150105.213327,2820.89,126,472788,124,0,0,0,0,0
20150105.213328,2820.27,10,472798,10,0,0,0,0,0
20150105.213329,2820.89,76,472874,10,0,0,0,0,0
20150105.21333,2821.26,634,473508,88,0,0,0,0,0
20150105.213331,2820.89,12,473520,2,0,0,0,0,0
20150105.213332,2820.89,22,473542,20,0,0,0,0,0
20150105.213333,2820.89,66,473608,56,0,0,0,0,0
20150105.213334,2820.89,58,473666,22,0,0,0,0,0
20150105.213335,2820.89,184,473850,118,0,0,0,0,0
20150105.213336,2820.27,836,474686,-206,0,0,0,0,0
20150105.213337,2820.89,330,475016,214,0,0,0,0,0
20150105.213338,2820.27,334,475350,6,0,0,0,0,0
20150105.213339,2819.65,98,475448,-4,0,0,0,0,0
20150105.21334,2820.27,20,475468,-8,0,0,0,0,0
20150105.213341,2820.27,142,475610,100,0,0,0,0,0
20150105.213342,2820.27,14,475624,2,0,0,0,0,0
20150105.213343,2820.27,48,475672,22,0,0,0,0,0
20150105.213344,2820.27,4,475676,2,0,0,0,0,0
20150105.213345,2820.27,6,475682,2,0,0,0,0,0
20150105.213346,2820.27,4,475686,2,0,0,0,0,0
20150105.213347,2820.27,12,475698,0,0,0,0,0,0
20150105.213348,2820.27,144,475842,104,0,0,0,0,0
20150105.213349,2819.9,112,475954,-2,0,0,0,0,0
20150105.21335,2820.27,28,475982,12,0,0,0,0,0
20150105.213351,2820.27,32,476014,4,0,0,0,0,0
20150105.213352,2820.27,28,476042,2,0,0,0,0,0
20150105.213353,2820.27,6,476048,2,0,0,0,0,0
20150105.213354,2820.27,8,476056,0,0,0,0,0,0
20150105.213355,2819.9,6,476062,0,0,0,0,0,0
20150105.213356,2820.27,346,476408,278,0,0,0,0,0
20150105.213357,2820.27,52,476460,0,0,0,0,0,0
20150105.213358,2819.65,74,476534,74,0,0,0,0,0
20150105.213359,2820.27,6,476540,0,0,0,0,0,0
20150105.2134,2820.27,602,477142,472,0,0,0,0,0
20150105.213401,2820.27,42,477184,-40,0,0,0,0,0
20150105.213402,2820.27,176,477360,-26,0,0,0,0,0
20150105.213403,2819.9,4,477364,0,0,0,0,0,0
20150105.213404,2820.27,6,477370,0,0,0,0,0,0
20150105.213405,2819.9,212,477582,6,0,0,0,0,0
20150105.213406,2820.27,4,477586,2,0,0,0,0,0
20150105.213407,2819.9,44,477630,-36,0,0,0,0,0
20150105.213408,2819.9,116,477746,12,0,0,0,0,0
20150105.213409,2820.27,170,477916,-152,0,0,0,0,0
20150105.21341,2820.27,14,477930,8,0,0,0,0,0
20150105.213411,2819.9,72,478002,-6,0,0,0,0,0
20150105.213412,2820.27,122,478124,-94,0,0,0,0,0
20150105.213413,2820.27,16,478140,-2,0,0,0,0,0
20150105.213414,2819.9,328,478468,-100,0,0,0,0,0
20150105.213415,2819.28,162,478630,-120,0,0,0,0,0
20150105.213416,2819.9,228,478858,160,0,0,0,0,0
20150105.213417,2819.89,38,478896,-6,0,0,0,0,0
20150105.213418,2819.52,406,479302,-400,0,0,0,0,0
20150105.213419,2819.89,200,479502,44,0,0,0,0,0
20150105.21342,2820.14,8,479510,2,0,0,0,0,0
20150105.213421,2819.52,4,479514,2,0,0,0,0,0
20150105.213422,2819.52,202,479716,-100,0,0,0,0,0
20150105.213423,2820.14,20,479736,10,0,0,0,0,0
20150105.213424,2820.14,8,479744,0,0,0,0,0,0
20150105.213425,2819.52,42,479786,36,0,0,0,0,0
20150105.213426,2820.51,54,479840,10,0,0,0,0,0
20150105.213427,2819.89,44,479884,-36,0,0,0,0,0
20150105.213428,2819.28,2004,481888,1430,0,0,0,0,0
20150105.213429,2819.9,230,482118,-10,0,0,0,0,0
20150105.21343,2819.28,134,482252,-20,0,0,0,0,0
20150105.213431,2819.9,124,482376,100,0,0,0,0,0
20150105.213432,2819.28,98,482474,16,0,0,0,0,0
20150105.213433,2819.28,42,482516,-40,0,0,0,0,0
20150105.213434,2818.9,12,482528,12,0,0,0,0,0
20150105.213435,2819.28,26,482554,24,0,0,0,0,0
20150105.213436,2818.9,66,482620,54,0,0,0,0,0
20150105.213437,2819.28,70,482690,-2,0,0,0,0,0
20150105.213438,2819.28,28,482718,-20,0,0,0,0,0
20150105.213439,2818.66,12,482730,2,0,0,0,0,0
20150105.21344,2819.28,12,482742,0,0,0,0,0,0
20150105.213441,2818.9,28,482770,20,0,0,0,0,0
20150105.213442,2819.28,28,482798,10,0,0,0,0,0
20150105.213443,2819.28,288,483086,14,0,0,0,0,0
20150105.213444,2819.28,40,483126,20,0,0,0,0,0
20150105.213445,2819.9,356,483482,-270,0,0,0,0,0
20150105.213446,2819.9,58,483540,-26,0,0,0,0,0
20150105.213447,2819.9,12,483552,-8,0,0,0,0,0
20150105.213448,2819.9,416,483968,134,0,0,0,0,0
20150105.213449,2819.9,12,483980,2,0,0,0,0,0
20150105.21345,2819.9,224,484204,124,0,0,0,0,0
20150105.213451,2819.9,4,484208,-2,0,0,0,0,0
20150105.213452,2820.89,610,484818,-70,0,0,0,0,0
20150105.213453,2820.27,244,485062,4,0,0,0,0,0
20150105.213454,2820.89,176,485238,-78,0,0,0,0,0
20150105.213455,2820.27,114,485352,78,0,0,0,0,0
20150105.213456,2820.89,60,485412,4,0,0,0,0,0
20150105.213457,2820.27,430,485842,142,0,0,0,0,0
20150105.213458,2820.64,174,486016,42,0,0,0,0,0
20150105.213459,2820.64,4,486020,2,0,0,0,0,0
20150105.2135,2821.26,210,486230,-14,0,0,0,0,0
20150105.213501,2820.89,18,486248,-12,0,0,0,0,0
20150105.213502,2821.26,200,486448,-46,0,0,0,0,0
20150105.213503,2820.89,170,486618,-2,0,0,0,0,0
20150105.213504,2821.26,26,486644,-4,0,0,0,0,0
20150105.213505,2821.26,38,486682,-22,0,0,0,0,0
20150105.213506,2821.26,16,486698,8,0,0,0,0,0
20150105.213507,2821.26,166,486864,66,0,0,0,0,0
20150105.213508,2821.26,258,487122,64,0,0,0,0,0
20150105.213509,2820.89,526,487648,-14,0,0,0,0,0
20150105.21351,2820.64,12,487660,10,0,0,0,0,0
20150105.213511,2821.26,4,487664,4,0,0,0,0,0
20150105.213512,2820.89,22,487686,2,0,0,0,0,0
20150105.213513,2821.26,4,487690,4,0,0,0,0,0
20150105.213514,2820.89,10,487700,4,0,0,0,0,0
20150105.213515,2820.89,152,487852,78,0,0,0,0,0
20150105.213516,2820.27,70,487922,6,0,0,0,0,0
20150105.213517,2820.89,236,488158,234,0,0,0,0,0
20150105.213518,2820.89,18,488176,18,0,0,0,0,0
20150105.213519,2820.27,10,488186,8,0,0,0,0,0
20150105.21352,2820.89,6,488192,6,0,0,0,0,0
20150105.213521,2820.27,18,488210,2,0,0,0,0,0
20150105.213522,2820.89,22,488232,22,0,0,0,0,0
20150105.213523,2820.27,44,488276,4,0,0,0,0,0
20150105.213524,2820.27,60,488336,20,0,0,0,0,0
20150105.213525,2820.89,114,488450,16,0,0,0,0,0
20150105.213526,2820.89,232,488682,4,0,0,0,0,0
20150105.213527,2820.27,268,488950,28,0,0,0,0,0
20150105.213528,2820.27,132,489082,54,0,0,0,0,0
20150105.213529,2821.26,12,489094,12,0,0,0,0,0
20150105.21353,2820.89,110,489204,2,0,0,0,0,0
20150105.213531,2820.89,6,489210,0,0,0,0,0,0
20150105.213532,2820.64,4,489214,2,0,0,0,0,0
20150105.213533,2820.27,620,489834,600,0,0,0,0,0
20150105.213534,2821.26,30,489864,20,0,0,0,0,0
20150105.213535,2820.64,264,490128,4,0,0,0,0,0
20150105.213536,2820.64,64,490192,42,0,0,0,0,0
20150105.213537,2820.27,354,490546,252,0,0,0,0,0
20150105.213538,2820.27,204,490750,202,0,0,0,0,0
20150105.213539,2820.27,134,490884,14,0,0,0,0,0
20150105.21354,2820.27,18,490902,18,0,0,0,0,0
20150105.213541,2820.52,102,491004,62,0,0,0,0,0
20150105.213542,2819.9,308,491312,304,0,0,0,0,0
20150105.213543,2819.52,150,491462,122,0,0,0,0,0
20150105.213544,2820.52,172,491634,112,0,0,0,0,0
20150105.213545,2819.9,112,491746,-34,0,0,0,0,0
20150105.213546,2820.52,40,491786,22,0,0,0,0,0
20150105.213547,2819.9,12,491798,-6,0,0,0,0,0
20150105.213548,2819.9,728,492526,510,0,0,0,0,0
20150105.213549,2820.27,56,492582,0,0,0,0,0,0
20150105.21355,2820.27,14,492596,2,0,0,0,0,0
20150105.213551,2819.65,28,492624,2,0,0,0,0,0
20150105.213552,2819.9,118,492742,84,0,0,0,0,0
20150105.213553,2819.9,20,492762,-2,0,0,0,0,0
20150105.213554,2819.9,14,492776,10,0,0,0,0,0
20150105.213555,2819.9,6,492782,2,0,0,0,0,0
20150105.213556,2819.9,36,492818,10,0,0,0,0,0
20150105.213557,2819.28,454,493272,-78,0,0,0,0,0
20150105.213558,2819.9,16,493288,0,0,0,0,0,0
20150105.213559,2819.28,204,493492,-38,0,0,0,0,0
20150105.2136,2819.9,10,493502,2,0,0,0,0,0
20150105.213601,2819.52,46,493548,-28,0,0,0,0,0
20150105.213602,2819.9,4,493552,2,0,0,0,0,0
20150105.213603,2819.9,54,493606,38,0,0,0,0,0
20150105.213604,2819.28,106,493712,44,0,0,0,0,0
20150105.213605,2819.9,4,493716,2,0,0,0,0,0
20150105.213606,2820.27,14,493730,-2,0,0,0,0,0
20150105.213607,2819.9,14,493744,0,0,0,0,0,0
20150105.213608,2819.9,4,493748,2,0,0,0,0,0
20150105.213609,2819.9,204,493952,30,0,0,0,0,0
20150105.21361,2819.9,32,493984,0,0,0,0,0,0
20150105.213611,2819.28,14,493998,10,0,0,0,0,0
20150105.213612,2820.27,32,494030,4,0,0,0,0,0
20150105.213613,2819.65,16,494046,6,0,0,0,0,0
20150105.213614,2819.28,22,494068,0,0,0,0,0,0
20150105.213615,2819.65,50,494118,40,0,0,0,0,0
20150105.213616,2819.65,22,494140,14,0,0,0,0,0
20150105.213617,2819.28,420,494560,0,0,0,0,0,0
20150105.213618,2819.65,34,494594,-18,0,0,0,0,0
20150105.213619,2819.28,52,494646,42,0,0,0,0,0
20150105.21362,2819.65,36,494682,0,0,0,0,0,0
20150105.213621,2819.65,40,494722,-18,0,0,0,0,0
20150105.213622,2819.65,16,494738,6,0,0,0,0,0
20150105.213623,2819.65,12,494750,2,0,0,0,0,0
20150105.213624,2819.65,12,494762,6,0,0,0,0,0
20150105.213625,2819.9,34,494796,16,0,0,0,0,0
20150105.213626,2819.65,12,494808,2,0,0,0,0,0
20150105.213627,2819.65,22,494830,10,0,0,0,0,0
20150105.213628,2819.65,110,494940,0,0,0,0,0,0
20150105.213629,2819.65,24,494964,6,0,0,0,0,0
20150105.21363,2819.65,94,495058,2,0,0,0,0,0
20150105.213631,2819.65,286,495344,170,0,0,0,0,0
20150105.213632,2819.65,668,496012,38,0,0,0,0,0
20150105.213633,2819.65,22,496034,-2,0,0,0,0,0
20150105.213634,2819.65,28,496062,0,0,0,0,0,0
20150105.213635,2819.65,10,496072,2,0,0,0,0,0
20150105.213636,2820.27,4,496076,2,0,0,0,0,0
20150105.213637,2819.65,238,496314,32,0,0,0,0,0
20150105.213638,2820.27,4,496318,2,0,0,0,0,0
20150105.213639,2819.89,772,497090,658,0,0,0,0,0
20150105.21364,2820.27,104,497194,2,0,0,0,0,0
20150105.213641,2820.27,4,497198,0,0,0,0,0,0
20150105.213642,2819.89,106,497304,2,0,0,0,0,0
20150105.213643,2819.65,48,497352,16,0,0,0,0,0
20150105.213644,2820.27,14,497366,0,0,0,0,0,0
20150105.213645,2819.65,14,497380,0,0,0,0,0,0
20150105.213646,2820.27,178,497558,-68,0,0,0,0,0
20150105.213647,2820.64,4,497562,2,0,0,0,0,0
20150105.213648,2820.02,52,497614,6,0,0,0,0,0
20150105.213649,2819.27,104,497718,0,0,0,0,0,0
20150105.21365,2820.27,22,497740,-20,0,0,0,0,0
20150105.213651,2820.27,4,497744,0,0,0,0,0,0
20150105.213652,2819.65,76,497820,-70,0,0,0,0,0
20150105.213653,2820.27,532,498352,380,0,0,0,0,0
20150105.213654,2820.27,166,498518,160,0,0,0,0,0
20150105.213655,2820.27,20,498538,14,0,0,0,0,0
20150105.213656,2820.27,26,498564,10,0,0,0,0,0
20150105.213657,2819.65,8,498572,6,0,0,0,0,0
20150105.213658,2820.27,6,498578,4,0,0,0,0,0
20150105.213659,2819.65,8,498586,2,0,0,0,0,0
20150105.2137,2820.27,4,498590,2,0,0,0,0,0
20150105.213701,2820.27,6,498596,0,0,0,0,0,0
20150105.213702,2820.27,6,498602,2,0,0,0,0,0
20150105.213703,2820.27,4,498606,2,0,0,0,0,0
20150105.213704,2820.27,22,498628,20,0,0,0,0,0
20150105.213705,2819.65,4,498632,2,0,0,0,0,0
20150105.213706,2820.27,16,498648,2,0,0,0,0,0
20150105.213707,2819.65,4,498652,0,0,0,0,0,0
20150105.213708,2820.27,34,498686,-22,0,0,0,0,0
20150105.213709,2819.9,206,498892,76,0,0,0,0,0
20150105.21371,2820.64,492,499384,12,0,0,0,0,0
20150105.213711,2819.65,24,499408,2,0,0,0,0,0
20150105.213712,2819.65,4,499412,2,0,0,0,0,0
20150105.213713,2819.65,104,499516,104,0,0,0,0,0
20150105.213714,2819.65,48,499564,48,0,0,0,0,0
20150105.213715,2820.64,6,499570,6,0,0,0,0,0
20150105.213716,2820.02,32,499602,20,0,0,0,0,0
20150105.213717,2819.65,40,499642,34,0,0,0,0,0
20150105.213718,2820.27,160,499802,160,0,0,0,0,0
20150105.213719,2819.65,6,499808,0,0,0,0,0,0
20150105.21372,2820.64,122,499930,64,0,0,0,0,0
20150105.213721,2819.65,102,500032,64,0,0,0,0,0
20150105.213722,2820.27,6,500038,6,0,0,0,0,0
20150105.213723,2820.27,22,500060,22,0,0,0,0,0
20150105.213724,2820.27,12,500072,10,0,0,0,0,0
20150105.213725,2819.65,16,500088,0,0,0,0,0,0
20150105.213726,2820.27,122,500210,-34,0,0,0,0,0
20150105.213727,2820.64,120,500330,6,0,0,0,0,0
20150105.213728,2820.02,52,500382,50,0,0,0,0,0
20150105.213729,2820.64,190,500572,150,0,0,0,0,0
20150105.21373,2820.64,10,500582,10,0,0,0,0,0
20150105.213731,2820.64,32,500614,30,0,0,0,0,0
20150105.213732,2820.64,104,500718,0,0,0,0,0,0
20150105.213733,2820.02,6,500724,2,0,0,0,0,0
20150105.213734,2820.64,12,500736,12,0,0,0,0,0
20150105.213735,2819.65,202,500938,52,0,0,0,0,0
20150105.213736,2820.64,12,500950,2,0,0,0,0,0
20150105.213737,2820.64,1590,502540,-782,0,0,0,0,0
20150105.213738,2820.27,150,502690,-8,0,0,0,0,0
20150105.213739,2820.64,34,502724,8,0,0,0,0,0
20150105.21374,2820.27,14,502738,-6,0,0,0,0,0
20150105.213741,2820.89,56,502794,-40,0,0,0,0,0
20150105.213742,2820.64,6,502800,2,0,0,0,0,0
20150105.213743,2821.26,24,502824,22,0,0,0,0,0
20150105.213744,2820.64,10,502834,10,0,0,0,0,0
20150105.213745,2820.64,4,502838,4,0,0,0,0,0
20150105.213746,2820.27,22,502860,-20,0,0,0,0,0
20150105.213747,2820.64,6,502866,6,0,0,0,0,0
20150105.213748,2820.27,4,502870,0,0,0,0,0,0
20150105.213749,2820.64,12,502882,4,0,0,0,0,0
20150105.21375,2820.27,16,502898,-4,0,0,0,0,0
20150105.213751,2820.64,14,502912,10,0,0,0,0,0
20150105.213752,2821.26,1038,503950,884,0,0,0,0,0
20150105.213753,2820.64,552,504502,538,0,0,0,0,0
20150105.213754,2820.64,14,504516,12,0,0,0,0,0
20150105.213755,2821.26,34,504550,26,0,0,0,0,0
20150105.213756,2820.64,54,504604,28,0,0,0,0,0
20150105.213757,2820.88,762,505366,400,0,0,0,0,0
20150105.213758,2820.88,342,505708,80,0,0,0,0,0
20150105.213759,2821.26,50,505758,26,0,0,0,0,0
20150105.2138,2820.26,18,505776,-16,0,0,0,0,0
20150105.213801,2820.88,342,506118,242,0,0,0,0,0
20150105.213802,2820.88,66,506184,62,0,0,0,0,0
20150105.213803,2820.26,16,506200,0,0,0,0,0,0
20150105.213804,2820.88,6,506206,4,0,0,0,0,0
20150105.213805,2819.89,20,506226,-16,0,0,0,0,0
20150105.213806,2820.26,34,506260,-2,0,0,0,0,0
20150105.213807,2820.51,10,506270,8,0,0,0,0,0
20150105.213808,2820.26,6,506276,4,0,0,0,0,0
20150105.213809,2820.88,210,506486,206,0,0,0,0,0
20150105.21381,2820.88,34,506520,30,0,0,0,0,0
20150105.213811,2820.88,30,506550,20,0,0,0,0,0
20150105.213812,2820.51,38,506588,0,0,0,0,0,0
20150105.213813,2821.26,12,506600,12,0,0,0,0,0
20150105.213814,2820.88,26,506626,0,0,0,0,0,0
20150105.213815,2819.89,6,506632,-2,0,0,0,0,0
20150105.213816,2820.51,4,506636,2,0,0,0,0,0
20150105.213817,2820.64,1002,507638,552,0,0,0,0,0
20150105.213818,2821.25,28,507666,14,0,0,0,0,0
20150105.213819,2820.63,46,507712,20,0,0,0,0,0
20150105.21382,2820.63,10,507722,-4,0,0,0,0,0
20150105.213821,2820.88,20,507742,-2,0,0,0,0,0
20150105.213822,2820.26,42,507784,0,0,0,0,0,0
20150105.213823,2821.25,36,507820,0,0,0,0,0,0
20150105.213824,2821.25,28,507848,-2,0,0,0,0,0
20150105.213825,2821.25,4,507852,2,0,0,0,0,0
20150105.213826,2820.63,20,507872,12,0,0,0,0,0
20150105.213827,2821.25,24,507896,18,0,0,0,0,0
20150105.213828,2821.25,12,507908,12,0,0,0,0,0
20150105.213829,2821.25,24,507932,-2,0,0,0,0,0
20150105.21383,2820.63,4,507936,2,0,0,0,0,0
20150105.213831,2821.25,8,507944,4,0,0,0,0,0
20150105.213832,2821.25,4,507948,4,0,0,0,0,0
20150105.213833,2821.25,14,507962,8,0,0,0,0,0
20150105.213834,2820.63,12,507974,2,0,0,0,0,0
20150105.213835,2820.64,44,508018,42,0,0,0,0,0
20150105.213836,2821.25,24,508042,12,0,0,0,0,0
20150105.213837,2821.25,22,508064,22,0,0,0,0,0
20150105.213838,2821.25,30,508094,4,0,0,0,0,0
20150105.213839,2820.63,6,508100,4,0,0,0,0,0
20150105.21384,2820.63,8,508108,0,0,0,0,0,0
20150105.213841,2820.63,48,508156,-2,0,0,0,0,0
20150105.213842,2821.25,220,508376,130,0,0,0,0,0
20150105.213843,2820.64,24,508400,2,0,0,0,0,0
20150105.213844,2821.25,26,508426,-18,0,0,0,0,0
20150105.213845,2820.63,6,508432,4,0,0,0,0,0
20150105.213846,2820.63,804,509236,-238,0,0,0,0,0
20150105.213847,2820.26,236,509472,64,0,0,0,0,0
20150105.213848,2820.63,22,509494,0,0,0,0,0,0
20150105.213849,2820.63,12,509506,2,0,0,0,0,0
20150105.21385,2820.63,22,509528,20,0,0,0,0,0
20150105.213851,2820.63,58,509586,-2,0,0,0,0,0
20150105.213852,2820.02,12,509598,-8,0,0,0,0,0
20150105.213853,2820.63,58,509656,-56,0,0,0,0,0
20150105.213854,2820.63,52,509708,24,0,0,0,0,0
20150105.213855,2820.63,28,509736,16,0,0,0,0,0
20150105.213856,2820.63,32,509768,10,0,0,0,0,0
20150105.213857,2820.63,20,509788,8,0,0,0,0,0
20150105.213858,2820.63,8,509796,4,0,0,0,0,0
20150105.213859,2820.63,6,509802,0,0,0,0,0,0
20150105.2139,2820.64,38,509840,-2,0,0,0,0,0
20150105.213901,2821.01,244,510084,70,0,0,0,0,0
20150105.213902,2821.01,44,510128,-4,0,0,0,0,0
20150105.213903,2820.02,4,510132,-2,0,0,0,0,0
20150105.213904,2820.63,22,510154,0,0,0,0,0,0
20150105.213905,2821.01,22,510176,14,0,0,0,0,0
20150105.213906,2820.39,4,510180,0,0,0,0,0,0
20150105.213907,2821.01,6,510186,-2,0,0,0,0,0
20150105.213908,2820.39,6,510192,2,0,0,0,0,0
20150105.213909,2820.63,62,510254,2,0,0,0,0,0
20150105.21391,2821.01,22,510276,0,0,0,0,0,0
20150105.213911,2820.63,80,510356,-20,0,0,0,0,0
20150105.213912,2820.64,334,510690,-64,0,0,0,0,0
20150105.213913,2820.02,10,510700,4,0,0,0,0,0
20150105.213914,2821.01,736,511436,-102,0,0,0,0,0
20150105.213915,2820.63,8,511444,-2,0,0,0,0,0
20150105.213916,2821.01,46,511490,8,0,0,0,0,0
20150105.213917,2820.63,102,511592,42,0,0,0,0,0
20150105.213918,2821.01,48,511640,-24,0,0,0,0,0
20150105.213919,2820.63,34,511674,0,0,0,0,0,0
20150105.21392,2820.63,476,512150,-106,0,0,0,0,0
20150105.213921,2821.01,8,512158,-2,0,0,0,0,0
20150105.213922,2820.02,22,512180,20,0,0,0,0,0
20150105.213923,2820.63,26,512206,-18,0,0,0,0,0
20150105.213924,2820.63,178,512384,-52,0,0,0,0,0
20150105.213925,2821.01,12,512396,-4,0,0,0,0,0
20150105.213926,2820.63,6,512402,0,0,0,0,0,0
20150105.213927,2820.02,30,512432,-2,0,0,0,0,0
20150105.213928,2821.01,14,512446,-2,0,0,0,0,0
20150105.213929,2820.63,4,512450,-2,0,0,0,0,0
20150105.21393,2820.63,164,512614,-4,0,0,0,0,0
20150105.213931,2820.63,72,512686,0,0,0,0,0,0
20150105.213932,2820.63,26,512712,0,0,0,0,0,0
20150105.213933,2819.64,6,512718,4,0,0,0,0,0
20150105.213934,2820.63,24,512742,0,0,0,0,0,0
20150105.213935,2820.63,18,512760,0,0,0,0,0,0
20150105.213936,2820.63,6,512766,0,0,0,0,0,0
20150105.213937,2820.63,4,512770,0,0,0,0,0,0
20150105.213938,2820.63,20,512790,-20,0,0,0,0,0
20150105.213939,2820.02,4,512794,0,0,0,0,0,0
20150105.21394,2820.63,6,512800,0,0,0,0,0,0
20150105.213941,2820.63,24,512824,-22,0,0,0,0,0
20150105.213942,2820.02,184,513008,0,0,0,0,0,0
20150105.213943,2820.26,6,513014,2,0,0,0,0,0
20150105.213944,2820.63,42,513056,0,0,0,0,0,0
20150105.213945,2820.63,12,513068,0,0,0,0,0,0
20150105.213946,2820.63,14,513082,0,0,0,0,0,0
20150105.213947,2820.63,656,513738,-24,0,0,0,0,0
20150105.213948,2820.02,8,513746,6,0,0,0,0,0
20150105.213949,2820.02,12,513758,2,0,0,0,0,0
20150105.21395,2820.63,192,513950,68,0,0,0,0,0
20150105.213951,2820.63,716,514666,38,0,0,0,0,0
20150105.213952,2821.01,216,514882,96,0,0,0,0,0
20150105.213953,2821.01,6,514888,0,0,0,0,0,0
20150105.213954,2820.64,152,515040,-136,0,0,0,0,0
20150105.213955,2820.64,58,515098,0,0,0,0,0,0
20150105.213956,2821.01,8,515106,2,0,0,0,0,0
20150105.213957,2821.01,44,515150,6,0,0,0,0,0
20150105.213958,2820.64,112,515262,0,0,0,0,0,0
20150105.213959,2821.01,174,515436,10,0,0,0,0,0
20150105.214,2821.01,16,515452,10,0,0,0,0,0
20150105.214001,2821.25,12,515464,6,0,0,0,0,0
20150105.214002,2821.63,34,515498,22,0,0,0,0,0
20150105.214003,2821.01,158,515656,54,0,0,0,0,0
20150105.214004,2821.01,168,515824,-60,0,0,0,0,0
20150105.214005,2821.63,48,515872,8,0,0,0,0,0
20150105.214006,2821.01,12,515884,-2,0,0,0,0,0
20150105.214007,2821.63,24,515908,-2,0,0,0,0,0
20150105.214008,2821.63,148,516056,-26,0,0,0,0,0
20150105.214009,2821.01,44,516100,4,0,0,0,0,0
20150105.21401,2821.63,102,516202,-100,0,0,0,0,0
20150105.214011,2821.01,56,516258,-52,0,0,0,0,0
20150105.214012,2821.01,4,516262,0,0,0,0,0,0
20150105.214013,2821.01,68,516330,28,0,0,0,0,0
20150105.214014,2821.25,6,516336,4,0,0,0,0,0
20150105.214015,2821.01,26,516362,0,0,0,0,0,0
20150105.214016,2821.01,4,516366,-2,0,0,0,0,0
20150105.214017,2821.01,6,516372,-4,0,0,0,0,0
20150105.214018,2821.25,12,516384,6,0,0,0,0,0
20150105.214019,2821.63,4,516388,0,0,0,0,0,0
20150105.21402,2821.63,62,516450,0,0,0,0,0,0
20150105.214021,2821.01,60,516510,-26,0,0,0,0,0
20150105.214022,2821.01,20,516530,-18,0,0,0,0,0
20150105.214023,2821.25,1856,518386,998,0,0,0,0,0
20150105.214024,2821.63,144,518530,4,0,0,0,0,0
20150105.214025,2821.25,12,518542,4,0,0,0,0,0
20150105.214026,2822.25,6,518548,2,0,0,0,0,0
20150105.214027,2822.25,76,518624,10,0,0,0,0,0
20150105.214028,2821.63,6,518630,6,0,0,0,0,0
20150105.214029,2822.25,128,518758,68,0,0,0,0,0
20150105.21403,2822,18,518776,2,0,0,0,0,0
20150105.214031,2822.62,4,518780,0,0,0,0,0,0
20150105.214032,2822.62,8,518788,0,0,0,0,0,0
20150105.214033,2822.25,118,518906,96,0,0,0,0,0
20150105.214034,2821.63,28,518934,28,0,0,0,0,0
20150105.214035,2822.25,34,518968,32,0,0,0,0,0
20150105.214036,2822.25,138,519106,102,0,0,0,0,0
20150105.214037,2822.25,24,519130,0,0,0,0,0,0
20150105.214038,2822.25,42,519172,-38,0,0,0,0,0
20150105.214039,2822.25,8,519180,4,0,0,0,0,0
20150105.21404,2821.63,44,519224,4,0,0,0,0,0
20150105.214041,2822.25,22,519246,20,0,0,0,0,0
20150105.214042,2822.25,640,519886,20,0,0,0,0,0
20150105.214043,2822.25,24,519910,-2,0,0,0,0,0
20150105.214044,2822.25,40,519950,0,0,0,0,0,0
20150105.214045,2822.25,70,520020,4,0,0,0,0,0
20150105.214046,2821.63,22,520042,18,0,0,0,0,0
20150105.214047,2822.25,22,520064,0,0,0,0,0,0
20150105.214048,2821.87,30,520094,-16,0,0,0,0,0
20150105.214049,2822.25,18,520112,-4,0,0,0,0,0
20150105.21405,2821.63,146,520258,54,0,0,0,0,0
20150105.214051,2821.25,14,520272,8,0,0,0,0,0
20150105.214052,2821.63,2106,522378,52,0,0,0,0,0
20150105.214053,2821.63,50,522428,-2,0,0,0,0,0
20150105.214054,2821.63,12,522440,2,0,0,0,0,0
20150105.214055,2821.63,214,522654,-10,0,0,0,0,0
20150105.214056,2821.63,6,522660,0,0,0,0,0,0
20150105.214057,2821.63,90,522750,0,0,0,0,0,0
20150105.214058,2821.63,58,522808,-6,0,0,0,0,0
20150105.214059,2821.63,42,522850,4,0,0,0,0,0
20150105.2141,2821.63,18,522868,0,0,0,0,0,0
20150105.214101,2821.63,34,522902,-30,0,0,0,0,0
20150105.214102,2821.63,12,522914,-4,0,0,0,0,0
20150105.214103,2821.63,32,522946,-32,0,0,0,0,0
20150105.214104,2821.01,6,522952,0,0,0,0,0,0
20150105.214105,2821.25,10,522962,-2,0,0,0,0,0
20150105.214106,2821.63,4,522966,0,0,0,0,0,0
20150105.214107,2821.63,110,523076,-100,0,0,0,0,0
20150105.214108,2821.25,1036,524112,-1024,0,0,0,0,0
20150105.214109,2821.63,4,524116,-2,0,0,0,0,0
20150105.21411,2821.63,142,524258,10,0,0,0,0,0
20150105.214111,2821.63,218,524476,-112,0,0,0,0,0
20150105.214112,2821.63,10,524486,0,0,0,0,0,0
20150105.214113,2821.25,48,524534,0,0,0,0,0,0
20150105.214114,2821.25,14,524548,8,0,0,0,0,0
20150105.214115,2821.25,4,524552,2,0,0,0,0,0
20150105.214116,2821.63,44,524596,4,0,0,0,0,0
20150105.214117,2821.63,22,524618,18,0,0,0,0,0
20150105.214118,2821.63,4,524622,4,0,0,0,0,0
20150105.214119,2821.63,230,524852,-48,0,0,0,0,0
20150105.21412,2821.63,232,525084,150,0,0,0,0,0
20150105.214121,2821.63,8,525092,4,0,0,0,0,0
20150105.214122,2821.63,52,525144,50,0,0,0,0,0
20150105.214123,2821.63,188,525332,6,0,0,0,0,0
20150105.214124,2821.63,796,526128,-90,0,0,0,0,0
20150105.214125,2821.63,160,526288,-20,0,0,0,0,0
20150105.214126,2821.63,4,526292,-2,0,0,0,0,0
20150105.214127,2821.63,80,526372,72,0,0,0,0,0
20150105.214128,2822,98,526470,12,0,0,0,0,0
20150105.214129,2821.63,190,526660,-166,0,0,0,0,0
20150105.21413,2822,494,527154,-90,0,0,0,0,0
20150105.214131,2822,4,527158,4,0,0,0,0,0
20150105.214132,2822,18,527176,0,0,0,0,0,0
20150105.214133,2821.63,4,527180,-2,0,0,0,0,0
20150105.214134,2822.62,10,527190,4,0,0,0,0,0
20150105.214135,2822.62,48,527238,-24,0,0,0,0,0
20150105.214136,2821.63,18,527256,10,0,0,0,0,0
20150105.214137,2821.63,12,527268,-2,0,0,0,0,0
20150105.214138,2822.62,44,527312,20,0,0,0,0,0
20150105.214139,2821.63,62,527374,-44,0,0,0,0,0
20150105.21414,2822.62,52,527426,22,0,0,0,0,0
20150105.214141,2822.62,40,527466,-12,0,0,0,0,0
20150105.214142,2822.25,8,527474,0,0,0,0,0,0
20150105.214143,2822,878,528352,-422,0,0,0,0,0
20150105.214144,2822,202,528554,8,0,0,0,0,0
20150105.214145,2822,8,528562,0,0,0,0,0,0
20150105.214146,2822,14,528576,2,0,0,0,0,0
20150105.214147,2821.63,6,528582,0,0,0,0,0,0
20150105.214148,2822.25,110,528692,-2,0,0,0,0,0
20150105.214149,2822.62,10,528702,2,0,0,0,0,0
20150105.21415,2822,4,528706,2,0,0,0,0,0
20150105.214151,2821.38,682,529388,654,0,0,0,0,0
20150105.214152,2821.63,72,529460,20,0,0,0,0,0
20150105.214153,2822,72,529532,14,0,0,0,0,0
20150105.214154,2821.01,30,529562,0,0,0,0,0,0
20150105.214155,2821.01,60,529622,54,0,0,0,0,0
20150105.214156,2822,12,529634,2,0,0,0,0,0
20150105.214157,2821.63,32,529666,12,0,0,0,0,0
20150105.214158,2821.38,40,529706,0,0,0,0,0,0
20150105.214159,2822,22,529728,22,0,0,0,0,0
20150105.2142,2821.38,12,529740,8,0,0,0,0,0
20150105.214201,2822,12,529752,12,0,0,0,0,0
20150105.214202,2821.63,436,530188,402,0,0,0,0,0
20150105.214203,2821.63,606,530794,-346,0,0,0,0,0
20150105.214204,2821.63,14,530808,4,0,0,0,0,0
20150105.214205,2821.25,54,530862,34,0,0,0,0,0
20150105.214206,2821.25,28,530890,28,0,0,0,0,0
20150105.214207,2821.63,8,530898,4,0,0,0,0,0
20150105.214208,2821.63,280,531178,20,0,0,0,0,0
20150105.214209,2820.63,222,531400,22,0,0,0,0,0
20150105.21421,2820.63,62,531462,54,0,0,0,0,0
20150105.214211,2821.25,658,532120,36,0,0,0,0,0
20150105.214212,2821.25,202,532322,200,0,0,0,0,0
20150105.214213,2821.25,1060,533382,548,0,0,0,0,0
20150105.214214,2820.63,412,533794,222,0,0,0,0,0
20150105.214215,2821.63,204,533998,0,0,0,0,0,0
20150105.214216,2821.87,24,534022,-20,0,0,0,0,0
20150105.214217,2821.25,14,534036,6,0,0,0,0,0
20150105.214218,2821.25,28,534064,18,0,0,0,0,0
20150105.214219,2821.25,6,534070,6,0,0,0,0,0
20150105.21422,2822.25,32,534102,0,0,0,0,0,0
20150105.214221,2821.63,402,534504,312,0,0,0,0,0
20150105.214222,2821.87,166,534670,-70,0,0,0,0,0
20150105.214223,2821.63,66,534736,40,0,0,0,0,0
20150105.214224,2821.63,8,534744,6,0,0,0,0,0
20150105.214225,2821.63,54,534798,2,0,0,0,0,0
20150105.214226,2822.25,98,534896,2,0,0,0,0,0
20150105.214227,2821.63,100,534996,4,0,0,0,0,0
20150105.214228,2821.63,6,535002,2,0,0,0,0,0
20150105.214229,2821.63,232,535234,-156,0,0,0,0,0
20150105.21423,2821.63,36,535270,-20,0,0,0,0,0
20150105.214231,2821.01,4,535274,-2,0,0,0,0,0
20150105.214232,2821.25,28,535302,-22,0,0,0,0,0
20150105.214233,2821.25,46,535348,2,0,0,0,0,0
20150105.214234,2821.25,26,535374,-20,0,0,0,0,0
20150105.214235,2820.63,12,535386,6,0,0,0,0,0
20150105.214236,2821.25,186,535572,166,0,0,0,0,0
20150105.214237,2821.25,462,536034,-164,0,0,0,0,0
20150105.214238,2820.63,8,536042,-4,0,0,0,0,0
20150105.214239,2821.25,40,536082,20,0,0,0,0,0
20150105.21424,2820.88,6,536088,0,0,0,0,0,0
20150105.214241,2821.25,292,536380,-256,0,0,0,0,0
20150105.214242,2820.63,426,536806,-182,0,0,0,0,0
20150105.214243,2821.25,10,536816,0,0,0,0,0,0
20150105.214244,2820.26,4,536820,2,0,0,0,0,0
20150105.214245,2821.25,8,536828,2,0,0,0,0,0
20150105.214246,2820.88,14,536842,-2,0,0,0,0,0
20150105.214247,2820.88,8,536850,0,0,0,0,0,0
20150105.214248,2820.63,320,537170,-82,0,0,0,0,0
20150105.214249,2821.25,94,537264,-92,0,0,0,0,0
20150105.21425,2821.25,4,537268,-2,0,0,0,0,0
20150105.214251,2821.01,6,537274,-4,0,0,0,0,0
20150105.214252,2821.25,6,537280,-2,0,0,0,0,0
20150105.214253,2821.25,124,537404,-96,0,0,0,0,0
20150105.214254,2821.25,96,537500,-86,0,0,0,0,0
20150105.214255,2821.25,186,537686,-44,0,0,0,0,0
20150105.214256,2821.25,30,537716,0,0,0,0,0,0
20150105.214257,2820.63,448,538164,-404,0,0,0,0,0
20150105.214258,2821.25,120,538284,-10,0,0,0,0,0
20150105.214259,2821.25,36,538320,22,0,0,0,0,0
20150105.2143,2821.25,256,538576,-14,0,0,0,0,0
20150105.214301,2821.25,60,538636,52,0,0,0,0,0
20150105.214302,2820.88,106,538742,-2,0,0,0,0,0
20150105.214303,2821.25,24,538766,-8,0,0,0,0,0
20150105.214304,2820.88,250,539016,74,0,0,0,0,0
20150105.214305,2820.88,4,539020,4,0,0,0,0,0
20150105.214306,2821.25,12,539032,12,0,0,0,0,0
20150105.214307,2821.25,74,539106,72,0,0,0,0,0
20150105.214308,2821.25,22,539128,22,0,0,0,0,0
20150105.214309,2821.25,14,539142,2,0,0,0,0,0
20150105.21431,2821.25,10,539152,6,0,0,0,0,0
20150105.214311,2821.87,22,539174,-20,0,0,0,0,0
20150105.214312,2821.25,4,539178,2,0,0,0,0,0
20150105.214313,2821.25,18,539196,0,0,0,0,0,0
20150105.214314,2821.5,8,539204,2,0,0,0,0,0
20150105.214315,2821.5,204,539408,194,0,0,0,0,0
20150105.214316,2821.5,44,539452,-2,0,0,0,0,0
20150105.214317,2821.5,22,539474,2,0,0,0,0,0
20150105.214318,2821.5,658,540132,192,0,0,0,0,0
20150105.214319,2821.87,124,540256,-2,0,0,0,0,0
20150105.21432,2821.5,162,540418,-16,0,0,0,0,0
20150105.214321,2821.5,12,540430,-4,0,0,0,0,0
20150105.214322,2821.5,8,540438,0,0,0,0,0,0
20150105.214323,2821.5,24,540462,14,0,0,0,0,0
20150105.214324,2821.5,688,541150,522,0,0,0,0,0
20150105.214325,2821.5,190,541340,-50,0,0,0,0,0
20150105.214326,2821.5,418,541758,-280,0,0,0,0,0
20150105.214327,2821.5,96,541854,-64,0,0,0,0,0
20150105.214328,2821.87,160,542014,130,0,0,0,0,0
20150105.214329,2821.87,230,542244,58,0,0,0,0,0
20150105.21433,2821.87,66,542310,4,0,0,0,0,0
20150105.214331,2821.87,116,542426,54,0,0,0,0,0
20150105.214332,2821.5,190,542616,62,0,0,0,0,0
20150105.214333,2821.87,14,542630,8,0,0,0,0,0
20150105.214334,2821.5,12,542642,6,0,0,0,0,0
20150105.214335,2821.5,6,542648,2,0,0,0,0,0
20150105.214336,2821.5,14,542662,4,0,0,0,0,0
20150105.214337,2822.49,8,542670,2,0,0,0,0,0
20150105.214338,2821.87,18,542688,10,0,0,0,0,0
20150105.214339,2821.87,8,542696,6,0,0,0,0,0
20150105.21434,2821.87,22,542718,20,0,0,0,0,0
20150105.214341,2822.12,32,542750,-10,0,0,0,0,0
20150105.214342,2821.5,162,542912,-18,0,0,0,0,0
20150105.214343,2822.11,152,543064,112,0,0,0,0,0
20150105.214344,2821.5,206,543270,18,0,0,0,0,0
20150105.214345,2821.12,90,543360,82,0,0,0,0,0
20150105.214346,2822.11,22,543382,2,0,0,0,0,0
20150105.214347,2822.11,6,543388,4,0,0,0,0,0
20150105.214348,2821.74,16,543404,2,0,0,0,0,0
20150105.214349,2821.74,312,543716,0,0,0,0,0,0
20150105.21435,2821.74,1388,545104,1038,0,0,0,0,0
20150105.214351,2821.36,46,545150,-34,0,0,0,0,0
20150105.214352,2821.74,44,545194,44,0,0,0,0,0
20150105.214353,2820.74,394,545588,136,0,0,0,0,0
20150105.214354,2821.36,6,545594,6,0,0,0,0,0
20150105.214355,2820.74,6,545600,2,0,0,0,0,0
20150105.214356,2821.36,16,545616,4,0,0,0,0,0
20150105.214357,2820.74,136,545752,106,0,0,0,0,0
20150105.214358,2821.36,10,545762,2,0,0,0,0,0
20150105.214359,2821.74,24,545786,2,0,0,0,0,0
20150105.2144,2821.74,4,545790,4,0,0,0,0,0
20150105.214401,2821.36,8,545798,8,0,0,0,0,0
20150105.214402,2821.36,14,545812,-4,0,0,0,0,0
20150105.214403,2821.36,136,545948,24,0,0,0,0,0
20150105.214404,2820.74,4,545952,0,0,0,0,0,0
20150105.214405,2820.74,24,545976,-4,0,0,0,0,0
20150105.214406,2821.12,44,546020,4,0,0,0,0,0
20150105.214407,2821.12,8,546028,0,0,0,0,0,0
20150105.214408,2820.74,210,546238,66,0,0,0,0,0
20150105.214409,2821.36,8,546246,-6,0,0,0,0,0
20150105.21441,2821.36,42,546288,10,0,0,0,0,0
20150105.214411,2821.36,26,546314,24,0,0,0,0,0
20150105.214412,2820.74,46,546360,42,0,0,0,0,0
20150105.214413,2821.36,24,546384,4,0,0,0,0,0
20150105.214414,2821.36,90,546474,68,0,0,0,0,0
20150105.214415,2820.74,938,547412,-82,0,0,0,0,0
20150105.214416,2820.74,100,547512,44,0,0,0,0,0
20150105.214417,2820.74,180,547692,144,0,0,0,0,0
20150105.214418,2820.74,4,547696,2,0,0,0,0,0
20150105.214419,2820.74,90,547786,88,0,0,0,0,0
20150105.21442,2820.74,246,548032,54,0,0,0,0,0
20150105.214421,2820.74,36,548068,14,0,0,0,0,0
20150105.214422,2820.74,192,548260,182,0,0,0,0,0
20150105.214423,2820.74,8,548268,8,0,0,0,0,0
20150105.214424,2820.74,52,548320,4,0,0,0,0,0
20150105.214425,2820.74,8,548328,6,0,0,0,0,0
20150105.214426,2820.12,216,548544,136,0,0,0,0,0
20150105.214427,2820.74,12,548556,2,0,0,0,0,0
20150105.214428,2820.74,4,548560,2,0,0,0,0,0
20150105.214429,2820.74,4,548564,2,0,0,0,0,0
20150105.21443,2820.74,6,548570,6,0,0,0,0,0
20150105.214431,2821.12,24,548594,20,0,0,0,0,0
20150105.214432,2821.12,4,548598,4,0,0,0,0,0
20150105.214433,2820.74,10,548608,4,0,0,0,0,0
20150105.214434,2820.74,6,548614,2,0,0,0,0,0
20150105.214435,2820.12,542,549156,354,0,0,0,0,0
20150105.214436,2820.74,206,549362,-116,0,0,0,0,0
20150105.214437,2820.12,28,549390,-12,0,0,0,0,0
20150105.214438,2820.74,204,549594,-76,0,0,0,0,0
20150105.214439,2820.74,8,549602,6,0,0,0,0,0
20150105.21444,2820.74,42,549644,40,0,0,0,0,0
20150105.214441,2820.74,362,550006,-110,0,0,0,0,0
20150105.214442,2820.12,424,550430,30,0,0,0,0,0
20150105.214443,2820.74,64,550494,32,0,0,0,0,0
20150105.214444,2820.74,142,550636,64,0,0,0,0,0
20150105.214445,2820.74,12,550648,2,0,0,0,0,0
20150105.214446,2820.74,32,550680,-6,0,0,0,0,0
20150105.214447,2820.74,64,550744,-56,0,0,0,0,0
20150105.214448,2820.12,130,550874,118,0,0,0,0,0
20150105.214449,2820.37,760,551634,630,0,0,0,0,0
20150105.21445,2820.36,374,552008,314,0,0,0,0,0
20150105.214451,2820.36,8,552016,0,0,0,0,0,0
20150105.214452,2820.36,20,552036,0,0,0,0,0,0
20150105.214453,2820.36,6,552042,0,0,0,0,0,0
20150105.214454,2820.36,26,552068,0,0,0,0,0,0
20150105.214455,2820.37,190,552258,-182,0,0,0,0,0
20150105.214456,2820.37,138,552396,10,0,0,0,0,0
20150105.214457,2819.75,18,552414,16,0,0,0,0,0
20150105.214458,2819.75,62,552476,-2,0,0,0,0,0
20150105.214459,2820.74,8,552484,6,0,0,0,0,0
20150105.2145,2820.37,184,552668,-20,0,0,0,0,0
20150105.214501,2820.37,6,552674,2,0,0,0,0,0
20150105.214502,2820.37,8,552682,0,0,0,0,0,0
20150105.214503,2820.74,12,552694,0,0,0,0,0,0
20150105.214504,2819.99,4,552698,2,0,0,0,0,0
20150105.214505,2819.99,128,552826,12,0,0,0,0,0
20150105.214506,2819.99,84,552910,6,0,0,0,0,0
20150105.214507,2820.37,4,552914,0,0,0,0,0,0
20150105.214508,2819.75,4,552918,2,0,0,0,0,0
20150105.214509,2820.37,18,552936,0,0,0,0,0,0
20150105.21451,2820.37,20,552956,-18,0,0,0,0,0
20150105.214511,2819.75,4,552960,-2,0,0,0,0,0
20150105.214512,2819.75,132,553092,-34,0,0,0,0,0
20150105.214513,2820.37,18,553110,4,0,0,0,0,0
20150105.214514,2819.75,4,553114,0,0,0,0,0,0
20150105.214515,2820.37,234,553348,-4,0,0,0,0,0
20150105.214516,2820.37,6,553354,4,0,0,0,0,0
20150105.214517,2820.74,10,553364,-2,0,0,0,0,0
20150105.214518,2820.37,24,553388,-22,0,0,0,0,0
20150105.214519,2819.75,24,553412,-14,0,0,0,0,0
20150105.21452,2819.75,30,553442,8,0,0,0,0,0
20150105.214521,2819.75,74,553516,70,0,0,0,0,0
20150105.214522,2819.75,22,553538,16,0,0,0,0,0
20150105.214523,2820.74,4,553542,-4,0,0,0,0,0
20150105.214524,2820.12,6,553548,-4,0,0,0,0,0
20150105.214525,2820.12,72,553620,0,0,0,0,0,0
20150105.214526,2820.37,4,553624,2,0,0,0,0,0
20150105.214527,2820.37,242,553866,-124,0,0,0,0,0
20150105.214528,2820.74,6,553872,-4,0,0,0,0,0
20150105.214529,2820.12,150,554022,-78,0,0,0,0,0
20150105.21453,2820.74,8,554030,-2,0,0,0,0,0
20150105.214531,2820.74,82,554112,80,0,0,0,0,0
20150105.214532,2820.74,8,554120,2,0,0,0,0,0
20150105.214533,2820.12,4,554124,-2,0,0,0,0,0
20150105.214534,2820.74,32,554156,0,0,0,0,0,0
20150105.214535,2820.74,44,554200,-38,0,0,0,0,0
20150105.214536,2820.74,206,554406,-128,0,0,0,0,0
20150105.214537,2820.74,204,554610,86,0,0,0,0,0
20150105.214538,2820.74,24,554634,0,0,0,0,0,0
20150105.214539,2820.74,10,554644,4,0,0,0,0,0
20150105.21454,2819.75,4,554648,0,0,0,0,0,0
20150105.214541,2820.74,6,554654,2,0,0,0,0,0
20150105.214542,2820.12,22,554676,-18,0,0,0,0,0
20150105.214543,2820.12,4,554680,-2,0,0,0,0,0
20150105.214544,2820.74,6,554686,-2,0,0,0,0,0
20150105.214545,2820.37,8,554694,-2,0,0,0,0,0
20150105.214546,2820.12,4,554698,2,0,0,0,0,0
20150105.214547,2820.12,198,554896,-4,0,0,0,0,0
20150105.214548,2821.11,8,554904,-6,0,0,0,0,0
20150105.214549,2820.12,24,554928,0,0,0,0,0,0
20150105.21455,2820.37,112,555040,-10,0,0,0,0,0
20150105.214551,2821.11,6,555046,4,0,0,0,0,0
20150105.214552,2820.74,14,555060,14,0,0,0,0,0
20150105.214553,2820.12,230,555290,-230,0,0,0,0,0
20150105.214554,2821.11,6,555296,4,0,0,0,0,0
20150105.214555,2820.12,826,556122,-690,0,0,0,0,0
20150105.214556,2820.12,24,556146,24,0,0,0,0,0
20150105.214557,2820.74,4,556150,2,0,0,0,0,0
20150105.214558,2820.12,10,556160,-4,0,0,0,0,0
20150105.214559,2820.5,8,556168,6,0,0,0,0,0
20150105.2146,2820.74,6,556174,6,0,0,0,0,0
20150105.214601,2820.12,24,556198,-18,0,0,0,0,0
20150105.214602,2820.74,24,556222,-20,0,0,0,0,0
20150105.214603,2821.11,48,556270,22,0,0,0,0,0
20150105.214604,2820.12,822,557092,-344,0,0,0,0,0
20150105.214605,2820.12,4,557096,0,0,0,0,0,0
20150105.214606,2820.49,8,557104,-6,0,0,0,0,0
20150105.214607,2821.11,24,557128,-8,0,0,0,0,0
20150105.214608,2820.49,44,557172,4,0,0,0,0,0
20150105.214609,2820.74,18,557190,-10,0,0,0,0,0
20150105.21461,2820.36,16,557206,2,0,0,0,0,0
20150105.214611,2820.12,22,557228,0,0,0,0,0,0
20150105.214612,2820.74,72,557300,64,0,0,0,0,0
20150105.214613,2820.12,4,557304,0,0,0,0,0,0
20150105.214614,2820.12,82,557386,8,0,0,0,0,0
20150105.214615,2820.12,16,557402,4,0,0,0,0,0
20150105.214616,2821.11,4,557406,2,0,0,0,0,0
20150105.214617,2820.12,202,557608,168,0,0,0,0,0
20150105.214618,2820.12,60,557668,38,0,0,0,0,0
20150105.214619,2820.74,62,557730,60,0,0,0,0,0
20150105.21462,2820.12,4,557734,4,0,0,0,0,0
20150105.214621,2820.74,22,557756,20,0,0,0,0,0
20150105.214622,2820.5,404,558160,-348,0,0,0,0,0
20150105.214623,2820.5,104,558264,100,0,0,0,0,0
20150105.214624,2820.5,42,558306,0,0,0,0,0,0
20150105.214625,2820.12,12,558318,10,0,0,0,0,0
20150105.214626,2820.5,14,558332,6,0,0,0,0,0
20150105.214627,2820.5,102,558434,88,0,0,0,0,0
20150105.214628,2820.12,24,558458,14,0,0,0,0,0
20150105.214629,2820.12,98,558556,94,0,0,0,0,0
20150105.21463,2820.5,24,558580,20,0,0,0,0,0
20150105.214631,2820.5,90,558670,24,0,0,0,0,0
20150105.214632,2820.5,242,558912,24,0,0,0,0,0
20150105.214633,2820.5,70,558982,60,0,0,0,0,0
20150105.214634,2820.5,124,559106,108,0,0,0,0,0
20150105.214635,2820.5,250,559356,6,0,0,0,0,0
20150105.214636,2820.5,552,559908,218,0,0,0,0,0
20150105.214637,2820.5,20,559928,-4,0,0,0,0,0
20150105.214638,2819.5,10,559938,-4,0,0,0,0,0
20150105.214639,2819.88,106,560044,-8,0,0,0,0,0
20150105.21464,2820.5,90,560134,0,0,0,0,0,0
20150105.214641,2820.5,1024,561158,-674,0,0,0,0,0
20150105.214642,2819.88,4,561162,0,0,0,0,0,0
20150105.214643,2820.25,12,561174,-8,0,0,0,0,0
20150105.214644,2820.87,26,561200,4,0,0,0,0,0
20150105.214645,2820.25,818,562018,-728,0,0,0,0,0
20150105.214646,2820.25,70,562088,8,0,0,0,0,0
20150105.214647,2820.25,20,562108,-6,0,0,0,0,0
20150105.214648,2819.88,1066,563174,62,0,0,0,0,0
20150105.214649,2819.88,66,563240,-30,0,0,0,0,0
20150105.21465,2820.25,34,563274,-4,0,0,0,0,0
20150105.214651,2820.5,14,563288,-12,0,0,0,0,0
20150105.214652,2820.25,56,563344,-4,0,0,0,0,0
20150105.214653,2820.25,12,563356,-4,0,0,0,0,0
20150105.214654,2820.87,1250,564606,-182,0,0,0,0,0
20150105.214655,2820.25,32,564638,8,0,0,0,0,0
20150105.214656,2820.25,42,564680,0,0,0,0,0,0
20150105.214657,2820.87,176,564856,-28,0,0,0,0,0
20150105.214658,2820.25,1060,565916,18,0,0,0,0,0
20150105.214659,2819.88,244,566160,78,0,0,0,0,0
20150105.2147,2820.25,6,566166,6,0,0,0,0,0
20150105.214701,2820.25,52,566218,20,0,0,0,0,0
20150105.214702,2820.25,28,566246,22,0,0,0,0,0
20150105.214703,2820.87,14,566260,12,0,0,0,0,0
20150105.214704,2820.25,22,566282,20,0,0,0,0,0
20150105.214705,2819.88,12,566294,-12,0,0,0,0,0
20150105.214706,2820.25,16,566310,4,0,0,0,0,0
20150105.214707,2819.88,4,566314,-4,0,0,0,0,0
20150105.214708,2819.88,48,566362,-8,0,0,0,0,0
20150105.214709,2819.88,80,566442,-60,0,0,0,0,0
20150105.21471,2820.5,12,566454,-2,0,0,0,0,0
20150105.214711,2819.88,92,566546,8,0,0,0,0,0
20150105.214712,2819.5,114,566660,88,0,0,0,0,0
20150105.214713,2819.5,106,566766,30,0,0,0,0,0
20150105.214714,2819.88,166,566932,-110,0,0,0,0,0
20150105.214715,2819.88,48,566980,-4,0,0,0,0,0
20150105.214716,2819.88,78,567058,-16,0,0,0,0,0
20150105.214717,2819.88,38,567096,14,0,0,0,0,0
20150105.214718,2819.88,282,567378,-22,0,0,0,0,0
20150105.214719,2819.88,6,567384,-4,0,0,0,0,0
20150105.21472,2819.88,16,567400,2,0,0,0,0,0
20150105.214721,2819.88,80,567480,-2,0,0,0,0,0
20150105.214722,2819.88,28,567508,10,0,0,0,0,0
20150105.214723,2819.88,104,567612,102,0,0,0,0,0
20150105.214724,2820.25,10,567622,4,0,0,0,0,0
20150105.214725,2819.88,52,567674,14,0,0,0,0,0
20150105.214726,2819.88,22,567696,22,0,0,0,0,0
20150105.214727,2819.88,70,567766,12,0,0,0,0,0
20150105.214728,2819.26,58,567824,2,0,0,0,0,0
20150105.214729,2819.26,10,567834,2,0,0,0,0,0
20150105.21473,2819.63,34,567868,18,0,0,0,0,0
20150105.214731,2819.26,4,567872,-2,0,0,0,0,0
20150105.214732,2819.26,28,567900,0,0,0,0,0,0
20150105.214733,2819.88,228,568128,20,0,0,0,0,0
20150105.214734,2819.26,68,568196,50,0,0,0,0,0
20150105.214735,2819.26,56,568252,0,0,0,0,0,0
20150105.214736,2819.5,430,568682,22,0,0,0,0,0
20150105.214737,2819.5,12,568694,6,0,0,0,0,0
20150105.214738,2819.5,6,568700,6,0,0,0,0,0
20150105.214739,2819.26,10,568710,6,0,0,0,0,0
20150105.21474,2819.88,8,568718,2,0,0,0,0,0
20150105.214741,2819.88,4,568722,0,0,0,0,0,0
20150105.214742,2819.88,6,568728,0,0,0,0,0,0
20150105.214743,2819.88,24,568752,2,0,0,0,0,0
20150105.214744,2819.26,10,568762,0,0,0,0,0,0
20150105.214745,2819.88,8,568770,6,0,0,0,0,0
20150105.214746,2819.26,90,568860,-62,0,0,0,0,0
20150105.214747,2819.26,86,568946,52,0,0,0,0,0
20150105.214748,2819.26,108,569054,16,0,0,0,0,0
20150105.214749,2820.25,26,569080,6,0,0,0,0,0
20150105.21475,2819.26,10,569090,4,0,0,0,0,0
20150105.214751,2820.25,842,569932,-48,0,0,0,0,0
20150105.214752,2819.26,26,569958,-18,0,0,0,0,0
20150105.214753,2819.63,2222,572180,1772,0,0,0,0,0
20150105.214754,2819.63,164,572344,28,0,0,0,0,0
20150105.214755,2819.63,116,572460,24,0,0,0,0,0
20150105.214756,2819.63,80,572540,0,0,0,0,0,0
20150105.214757,2819.64,4,572544,2,0,0,0,0,0
20150105.214758,2819.64,14,572558,0,0,0,0,0,0
20150105.214759,2819.02,366,572924,218,0,0,0,0,0
20150105.2148,2819.02,4,572928,4,0,0,0,0,0
20150105.214801,2819.02,40,572968,36,0,0,0,0,0
20150105.214802,2818.64,186,573154,72,0,0,0,0,0
20150105.214803,2819.02,26,573180,-18,0,0,0,0,0
20150105.214804,2818.64,16,573196,0,0,0,0,0,0
20150105.214805,2819.63,12,573208,8,0,0,0,0,0
20150105.214806,2818.64,16,573224,12,0,0,0,0,0
20150105.214807,2818.64,4,573228,4,0,0,0,0,0
20150105.214808,2818.64,8,573236,6,0,0,0,0,0
20150105.214809,2818.64,8,573244,6,0,0,0,0,0
20150105.21481,2818.64,132,573376,70,0,0,0,0,0
20150105.214811,2818.64,8,573384,4,0,0,0,0,0
20150105.214812,2818.27,6,573390,2,0,0,0,0,0
20150105.214813,2818.64,16,573406,14,0,0,0,0,0
20150105.214814,2819.26,108,573514,98,0,0,0,0,0
20150105.214815,2818.64,38,573552,26,0,0,0,0,0
20150105.214816,2819.26,12,573564,0,0,0,0,0,0
20150105.214817,2819.26,132,573696,24,0,0,0,0,0
20150105.214818,2819.02,4,573700,0,0,0,0,0,0
20150105.214819,2818.64,210,573910,66,0,0,0,0,0
20150105.21482,2819.26,50,573960,44,0,0,0,0,0
20150105.214821,2819.26,4,573964,2,0,0,0,0,0
20150105.214822,2819.64,386,574350,194,0,0,0,0,0
20150105.214823,2818.64,576,574926,350,0,0,0,0,0
20150105.214824,2818.64,480,575406,186,0,0,0,0,0
20150105.214825,2818.02,18,575424,0,0,0,0,0,0
20150105.214826,2818.64,660,576084,-278,0,0,0,0,0
20150105.214827,2818.27,148,576232,-110,0,0,0,0,0
20150105.214828,2818.64,28,576260,-24,0,0,0,0,0
20150105.214829,2818.64,176,576436,-16,0,0,0,0,0
20150105.21483,2818.64,22,576458,2,0,0,0,0,0
20150105.214831,2818.64,76,576534,44,0,0,0,0,0
20150105.214832,2818.64,20,576554,2,0,0,0,0,0
20150105.214833,2818.64,10,576564,4,0,0,0,0,0
20150105.214834,2819.26,18,576582,0,0,0,0,0,0
20150105.214835,2818.64,12,576594,0,0,0,0,0,0
20150105.214836,2819.26,20,576614,2,0,0,0,0,0
20150105.214837,2818.64,8,576622,2,0,0,0,0,0
20150105.214838,2818.64,6,576628,2,0,0,0,0,0
20150105.214839,2818.27,8,576636,-6,0,0,0,0,0
20150105.21484,2818.27,20,576656,-2,0,0,0,0,0
20150105.214841,2818.64,12,576668,0,0,0,0,0,0
20150105.214842,2818.27,120,576788,80,0,0,0,0,0
20150105.214843,2818.27,44,576832,-18,0,0,0,0,0
20150105.214844,2819.26,4,576836,4,0,0,0,0,0
20150105.214845,2818.89,22,576858,20,0,0,0,0,0
20150105.214846,2818.64,12,576870,-8,0,0,0,0,0
20150105.214847,2819.26,122,576992,-78,0,0,0,0,0
20150105.214848,2818.14,2004,578996,-1312,0,0,0,0,0
20150105.214849,2818.51,114,579110,96,0,0,0,0,0
20150105.21485,2818.51,40,579150,16,0,0,0,0,0
20150105.214851,2818.51,38,579188,-16,0,0,0,0,0
20150105.214852,2817.9,18,579206,-10,0,0,0,0,0
20150105.214853,2817.9,20,579226,-12,0,0,0,0,0
20150105.214854,2817.9,178,579404,-158,0,0,0,0,0
20150105.214855,2817.9,18,579422,-10,0,0,0,0,0
20150105.214856,2818.27,4,579426,-2,0,0,0,0,0
20150105.214857,2817.9,86,579512,-72,0,0,0,0,0
20150105.214858,2818.27,76,579588,4,0,0,0,0,0
20150105.214859,2817.9,26,579614,2,0,0,0,0,0
20150105.2149,2818.27,8,579622,0,0,0,0,0,0
20150105.214901,2817.9,144,579766,0,0,0,0,0,0
20150105.214902,2817.9,8,579774,0,0,0,0,0,0
20150105.214903,2818.51,104,579878,-80,0,0,0,0,0
20150105.214904,2818.27,14,579892,4,0,0,0,0,0
20150105.214905,2817.9,32,579924,-4,0,0,0,0,0
20150105.214906,2818.89,10,579934,2,0,0,0,0,0
20150105.214907,2818.27,112,580046,2,0,0,0,0,0
20150105.214908,2817.9,38,580084,22,0,0,0,0,0
20150105.214909,2818.27,422,580506,220,0,0,0,0,0
20150105.21491,2818.27,198,580704,-32,0,0,0,0,0
20150105.214911,2818.27,6,580710,0,0,0,0,0,0
20150105.214912,2818.27,10,580720,-8,0,0,0,0,0
20150105.214913,2818.89,20,580740,-8,0,0,0,0,0
20150105.214914,2818.27,106,580846,8,0,0,0,0,0
20150105.214915,2818.89,8,580854,-2,0,0,0,0,0
20150105.214916,2818.89,26,580880,-18,0,0,0,0,0
20150105.214917,2818.89,4,580884,4,0,0,0,0,0
20150105.214918,2818.89,4,580888,4,0,0,0,0,0
20150105.214919,2817.89,630,581518,-402,0,0,0,0,0
20150105.21492,2818.51,1032,582550,92,0,0,0,0,0
20150105.214921,2819.51,96,582646,36,0,0,0,0,0
20150105.214922,2819.51,6,582652,2,0,0,0,0,0
20150105.214923,2818.89,102,582754,72,0,0,0,0,0
20150105.214924,2819.13,22,582776,22,0,0,0,0,0
20150105.214925,2818.89,64,582840,64,0,0,0,0,0
20150105.214926,2818.89,16,582856,2,0,0,0,0,0
20150105.214927,2818.89,10,582866,4,0,0,0,0,0
20150105.214928,2819.13,26,582892,10,0,0,0,0,0
20150105.214929,2818.89,102,582994,62,0,0,0,0,0
20150105.21493,2818.89,412,583406,-104,0,0,0,0,0
20150105.214931,2818.89,124,583530,-62,0,0,0,0,0
20150105.214932,2818.89,256,583786,-208,0,0,0,0,0
20150105.214933,2818.51,216,584002,-92,0,0,0,0,0
20150105.214934,2818.51,292,584294,128,0,0,0,0,0
20150105.214935,2818.27,10,584304,8,0,0,0,0,0
20150105.214936,2819.5,404,584708,-126,0,0,0,0,0
20150105.214937,2818.89,94,584802,84,0,0,0,0,0
20150105.214938,2818.27,14,584816,4,0,0,0,0,0
20150105.214939,2818.89,6,584822,0,0,0,0,0,0
20150105.21494,2818.27,8,584830,0,0,0,0,0,0
20150105.214941,2818.89,6,584836,0,0,0,0,0,0
20150105.214942,2818.89,10,584846,-4,0,0,0,0,0
20150105.214943,2818.89,146,584992,0,0,0,0,0,0
20150105.214944,2818.89,28,585020,6,0,0,0,0,0
20150105.214945,2818.89,296,585316,190,0,0,0,0,0
20150105.214946,2818.89,40,585356,40,0,0,0,0,0
20150105.214947,2818.51,206,585562,180,0,0,0,0,0
20150105.214948,2818.89,168,585730,-78,0,0,0,0,0
20150105.214949,2818.89,208,585938,116,0,0,0,0,0
20150105.21495,2818.89,204,586142,164,0,0,0,0,0
20150105.214951,2818.89,8,586150,4,0,0,0,0,0
20150105.214952,2818.51,88,586238,88,0,0,0,0,0
20150105.214953,2818.51,142,586380,56,0,0,0,0,0
20150105.214954,2818.89,12,586392,2,0,0,0,0,0
20150105.214955,2818.89,4,586396,2,0,0,0,0,0
20150105.214956,2818.51,18,586414,4,0,0,0,0,0
20150105.214957,2818.51,164,586578,114,0,0,0,0,0
20150105.214958,2818.51,4,586582,2,0,0,0,0,0
20150105.214959,2818.51,72,586654,-28,0,0,0,0,0
20150105.215,2818.51,152,586806,140,0,0,0,0,0
20150105.215001,2818.89,24,586830,2,0,0,0,0,0
20150105.215002,2818.51,142,586972,18,0,0,0,0,0
20150105.215003,2818.51,126,587098,42,0,0,0,0,0
20150105.215004,2817.52,112,587210,-2,0,0,0,0,0
20150105.215005,2818.51,4,587214,2,0,0,0,0,0
20150105.215006,2817.52,66,587280,28,0,0,0,0,0
20150105.215007,2817.52,8,587288,4,0,0,0,0,0
20150105.215008,2817.89,14,587302,-8,0,0,0,0,0
20150105.215009,2817.89,6,587308,4,0,0,0,0,0
20150105.21501,2817.89,46,587354,44,0,0,0,0,0
20150105.215011,2818.51,42,587396,38,0,0,0,0,0
20150105.215012,2818.51,6,587402,6,0,0,0,0,0
20150105.215013,2817.89,28,587430,4,0,0,0,0,0
20150105.215014,2817.52,96,587526,-18,0,0,0,0,0
20150105.215015,2817.89,30,587556,22,0,0,0,0,0
20150105.215016,2818.51,324,587880,320,0,0,0,0,0
20150105.215017,2818.51,84,587964,-24,0,0,0,0,0
20150105.215018,2818.51,54,588018,-2,0,0,0,0,0
20150105.215019,2818.14,44,588062,42,0,0,0,0,0
20150105.21502,2818.51,106,588168,-98,0,0,0,0,0
20150105.215021,2818.51,18,588186,2,0,0,0,0,0
20150105.215022,2818.14,444,588630,20,0,0,0,0,0
20150105.215023,2818.51,46,588676,14,0,0,0,0,0
20150105.215024,2818.89,198,588874,92,0,0,0,0,0
20150105.215025,2818.51,26,588900,22,0,0,0,0,0
20150105.215026,2818.51,788,589688,-200,0,0,0,0,0
20150105.215027,2817.89,20,589708,-12,0,0,0,0,0
20150105.215028,2818.89,10,589718,4,0,0,0,0,0
20150105.215029,2818.51,42,589760,4,0,0,0,0,0
20150105.21503,2818.51,704,590464,358,0,0,0,0,0
20150105.215031,2817.52,6,590470,0,0,0,0,0,0
20150105.215032,2818.51,14,590484,-2,0,0,0,0,0
20150105.215033,2817.52,12,590496,2,0,0,0,0,0
20150105.215034,2817.89,4,590500,0,0,0,0,0,0
20150105.215035,2817.89,18,590518,0,0,0,0,0,0
20150105.215036,2817.52,8,590526,0,0,0,0,0,0
20150105.215037,2817.52,4,590530,2,0,0,0,0,0
20150105.215038,2817.52,302,590832,210,0,0,0,0,0
20150105.215039,2818.13,418,591250,314,0,0,0,0,0
20150105.21504,2817.89,662,591912,370,0,0,0,0,0
20150105.215041,2817.52,40,591952,34,0,0,0,0,0
20150105.215042,2818.13,322,592274,202,0,0,0,0,0
20150105.215043,2817.14,216,592490,-48,0,0,0,0,0
20150105.215044,2817.76,162,592652,98,0,0,0,0,0
20150105.215045,2817.14,132,592784,20,0,0,0,0,0
20150105.215046,2817.14,510,593294,250,0,0,0,0,0
20150105.215047,2817.14,258,593552,226,0,0,0,0,0
20150105.215048,2817.14,404,593956,308,0,0,0,0,0
20150105.215049,2816.52,8,593964,0,0,0,0,0,0
20150105.21505,2816.52,18,593982,-16,0,0,0,0,0
20150105.215051,2816.15,514,594496,200,0,0,0,0,0
20150105.215052,2816.77,30,594526,0,0,0,0,0,0
20150105.215053,2816.15,12,594538,-2,0,0,0,0,0
20150105.215054,2817.14,292,594830,-108,0,0,0,0,0
20150105.215055,2816.52,152,594982,36,0,0,0,0,0
20150105.215056,2817.52,14,594996,14,0,0,0,0,0
20150105.215057,2817.14,126,595122,-34,0,0,0,0,0
20150105.215058,2816.9,64,595186,24,0,0,0,0,0
20150105.215059,2816.9,280,595466,-6,0,0,0,0,0
20150105.2151,2817.14,36,595502,8,0,0,0,0,0
20150105.215101,2817.52,202,595704,150,0,0,0,0,0
20150105.215102,2817.89,8,595712,2,0,0,0,0,0
20150105.215103,2817.52,12,595724,8,0,0,0,0,0
20150105.215104,2816.9,62,595786,60,0,0,0,0,0
20150105.215105,2817.51,220,596006,152,0,0,0,0,0
20150105.215106,2817.51,10,596016,2,0,0,0,0,0
20150105.215107,2816.52,88,596104,20,0,0,0,0,0
20150105.215108,2816.9,4,596108,-2,0,0,0,0,0
20150105.215109,2816.52,104,596212,-88,0,0,0,0,0
20150105.21511,2816.9,142,596354,56,0,0,0,0,0
20150105.215111,2817.51,6,596360,0,0,0,0,0,0
20150105.215112,2817.51,150,596510,-2,0,0,0,0,0
20150105.215113,2816.9,18,596528,16,0,0,0,0,0
20150105.215114,2817.51,6,596534,6,0,0,0,0,0
20150105.215115,2817.52,406,596940,362,0,0,0,0,0
20150105.215116,2816.52,34,596974,2,0,0,0,0,0
20150105.215117,2816.9,12,596986,0,0,0,0,0,0
20150105.215118,2816.52,8,596994,4,0,0,0,0,0
20150105.215119,2816.9,18,597012,12,0,0,0,0,0
20150105.21512,2817.14,30,597042,8,0,0,0,0,0
20150105.215121,2817.52,6,597048,4,0,0,0,0,0
20150105.215122,2816.52,76,597124,14,0,0,0,0,0
20150105.215123,2816.9,106,597230,10,0,0,0,0,0
20150105.215124,2816.9,4,597234,2,0,0,0,0,0
20150105.215125,2816.52,300,597534,182,0,0,0,0,0
20150105.215126,2817.14,8,597542,4,0,0,0,0,0
20150105.215127,2816.77,22,597564,22,0,0,0,0,0
20150105.215128,2816.52,46,597610,22,0,0,0,0,0
20150105.215129,2816.52,80,597690,70,0,0,0,0,0
20150105.21513,2816.15,22,597712,20,0,0,0,0,0
20150105.215131,2817.14,52,597764,12,0,0,0,0,0
20150105.215132,2817.51,46,597810,6,0,0,0,0,0
20150105.215133,2816.52,8,597818,8,0,0,0,0,0
20150105.215134,2816.52,26,597844,20,0,0,0,0,0
20150105.215135,2817.14,4,597848,4,0,0,0,0,0
20150105.215136,2817.14,6,597854,2,0,0,0,0,0
20150105.215137,2816.52,14,597868,-8,0,0,0,0,0
20150105.215138,2817.14,14,597882,4,0,0,0,0,0
20150105.215139,2817.14,24,597906,2,0,0,0,0,0
20150105.21514,2816.52,100,598006,78,0,0,0,0,0
20150105.215141,2817.14,4,598010,-2,0,0,0,0,0
20150105.215142,2816.76,136,598146,34,0,0,0,0,0
20150105.215143,2816.52,28,598174,16,0,0,0,0,0
20150105.215144,2817.14,66,598240,2,0,0,0,0,0
20150105.215145,2816.52,4,598244,2,0,0,0,0,0
20150105.215146,2816.52,36,598280,24,0,0,0,0,0
20150105.215147,2816.52,32,598312,30,0,0,0,0,0
20150105.215148,2816.52,4,598316,2,0,0,0,0,0
20150105.215149,2817.14,10,598326,2,0,0,0,0,0
20150105.21515,2817.14,12,598338,0,0,0,0,0,0
20150105.215151,2816.52,28,598366,10,0,0,0,0,0
20150105.215152,2817.51,24,598390,6,0,0,0,0,0
20150105.215153,2817.14,62,598452,0,0,0,0,0,0
20150105.215154,2816.52,4,598456,-2,0,0,0,0,0
20150105.215155,2816.52,30,598486,20,0,0,0,0,0
20150105.215156,2817.14,10,598496,2,0,0,0,0,0
20150105.215157,2817.14,28,598524,0,0,0,0,0,0
20150105.215158,2816.15,26,598550,24,0,0,0,0,0
20150105.215159,2816.52,48,598598,34,0,0,0,0,0
20150105.2152,2816.52,24,598622,22,0,0,0,0,0
20150105.215201,2816.52,30,598652,18,0,0,0,0,0
20150105.215202,2817.14,6,598658,6,0,0,0,0,0
20150105.215203,2816.52,202,598860,20,0,0,0,0,0
20150105.215204,2816.52,84,598944,-82,0,0,0,0,0
20150105.215205,2816.9,6,598950,4,0,0,0,0,0
20150105.215206,2817.52,4,598954,-2,0,0,0,0,0
20150105.215207,2817.51,4,598958,-2,0,0,0,0,0
20150105.215208,2817.14,10,598968,-2,0,0,0,0,0
20150105.215209,2816.52,38,599006,14,0,0,0,0,0
20150105.21521,2817.14,14,599020,-6,0,0,0,0,0
20150105.215211,2816.52,106,599126,-102,0,0,0,0,0
20150105.215212,2816.9,44,599170,40,0,0,0,0,0
20150105.215213,2817.14,8,599178,4,0,0,0,0,0
20150105.215214,2817.14,8,599186,-4,0,0,0,0,0
20150105.215215,2817.52,442,599628,216,0,0,0,0,0
20150105.215216,2816.76,550,600178,406,0,0,0,0,0
20150105.215217,2817.14,22,600200,20,0,0,0,0,0
20150105.215218,2817.14,8,600208,6,0,0,0,0,0
20150105.215219,2817.14,12,600220,2,0,0,0,0,0
20150105.21522,2817.38,84,600304,84,0,0,0,0,0
20150105.215221,2816.76,246,600550,-10,0,0,0,0,0
20150105.215222,2817.14,10,600560,8,0,0,0,0,0
20150105.215223,2817.76,10,600570,6,0,0,0,0,0
20150105.215224,2817.14,44,600614,36,0,0,0,0,0
20150105.215225,2817.14,32,600646,20,0,0,0,0,0
20150105.215226,2817.76,12,600658,2,0,0,0,0,0
20150105.215227,2817.76,4,600662,2,0,0,0,0,0
20150105.215228,2817.14,34,600696,18,0,0,0,0,0
20150105.215229,2817.14,44,600740,36,0,0,0,0,0
20150105.21523,2817.76,252,600992,2,0,0,0,0,0
20150105.215231,2817.76,12,601004,10,0,0,0,0,0
20150105.215232,2817.14,6,601010,2,0,0,0,0,0
20150105.215233,2817.76,18,601028,18,0,0,0,0,0
20150105.215234,2817.76,6,601034,2,0,0,0,0,0
20150105.215235,2817.14,22,601056,20,0,0,0,0,0
20150105.215236,2817.38,14,601070,8,0,0,0,0,0
20150105.215237,2817.76,4,601074,2,0,0,0,0,0
20150105.215238,2817.38,4,601078,0,0,0,0,0,0
20150105.215239,2817.76,8,601086,2,0,0,0,0,0
20150105.21524,2817.76,6,601092,6,0,0,0,0,0
20150105.215241,2817.76,414,601506,-62,0,0,0,0,0
20150105.215242,2818,454,601960,94,0,0,0,0,0
20150105.215243,2818.38,60,602020,10,0,0,0,0,0
20150105.215244,2818.38,22,602042,2,0,0,0,0,0
20150105.215245,2817.76,6,602048,2,0,0,0,0,0
20150105.215246,2817.76,18,602066,16,0,0,0,0,0
20150105.215247,2818,4,602070,0,0,0,0,0,0
20150105.215248,2817.76,12,602082,-8,0,0,0,0,0
20150105.215249,2817.76,32,602114,2,0,0,0,0,0
20150105.21525,2817.38,48,602162,-18,0,0,0,0,0
20150105.215251,2818,6,602168,-2,0,0,0,0,0
20150105.215252,2817.76,22,602190,2,0,0,0,0,0
20150105.215253,2817.76,650,602840,402,0,0,0,0,0
20150105.215254,2817.38,6,602846,-2,0,0,0,0,0
20150105.215255,2817.38,340,603186,8,0,0,0,0,0
20150105.215256,2817.38,180,603366,68,0,0,0,0,0
20150105.215257,2817.76,398,603764,56,0,0,0,0,0
20150105.215258,2817.76,46,603810,44,0,0,0,0,0
20150105.215259,2817.14,8,603818,-2,0,0,0,0,0
20150105.2153,2817.76,182,604000,-68,0,0,0,0,0
20150105.215301,2817.76,216,604216,134,0,0,0,0,0
20150105.215302,2818.13,8,604224,4,0,0,0,0,0
20150105.215303,2817.14,22,604246,0,0,0,0,0,0
20150105.215304,2817.51,8,604254,-6,0,0,0,0,0
20150105.215305,2817.14,56,604310,16,0,0,0,0,0
20150105.215306,2817.51,8,604318,0,0,0,0,0,0
20150105.215307,2818.13,8,604326,0,0,0,0,0,0
20150105.215308,2818.13,4,604330,2,0,0,0,0,0
20150105.215309,2817.14,4,604334,2,0,0,0,0,0
20150105.21531,2817.51,6,604340,-6,0,0,0,0,0
20150105.215311,2817.51,10,604350,-8,0,0,0,0,0
20150105.215312,2817.76,12,604362,12,0,0,0,0,0
20150105.215313,2817.51,8,604370,-6,0,0,0,0,0
20150105.215314,2817.76,8,604378,2,0,0,0,0,0
20150105.215315,2817.76,4,604382,2,0,0,0,0,0
20150105.215316,2817.14,12,604394,2,0,0,0,0,0
20150105.215317,2818.13,50,604444,48,0,0,0,0,0
20150105.215318,2818.13,6,604450,2,0,0,0,0,0
20150105.215319,2818.13,302,604752,76,0,0,0,0,0
20150105.21532,2818.13,278,605030,16,0,0,0,0,0
20150105.215321,2817.76,4,605034,-2,0,0,0,0,0
20150105.215322,2818.13,84,605118,-2,0,0,0,0,0
20150105.215323,2818.13,52,605170,16,0,0,0,0,0
20150105.215324,2818.13,28,605198,6,0,0,0,0,0
20150105.215325,2818.13,26,605224,-6,0,0,0,0,0
20150105.215326,2818.75,96,605320,48,0,0,0,0,0
20150105.215327,2818.75,4,605324,4,0,0,0,0,0
20150105.215328,2818.51,12,605336,8,0,0,0,0,0
20150105.215329,2819.12,164,605500,62,0,0,0,0,0
20150105.21533,2818.51,14,605514,0,0,0,0,0,0
20150105.215331,2818.75,164,605678,-74,0,0,0,0,0
20150105.215332,2819.12,474,606152,-42,0,0,0,0,0
20150105.215333,2818.51,8,606160,4,0,0,0,0,0
20150105.215334,2818.51,6,606166,4,0,0,0,0,0
20150105.215335,2819.12,10,606176,-4,0,0,0,0,0
20150105.215336,2819.12,32,606208,-20,0,0,0,0,0
20150105.215337,2818.13,130,606338,96,0,0,0,0,0
20150105.215338,2819.12,248,606586,-182,0,0,0,0,0
20150105.215339,2819.12,6,606592,-2,0,0,0,0,0
20150105.21534,2819.12,14,606606,2,0,0,0,0,0
20150105.215341,2819.12,4,606610,0,0,0,0,0,0
20150105.215342,2818.51,402,607012,240,0,0,0,0,0
20150105.215343,2818.75,4,607016,0,0,0,0,0,0
20150105.215344,2819.12,162,607178,64,0,0,0,0,0
20150105.215345,2819.12,188,607366,140,0,0,0,0,0
20150105.215346,2819.12,8,607374,2,0,0,0,0,0
20150105.215347,2819.12,96,607470,36,0,0,0,0,0
20150105.215348,2818.51,24,607494,0,0,0,0,0,0
20150105.215349,2818.51,4,607498,4,0,0,0,0,0
20150105.21535,2819.12,62,607560,-28,0,0,0,0,0
20150105.215351,2818.51,68,607628,68,0,0,0,0,0
20150105.215352,2818.51,684,608312,-226,0,0,0,0,0
20150105.215353,2818.51,12,608324,-2,0,0,0,0,0
20150105.215354,2818.51,386,608710,110,0,0,0,0,0
20150105.215355,2817.51,1492,610202,690,0,0,0,0,0
20150105.215356,2817.89,36,610238,-10,0,0,0,0,0
20150105.215357,2817.51,124,610362,-2,0,0,0,0,0
20150105.215358,2818.51,6,610368,0,0,0,0,0,0
20150105.215359,2818.13,140,610508,-54,0,0,0,0,0
20150105.2154,2817.89,6,610514,2,0,0,0,0,0
20150105.215401,2818.13,22,610536,20,0,0,0,0,0
20150105.215402,2817.89,222,610758,-162,0,0,0,0,0
20150105.215403,2817.89,4,610762,0,0,0,0,0,0
20150105.215404,2817.89,116,610878,-2,0,0,0,0,0
20150105.215405,2817.89,180,611058,-26,0,0,0,0,0
20150105.215406,2817.89,10,611068,-4,0,0,0,0,0
20150105.215407,2817.89,24,611092,2,0,0,0,0,0
20150105.215408,2817.89,210,611302,-132,0,0,0,0,0
20150105.215409,2818.26,8,611310,0,0,0,0,0,0
20150105.21541,2818.26,4,611314,2,0,0,0,0,0
20150105.215411,2818.26,204,611518,98,0,0,0,0,0
20150105.215412,2817.89,132,611650,-120,0,0,0,0,0
20150105.215413,2817.89,68,611718,38,0,0,0,0,0
20150105.215414,2817.89,202,611920,110,0,0,0,0,0
20150105.215415,2817.89,62,611982,-22,0,0,0,0,0
20150105.215416,2818.26,12,611994,0,0,0,0,0,0
20150105.215417,2817.89,18,612012,-12,0,0,0,0,0
20150105.215418,2817.27,94,612106,2,0,0,0,0,0
20150105.215419,2817.27,78,612184,-2,0,0,0,0,0
20150105.21542,2817.89,4,612188,2,0,0,0,0,0
20150105.215421,2817.89,244,612432,-172,0,0,0,0,0
20150105.215422,2817.89,482,612914,-104,0,0,0,0,0
20150105.215423,2817.89,4,612918,2,0,0,0,0,0
20150105.215424,2817.89,444,613362,24,0,0,0,0,0
20150105.215425,2817.89,350,613712,46,0,0,0,0,0
20150105.215426,2817.51,226,613938,102,0,0,0,0,0
20150105.215427,2817.89,28,613966,24,0,0,0,0,0
20150105.215428,2817.89,4,613970,2,0,0,0,0,0
20150105.215429,2817.89,62,614032,62,0,0,0,0,0
20150105.21543,2817.89,10,614042,10,0,0,0,0,0
20150105.215431,2817.89,16,614058,4,0,0,0,0,0
20150105.215432,2817.89,16,614074,16,0,0,0,0,0
20150105.215433,2818.51,76,614150,-6,0,0,0,0,0
20150105.215434,2818.88,4,614154,-2,0,0,0,0,0
20150105.215435,2818.26,8,614162,6,0,0,0,0,0
20150105.215436,2818.51,24,614186,-22,0,0,0,0,0
20150105.215437,2818.26,4,614190,0,0,0,0,0,0
20150105.215438,2817.89,20,614210,2,0,0,0,0,0
20150105.215439,2818.88,28,614238,24,0,0,0,0,0
20150105.21544,2818.88,10,614248,6,0,0,0,0,0
20150105.215441,2818.26,12,614260,0,0,0,0,0,0
20150105.215442,2818.26,4,614264,2,0,0,0,0,0
20150105.215443,2818.51,208,614472,166,0,0,0,0,0
20150105.215444,2817.89,34,614506,4,0,0,0,0,0
20150105.215445,2818.51,100,614606,94,0,0,0,0,0
20150105.215446,2817.89,12,614618,2,0,0,0,0,0
20150105.215447,2817.89,42,614660,0,0,0,0,0,0
20150105.215448,2817.89,14,614674,10,0,0,0,0,0
20150105.215449,2817.51,10,614684,0,0,0,0,0,0
20150105.21545,2818.13,14,614698,0,0,0,0,0,0
20150105.215451,2818.51,22,614720,2,0,0,0,0,0
20150105.215452,2817.51,444,615164,206,0,0,0,0,0
20150105.215453,2817.51,138,615302,-70,0,0,0,0,0
20150105.215454,2817.89,12,615314,2,0,0,0,0,0
20150105.215455,2818.51,8,615322,-2,0,0,0,0,0
20150105.215456,2818.51,14,615336,4,0,0,0,0,0
20150105.215457,2818.51,12,615348,2,0,0,0,0,0
20150105.215458,2817.89,122,615470,56,0,0,0,0,0
20150105.215459,2817.51,14,615484,12,0,0,0,0,0
20150105.2155,2817.51,306,615790,274,0,0,0,0,0
20150105.215501,2817.51,26,615816,20,0,0,0,0,0
20150105.215502,2818.13,4,615820,2,0,0,0,0,0
20150105.215503,2817.51,6,615826,2,0,0,0,0,0
20150105.215504,2818.13,202,616028,42,0,0,0,0,0
20150105.215505,2817.76,146,616174,-144,0,0,0,0,0
20150105.215506,2818.13,24,616198,2,0,0,0,0,0
20150105.215507,2817.14,20,616218,12,0,0,0,0,0
20150105.215508,2818.13,158,616376,148,0,0,0,0,0
20150105.215509,2818.13,28,616404,-22,0,0,0,0,0
20150105.21551,2818.13,10,616414,2,0,0,0,0,0
20150105.215511,2818.51,32,616446,-28,0,0,0,0,0
20150105.215512,2818.13,4,616450,0,0,0,0,0,0
20150105.215513,2817.89,8,616458,2,0,0,0,0,0
20150105.215514,2817.89,728,617186,328,0,0,0,0,0
20150105.215515,2817.51,224,617410,222,0,0,0,0,0
20150105.215516,2817.51,10,617420,8,0,0,0,0,0
20150105.215517,2817.51,30,617450,2,0,0,0,0,0
20150105.215518,2817.89,22,617472,20,0,0,0,0,0
20150105.215519,2817.89,4,617476,0,0,0,0,0,0
20150105.21552,2817.89,82,617558,82,0,0,0,0,0
20150105.215521,2817.89,4,617562,4,0,0,0,0,0
20150105.215522,2817.89,8,617570,6,0,0,0,0,0
20150105.215523,2817.51,24,617594,0,0,0,0,0,0
20150105.215524,2817.51,46,617640,2,0,0,0,0,0
20150105.215525,2817.51,44,617684,32,0,0,0,0,0
20150105.215526,2817.51,24,617708,24,0,0,0,0,0
20150105.215527,2817.89,4,617712,2,0,0,0,0,0
20150105.215528,2816.89,572,618284,564,0,0,0,0,0
20150105.215529,2817.51,4,618288,4,0,0,0,0,0
20150105.21553,2816.52,384,618672,268,0,0,0,0,0
20150105.215531,2817.51,8,618680,4,0,0,0,0,0
20150105.215532,2817.51,22,618702,20,0,0,0,0,0
20150105.215533,2816.52,14,618716,-10,0,0,0,0,0
20150105.215534,2816.52,10,618726,0,0,0,0,0,0
20150105.215535,2817.51,4,618730,4,0,0,0,0,0
20150105.215536,2816.89,4,618734,2,0,0,0,0,0
20150105.215537,2816.89,12,618746,2,0,0,0,0,0
20150105.215538,2816.52,8,618754,-2,0,0,0,0,0
20150105.215539,2816.89,8,618762,4,0,0,0,0,0
20150105.21554,2817.51,100,618862,90,0,0,0,0,0
20150105.215541,2817.51,204,619066,4,0,0,0,0,0
20150105.215542,2817.51,280,619346,-68,0,0,0,0,0
20150105.215543,2817.51,32,619378,30,0,0,0,0,0
20150105.215544,2817.51,24,619402,18,0,0,0,0,0
20150105.215545,2817.51,10,619412,6,0,0,0,0,0
20150105.215546,2817.51,10,619422,0,0,0,0,0,0
20150105.215547,2817.51,16,619438,-6,0,0,0,0,0
20150105.215548,2817.76,28,619466,0,0,0,0,0,0
20150105.215549,2818.13,38,619504,-30,0,0,0,0,0
20150105.21555,2817.51,240,619744,200,0,0,0,0,0
20150105.215551,2817.51,42,619786,2,0,0,0,0,0
20150105.215552,2818.13,26,619812,8,0,0,0,0,0
20150105.215553,2818.13,32,619844,-12,0,0,0,0,0
20150105.215554,2818.13,22,619866,6,0,0,0,0,0
20150105.215555,2818.13,160,620026,106,0,0,0,0,0
20150105.215556,2818.13,378,620404,88,0,0,0,0,0
20150105.215557,2818.13,6,620410,-2,0,0,0,0,0
20150105.215558,2818.75,24,620434,8,0,0,0,0,0
20150105.215559,2818.13,1204,621638,1002,0,0,0,0,0
20150105.2156,2818.13,22,621660,4,0,0,0,0,0
20150105.215601,2817.76,22,621682,0,0,0,0,0,0
20150105.215602,2817.76,30,621712,0,0,0,0,0,0
20150105.215603,2818.13,102,621814,-98,0,0,0,0,0
20150105.215604,2818.13,14,621828,-8,0,0,0,0,0
20150105.215605,2818.13,42,621870,10,0,0,0,0,0
20150105.215606,2818.13,8,621878,0,0,0,0,0,0
20150105.215607,2818.13,114,621992,26,0,0,0,0,0
20150105.215608,2818.13,6,621998,-4,0,0,0,0,0
20150105.215609,2817.51,1212,623210,1000,0,0,0,0,0
20150105.21561,2817.51,146,623356,-96,0,0,0,0,0
20150105.215611,2817.51,10,623366,-2,0,0,0,0,0
20150105.215612,2817.51,8,623374,2,0,0,0,0,0
20150105.215613,2818.13,80,623454,16,0,0,0,0,0
20150105.215614,2818.13,50,623504,-20,0,0,0,0,0
20150105.215615,2818.13,6,623510,-4,0,0,0,0,0
20150105.215616,2817.51,142,623652,62,0,0,0,0,0
20150105.215617,2817.51,38,623690,0,0,0,0,0,0
20150105.215618,2818.13,264,623954,34,0,0,0,0,0
20150105.215619,2817.51,468,624422,166,0,0,0,0,0
20150105.21562,2817.51,6,624428,0,0,0,0,0,0
20150105.215621,2817.51,24,624452,12,0,0,0,0,0
20150105.215622,2817.51,4,624456,2,0,0,0,0,0
20150105.215623,2817.51,24,624480,16,0,0,0,0,0
20150105.215624,2817.51,16,624496,2,0,0,0,0,0
20150105.215625,2817.51,164,624660,16,0,0,0,0,0
20150105.215626,2817.89,4,624664,4,0,0,0,0,0
20150105.215627,2817.89,22,624686,22,0,0,0,0,0
20150105.215628,2816.9,22,624708,0,0,0,0,0,0
20150105.215629,2817.89,22,624730,14,0,0,0,0,0
20150105.21563,2817.51,32,624762,10,0,0,0,0,0
20150105.215631,2817.89,4,624766,2,0,0,0,0,0
20150105.215632,2817.27,6,624772,2,0,0,0,0,0
20150105.215633,2817.89,10,624782,6,0,0,0,0,0
20150105.215634,2816.9,66,624848,0,0,0,0,0,0
20150105.215635,2817.27,256,625104,150,0,0,0,0,0
20150105.215636,2817.89,6,625110,0,0,0,0,0,0
20150105.215637,2817.89,34,625144,0,0,0,0,0,0
20150105.215638,2817.27,6,625150,4,0,0,0,0,0
20150105.215639,2817.89,440,625590,2,0,0,0,0,0
20150105.21564,2817.27,74,625664,22,0,0,0,0,0
20150105.215641,2817.89,16,625680,6,0,0,0,0,0
20150105.215642,2817.89,282,625962,4,0,0,0,0,0
20150105.215643,2817.89,274,626236,80,0,0,0,0,0
20150105.215644,2817.89,12,626248,10,0,0,0,0,0
20150105.215645,2817.89,122,626370,26,0,0,0,0,0
20150105.215646,2818.26,82,626452,-2,0,0,0,0,0
20150105.215647,2817.89,22,626474,6,0,0,0,0,0
20150105.215648,2818.51,14,626488,-2,0,0,0,0,0
20150105.215649,2818.51,60,626548,-60,0,0,0,0,0
20150105.21565,2817.51,14,626562,-2,0,0,0,0,0
20150105.215651,2818.51,18,626580,2,0,0,0,0,0
20150105.215652,2817.89,66,626646,12,0,0,0,0,0
20150105.215653,2817.89,26,626672,-4,0,0,0,0,0
20150105.215654,2818.51,102,626774,20,0,0,0,0,0
20150105.215655,2817.89,6,626780,-6,0,0,0,0,0
20150105.215656,2817.89,14,626794,4,0,0,0,0,0
20150105.215657,2817.89,8,626802,0,0,0,0,0,0
20150105.215658,2817.89,80,626882,56,0,0,0,0,0
20150105.215659,2817.51,142,627024,0,0,0,0,0,0
20150105.2157,2818.88,96,627120,74,0,0,0,0,0
20150105.215701,2818.26,8,627128,4,0,0,0,0,0
20150105.215702,2818.26,26,627154,0,0,0,0,0,0
20150105.215703,2817.51,8,627162,4,0,0,0,0,0
20150105.215704,2817.89,104,627266,0,0,0,0,0,0
20150105.215705,2817.89,62,627328,38,0,0,0,0,0
20150105.215706,2818.26,24,627352,0,0,0,0,0,0
20150105.215707,2817.51,34,627386,0,0,0,0,0,0
20150105.215708,2818.26,14,627400,0,0,0,0,0,0
20150105.215709,2817.89,116,627516,-6,0,0,0,0,0
20150105.21571,2817.89,4,627520,0,0,0,0,0,0
20150105.215711,2818.26,14,627534,0,0,0,0,0,0
20150105.215712,2818.26,26,627560,0,0,0,0,0,0
20150105.215713,2818.26,4,627564,0,0,0,0,0,0
20150105.215714,2817.89,4,627568,0,0,0,0,0,0
20150105.215715,2818.26,8,627576,-6,0,0,0,0,0
20150105.215716,2818.26,8,627584,0,0,0,0,0,0
20150105.215717,2818.26,28,627612,4,0,0,0,0,0
20150105.215718,2818.26,30,627642,-2,0,0,0,0,0
20150105.215719,2818.26,6,627648,2,0,0,0,0,0
20150105.21572,2818.26,30,627678,4,0,0,0,0,0
20150105.215721,2818.26,14,627692,12,0,0,0,0,0
20150105.215722,2818.26,54,627746,-20,0,0,0,0,0
20150105.215723,2818.26,68,627814,-34,0,0,0,0,0
20150105.215724,2818.88,48,627862,20,0,0,0,0,0
20150105.215725,2818.26,4,627866,0,0,0,0,0,0
20150105.215726,2818.88,16,627882,16,0,0,0,0,0
20150105.215727,2818.88,22,627904,18,0,0,0,0,0
20150105.215728,2818.88,4,627908,0,0,0,0,0,0
20150105.215729,2818.88,160,628068,4,0,0,0,0,0
20150105.21573,2818.88,6,628074,-4,0,0,0,0,0
20150105.215731,2818.88,24,628098,0,0,0,0,0,0
20150105.215732,2818.88,24,628122,-20,0,0,0,0,0
20150105.215733,2818.88,4,628126,0,0,0,0,0,0
20150105.215734,2818.51,4,628130,-2,0,0,0,0,0
20150105.215735,2818.51,14,628144,-14,0,0,0,0,0
20150105.215736,2818.51,428,628572,284,0,0,0,0,0
20150105.215737,2818.51,12,628584,-10,0,0,0,0,0
20150105.215738,2818.88,6,628590,0,0,0,0,0,0
20150105.215739,2818.51,14,628604,-2,0,0,0,0,0
20150105.21574,2817.89,12,628616,-10,0,0,0,0,0
20150105.215741,2818.88,6,628622,0,0,0,0,0,0
20150105.215742,2818.88,22,628644,0,0,0,0,0,0
20150105.215743,2818.88,22,628666,6,0,0,0,0,0
20150105.215744,2818.88,4,628670,2,0,0,0,0,0
20150105.215745,2818.26,322,628992,-322,0,0,0,0,0
20150105.215746,2818.88,8,629000,-2,0,0,0,0,0
20150105.215747,2818.88,4,629004,0,0,0,0,0,0
20150105.215748,2818.88,74,629078,-52,0,0,0,0,0
20150105.215749,2818.88,20,629098,-10,0,0,0,0,0
20150105.21575,2818.88,4,629102,0,0,0,0,0,0
20150105.215751,2818.88,4,629106,2,0,0,0,0,0
20150105.215752,2818.26,4,629110,0,0,0,0,0,0
20150105.215753,2818.88,4,629114,0,0,0,0,0,0
20150105.215754,2818.88,22,629136,-2,0,0,0,0,0
20150105.215755,2817.89,6,629142,-6,0,0,0,0,0
20150105.215756,2818.26,72,629214,-64,0,0,0,0,0
20150105.215757,2818.88,4,629218,2,0,0,0,0,0
20150105.215758,2818.88,12,629230,6,0,0,0,0,0
20150105.215759,2818.88,4,629234,4,0,0,0,0,0
20150105.2158,2818.88,624,629858,-528,0,0,0,0,0
20150105.215801,2818.88,10,629868,2,0,0,0,0,0
20150105.215802,2818.88,12,629880,2,0,0,0,0,0
20150105.215803,2818.5,6,629886,-2,0,0,0,0,0
20150105.215804,2818.26,64,629950,60,0,0,0,0,0
20150105.215805,2818.51,12,629962,10,0,0,0,0,0
20150105.215806,2817.89,20,629982,-2,0,0,0,0,0
20150105.215807,2818.51,8,629990,4,0,0,0,0,0
20150105.215808,2818.26,14,630004,0,0,0,0,0,0
20150105.215809,2817.89,46,630050,34,0,0,0,0,0
20150105.21581,2817.89,184,630234,-28,0,0,0,0,0
20150105.215811,2818.5,326,630560,320,0,0,0,0,0
20150105.215812,2817.89,6,630566,-2,0,0,0,0,0
20150105.215813,2818.5,6,630572,2,0,0,0,0,0
20150105.215814,2817.89,210,630782,-34,0,0,0,0,0
20150105.215815,2818.88,60,630842,46,0,0,0,0,0
20150105.215816,2817.89,4,630846,0,0,0,0,0,0
20150105.215817,2818.26,46,630892,4,0,0,0,0,0
20150105.215818,2818.26,48,630940,14,0,0,0,0,0
20150105.215819,2818.5,174,631114,110,0,0,0,0,0
20150105.21582,2818.5,544,631658,94,0,0,0,0,0
20150105.215821,2818.5,10,631668,-2,0,0,0,0,0
20150105.215822,2818.5,14,631682,12,0,0,0,0,0
20150105.215823,2817.89,10,631692,0,0,0,0,0,0
20150105.215824,2818.5,16,631708,14,0,0,0,0,0
20150105.215825,2818.26,44,631752,0,0,0,0,0,0
20150105.215826,2818.5,24,631776,0,0,0,0,0,0
20150105.215827,2818.5,4,631780,2,0,0,0,0,0
20150105.215828,2818.5,4,631784,2,0,0,0,0,0
20150105.215829,2818.51,770,632554,464,0,0,0,0,0
20150105.21583,2818.51,490,633044,14,0,0,0,0,0
20150105.215831,2818.5,16,633060,-2,0,0,0,0,0
20150105.215832,2818.88,6,633066,0,0,0,0,0,0
20150105.215833,2817.89,14,633080,14,0,0,0,0,0
20150105.215834,2818.88,4,633084,2,0,0,0,0,0
20150105.215835,2818.88,12,633096,2,0,0,0,0,0
20150105.215836,2818.5,26,633122,-14,0,0,0,0,0
20150105.215837,2817.89,140,633262,-128,0,0,0,0,0
20150105.215838,2818.51,42,633304,0,0,0,0,0,0
20150105.215839,2817.89,32,633336,20,0,0,0,0,0
20150105.21584,2817.89,12,633348,10,0,0,0,0,0
20150105.215841,2818.26,8,633356,6,0,0,0,0,0
20150105.215842,2818.26,242,633598,-86,0,0,0,0,0
20150105.215843,2817.89,26,633624,0,0,0,0,0,0
20150105.215844,2818.51,164,633788,104,0,0,0,0,0
20150105.215845,2818.51,202,633990,-130,0,0,0,0,0
20150105.215846,2817.89,74,634064,-10,0,0,0,0,0
20150105.215847,2818.26,188,634252,-58,0,0,0,0,0
20150105.215848,2818.88,40,634292,18,0,0,0,0,0
20150105.215849,2818.51,32,634324,-28,0,0,0,0,0
20150105.21585,2818.88,14,634338,8,0,0,0,0,0
20150105.215851,2818.88,10,634348,4,0,0,0,0,0
20150105.215852,2818.13,146,634494,32,0,0,0,0,0
20150105.215853,2818.51,4,634498,2,0,0,0,0,0
20150105.215854,2817.89,12,634510,10,0,0,0,0,0
20150105.215855,2818.88,48,634558,-22,0,0,0,0,0
20150105.215856,2818.26,20,634578,0,0,0,0,0,0
20150105.215857,2818.88,4,634582,0,0,0,0,0,0
20150105.215858,2818.13,10,634592,-4,0,0,0,0,0
20150105.215859,2817.51,18,634610,2,0,0,0,0,0
20150105.2159,2818.51,38,634648,2,0,0,0,0,0
20150105.215901,2818.51,44,634692,12,0,0,0,0,0
20150105.215902,2817.89,42,634734,-24,0,0,0,0,0
20150105.215903,2817.89,52,634786,0,0,0,0,0,0
20150105.215904,2817.51,330,635116,126,0,0,0,0,0
20150105.215905,2818.26,20,635136,0,0,0,0,0,0
20150105.215906,2818.26,22,635158,10,0,0,0,0,0
20150105.215907,2817.89,6,635164,4,0,0,0,0,0
20150105.215908,2818.26,18,635182,0,0,0,0,0,0
20150105.215909,2818.26,4,635186,0,0,0,0,0,0
20150105.21591,2818.51,6,635192,2,0,0,0,0,0
20150105.215911,2818.88,14,635206,0,0,0,0,0,0
20150105.215912,2817.51,4,635210,4,0,0,0,0,0
20150105.215913,2817.89,38,635248,-4,0,0,0,0,0
20150105.215914,2818.51,4,635252,2,0,0,0,0,0
20150105.215915,2818.51,8,635260,4,0,0,0,0,0
20150105.215916,2818.51,22,635282,-20,0,0,0,0,0
20150105.215917,2818.51,12,635294,2,0,0,0,0,0
20150105.215918,2817.51,20,635314,-18,0,0,0,0,0
20150105.215919,2817.89,16,635330,-8,0,0,0,0,0
20150105.21592,2818.51,6,635336,2,0,0,0,0,0
20150105.215921,2818.26,114,635450,22,0,0,0,0,0
20150105.215922,2818.26,34,635484,-28,0,0,0,0,0
20150105.215923,2818.51,8,635492,0,0,0,0,0,0
20150105.215924,2818.26,34,635526,-14,0,0,0,0,0
20150105.215925,2818.51,54,635580,34,0,0,0,0,0
20150105.215926,2817.89,12,635592,0,0,0,0,0,0
20150105.215927,2817.89,12,635604,0,0,0,0,0,0
20150105.215928,2818.26,410,636014,-106,0,0,0,0,0
20150105.215929,2818.51,6,636020,0,0,0,0,0,0
20150105.21593,2817.51,8,636028,0,0,0,0,0,0
20150105.215931,2817.89,8,636036,-6,0,0,0,0,0
20150105.215932,2818.13,6,636042,6,0,0,0,0,0
20150105.215933,2818.13,26,636068,26,0,0,0,0,0
20150105.215934,2818.13,22,636090,22,0,0,0,0,0
20150105.215935,2818.13,4,636094,4,0,0,0,0,0
20150105.215936,2818.13,4,636098,2,0,0,0,0,0
20150105.215937,2818.13,16,636114,2,0,0,0,0,0
20150105.215938,2817.51,24,636138,-20,0,0,0,0,0
20150105.215939,2818.13,4,636142,4,0,0,0,0,0
20150105.21594,2818.13,46,636188,8,0,0,0,0,0
20150105.215941,2818.13,10,636198,8,0,0,0,0,0
20150105.215942,2818.13,32,636230,30,0,0,0,0,0
20150105.215943,2818.13,6,636236,4,0,0,0,0,0
20150105.215944,2817.51,6,636242,4,0,0,0,0,0
20150105.215945,2817.89,22,636264,0,0,0,0,0,0
20150105.215946,2818.51,22,636286,12,0,0,0,0,0
20150105.215947,2818.51,190,636476,-146,0,0,0,0,0
20150105.215948,2818.51,68,636544,2,0,0,0,0,0
20150105.215949,2817.51,154,636698,60,0,0,0,0,0
20150105.21595,2818.13,328,637026,274,0,0,0,0,0
20150105.215951,2817.51,528,637554,368,0,0,0,0,0
20150105.215952,2817.51,12,637566,-8,0,0,0,0,0
20150105.215953,2818.13,24,637590,24,0,0,0,0,0
20150105.215954,2818.13,22,637612,2,0,0,0,0,0
20150105.215955,2817.76,104,637716,0,0,0,0,0,0
20150105.215956,2817.14,6,637722,4,0,0,0,0,0
20150105.215957,2817.76,532,638254,362,0,0,0,0,0
20150105.215958,2817.76,298,638552,190,0,0,0,0,0
20150105.215959,2817.14,34,638586,28,0,0,0,0,0
20150105.22,2817.76,90,638676,-74,0,0,0,0,0
20150105.220001,2817.76,94,638770,-30,0,0,0,0,0
20150105.220002,2817.38,16,638786,0,0,0,0,0,0
20150105.220003,2817.76,4,638790,0,0,0,0,0,0
20150105.220004,2817.76,4,638794,2,0,0,0,0,0
20150105.220005,2817.76,212,639006,206,0,0,0,0,0
20150105.220006,2817.76,6,639012,2,0,0,0,0,0
20150105.220007,2817.14,16,639028,-10,0,0,0,0,0
20150105.220008,2817.76,204,639232,132,0,0,0,0,0
20150105.220009,2817.76,18,639250,0,0,0,0,0,0
20150105.22001,2817.76,36,639286,-22,0,0,0,0,0
20150105.220011,2817.38,46,639332,20,0,0,0,0,0
20150105.220012,2816.76,6,639338,2,0,0,0,0,0
20150105.220013,2817.38,8,639346,2,0,0,0,0,0
20150105.220014,2817.38,6,639352,2,0,0,0,0,0
20150105.220015,2817.38,4,639356,2,0,0,0,0,0
20150105.220016,2817.38,70,639426,-10,0,0,0,0,0
20150105.220017,2817.38,22,639448,2,0,0,0,0,0
20150105.220018,2817.38,6,639454,-2,0,0,0,0,0
20150105.220019,2817.38,6,639460,2,0,0,0,0,0
20150105.22002,2817.38,4,639464,2,0,0,0,0,0
20150105.220021,2817.38,86,639550,82,0,0,0,0,0
20150105.220022,2817.38,300,639850,-42,0,0,0,0,0
20150105.220023,2817.76,106,639956,4,0,0,0,0,0
20150105.220024,2817.38,82,640038,-42,0,0,0,0,0
20150105.220025,2817.38,24,640062,16,0,0,0,0,0
20150105.220026,2817.76,6,640068,-4,0,0,0,0,0
20150105.220027,2817.76,8,640076,2,0,0,0,0,0
20150105.220028,2817.76,42,640118,-2,0,0,0,0,0
20150105.220029,2817.76,4,640122,0,0,0,0,0,0
20150105.22003,2817.76,14,640136,-4,0,0,0,0,0
20150105.220031,2818.37,6,640142,4,0,0,0,0,0
20150105.220032,2818.37,26,640168,12,0,0,0,0,0
20150105.220033,2818,12,640180,0,0,0,0,0,0
20150105.220034,2818.37,4,640184,2,0,0,0,0,0
20150105.220035,2817.76,4,640188,0,0,0,0,0,0
20150105.220036,2818,34,640222,-24,0,0,0,0,0
20150105.220037,2818,62,640284,-18,0,0,0,0,0
20150105.220038,2818,12,640296,2,0,0,0,0,0
20150105.220039,2818,4,640300,0,0,0,0,0,0
20150105.22004,2817.38,6,640306,2,0,0,0,0,0
20150105.220041,2817.38,24,640330,0,0,0,0,0,0
20150105.220042,2818,18,640348,14,0,0,0,0,0
20150105.220043,2818,24,640372,16,0,0,0,0,0
20150105.220044,2818.37,190,640562,0,0,0,0,0,0
20150105.220045,2818.37,264,640826,-148,0,0,0,0,0
20150105.220046,2817.76,610,641436,-348,0,0,0,0,0
20150105.220047,2818.75,32,641468,32,0,0,0,0,0
20150105.220048,2817.76,4,641472,4,0,0,0,0,0
20150105.220049,2818.13,82,641554,2,0,0,0,0,0
20150105.22005,2818.75,104,641658,-4,0,0,0,0,0
20150105.220051,2818.38,22,641680,22,0,0,0,0,0
20150105.220052,2817.76,10,641690,10,0,0,0,0,0
20150105.220053,2818.38,136,641826,136,0,0,0,0,0
20150105.220054,2818,96,641922,94,0,0,0,0,0
20150105.220055,2817.38,64,641986,64,0,0,0,0,0
20150105.220056,2818,18,642004,12,0,0,0,0,0
20150105.220057,2818,14,642018,6,0,0,0,0,0
20150105.220058,2818,24,642042,4,0,0,0,0,0
20150105.220059,2818,174,642216,68,0,0,0,0,0
20150105.2201,2818,50,642266,46,0,0,0,0,0
20150105.220101,2818.37,74,642340,66,0,0,0,0,0
20150105.220102,2818.37,14,642354,2,0,0,0,0,0
20150105.220103,2818.37,78,642432,6,0,0,0,0,0
20150105.220104,2817.76,34,642466,34,0,0,0,0,0
20150105.220105,2818.37,4,642470,-2,0,0,0,0,0
20150105.220106,2817.76,14,642484,12,0,0,0,0,0
20150105.220107,2817.76,10,642494,10,0,0,0,0,0
20150105.220108,2818.37,210,642704,112,0,0,0,0,0
20150105.220109,2818.37,26,642730,22,0,0,0,0,0
20150105.22011,2817.76,156,642886,84,0,0,0,0,0
20150105.220111,2818.37,82,642968,82,0,0,0,0,0
20150105.220112,2818,172,643140,146,0,0,0,0,0
20150105.220113,2818,256,643396,118,0,0,0,0,0
20150105.220114,2818.37,46,643442,10,0,0,0,0,0
20150105.220115,2818.37,16,643458,-12,0,0,0,0,0
20150105.220116,2818.37,210,643668,-30,0,0,0,0,0
20150105.220117,2818.37,124,643792,4,0,0,0,0,0
20150105.220118,2818.37,46,643838,-40,0,0,0,0,0
20150105.220119,2818.37,326,644164,244,0,0,0,0,0
20150105.22012,2818.38,22,644186,6,0,0,0,0,0
20150105.220121,2818.38,14,644200,4,0,0,0,0,0
20150105.220122,2818.37,22,644222,2,0,0,0,0,0
20150105.220123,2818.37,6,644228,0,0,0,0,0,0
20150105.220124,2818.37,12,644240,0,0,0,0,0,0
20150105.220125,2818.37,14,644254,8,0,0,0,0,0
20150105.220126,2818.38,6,644260,2,0,0,0,0,0
20150105.220127,2818.75,6,644266,6,0,0,0,0,0
20150105.220128,2818.75,12,644278,12,0,0,0,0,0
20150105.220129,2817.76,12,644290,2,0,0,0,0,0
20150105.22013,2818.38,24,644314,4,0,0,0,0,0
20150105.220131,2818.38,22,644336,20,0,0,0,0,0
20150105.220132,2818.75,420,644756,-382,0,0,0,0,0
20150105.220133,2818.75,110,644866,-100,0,0,0,0,0
20150105.220134,2818.75,22,644888,2,0,0,0,0,0
20150105.220135,2818.75,4,644892,0,0,0,0,0,0
20150105.220136,2818.37,116,645008,110,0,0,0,0,0
20150105.220137,2818.37,6,645014,0,0,0,0,0,0
20150105.220138,2818.75,6,645020,-4,0,0,0,0,0
20150105.220139,2818.75,6,645026,4,0,0,0,0,0
20150105.22014,2818.37,22,645048,0,0,0,0,0,0
20150105.220141,2818.13,72,645120,68,0,0,0,0,0
20150105.220142,2818.37,404,645524,-356,0,0,0,0,0
20150105.220143,2818.75,4,645528,2,0,0,0,0,0
20150105.220144,2818.75,4,645532,2,0,0,0,0,0
20150105.220145,2818.37,8,645540,-2,0,0,0,0,0
20150105.220146,2818.75,26,645566,2,0,0,0,0,0
20150105.220147,2818.75,24,645590,20,0,0,0,0,0
20150105.220148,2818.37,22,645612,0,0,0,0,0,0
20150105.220149,2818.37,14,645626,-4,0,0,0,0,0
20150105.22015,2818.75,8,645634,4,0,0,0,0,0
20150105.220151,2818.75,14,645648,6,0,0,0,0,0
20150105.220152,2818.37,382,646030,-104,0,0,0,0,0
20150105.220153,2818.37,42,646072,0,0,0,0,0,0
20150105.220154,2818.37,44,646116,40,0,0,0,0,0
20150105.220155,2818.75,28,646144,28,0,0,0,0,0
20150105.220156,2818.75,22,646166,22,0,0,0,0,0
20150105.220157,2818.37,30,646196,10,0,0,0,0,0
20150105.220158,2818.37,16,646212,6,0,0,0,0,0
20150105.220159,2818.75,4,646216,4,0,0,0,0,0
20150105.2202,2818.75,12,646228,12,0,0,0,0,0
20150105.220201,2818.37,8,646236,6,0,0,0,0,0
20150105.220202,2818.37,60,646296,26,0,0,0,0,0
20150105.220203,2817.76,20,646316,8,0,0,0,0,0
20150105.220204,2818.37,8,646324,6,0,0,0,0,0
20150105.220205,2818.37,36,646360,14,0,0,0,0,0
20150105.220206,2817.76,20,646380,16,0,0,0,0,0
20150105.220207,2818.75,12,646392,12,0,0,0,0,0
20150105.220208,2818.75,4,646396,2,0,0,0,0,0
20150105.220209,2818.75,402,646798,400,0,0,0,0,0
20150105.22021,2818.37,4,646802,0,0,0,0,0,0
20150105.220211,2818.13,102,646904,102,0,0,0,0,0
20150105.220212,2818.75,102,647006,62,0,0,0,0,0
20150105.220213,2818.37,190,647196,146,0,0,0,0,0
20150105.220214,2818,12,647208,4,0,0,0,0,0
20150105.220215,2818,18,647226,-2,0,0,0,0,0
20150105.220216,2817.75,52,647278,-28,0,0,0,0,0
20150105.220217,2818.37,214,647492,-22,0,0,0,0,0
20150105.220218,2818.37,62,647554,-38,0,0,0,0,0
20150105.220219,2818.37,178,647732,0,0,0,0,0,0
20150105.22022,2818.37,16,647748,-12,0,0,0,0,0
20150105.220221,2817.75,8,647756,2,0,0,0,0,0
20150105.220222,2817.75,4,647760,2,0,0,0,0,0
20150105.220223,2818.37,24,647784,20,0,0,0,0,0
20150105.220224,2817.75,6,647790,6,0,0,0,0,0
20150105.220225,2817.75,44,647834,0,0,0,0,0,0
20150105.220226,2817.38,4,647838,-2,0,0,0,0,0
20150105.220227,2818,42,647880,-6,0,0,0,0,0
20150105.220228,2818,4,647884,2,0,0,0,0,0
20150105.220229,2817.38,6,647890,2,0,0,0,0,0
20150105.22023,2818,168,648058,138,0,0,0,0,0
20150105.220231,2817.38,116,648174,-62,0,0,0,0,0
20150105.220232,2818,4,648178,2,0,0,0,0,0
20150105.220233,2818,42,648220,42,0,0,0,0,0
20150105.220234,2818,20,648240,8,0,0,0,0,0
20150105.220235,2817.38,4,648244,4,0,0,0,0,0
20150105.220236,2817.38,46,648290,12,0,0,0,0,0
20150105.220237,2817.62,50,648340,2,0,0,0,0,0
20150105.220238,2817.62,34,648374,4,0,0,0,0,0
20150105.220239,2817.62,96,648470,14,0,0,0,0,0
20150105.22024,2817.62,30,648500,30,0,0,0,0,0
20150105.220241,2817.62,312,648812,170,0,0,0,0,0
20150105.220242,2817.62,34,648846,34,0,0,0,0,0
20150105.220243,2817.62,278,649124,150,0,0,0,0,0
20150105.220244,2817.62,72,649196,24,0,0,0,0,0
20150105.220245,2817.25,52,649248,20,0,0,0,0,0
20150105.220246,2817.86,10,649258,2,0,0,0,0,0
20150105.220247,2817.62,72,649330,66,0,0,0,0,0
20150105.220248,2817.86,26,649356,14,0,0,0,0,0
20150105.220249,2817.62,12,649368,12,0,0,0,0,0
20150105.22025,2817.25,50,649418,10,0,0,0,0,0
20150105.220251,2817.62,12,649430,10,0,0,0,0,0
20150105.220252,2818.24,10,649440,6,0,0,0,0,0
20150105.220253,2817.62,206,649646,-26,0,0,0,0,0
20150105.220254,2818.61,22,649668,-10,0,0,0,0,0
20150105.220255,2818.61,12,649680,10,0,0,0,0,0
20150105.220256,2818.24,8,649688,0,0,0,0,0,0
20150105.220257,2818.24,102,649790,4,0,0,0,0,0
20150105.220258,2818.24,1100,650890,742,0,0,0,0,0
20150105.220259,2818.86,30,650920,10,0,0,0,0,0
20150105.2203,2818.24,56,650976,10,0,0,0,0,0
20150105.220301,2818.86,90,651066,12,0,0,0,0,0
20150105.220302,2818.86,44,651110,-2,0,0,0,0,0
20150105.220303,2818.86,96,651206,-8,0,0,0,0,0
20150105.220304,2818.86,24,651230,10,0,0,0,0,0
20150105.220305,2818.86,10,651240,4,0,0,0,0,0
20150105.220306,2818.86,22,651262,0,0,0,0,0,0
20150105.220307,2818.86,8,651270,4,0,0,0,0,0
20150105.220308,2818.86,22,651292,-4,0,0,0,0,0
20150105.220309,2818.24,520,651812,-408,0,0,0,0,0
20150105.22031,2818.24,128,651940,-30,0,0,0,0,0
20150105.220311,2818.86,114,652054,-2,0,0,0,0,0
20150105.220312,2818.24,188,652242,56,0,0,0,0,0
20150105.220313,2818.24,26,652268,2,0,0,0,0,0
20150105.220314,2819.23,48,652316,2,0,0,0,0,0
20150105.220315,2818.86,6,652322,0,0,0,0,0,0
20150105.220316,2818.61,6,652328,0,0,0,0,0,0
20150105.220317,2819.23,22,652350,18,0,0,0,0,0
20150105.220318,2818.48,804,653154,-134,0,0,0,0,0
20150105.220319,2818.24,248,653402,-8,0,0,0,0,0
20150105.22032,2818.61,6,653408,6,0,0,0,0,0
20150105.220321,2817.86,10,653418,-2,0,0,0,0,0
20150105.220322,2818.61,26,653444,-16,0,0,0,0,0
20150105.220323,2818.24,14,653458,10,0,0,0,0,0
20150105.220324,2818.24,8,653466,2,0,0,0,0,0
20150105.220325,2818.24,10,653476,2,0,0,0,0,0
20150105.220326,2817.62,12,653488,8,0,0,0,0,0
20150105.220327,2817.86,12,653500,0,0,0,0,0,0
20150105.220328,2817.86,18,653518,0,0,0,0,0,0
20150105.220329,2817.86,10,653528,-6,0,0,0,0,0
20150105.22033,2817.86,8,653536,0,0,0,0,0,0
20150105.220331,2817.86,70,653606,-60,0,0,0,0,0
20150105.220332,2818.24,188,653794,28,0,0,0,0,0
20150105.220333,2818.24,98,653892,-70,0,0,0,0,0
20150105.220334,2817.86,24,653916,2,0,0,0,0,0
20150105.220335,2817.86,22,653938,0,0,0,0,0,0
20150105.220336,2818.24,8,653946,-4,0,0,0,0,0
20150105.220337,2818.24,4,653950,-2,0,0,0,0,0
20150105.220338,2817.86,92,654042,88,0,0,0,0,0
20150105.220339,2817.86,10,654052,-2,0,0,0,0,0
20150105.22034,2818.24,8,654060,-4,0,0,0,0,0
20150105.220341,2817.86,8,654068,8,0,0,0,0,0
20150105.220342,2817.86,212,654280,190,0,0,0,0,0
20150105.220343,2818.24,6,654286,2,0,0,0,0,0
20150105.220344,2818.24,6,654292,2,0,0,0,0,0
20150105.220345,2817.86,4,654296,2,0,0,0,0,0
20150105.220346,2818.24,24,654320,12,0,0,0,0,0
20150105.220347,2818.24,66,654386,0,0,0,0,0,0
20150105.220348,2818.24,194,654580,8,0,0,0,0,0
20150105.220349,2818.24,10,654590,0,0,0,0,0,0
20150105.22035,2818.24,14,654604,0,0,0,0,0,0
20150105.220351,2818.24,224,654828,38,0,0,0,0,0
20150105.220352,2818.24,196,655024,-106,0,0,0,0,0
20150105.220353,2818.24,30,655054,0,0,0,0,0,0
20150105.220354,2818.24,26,655080,22,0,0,0,0,0
20150105.220355,2818.61,82,655162,2,0,0,0,0,0
20150105.220356,2818.24,132,655294,2,0,0,0,0,0
20150105.220357,2818.24,112,655406,0,0,0,0,0,0
20150105.220358,2818.24,18,655424,10,0,0,0,0,0
20150105.220359,2818.24,132,655556,8,0,0,0,0,0
20150105.2204,2818.24,232,655788,-176,0,0,0,0,0
20150105.220401,2817.62,12,655800,-2,0,0,0,0,0
20150105.220402,2818,12,655812,4,0,0,0,0,0
20150105.220403,2818.61,46,655858,34,0,0,0,0,0
20150105.220404,2818.61,4,655862,0,0,0,0,0,0
20150105.220405,2818.24,88,655950,2,0,0,0,0,0
20150105.220406,2818.61,12,655962,-10,0,0,0,0,0
20150105.220407,2818.24,172,656134,68,0,0,0,0,0
20150105.220408,2818.24,192,656326,168,0,0,0,0,0
20150105.220409,2818.24,328,656654,-16,0,0,0,0,0
20150105.22041,2818.24,4,656658,-2,0,0,0,0,0
20150105.220411,2818.24,38,656696,-10,0,0,0,0,0
20150105.220412,2818.24,12,656708,0,0,0,0,0,0
20150105.220413,2817.86,6,656714,-2,0,0,0,0,0
20150105.220414,2817.86,48,656762,12,0,0,0,0,0
20150105.220415,2818.24,18,656780,2,0,0,0,0,0
20150105.220416,2818.24,102,656882,96,0,0,0,0,0
20150105.220417,2818.24,18,656900,4,0,0,0,0,0
20150105.220418,2817.86,108,657008,104,0,0,0,0,0
20150105.220419,2817.86,8,657016,-4,0,0,0,0,0
20150105.22042,2817.62,6,657022,2,0,0,0,0,0
20150105.220421,2817.86,270,657292,-94,0,0,0,0,0
20150105.220422,2817.86,258,657550,-18,0,0,0,0,0
20150105.220423,2818.24,94,657644,-76,0,0,0,0,0
20150105.220424,2818.24,4,657648,0,0,0,0,0,0
20150105.220425,2818.24,10,657658,0,0,0,0,0,0
20150105.220426,2818.24,6,657664,-2,0,0,0,0,0
20150105.220427,2817.86,42,657706,40,0,0,0,0,0
20150105.220428,2818.86,12,657718,2,0,0,0,0,0
20150105.220429,2818.24,96,657814,6,0,0,0,0,0
20150105.22043,2817.86,12,657826,10,0,0,0,0,0
20150105.220431,2818.24,240,658066,100,0,0,0,0,0
20150105.220432,2818.61,202,658268,200,0,0,0,0,0
20150105.220433,2818.61,258,658526,108,0,0,0,0,0
20150105.220434,2817.62,808,659334,452,0,0,0,0,0
20150105.220435,2817.87,12,659346,0,0,0,0,0,0
20150105.220436,2817.62,184,659530,-130,0,0,0,0,0
20150105.220437,2817.62,226,659756,-24,0,0,0,0,0
20150105.220438,2818.24,38,659794,-32,0,0,0,0,0
20150105.220439,2818.24,244,660038,-78,0,0,0,0,0
20150105.22044,2818.24,388,660426,-56,0,0,0,0,0
20150105.220441,2818.24,8,660434,0,0,0,0,0,0
20150105.220442,2818.24,6,660440,-4,0,0,0,0,0
20150105.220443,2818.24,4,660444,0,0,0,0,0,0
20150105.220444,2818.24,102,660546,-98,0,0,0,0,0
20150105.220445,2817.87,10,660556,-2,0,0,0,0,0
20150105.220446,2818.24,24,660580,16,0,0,0,0,0
20150105.220447,2818.24,10,660590,0,0,0,0,0,0
20150105.220448,2818.86,44,660634,-20,0,0,0,0,0
20150105.220449,2817.87,34,660668,-30,0,0,0,0,0
20150105.22045,2818.48,12,660680,0,0,0,0,0,0
20150105.220451,2818.24,26,660706,20,0,0,0,0,0
20150105.220452,2818.86,10,660716,4,0,0,0,0,0
20150105.220453,2818.24,4,660720,2,0,0,0,0,0
20150105.220454,2818.24,172,660892,58,0,0,0,0,0
20150105.220455,2818.86,34,660926,10,0,0,0,0,0
20150105.220456,2818.86,8,660934,2,0,0,0,0,0
20150105.220457,2818.24,8,660942,-4,0,0,0,0,0
20150105.220458,2818.24,4,660946,2,0,0,0,0,0
20150105.220459,2818.24,102,661048,88,0,0,0,0,0
20150105.2205,2818.86,12,661060,0,0,0,0,0,0
20150105.220501,2817.86,236,661296,208,0,0,0,0,0
20150105.220502,2818.48,234,661530,148,0,0,0,0,0
20150105.220503,2817.86,280,661810,-10,0,0,0,0,0
20150105.220504,2818.48,4,661814,0,0,0,0,0,0
20150105.220505,2817.86,30,661844,-4,0,0,0,0,0
20150105.220506,2817.86,24,661868,10,0,0,0,0,0
20150105.220507,2818.86,14,661882,0,0,0,0,0,0
20150105.220508,2818.86,22,661904,-2,0,0,0,0,0
20150105.220509,2818.48,4,661908,0,0,0,0,0,0
20150105.22051,2818.48,10,661918,8,0,0,0,0,0
20150105.220511,2817.86,22,661940,18,0,0,0,0,0
20150105.220512,2818.11,20,661960,4,0,0,0,0,0
20150105.220513,2817.49,26,661986,-24,0,0,0,0,0
20150105.220514,2817.86,12,661998,0,0,0,0,0,0
20150105.220515,2817.86,84,662082,24,0,0,0,0,0
20150105.220516,2817.86,6,662088,-2,0,0,0,0,0
20150105.220517,2817.86,236,662324,22,0,0,0,0,0
20150105.220518,2817.86,320,662644,-194,0,0,0,0,0
20150105.220519,2817.25,14,662658,-2,0,0,0,0,0
20150105.22052,2817.86,6,662664,2,0,0,0,0,0
20150105.220521,2817.86,982,663646,530,0,0,0,0,0
20150105.220522,2817.86,8,663654,-2,0,0,0,0,0
20150105.220523,2817.86,22,663676,8,0,0,0,0,0
20150105.220524,2817.86,6,663682,6,0,0,0,0,0
20150105.220525,2817.49,52,663734,-2,0,0,0,0,0
20150105.220526,2817.86,8,663742,4,0,0,0,0,0
20150105.220527,2817.86,22,663764,22,0,0,0,0,0
20150105.220528,2817.86,4,663768,2,0,0,0,0,0
20150105.220529,2817.86,10,663778,4,0,0,0,0,0
20150105.22053,2817.86,12,663790,12,0,0,0,0,0
20150105.220531,2817.25,14,663804,-2,0,0,0,0,0
20150105.220532,2817.49,14,663818,2,0,0,0,0,0
20150105.220533,2817.25,6,663824,2,0,0,0,0,0
20150105.220534,2817.49,22,663846,2,0,0,0,0,0
20150105.220535,2816.87,20,663866,0,0,0,0,0,0
20150105.220536,2817.25,6,663872,2,0,0,0,0,0
20150105.220537,2816.87,8,663880,-6,0,0,0,0,0
20150105.220538,2817.25,6,663886,4,0,0,0,0,0
20150105.220539,2817.25,56,663942,-10,0,0,0,0,0
20150105.22054,2817.86,10,663952,2,0,0,0,0,0
20150105.220541,2817.86,68,664020,-36,0,0,0,0,0
20150105.220542,2818.24,10,664030,10,0,0,0,0,0
20150105.220543,2817.62,50,664080,-10,0,0,0,0,0
20150105.220544,2817.86,46,664126,6,0,0,0,0,0
20150105.220545,2817.25,22,664148,-22,0,0,0,0,0
20150105.220546,2818.24,22,664170,22,0,0,0,0,0
20150105.220547,2817.25,80,664250,-40,0,0,0,0,0
20150105.220548,2817.86,4,664254,2,0,0,0,0,0
20150105.220549,2817.25,68,664322,10,0,0,0,0,0
20150105.22055,2817.86,18,664340,-2,0,0,0,0,0
20150105.220551,2817.86,88,664428,22,0,0,0,0,0
20150105.220552,2817.86,60,664488,22,0,0,0,0,0
20150105.220553,2817.86,6,664494,-4,0,0,0,0,0
20150105.220554,2817.86,4,664498,2,0,0,0,0,0
20150105.220555,2817.86,166,664664,-50,0,0,0,0,0
20150105.220556,2817.86,8,664672,6,0,0,0,0,0
20150105.220557,2817.86,82,664754,2,0,0,0,0,0
20150105.220558,2818.24,14,664768,14,0,0,0,0,0
20150105.220559,2818.24,4,664772,2,0,0,0,0,0
20150105.2206,2817.25,12,664784,-6,0,0,0,0,0
20150105.220601,2817.25,10,664794,6,0,0,0,0,0
20150105.220602,2818.24,24,664818,24,0,0,0,0,0
20150105.220603,2818.24,14,664832,4,0,0,0,0,0
20150105.220604,2817.25,94,664926,-2,0,0,0,0,0
20150105.220605,2817.25,218,665144,-10,0,0,0,0,0
20150105.220606,2817.25,42,665186,36,0,0,0,0,0
20150105.220607,2817.62,8,665194,6,0,0,0,0,0
20150105.220608,2817.86,472,665666,378,0,0,0,0,0
20150105.220609,2817.86,262,665928,-182,0,0,0,0,0
20150105.22061,2817.86,22,665950,0,0,0,0,0,0
20150105.220611,2817.86,102,666052,12,0,0,0,0,0
20150105.220612,2817.25,8,666060,-8,0,0,0,0,0
20150105.220613,2818.24,42,666102,42,0,0,0,0,0
20150105.220614,2818.24,6,666108,6,0,0,0,0,0
20150105.220615,2818.24,10,666118,0,0,0,0,0,0
20150105.220616,2817.62,6,666124,6,0,0,0,0,0
20150105.220617,2817.86,4,666128,2,0,0,0,0,0
20150105.220618,2818.24,124,666252,-6,0,0,0,0,0
20150105.220619,2818.24,4,666256,4,0,0,0,0,0
20150105.22062,2817.86,206,666462,94,0,0,0,0,0
20150105.220621,2818.24,158,666620,80,0,0,0,0,0
20150105.220622,2817.86,584,667204,-360,0,0,0,0,0
20150105.220623,2818.24,344,667548,24,0,0,0,0,0
20150105.220624,2818.24,152,667700,-44,0,0,0,0,0
20150105.220625,2818.24,8,667708,2,0,0,0,0,0
20150105.220626,2818.24,242,667950,-64,0,0,0,0,0
20150105.220627,2818.86,270,668220,-16,0,0,0,0,0
20150105.220628,2818.61,6,668226,-6,0,0,0,0,0
20150105.220629,2818.24,198,668424,56,0,0,0,0,0
20150105.22063,2818.86,40,668464,0,0,0,0,0,0
20150105.220631,2818.24,10,668474,0,0,0,0,0,0
20150105.220632,2818.24,14,668488,12,0,0,0,0,0
20150105.220633,2818.24,4,668492,-2,0,0,0,0,0
20150105.220634,2818.24,4,668496,-2,0,0,0,0,0
20150105.220635,2818.86,4,668500,0,0,0,0,0,0
20150105.220636,2818.24,6,668506,0,0,0,0,0,0
20150105.220637,2818.86,208,668714,6,0,0,0,0,0
20150105.220638,2818.86,202,668916,0,0,0,0,0,0
20150105.220639,2818.86,202,669118,202,0,0,0,0,0
20150105.22064,2818.48,6,669124,2,0,0,0,0,0
20150105.220641,2818.48,24,669148,4,0,0,0,0,0
20150105.220642,2818.24,4,669152,-2,0,0,0,0,0
20150105.220643,2819.23,6,669158,2,0,0,0,0,0
20150105.220644,2818.48,8,669166,6,0,0,0,0,0
20150105.220645,2818.86,6,669172,-2,0,0,0,0,0
20150105.220646,2817.86,6,669178,-6,0,0,0,0,0
20150105.220647,2818.86,202,669380,0,0,0,0,0,0
20150105.220648,2818.86,12,669392,0,0,0,0,0,0
20150105.220649,2818.48,8,669400,6,0,0,0,0,0
20150105.22065,2818.86,26,669426,0,0,0,0,0,0
20150105.220651,2818.24,6,669432,-2,0,0,0,0,0
20150105.220652,2818.86,44,669476,0,0,0,0,0,0
20150105.220653,2818.86,26,669502,24,0,0,0,0,0
20150105.220654,2818.86,118,669620,-90,0,0,0,0,0
20150105.220655,2818.24,76,669696,0,0,0,0,0,0
20150105.220656,2818.24,4,669700,-2,0,0,0,0,0
20150105.220657,2818.24,8,669708,-2,0,0,0,0,0
20150105.220658,2818.48,34,669742,0,0,0,0,0,0
20150105.220659,2817.86,54,669796,28,0,0,0,0,0
20150105.2207,2818.48,16,669812,12,0,0,0,0,0
20150105.220701,2818.48,56,669868,54,0,0,0,0,0
20150105.220702,2818.24,412,670280,-30,0,0,0,0,0
20150105.220703,2817.86,82,670362,78,0,0,0,0,0
20150105.220704,2818.48,36,670398,18,0,0,0,0,0
20150105.220705,2818.48,600,670998,-22,0,0,0,0,0
20150105.220706,2818.86,32,671030,-14,0,0,0,0,0
20150105.220707,2818.24,104,671134,-20,0,0,0,0,0
20150105.220708,2818.86,8,671142,-4,0,0,0,0,0
20150105.220709,2818.61,4,671146,0,0,0,0,0,0
20150105.22071,2818.48,576,671722,326,0,0,0,0,0
20150105.220711,2817.86,14,671736,2,0,0,0,0,0
20150105.220712,2818.48,14,671750,10,0,0,0,0,0
20150105.220713,2817.86,6,671756,-4,0,0,0,0,0
20150105.220714,2818.48,22,671778,-2,0,0,0,0,0
20150105.220715,2818.48,12,671790,2,0,0,0,0,0
20150105.220716,2817.49,82,671872,-2,0,0,0,0,0
20150105.220717,2817.86,42,671914,2,0,0,0,0,0
20150105.220718,2818.48,4,671918,-2,0,0,0,0,0
20150105.220719,2818.48,70,671988,22,0,0,0,0,0
20150105.22072,2817.86,50,672038,-22,0,0,0,0,0
20150105.220721,2817.86,4,672042,0,0,0,0,0,0
20150105.220722,2818.48,38,672080,2,0,0,0,0,0
20150105.220723,2817.49,52,672132,18,0,0,0,0,0
20150105.220724,2817.86,4,672136,0,0,0,0,0,0
20150105.220725,2817.86,4,672140,0,0,0,0,0,0
20150105.220726,2817.86,16,672156,-2,0,0,0,0,0
20150105.220727,2817.86,320,672476,-100,0,0,0,0,0
20150105.220728,2817.86,176,672652,-96,0,0,0,0,0
20150105.220729,2817.86,4,672656,-2,0,0,0,0,0
20150105.22073,2818.48,76,672732,12,0,0,0,0,0
20150105.220731,2817.86,4,672736,-2,0,0,0,0,0
20150105.220732,2818.24,22,672758,0,0,0,0,0,0
20150105.220733,2818.24,352,673110,162,0,0,0,0,0
20150105.220734,2818.24,76,673186,-14,0,0,0,0,0
20150105.220735,2818.24,10,673196,-6,0,0,0,0,0
20150105.220736,2817.86,62,673258,40,0,0,0,0,0
20150105.220737,2818.86,6,673264,2,0,0,0,0,0
20150105.220738,2818.48,54,673318,18,0,0,0,0,0
20150105.220739,2817.86,22,673340,-20,0,0,0,0,0
20150105.22074,2817.86,6,673346,0,0,0,0,0,0
20150105.220741,2817.86,4,673350,0,0,0,0,0,0
20150105.220742,2817.86,16,673366,-4,0,0,0,0,0
20150105.220743,2818.86,8,673374,-2,0,0,0,0,0
20150105.220744,2818.86,108,673482,-82,0,0,0,0,0
20150105.220745,2819.23,62,673544,4,0,0,0,0,0
20150105.220746,2819.23,4,673548,2,0,0,0,0,0
20150105.220747,2818.24,82,673630,-32,0,0,0,0,0
20150105.220748,2818.24,18,673648,-2,0,0,0,0,0
20150105.220749,2818.86,18,673666,14,0,0,0,0,0
20150105.22075,2817.86,52,673718,50,0,0,0,0,0
20150105.220751,2817.86,82,673800,78,0,0,0,0,0
20150105.220752,2818.48,26,673826,20,0,0,0,0,0
20150105.220753,2818.48,232,674058,-54,0,0,0,0,0
20150105.220754,2818.24,642,674700,236,0,0,0,0,0
20150105.220755,2818.24,858,675558,456,0,0,0,0,0
20150105.220756,2817.25,172,675730,8,0,0,0,0,0
20150105.220757,2818.24,10,675740,2,0,0,0,0,0
20150105.220758,2818.24,54,675794,4,0,0,0,0,0
20150105.220759,2817.86,4,675798,0,0,0,0,0,0
20150105.2208,2817.62,14,675812,4,0,0,0,0,0
20150105.220801,2818.24,6,675818,2,0,0,0,0,0
20150105.220802,2817.25,48,675866,-36,0,0,0,0,0
20150105.220803,2817.86,8,675874,4,0,0,0,0,0
20150105.220804,2817.62,8,675882,0,0,0,0,0,0
20150105.220805,2818.24,6,675888,2,0,0,0,0,0
20150105.220806,2818.24,4,675892,2,0,0,0,0,0
20150105.220807,2817.25,602,676494,184,0,0,0,0,0
20150105.220808,2817.25,10,676504,4,0,0,0,0,0
20150105.220809,2817.25,498,677002,-6,0,0,0,0,0
20150105.22081,2817.62,54,677056,-8,0,0,0,0,0
20150105.220811,2817.25,4,677060,0,0,0,0,0,0
20150105.220812,2817.62,4,677064,0,0,0,0,0,0
20150105.220813,2817.62,10,677074,-4,0,0,0,0,0
20150105.220814,2817.62,94,677168,-6,0,0,0,0,0
20150105.220815,2817.62,20,677188,-8,0,0,0,0,0
20150105.220816,2817.62,202,677390,14,0,0,0,0,0
20150105.220817,2817.62,22,677412,8,0,0,0,0,0
20150105.220818,2817.25,124,677536,4,0,0,0,0,0
20150105.220819,2817,8,677544,0,0,0,0,0,0
20150105.22082,2816.63,10,677554,0,0,0,0,0,0
20150105.220821,2817,4,677558,-2,0,0,0,0,0
20150105.220822,2817.62,116,677674,88,0,0,0,0,0
20150105.220823,2817.62,68,677742,-16,0,0,0,0,0
20150105.220824,2817.62,28,677770,-20,0,0,0,0,0
20150105.220825,2817.62,4,677774,0,0,0,0,0,0
20150105.220826,2817.62,18,677792,-2,0,0,0,0,0
20150105.220827,2817.62,42,677834,38,0,0,0,0,0
20150105.220828,2817.62,12,677846,-2,0,0,0,0,0
20150105.220829,2817.62,4,677850,-2,0,0,0,0,0
20150105.22083,2817.62,158,678008,104,0,0,0,0,0
20150105.220831,2818.24,12,678020,10,0,0,0,0,0
20150105.220832,2818.24,6,678026,4,0,0,0,0,0
20150105.220833,2818.24,26,678052,24,0,0,0,0,0
20150105.220834,2817.87,104,678156,68,0,0,0,0,0
20150105.220835,2817.62,6,678162,0,0,0,0,0,0
20150105.220836,2817.62,8,678170,4,0,0,0,0,0
20150105.220837,2818.24,4,678174,0,0,0,0,0,0
20150105.220838,2817.87,42,678216,20,0,0,0,0,0
20150105.220839,2817.62,130,678346,-10,0,0,0,0,0
20150105.22084,2818.24,16,678362,-10,0,0,0,0,0
20150105.220841,2818,70,678432,48,0,0,0,0,0
20150105.220842,2818,28,678460,-22,0,0,0,0,0
20150105.220843,2818,28,678488,-6,0,0,0,0,0
20150105.220844,2818.62,10,678498,0,0,0,0,0,0
20150105.220845,2818,86,678584,14,0,0,0,0,0
20150105.220846,2818,4,678588,2,0,0,0,0,0
20150105.220847,2818,44,678632,-34,0,0,0,0,0
20150105.220848,2818,110,678742,12,0,0,0,0,0
20150105.220849,2818,4,678746,0,0,0,0,0,0
20150105.22085,2818,14,678760,-2,0,0,0,0,0
20150105.220851,2818,8,678768,0,0,0,0,0,0
20150105.220852,2818,232,679000,-106,0,0,0,0,0
20150105.220853,2818,14,679014,-2,0,0,0,0,0
20150105.220854,2818.62,12,679026,-8,0,0,0,0,0
20150105.220855,2818,10,679036,-4,0,0,0,0,0
20150105.220856,2818.62,6,679042,2,0,0,0,0,0
20150105.220857,2818,6,679048,4,0,0,0,0,0
20150105.220858,2818,6,679054,0,0,0,0,0,0
20150105.220859,2817.62,404,679458,96,0,0,0,0,0
20150105.2209,2817.62,258,679716,-160,0,0,0,0,0
20150105.220901,2817,24,679740,-4,0,0,0,0,0
20150105.220902,2818,4,679744,2,0,0,0,0,0
20150105.220903,2817.62,84,679828,22,0,0,0,0,0
20150105.220904,2817.25,406,680234,276,0,0,0,0,0
20150105.220905,2818,8,680242,8,0,0,0,0,0
20150105.220906,2817.62,32,680274,-28,0,0,0,0,0
20150105.220907,2818,4,680278,4,0,0,0,0,0
20150105.220908,2817,22,680300,-8,0,0,0,0,0
20150105.220909,2817.62,80,680380,-38,0,0,0,0,0
20150105.22091,2817.62,16,680396,2,0,0,0,0,0
20150105.220911,2817.25,402,680798,282,0,0,0,0,0
20150105.220912,2817.62,6,680804,0,0,0,0,0,0
20150105.220913,2817,12,680816,10,0,0,0,0,0
20150105.220914,2817,4,680820,2,0,0,0,0,0
20150105.220915,2817,204,681024,-16,0,0,0,0,0
20150105.220916,2817.62,10,681034,0,0,0,0,0,0
20150105.220917,2816.63,408,681442,54,0,0,0,0,0
20150105.220918,2816.63,128,681570,46,0,0,0,0,0
20150105.220919,2817,14,681584,4,0,0,0,0,0
20150105.22092,2816.63,4,681588,2,0,0,0,0,0
20150105.220921,2816.63,72,681660,6,0,0,0,0,0
20150105.220922,2817.62,4,681664,0,0,0,0,0,0
20150105.220923,2816.63,14,681678,-10,0,0,0,0,0
20150105.220924,2817.62,6,681684,0,0,0,0,0,0
20150105.220925,2817.62,440,682124,-84,0,0,0,0,0
20150105.220926,2817,198,682322,150,0,0,0,0,0
20150105.220927,2817,162,682484,34,0,0,0,0,0
20150105.220928,2817,10,682494,0,0,0,0,0,0
20150105.220929,2817,404,682898,336,0,0,0,0,0
20150105.22093,2817.62,20,682918,-20,0,0,0,0,0
20150105.220931,2817.62,88,683006,0,0,0,0,0,0
20150105.220932,2817,16,683022,-4,0,0,0,0,0
20150105.220933,2817.62,4,683026,0,0,0,0,0,0
20150105.220934,2817,40,683066,10,0,0,0,0,0
20150105.220935,2816.63,498,683564,492,0,0,0,0,0
20150105.220936,2817,6,683570,0,0,0,0,0,0
20150105.220937,2817,40,683610,0,0,0,0,0,0
20150105.220938,2817.62,44,683654,-2,0,0,0,0,0
20150105.220939,2817.24,420,684074,128,0,0,0,0,0
20150105.22094,2817.62,244,684318,-126,0,0,0,0,0
20150105.220941,2817,212,684530,2,0,0,0,0,0
20150105.220942,2816.62,494,685024,488,0,0,0,0,0
20150105.220943,2816.62,4,685028,4,0,0,0,0,0
20150105.220944,2817,20,685048,4,0,0,0,0,0
20150105.220945,2817,28,685076,0,0,0,0,0,0
20150105.220946,2817,24,685100,-6,0,0,0,0,0
20150105.220947,2817.24,6,685106,-2,0,0,0,0,0
20150105.220948,2816.62,28,685134,-24,0,0,0,0,0
20150105.220949,2817,22,685156,14,0,0,0,0,0
20150105.22095,2817,6,685162,4,0,0,0,0,0
20150105.220951,2816.62,62,685224,2,0,0,0,0,0
20150105.220952,2816.62,32,685256,22,0,0,0,0,0
20150105.220953,2817,22,685278,4,0,0,0,0,0
20150105.220954,2817.62,24,685302,12,0,0,0,0,0
20150105.220955,2817,12,685314,-6,0,0,0,0,0
20150105.220956,2816.62,6,685320,-2,0,0,0,0,0
20150105.220957,2817.62,12,685332,0,0,0,0,0,0
20150105.220958,2816.62,110,685442,98,0,0,0,0,0
20150105.220959,2817,22,685464,-20,0,0,0,0,0
20150105.221,2817.62,14,685478,12,0,0,0,0,0
20150105.221001,2816.62,84,685562,-16,0,0,0,0,0
20150105.221002,2817.62,4,685566,2,0,0,0,0,0
20150105.221003,2817,62,685628,-2,0,0,0,0,0
20150105.221004,2817,12,685640,0,0,0,0,0,0
20150105.221005,2817.24,102,685742,42,0,0,0,0,0
20150105.221006,2817,22,685764,-2,0,0,0,0,0
20150105.221007,2816.62,14,685778,-4,0,0,0,0,0
20150105.221008,2816.62,8,685786,-6,0,0,0,0,0
20150105.221009,2816.62,48,685834,-16,0,0,0,0,0
20150105.22101,2817,4,685838,-2,0,0,0,0,0
20150105.221011,2817,8,685846,-6,0,0,0,0,0
20150105.221012,2816.62,4,685850,-2,0,0,0,0,0
20150105.221013,2816.62,6,685856,0,0,0,0,0,0
20150105.221014,2816.62,54,685910,6,0,0,0,0,0
20150105.221015,2817.24,34,685944,32,0,0,0,0,0
20150105.221016,2816.62,68,686012,-4,0,0,0,0,0
20150105.221017,2817,8,686020,0,0,0,0,0,0
20150105.221018,2816.62,162,686182,42,0,0,0,0,0
20150105.221019,2816.25,242,686424,-168,0,0,0,0,0
20150105.22102,2816.63,6,686430,4,0,0,0,0,0
20150105.221021,2816.63,4,686434,2,0,0,0,0,0
20150105.221022,2816.63,4,686438,0,0,0,0,0,0
20150105.221023,2816.63,4,686442,2,0,0,0,0,0
20150105.221024,2816.62,6,686448,2,0,0,0,0,0
20150105.221025,2816.63,4,686452,2,0,0,0,0,0
20150105.221026,2816.63,34,686486,24,0,0,0,0,0
20150105.221027,2817.24,22,686508,22,0,0,0,0,0
20150105.221028,2816.63,64,686572,60,0,0,0,0,0
20150105.221029,2816.25,4,686576,-2,0,0,0,0,0
20150105.22103,2816.25,16,686592,-14,0,0,0,0,0
20150105.221031,2816.62,84,686676,80,0,0,0,0,0
20150105.221032,2816.25,4,686680,0,0,0,0,0,0
20150105.221033,2816.25,78,686758,-56,0,0,0,0,0
20150105.221034,2817.24,110,686868,110,0,0,0,0,0
20150105.221035,2816.62,100,686968,38,0,0,0,0,0
20150105.221036,2816.63,66,687034,-58,0,0,0,0,0
20150105.221037,2816.63,4,687038,0,0,0,0,0,0
20150105.221038,2816.62,6,687044,2,0,0,0,0,0
20150105.221039,2817.24,60,687104,12,0,0,0,0,0
20150105.22104,2816.62,30,687134,-4,0,0,0,0,0
20150105.221041,2817.24,10,687144,4,0,0,0,0,0
20150105.221042,2817,316,687460,202,0,0,0,0,0
20150105.221043,2817.62,110,687570,96,0,0,0,0,0
20150105.221044,2817.99,682,688252,60,0,0,0,0,0
20150105.221045,2817.99,272,688524,68,0,0,0,0,0
20150105.221046,2817.37,4,688528,0,0,0,0,0,0
20150105.221047,2817.38,122,688650,-70,0,0,0,0,0
20150105.221048,2817.99,4,688654,2,0,0,0,0,0
20150105.221049,2817.99,12,688666,2,0,0,0,0,0
20150105.22105,2817.75,28,688694,-2,0,0,0,0,0
20150105.221051,2817.99,12,688706,4,0,0,0,0,0
20150105.221052,2818.37,206,688912,-182,0,0,0,0,0
20150105.221053,2817.75,156,689068,82,0,0,0,0,0
20150105.221054,2818.13,26,689094,10,0,0,0,0,0
20150105.221055,2818.37,128,689222,32,0,0,0,0,0
20150105.221056,2817.75,38,689260,16,0,0,0,0,0
20150105.221057,2818.37,8,689268,2,0,0,0,0,0
20150105.221058,2818.37,64,689332,0,0,0,0,0,0
20150105.221059,2817.75,24,689356,14,0,0,0,0,0
20150105.2211,2817.38,14,689370,6,0,0,0,0,0
20150105.221101,2817.38,22,689392,2,0,0,0,0,0
20150105.221102,2817.38,222,689614,0,0,0,0,0,0
20150105.221103,2817.75,78,689692,24,0,0,0,0,0
20150105.221104,2817.75,16,689708,6,0,0,0,0,0
20150105.221105,2817.38,60,689768,10,0,0,0,0,0
20150105.221106,2817.38,6,689774,0,0,0,0,0,0
20150105.221107,2817.38,6,689780,0,0,0,0,0,0
20150105.221108,2817.38,78,689858,56,0,0,0,0,0
20150105.221109,2817.75,208,690066,154,0,0,0,0,0
20150105.22111,2817.38,54,690120,-32,0,0,0,0,0
20150105.221111,2817.38,8,690128,2,0,0,0,0,0
20150105.221112,2817.38,8,690136,4,0,0,0,0,0
20150105.221113,2817.75,222,690358,104,0,0,0,0,0
20150105.221114,2817.38,96,690454,-52,0,0,0,0,0
20150105.221115,2817.38,172,690626,32,0,0,0,0,0
20150105.221116,2816.76,114,690740,82,0,0,0,0,0
20150105.221117,2817.13,26,690766,0,0,0,0,0,0
20150105.221118,2816.76,112,690878,12,0,0,0,0,0
20150105.221119,2817.13,6,690884,-4,0,0,0,0,0
20150105.22112,2816.76,12,690896,0,0,0,0,0,0
20150105.221121,2817.38,26,690922,0,0,0,0,0,0
20150105.221122,2817.13,210,691132,10,0,0,0,0,0
20150105.221123,2817.75,4,691136,2,0,0,0,0,0
20150105.221124,2817.13,4,691140,2,0,0,0,0,0
20150105.221125,2817.38,62,691202,62,0,0,0,0,0
20150105.221126,2816.38,404,691606,378,0,0,0,0,0
20150105.221127,2817.13,18,691624,-14,0,0,0,0,0
20150105.221128,2816.76,20,691644,18,0,0,0,0,0
20150105.221129,2817.13,12,691656,4,0,0,0,0,0
20150105.22113,2816.76,4,691660,0,0,0,0,0,0
20150105.221131,2816.76,22,691682,22,0,0,0,0,0
20150105.221132,2816.76,14,691696,10,0,0,0,0,0
20150105.221133,2816.76,4,691700,0,0,0,0,0,0
20150105.221134,2816.76,18,691718,16,0,0,0,0,0
20150105.221135,2817.75,6,691724,2,0,0,0,0,0
20150105.221136,2816.76,4,691728,4,0,0,0,0,0
20150105.221137,2817.37,30,691758,28,0,0,0,0,0
20150105.221138,2817.13,42,691800,0,0,0,0,0,0
20150105.221139,2817.13,34,691834,6,0,0,0,0,0
20150105.22114,2817.13,6,691840,2,0,0,0,0,0
20150105.221141,2816.76,50,691890,36,0,0,0,0,0
20150105.221142,2817.13,24,691914,2,0,0,0,0,0
20150105.221143,2817.13,82,691996,0,0,0,0,0,0
20150105.221144,2817.75,438,692434,220,0,0,0,0,0
20150105.221145,2817.13,4,692438,2,0,0,0,0,0
20150105.221146,2817.75,88,692526,48,0,0,0,0,0
20150105.221147,2817.13,14,692540,-10,0,0,0,0,0
20150105.221148,2817.13,6,692546,6,0,0,0,0,0
20150105.221149,2817.13,104,692650,102,0,0,0,0,0
20150105.22115,2817.13,4,692654,2,0,0,0,0,0
20150105.221151,2817.13,310,692964,48,0,0,0,0,0
20150105.221152,2817.51,8,692972,4,0,0,0,0,0
20150105.221153,2817.13,32,693004,30,0,0,0,0,0
20150105.221154,2817.51,262,693266,118,0,0,0,0,0
20150105.221155,2817.13,4,693270,0,0,0,0,0,0
20150105.221156,2817.13,202,693472,0,0,0,0,0,0
20150105.221157,2817.51,10,693482,4,0,0,0,0,0
20150105.221158,2817.51,32,693514,10,0,0,0,0,0
20150105.221159,2817.51,208,693722,162,0,0,0,0,0
20150105.2212,2817.51,12,693734,12,0,0,0,0,0
20150105.221201,2817.51,410,694144,-266,0,0,0,0,0
20150105.221202,2817.51,128,694272,-18,0,0,0,0,0
20150105.221203,2817.51,52,694324,10,0,0,0,0,0
20150105.221204,2817.51,4,694328,0,0,0,0,0,0
20150105.221205,2817.88,28,694356,26,0,0,0,0,0
20150105.221206,2817.51,836,695192,736,0,0,0,0,0
20150105.221207,2817.51,4,695196,0,0,0,0,0,0
20150105.221208,2817.51,236,695432,96,0,0,0,0,0
20150105.221209,2817.51,76,695508,0,0,0,0,0,0
20150105.22121,2817.51,4,695512,2,0,0,0,0,0
20150105.221211,2817.51,4,695516,2,0,0,0,0,0
20150105.221212,2817.51,42,695558,2,0,0,0,0,0
20150105.221213,2817.51,44,695602,4,0,0,0,0,0
20150105.221214,2817.51,8,695610,6,0,0,0,0,0
20150105.221215,2817.51,42,695652,40,0,0,0,0,0
20150105.221216,2817.51,6,695658,-2,0,0,0,0,0
20150105.221217,2817.13,48,695706,0,0,0,0,0,0
20150105.221218,2817.51,22,695728,0,0,0,0,0,0
20150105.221219,2818.13,4,695732,0,0,0,0,0,0
20150105.22122,2817.51,24,695756,-20,0,0,0,0,0
20150105.221221,2817.51,52,695808,2,0,0,0,0,0
20150105.221222,2817.51,32,695840,0,0,0,0,0,0
20150105.221223,2817.13,8,695848,-4,0,0,0,0,0
20150105.221224,2818.13,26,695874,8,0,0,0,0,0
20150105.221225,2817.51,14,695888,2,0,0,0,0,0
20150105.221226,2817.51,8,695896,-4,0,0,0,0,0
20150105.221227,2817.51,604,696500,-2,0,0,0,0,0
20150105.221228,2817.51,6,696506,0,0,0,0,0,0
20150105.221229,2817.51,12,696518,-6,0,0,0,0,0
20150105.22123,2818.13,4,696522,-2,0,0,0,0,0
20150105.221231,2817.51,36,696558,-30,0,0,0,0,0
20150105.221232,2817.51,6,696564,-4,0,0,0,0,0
20150105.221233,2817.51,10,696574,2,0,0,0,0,0
20150105.221234,2818.13,4,696578,2,0,0,0,0,0
20150105.221235,2817.51,6,696584,0,0,0,0,0,0
20150105.221236,2817.51,14,696598,-10,0,0,0,0,0
20150105.221237,2818.13,30,696628,10,0,0,0,0,0
20150105.221238,2817.51,20,696648,6,0,0,0,0,0
20150105.221239,2817.75,102,696750,-58,0,0,0,0,0
20150105.22124,2817.51,36,696786,34,0,0,0,0,0
20150105.221241,2818.13,616,697402,504,0,0,0,0,0
20150105.221242,2817.51,36,697438,16,0,0,0,0,0
20150105.221243,2818.5,346,697784,150,0,0,0,0,0
20150105.221244,2817.88,12,697796,2,0,0,0,0,0
20150105.221245,2817.88,42,697838,2,0,0,0,0,0
20150105.221246,2818.26,20,697858,20,0,0,0,0,0
20150105.221247,2817.88,12,697870,10,0,0,0,0,0
20150105.221248,2818.26,12,697882,10,0,0,0,0,0
20150105.221249,2817.88,34,697916,14,0,0,0,0,0
20150105.22125,2817.88,12,697928,2,0,0,0,0,0
20150105.221251,2817.88,26,697954,2,0,0,0,0,0
20150105.221252,2817.88,614,698568,354,0,0,0,0,0
20150105.221253,2817.88,48,698616,44,0,0,0,0,0
20150105.221254,2817.88,10,698626,6,0,0,0,0,0
20150105.221255,2817.88,58,698684,0,0,0,0,0,0
20150105.221256,2817.88,32,698716,-12,0,0,0,0,0
20150105.221257,2818.5,4,698720,0,0,0,0,0,0
20150105.221258,2817.88,42,698762,10,0,0,0,0,0
20150105.221259,2817.88,6,698768,-2,0,0,0,0,0
20150105.2213,2817.88,14,698782,8,0,0,0,0,0
20150105.221301,2817.88,6,698788,2,0,0,0,0,0
20150105.221302,2817.88,8,698796,4,0,0,0,0,0
20150105.221303,2818.12,4,698800,2,0,0,0,0,0
20150105.221304,2817.88,6,698806,2,0,0,0,0,0
20150105.221305,2817.51,8,698814,2,0,0,0,0,0
20150105.221306,2817.51,40,698854,8,0,0,0,0,0
20150105.221307,2817.51,14,698868,2,0,0,0,0,0
20150105.221308,2817.88,4,698872,0,0,0,0,0,0
20150105.221309,2817.51,24,698896,18,0,0,0,0,0
20150105.22131,2817.51,6,698902,6,0,0,0,0,0
20150105.221311,2817.51,360,699262,-2,0,0,0,0,0
20150105.221312,2817.51,6,699268,2,0,0,0,0,0
20150105.221313,2818.12,4,699272,2,0,0,0,0,0
20150105.221314,2817.51,16,699288,16,0,0,0,0,0
20150105.221315,2817.51,138,699426,26,0,0,0,0,0
20150105.221316,2817.51,4,699430,0,0,0,0,0,0
20150105.221317,2818.12,24,699454,22,0,0,0,0,0
20150105.221318,2817.51,14,699468,6,0,0,0,0,0
20150105.221319,2817.51,12,699480,8,0,0,0,0,0
20150105.22132,2817.51,12,699492,10,0,0,0,0,0
20150105.221321,2817.51,4,699496,2,0,0,0,0,0
20150105.221322,2817.51,54,699550,20,0,0,0,0,0
20150105.221323,2817.88,204,699754,48,0,0,0,0,0
20150105.221324,2817.51,4,699758,0,0,0,0,0,0
20150105.221325,2817.51,8,699766,-4,0,0,0,0,0
20150105.221326,2817.51,204,699970,2,0,0,0,0,0
20150105.221327,2817.51,16,699986,12,0,0,0,0,0
20150105.221328,2817.51,4,699990,2,0,0,0,0,0
20150105.221329,2817.51,6,699996,-2,0,0,0,0,0
20150105.22133,2817.88,36,700032,28,0,0,0,0,0
20150105.221331,2818.13,8,700040,-4,0,0,0,0,0
20150105.221332,2817.51,6,700046,2,0,0,0,0,0
20150105.221333,2817.51,62,700108,-22,0,0,0,0,0
20150105.221334,2818.12,24,700132,18,0,0,0,0,0
20150105.221335,2817.51,4,700136,0,0,0,0,0,0
20150105.221336,2818.5,28,700164,18,0,0,0,0,0
20150105.221337,2817.51,242,700406,-2,0,0,0,0,0
20150105.221338,2817.51,4,700410,-2,0,0,0,0,0
20150105.221339,2818.13,82,700492,-78,0,0,0,0,0
20150105.22134,2818.13,28,700520,2,0,0,0,0,0
20150105.221341,2817.51,214,700734,166,0,0,0,0,0
20150105.221342,2817.51,12,700746,-8,0,0,0,0,0
20150105.221343,2817.88,182,700928,-2,0,0,0,0,0
20150105.221344,2817.51,54,700982,2,0,0,0,0,0
20150105.221345,2817.51,108,701090,-10,0,0,0,0,0
20150105.221346,2816.89,202,701292,202,0,0,0,0,0
20150105.221347,2817.88,242,701534,150,0,0,0,0,0
20150105.221348,2817.51,6,701540,2,0,0,0,0,0
20150105.221349,2817.51,6,701546,0,0,0,0,0,0
20150105.22135,2817.51,16,701562,10,0,0,0,0,0
20150105.221351,2817.27,802,702364,802,0,0,0,0,0
20150105.221352,2817.88,46,702410,44,0,0,0,0,0
20150105.221353,2817.51,10,702420,6,0,0,0,0,0
20150105.221354,2817.51,14,702434,2,0,0,0,0,0
20150105.221355,2817.88,12,702446,6,0,0,0,0,0
20150105.221356,2817.51,4,702450,0,0,0,0,0,0
20150105.221357,2817.88,806,703256,710,0,0,0,0,0
20150105.221358,2817.51,50,703306,42,0,0,0,0,0
20150105.221359,2817.27,52,703358,42,0,0,0,0,0
20150105.2214,2817.27,96,703454,14,0,0,0,0,0
20150105.221401,2817.88,76,703530,12,0,0,0,0,0
20150105.221402,2817.27,806,704336,610,0,0,0,0,0
20150105.221403,2817.88,16,704352,6,0,0,0,0,0
20150105.221404,2816.89,86,704438,30,0,0,0,0,0
20150105.221405,2817.27,816,705254,382,0,0,0,0,0
20150105.221406,2817.89,50,705304,44,0,0,0,0,0
20150105.221407,2816.89,8,705312,-2,0,0,0,0,0
20150105.221408,2817.27,2042,707354,678,0,0,0,0,0
20150105.221409,2817.27,688,708042,504,0,0,0,0,0
20150105.22141,2817.27,1352,709394,1046,0,0,0,0,0
20150105.221411,2817.89,834,710228,682,0,0,0,0,0
20150105.221412,2816.65,118,710346,34,0,0,0,0,0
20150105.221413,2816.65,188,710534,16,0,0,0,0,0
20150105.221414,2817.02,226,710760,34,0,0,0,0,0
20150105.221415,2816.65,12,710772,-4,0,0,0,0,0
20150105.221416,2817.27,14,710786,0,0,0,0,0,0
20150105.221417,2817.27,6,710792,-2,0,0,0,0,0
20150105.221418,2816.65,820,711612,194,0,0,0,0,0
20150105.221419,2817.02,616,712228,368,0,0,0,0,0
20150105.22142,2816.65,6,712234,0,0,0,0,0,0
20150105.221421,2817.02,22,712256,-6,0,0,0,0,0
20150105.221422,2816.65,10,712266,6,0,0,0,0,0
20150105.221423,2816.65,206,712472,200,0,0,0,0,0
20150105.221424,2816.65,8,712480,2,0,0,0,0,0
20150105.221425,2816.65,322,712802,188,0,0,0,0,0
20150105.221426,2816.28,4,712806,-2,0,0,0,0,0
20150105.221427,2816.65,80,712886,-30,0,0,0,0,0
20150105.221428,2816.65,196,713082,-12,0,0,0,0,0
20150105.221429,2816.65,12,713094,6,0,0,0,0,0
20150105.22143,2816.65,92,713186,-70,0,0,0,0,0
20150105.221431,2816.65,46,713232,0,0,0,0,0,0
20150105.221432,2816.28,18,713250,-2,0,0,0,0,0
20150105.221433,2816.28,10,713260,-2,0,0,0,0,0
20150105.221434,2816.28,84,713344,0,0,0,0,0,0
20150105.221435,2816.28,22,713366,-20,0,0,0,0,0
20150105.221436,2816.28,4,713370,0,0,0,0,0,0
20150105.221437,2816.28,28,713398,16,0,0,0,0,0
20150105.221438,2816.28,24,713422,-2,0,0,0,0,0
20150105.221439,2816.89,42,713464,8,0,0,0,0,0
20150105.22144,2816.89,58,713522,12,0,0,0,0,0
20150105.221441,2816.89,406,713928,378,0,0,0,0,0
20150105.221442,2816.89,300,714228,32,0,0,0,0,0
20150105.221443,2816.89,38,714266,28,0,0,0,0,0
20150105.221444,2816.27,16,714282,-4,0,0,0,0,0
20150105.221445,2816.89,226,714508,216,0,0,0,0,0
20150105.221446,2816.89,6,714514,4,0,0,0,0,0
20150105.221447,2816.27,200,714714,-126,0,0,0,0,0
20150105.221448,2816.52,10,714724,-2,0,0,0,0,0
20150105.221449,2816.89,34,714758,-10,0,0,0,0,0
20150105.22145,2816.52,4,714762,2,0,0,0,0,0
20150105.221451,2816.89,6,714768,0,0,0,0,0,0
20150105.221452,2816.89,74,714842,6,0,0,0,0,0
20150105.221453,2816.89,6,714848,0,0,0,0,0,0
20150105.221454,2816.89,78,714926,-36,0,0,0,0,0
20150105.221455,2816.52,114,715040,-66,0,0,0,0,0
20150105.221456,2816.52,6,715046,6,0,0,0,0,0
20150105.221457,2816.89,34,715080,6,0,0,0,0,0
20150105.221458,2816.27,414,715494,218,0,0,0,0,0
20150105.221459,2815.9,148,715642,98,0,0,0,0,0
20150105.2215,2816.52,34,715676,32,0,0,0,0,0
20150105.221501,2815.9,66,715742,10,0,0,0,0,0
20150105.221502,2816.27,6,715748,2,0,0,0,0,0
20150105.221503,2815.9,88,715836,82,0,0,0,0,0
20150105.221504,2816.27,130,715966,118,0,0,0,0,0
20150105.221505,2815.9,26,715992,20,0,0,0,0,0
20150105.221506,2816.27,68,716060,8,0,0,0,0,0
20150105.221507,2815.9,104,716164,94,0,0,0,0,0
20150105.221508,2816.28,140,716304,136,0,0,0,0,0
20150105.221509,2816.28,14,716318,0,0,0,0,0,0
20150105.22151,2816.28,52,716370,-4,0,0,0,0,0
20150105.221511,2816.28,110,716480,84,0,0,0,0,0
20150105.221512,2816.28,6,716486,4,0,0,0,0,0
20150105.221513,2816.28,30,716516,4,0,0,0,0,0
20150105.221514,2816.28,116,716632,106,0,0,0,0,0
20150105.221515,2816.28,14,716646,10,0,0,0,0,0
20150105.221516,2815.9,6,716652,6,0,0,0,0,0
20150105.221517,2815.9,8,716660,4,0,0,0,0,0
20150105.221518,2815.9,866,717526,824,0,0,0,0,0
20150105.221519,2815.9,4,717530,0,0,0,0,0,0
20150105.22152,2815.9,6,717536,0,0,0,0,0,0
20150105.221521,2815.9,50,717586,-4,0,0,0,0,0
20150105.221522,2815.9,88,717674,-78,0,0,0,0,0
20150105.221523,2816.89,1414,719088,990,0,0,0,0,0
20150105.221524,2816.27,182,719270,60,0,0,0,0,0
20150105.221525,2816.27,42,719312,-30,0,0,0,0,0
20150105.221526,2816.89,140,719452,2,0,0,0,0,0
20150105.221527,2816.89,8,719460,4,0,0,0,0,0
20150105.221528,2816.89,14,719474,10,0,0,0,0,0
20150105.221529,2816.89,1428,720902,-488,0,0,0,0,0
20150105.22153,2816.27,38,720940,2,0,0,0,0,0
20150105.221531,2816.14,50,720990,0,0,0,0,0,0
20150105.221532,2816.14,44,721034,0,0,0,0,0,0
20150105.221533,2816.89,1002,722036,696,0,0,0,0,0
20150105.221534,2816.51,76,722112,-28,0,0,0,0,0
20150105.221535,2815.9,42,722154,-2,0,0,0,0,0
20150105.221536,2815.9,70,722224,-68,0,0,0,0,0
20150105.221537,2816.51,26,722250,14,0,0,0,0,0
20150105.221538,2816.52,6,722256,2,0,0,0,0,0
20150105.221539,2816.89,14,722270,-2,0,0,0,0,0
20150105.22154,2816.27,6,722276,-6,0,0,0,0,0
20150105.221541,2816.89,24,722300,6,0,0,0,0,0
20150105.221542,2816.51,22,722322,0,0,0,0,0,0
20150105.221543,2816.51,6,722328,-4,0,0,0,0,0
20150105.221544,2815.9,10,722338,-8,0,0,0,0,0
20150105.221545,2816.27,230,722568,110,0,0,0,0,0
20150105.221546,2816.27,148,722716,94,0,0,0,0,0
20150105.221547,2815.9,16,722732,10,0,0,0,0,0
20150105.221548,2816.89,554,723286,100,0,0,0,0,0
20150105.221549,2816.89,42,723328,-28,0,0,0,0,0
20150105.22155,2816.89,28,723356,10,0,0,0,0,0
20150105.221551,2816.65,52,723408,-14,0,0,0,0,0
20150105.221552,2816.65,36,723444,-2,0,0,0,0,0
20150105.221553,2816.27,24,723468,-16,0,0,0,0,0
20150105.221554,2816.52,30,723498,-2,0,0,0,0,0
20150105.221555,2816.27,50,723548,-8,0,0,0,0,0
20150105.221556,2816.27,40,723588,8,0,0,0,0,0
20150105.221557,2816.89,4,723592,2,0,0,0,0,0
20150105.221558,2816.27,10,723602,0,0,0,0,0,0
20150105.221559,2816.89,18,723620,4,0,0,0,0,0
20150105.2216,2816.89,14,723634,6,0,0,0,0,0
20150105.221601,2816.52,248,723882,-144,0,0,0,0,0
20150105.221602,2816.52,24,723906,4,0,0,0,0,0
20150105.221603,2815.9,8,723914,2,0,0,0,0,0
20150105.221604,2816.52,102,724016,2,0,0,0,0,0
20150105.221605,2816.52,240,724256,196,0,0,0,0,0
20150105.221606,2815.52,16,724272,14,0,0,0,0,0
20150105.221607,2816.52,86,724358,6,0,0,0,0,0
20150105.221608,2816.89,6,724364,4,0,0,0,0,0
20150105.221609,2815.9,24,724388,6,0,0,0,0,0
20150105.22161,2816.52,6,724394,2,0,0,0,0,0
20150105.221611,2816.27,100,724494,98,0,0,0,0,0
20150105.221612,2815.9,144,724638,74,0,0,0,0,0
20150105.221613,2816.52,536,725174,102,0,0,0,0,0
20150105.221614,2815.9,22,725196,6,0,0,0,0,0
20150105.221615,2816.89,22,725218,14,0,0,0,0,0
20150105.221616,2816.89,50,725268,42,0,0,0,0,0
20150105.221617,2816.52,32,725300,28,0,0,0,0,0
20150105.221618,2816.52,120,725420,96,0,0,0,0,0
20150105.221619,2815.9,8,725428,2,0,0,0,0,0
20150105.22162,2816.52,16,725444,0,0,0,0,0,0
20150105.221621,2816.14,128,725572,42,0,0,0,0,0
20150105.221622,2816.14,14,725586,2,0,0,0,0,0
20150105.221623,2815.9,28,725614,4,0,0,0,0,0
20150105.221624,2816.14,38,725652,2,0,0,0,0,0
20150105.221625,2816.52,4,725656,0,0,0,0,0,0
20150105.221626,2816.89,64,725720,46,0,0,0,0,0
20150105.221627,2816.52,6,725726,-2,0,0,0,0,0
20150105.221628,2816.52,8,725734,-4,0,0,0,0,0
20150105.221629,2815.9,30,725764,-24,0,0,0,0,0
20150105.22163,2816.89,14,725778,8,0,0,0,0,0
20150105.221631,2816.27,570,726348,32,0,0,0,0,0
20150105.221632,2816.27,366,726714,322,0,0,0,0,0
20150105.221633,2815.9,24,726738,-22,0,0,0,0,0
20150105.221634,2815.9,14,726752,-12,0,0,0,0,0
20150105.221635,2816.89,1028,727780,430,0,0,0,0,0
20150105.221636,2816.89,24,727804,-2,0,0,0,0,0
20150105.221637,2815.65,3086,730890,2036,0,0,0,0,0
20150105.221638,2815.66,2108,732998,1194,0,0,0,0,0
20150105.221639,2815.04,346,733344,48,0,0,0,0,0
20150105.22164,2815.41,108,733452,8,0,0,0,0,0
20150105.221641,2815.04,70,733522,6,0,0,0,0,0
20150105.221642,2815.04,148,733670,64,0,0,0,0,0
20150105.221643,2815.66,116,733786,58,0,0,0,0,0
20150105.221644,2815.66,36,733822,30,0,0,0,0,0
20150105.221645,2815.66,42,733864,36,0,0,0,0,0
20150105.221646,2815.66,48,733912,28,0,0,0,0,0
20150105.221647,2815.04,26,733938,-12,0,0,0,0,0
20150105.221648,2815.04,68,734006,6,0,0,0,0,0
20150105.221649,2815.66,20,734026,20,0,0,0,0,0
20150105.22165,2815.04,84,734110,60,0,0,0,0,0
20150105.221651,2815.66,14,734124,8,0,0,0,0,0
20150105.221652,2815.04,128,734252,80,0,0,0,0,0
20150105.221653,2815.04,90,734342,4,0,0,0,0,0
20150105.221654,2815.04,80,734422,8,0,0,0,0,0
20150105.221655,2814.66,78,734500,26,0,0,0,0,0
20150105.221656,2815.04,136,734636,32,0,0,0,0,0
20150105.221657,2814.66,86,734722,-2,0,0,0,0,0
20150105.221658,2815.04,38,734760,-2,0,0,0,0,0
20150105.221659,2815.04,82,734842,44,0,0,0,0,0
20150105.2217,2815.28,236,735078,-48,0,0,0,0,0
20150105.221701,2815.28,82,735160,56,0,0,0,0,0
20150105.221702,2815.28,36,735196,30,0,0,0,0,0
20150105.221703,2814.66,48,735244,-2,0,0,0,0,0
20150105.221704,2815.28,212,735456,-152,0,0,0,0,0
20150105.221705,2815.28,70,735526,28,0,0,0,0,0
20150105.221706,2814.66,120,735646,114,0,0,0,0,0
20150105.221707,2815.66,32,735678,-24,0,0,0,0,0
20150105.221708,2815.28,12,735690,2,0,0,0,0,0
20150105.221709,2815.04,48,735738,10,0,0,0,0,0
20150105.22171,2815.66,132,735870,-26,0,0,0,0,0
20150105.221711,2815.66,8,735878,6,0,0,0,0,0
20150105.221712,2815.04,16,735894,2,0,0,0,0,0
20150105.221713,2815.04,12,735906,8,0,0,0,0,0
20150105.221714,2815.04,100,736006,44,0,0,0,0,0
20150105.221715,2815.04,18,736024,10,0,0,0,0,0
20150105.221716,2815.04,666,736690,-218,0,0,0,0,0
20150105.221717,2815.04,138,736828,132,0,0,0,0,0
20150105.221718,2814.66,150,736978,-44,0,0,0,0,0
20150105.221719,2814.04,60,737038,-16,0,0,0,0,0
20150105.22172,2815.04,24,737062,10,0,0,0,0,0
20150105.221721,2814.66,534,737596,82,0,0,0,0,0
20150105.221722,2814.66,130,737726,14,0,0,0,0,0
20150105.221723,2815.28,36,737762,22,0,0,0,0,0
20150105.221724,2815.28,74,737836,-52,0,0,0,0,0
20150105.221725,2815.04,36,737872,-28,0,0,0,0,0
20150105.221726,2815.04,508,738380,-254,0,0,0,0,0
20150105.221727,2815.66,92,738472,-32,0,0,0,0,0
20150105.221728,2815.66,4,738476,0,0,0,0,0,0
20150105.221729,2815.66,38,738514,-12,0,0,0,0,0
20150105.22173,2815.04,18,738532,12,0,0,0,0,0
20150105.221731,2815.04,68,738600,4,0,0,0,0,0
20150105.221732,2815.66,16,738616,2,0,0,0,0,0
20150105.221733,2815.04,4,738620,2,0,0,0,0,0
20150105.221734,2815.04,310,738930,-20,0,0,0,0,0
20150105.221735,2815.04,184,739114,8,0,0,0,0,0
20150105.221736,2815.28,6,739120,2,0,0,0,0,0
20150105.221737,2815.66,4,739124,2,0,0,0,0,0
20150105.221738,2815.04,134,739258,54,0,0,0,0,0
20150105.221739,2815.66,10,739268,6,0,0,0,0,0
20150105.22174,2815.66,14,739282,4,0,0,0,0,0
20150105.221741,2815.28,46,739328,-36,0,0,0,0,0
20150105.221742,2815.04,48,739376,2,0,0,0,0,0
20150105.221743,2815.66,122,739498,68,0,0,0,0,0
20150105.221744,2815.04,102,739600,34,0,0,0,0,0
20150105.221745,2815.66,4,739604,2,0,0,0,0,0
20150105.221746,2815.66,6,739610,0,0,0,0,0,0
20150105.221747,2815.04,38,739648,4,0,0,0,0,0
20150105.221748,2815.66,204,739852,200,0,0,0,0,0
20150105.221749,2815.66,4,739856,4,0,0,0,0,0
20150105.22175,2815.66,4,739860,2,0,0,0,0,0
20150105.221751,2815.66,22,739882,12,0,0,0,0,0
20150105.221752,2815.04,828,740710,-62,0,0,0,0,0
20150105.221753,2815.66,164,740874,0,0,0,0,0,0
20150105.221754,2816.03,14,740888,-8,0,0,0,0,0
20150105.221755,2815.66,234,741122,170,0,0,0,0,0
20150105.221756,2815.66,8,741130,0,0,0,0,0,0
20150105.221757,2815.04,214,741344,202,0,0,0,0,0
20150105.221758,2815.41,344,741688,-136,0,0,0,0,0
20150105.221759,2816.03,10,741698,0,0,0,0,0,0
20150105.2218,2816.03,178,741876,-2,0,0,0,0,0
20150105.221801,2816.03,168,742044,46,0,0,0,0,0
20150105.221802,2816.03,62,742106,2,0,0,0,0,0
20150105.221803,2816.03,150,742256,50,0,0,0,0,0
20150105.221804,2816.03,14,742270,12,0,0,0,0,0
20150105.221805,2816.03,10,742280,4,0,0,0,0,0
20150105.221806,2816.03,208,742488,-94,0,0,0,0,0
20150105.221807,2816.03,26,742514,6,0,0,0,0,0
20150105.221808,2816.03,38,742552,-2,0,0,0,0,0
20150105.221809,2816.03,14,742566,8,0,0,0,0,0
20150105.22181,2816.03,106,742672,-46,0,0,0,0,0
20150105.221811,2816.4,6,742678,2,0,0,0,0,0
20150105.221812,2816.4,6,742684,2,0,0,0,0,0
20150105.221813,2816.03,24,742708,-4,0,0,0,0,0
20150105.221814,2815.41,10,742718,-4,0,0,0,0,0
20150105.221815,2816.03,94,742812,2,0,0,0,0,0
20150105.221816,2816.03,94,742906,2,0,0,0,0,0
20150105.221817,2815.41,8,742914,4,0,0,0,0,0
20150105.221818,2816.03,30,742944,26,0,0,0,0,0
20150105.221819,2816.03,120,743064,38,0,0,0,0,0
20150105.22182,2816.03,62,743126,62,0,0,0,0,0
20150105.221821,2815.66,44,743170,2,0,0,0,0,0
20150105.221822,2816.03,4,743174,4,0,0,0,0,0
20150105.221823,2816.03,16,743190,14,0,0,0,0,0
20150105.221824,2816.03,6,743196,6,0,0,0,0,0
20150105.221825,2816.03,12,743208,4,0,0,0,0,0
20150105.221826,2815.41,114,743322,92,0,0,0,0,0
20150105.221827,2816.03,48,743370,42,0,0,0,0,0
20150105.221828,2815.66,6,743376,6,0,0,0,0,0
20150105.221829,2816.03,22,743398,6,0,0,0,0,0
20150105.22183,2816.03,4,743402,2,0,0,0,0,0
20150105.221831,2816.03,8,743410,2,0,0,0,0,0
20150105.221832,2815.66,6,743416,4,0,0,0,0,0
20150105.221833,2815.65,582,743998,582,0,0,0,0,0
20150105.221834,2815.65,770,744768,148,0,0,0,0,0
20150105.221835,2816.27,6,744774,0,0,0,0,0,0
20150105.221836,2816.27,14,744788,0,0,0,0,0,0
20150105.221837,2816.27,128,744916,10,0,0,0,0,0
20150105.221838,2815.65,26,744942,16,0,0,0,0,0
20150105.221839,2816.27,384,745326,84,0,0,0,0,0
20150105.22184,2815.65,8,745334,2,0,0,0,0,0
20150105.221841,2816.65,20,745354,-8,0,0,0,0,0
20150105.221842,2815.65,208,745562,102,0,0,0,0,0
20150105.221843,2815.65,20,745582,4,0,0,0,0,0
20150105.221844,2815.66,32,745614,-6,0,0,0,0,0
20150105.221845,2815.66,20,745634,20,0,0,0,0,0
20150105.221846,2815.28,26,745660,0,0,0,0,0,0
20150105.221847,2814.66,104,745764,80,0,0,0,0,0
20150105.221848,2815.28,230,745994,158,0,0,0,0,0
20150105.221849,2815.28,30,746024,24,0,0,0,0,0
20150105.22185,2814.91,144,746168,-112,0,0,0,0,0
20150105.221851,2814.91,130,746298,-80,0,0,0,0,0
20150105.221852,2814.91,146,746444,-46,0,0,0,0,0
20150105.221853,2814.91,102,746546,-28,0,0,0,0,0
20150105.221854,2815.28,68,746614,-34,0,0,0,0,0
20150105.221855,2815.52,202,746816,-8,0,0,0,0,0
20150105.221856,2814.91,276,747092,88,0,0,0,0,0
20150105.221857,2814.91,84,747176,-48,0,0,0,0,0
20150105.221858,2814.91,40,747216,0,0,0,0,0,0
20150105.221859,2815.15,44,747260,-30,0,0,0,0,0
20150105.2219,2814.53,14,747274,4,0,0,0,0,0
20150105.221901,2815.52,12,747286,0,0,0,0,0,0
20150105.221902,2815.15,48,747334,28,0,0,0,0,0
20150105.221903,2815.15,380,747714,-156,0,0,0,0,0
20150105.221904,2815.52,602,748316,-326,0,0,0,0,0
20150105.221905,2815.15,284,748600,-78,0,0,0,0,0
20150105.221906,2814.53,102,748702,0,0,0,0,0,0
20150105.221907,2814.91,36,748738,8,0,0,0,0,0
20150105.221908,2814.53,190,748928,-14,0,0,0,0,0
20150105.221909,2814.91,12,748940,12,0,0,0,0,0
20150105.22191,2815.52,32,748972,-6,0,0,0,0,0
20150105.221911,2814.91,14,748986,10,0,0,0,0,0
20150105.221912,2815.52,26,749012,2,0,0,0,0,0
20150105.221913,2814.91,30,749042,-22,0,0,0,0,0
20150105.221914,2815.52,330,749372,-86,0,0,0,0,0
20150105.221915,2814.91,8,749380,2,0,0,0,0,0
20150105.221916,2815.9,146,749526,102,0,0,0,0,0
20150105.221917,2814.91,120,749646,8,0,0,0,0,0
20150105.221918,2815.52,16,749662,-8,0,0,0,0,0
20150105.221919,2815.28,116,749778,56,0,0,0,0,0
20150105.22192,2815.28,4,749782,2,0,0,0,0,0
20150105.221921,2815.52,12,749794,8,0,0,0,0,0
20150105.221922,2815.28,4,749798,0,0,0,0,0,0
20150105.221923,2815.28,4,749802,0,0,0,0,0,0
20150105.221924,2815.52,44,749846,10,0,0,0,0,0
20150105.221925,2814.91,6,749852,0,0,0,0,0,0
20150105.221926,2814.91,4,749856,0,0,0,0,0,0
20150105.221927,2814.91,4,749860,0,0,0,0,0,0
20150105.221928,2814.91,110,749970,10,0,0,0,0,0
20150105.221929,2815.28,130,750100,-52,0,0,0,0,0
20150105.22193,2814.91,12,750112,-10,0,0,0,0,0
20150105.221931,2814.91,14,750126,-8,0,0,0,0,0
20150105.221932,2814.91,12,750138,-6,0,0,0,0,0
20150105.221933,2814.91,56,750194,22,0,0,0,0,0
20150105.221934,2815.52,98,750292,-14,0,0,0,0,0
20150105.221935,2814.91,26,750318,-20,0,0,0,0,0
20150105.221936,2814.91,102,750420,-100,0,0,0,0,0
20150105.221937,2814.91,42,750462,-38,0,0,0,0,0
20150105.221938,2815.52,22,750484,-2,0,0,0,0,0
20150105.221939,2814.91,22,750506,0,0,0,0,0,0
20150105.22194,2814.91,20,750526,-8,0,0,0,0,0
20150105.221941,2814.91,42,750568,-40,0,0,0,0,0
20150105.221942,2815.53,10,750578,0,0,0,0,0,0
20150105.221943,2814.53,186,750764,-2,0,0,0,0,0
20150105.221944,2814.91,46,750810,-28,0,0,0,0,0
20150105.221945,2814.91,74,750884,-14,0,0,0,0,0
20150105.221946,2814.91,14,750898,-2,0,0,0,0,0
20150105.221947,2815.52,108,751006,0,0,0,0,0,0
20150105.221948,2814.91,72,751078,-58,0,0,0,0,0
20150105.221949,2814.91,6,751084,-2,0,0,0,0,0
20150105.22195,2814.91,74,751158,-2,0,0,0,0,0
20150105.221951,2815.53,6,751164,-2,0,0,0,0,0
20150105.221952,2814.91,250,751414,12,0,0,0,0,0
20150105.221953,2814.91,28,751442,-6,0,0,0,0,0
20150105.221954,2814.91,4,751446,-4,0,0,0,0,0
20150105.221955,2814.91,44,751490,-10,0,0,0,0,0
20150105.221956,2814.53,58,751548,6,0,0,0,0,0
20150105.221957,2815.53,18,751566,-2,0,0,0,0,0
20150105.221958,2814.91,14,751580,2,0,0,0,0,0
20150105.221959,2814.91,104,751684,70,0,0,0,0,0
20150105.222,2814.53,10,751694,0,0,0,0,0,0
20150105.222001,2815.15,44,751738,-36,0,0,0,0,0
20150105.222002,2815.53,14,751752,-4,0,0,0,0,0
20150105.222003,2814.53,4,751756,-2,0,0,0,0,0
20150105.222004,2814.53,14,751770,-4,0,0,0,0,0
20150105.222005,2815.15,6,751776,-6,0,0,0,0,0
20150105.222006,2814.91,10,751786,-2,0,0,0,0,0
20150105.222007,2814.91,12,751798,4,0,0,0,0,0
20150105.222008,2814.91,48,751846,20,0,0,0,0,0
20150105.222009,2815.53,32,751878,12,0,0,0,0,0
20150105.22201,2814.53,10,751888,-4,0,0,0,0,0
20150105.222011,2815.15,16,751904,-2,0,0,0,0,0
20150105.222012,2815.15,62,751966,-24,0,0,0,0,0
20150105.222013,2815.15,20,751986,8,0,0,0,0,0
20150105.222014,2814.53,18,752004,4,0,0,0,0,0
20150105.222015,2815.15,4,752008,0,0,0,0,0,0
20150105.222016,2815.15,100,752108,-98,0,0,0,0,0
20150105.222017,2815.15,10,752118,-8,0,0,0,0,0
20150105.222018,2815.15,78,752196,0,0,0,0,0,0
20150105.222019,2815.15,500,752696,318,0,0,0,0,0
20150105.22202,2814.53,22,752718,10,0,0,0,0,0
20150105.222021,2815.15,12,752730,2,0,0,0,0,0
20150105.222022,2815.15,58,752788,-4,0,0,0,0,0
20150105.222023,2815.15,6,752794,0,0,0,0,0,0
20150105.222024,2815.15,58,752852,-12,0,0,0,0,0
20150105.222025,2815.15,214,753066,-46,0,0,0,0,0
20150105.222026,2815.15,10,753076,-4,0,0,0,0,0
20150105.222027,2815.53,18,753094,14,0,0,0,0,0
20150105.222028,2815.77,104,753198,-82,0,0,0,0,0
20150105.222029,2815.15,42,753240,38,0,0,0,0,0
20150105.22203,2815.53,212,753452,74,0,0,0,0,0
20150105.222031,2815.15,802,754254,410,0,0,0,0,0
20150105.222032,2815.15,6,754260,0,0,0,0,0,0
20150105.222033,2815.15,6,754266,-2,0,0,0,0,0
20150105.222034,2815.15,6,754272,2,0,0,0,0,0
20150105.222035,2815.77,106,754378,28,0,0,0,0,0
20150105.222036,2815.77,26,754404,-18,0,0,0,0,0
20150105.222037,2815.52,100,754504,52,0,0,0,0,0
20150105.222038,2815.52,114,754618,-6,0,0,0,0,0
20150105.222039,2815.15,8,754626,0,0,0,0,0,0
20150105.22204,2815.52,6,754632,2,0,0,0,0,0
20150105.222041,2815.52,84,754716,80,0,0,0,0,0
20150105.222042,2815.52,46,754762,-18,0,0,0,0,0
20150105.222043,2815.15,16,754778,-6,0,0,0,0,0
20150105.222044,2815.52,16,754794,-12,0,0,0,0,0
20150105.222045,2815.52,6,754800,-2,0,0,0,0,0
20150105.222046,2815.52,172,754972,0,0,0,0,0,0
20150105.222047,2815.52,48,755020,0,0,0,0,0,0
20150105.222048,2815.52,282,755302,166,0,0,0,0,0
20150105.222049,2815.52,138,755440,-134,0,0,0,0,0
20150105.22205,2815.52,486,755926,-302,0,0,0,0,0
20150105.222051,2815.9,40,755966,38,0,0,0,0,0
20150105.222052,2815.9,86,756052,-70,0,0,0,0,0
20150105.222053,2815.9,62,756114,-60,0,0,0,0,0
20150105.222054,2816.27,20,756134,-16,0,0,0,0,0
20150105.222055,2816.27,8,756142,-4,0,0,0,0,0
20150105.222056,2816.27,360,756502,-248,0,0,0,0,0
20150105.222057,2816.27,32,756534,-26,0,0,0,0,0
20150105.222058,2816.27,6,756540,-4,0,0,0,0,0
20150105.222059,2816.27,8,756548,-4,0,0,0,0,0
20150105.2221,2816.03,422,756970,-178,0,0,0,0,0
20150105.222101,2815.66,76,757046,30,0,0,0,0,0
20150105.222102,2817.02,222,757268,-166,0,0,0,0,0
20150105.222103,2816.65,14,757282,14,0,0,0,0,0
20150105.222104,2817.02,14,757296,0,0,0,0,0,0
20150105.222105,2816.27,892,758188,450,0,0,0,0,0
20150105.222106,2816.27,56,758244,-48,0,0,0,0,0
20150105.222107,2816.27,28,758272,-12,0,0,0,0,0
20150105.222108,2816.65,4,758276,0,0,0,0,0,0
20150105.222109,2816.65,12,758288,10,0,0,0,0,0
20150105.22211,2817.27,14,758302,-2,0,0,0,0,0
20150105.222111,2816.65,4,758306,2,0,0,0,0,0
20150105.222112,2816.65,404,758710,-90,0,0,0,0,0
20150105.222113,2816.27,36,758746,8,0,0,0,0,0
20150105.222114,2817.27,8,758754,-4,0,0,0,0,0
20150105.222115,2816.27,32,758786,-8,0,0,0,0,0
20150105.222116,2816.89,54,758840,-54,0,0,0,0,0
20150105.222117,2816.65,12,758852,-4,0,0,0,0,0
20150105.222118,2816.27,404,759256,2,0,0,0,0,0
20150105.222119,2817.27,6,759262,-6,0,0,0,0,0
20150105.22212,2816.89,6,759268,2,0,0,0,0,0
20150105.222121,2816.27,82,759350,0,0,0,0,0,0
20150105.222122,2816.89,4,759354,-2,0,0,0,0,0
20150105.222123,2817.27,10,759364,0,0,0,0,0,0
20150105.222124,2817.27,240,759604,-40,0,0,0,0,0
20150105.222125,2817.27,8,759612,-2,0,0,0,0,0
20150105.222126,2817.27,18,759630,-10,0,0,0,0,0
20150105.222127,2817.27,468,760098,-154,0,0,0,0,0
20150105.222128,2816.65,32,760130,0,0,0,0,0,0
20150105.222129,2816.89,28,760158,-20,0,0,0,0,0
20150105.22213,2817.27,204,760362,-42,0,0,0,0,0
20150105.222131,2817.27,206,760568,76,0,0,0,0,0
20150105.222132,2816.65,38,760606,-6,0,0,0,0,0
20150105.222133,2817.27,28,760634,-20,0,0,0,0,0
20150105.222134,2817.27,208,760842,10,0,0,0,0,0
20150105.222135,2817.27,158,761000,66,0,0,0,0,0
20150105.222136,2817.27,14,761014,4,0,0,0,0,0
20150105.222137,2817.02,10,761024,2,0,0,0,0,0
20150105.222138,2817.27,18,761042,0,0,0,0,0,0
20150105.222139,2817.27,208,761250,162,0,0,0,0,0
20150105.22214,2816.65,20,761270,16,0,0,0,0,0
20150105.222141,2817.27,8,761278,-2,0,0,0,0,0
20150105.222142,2817.27,10,761288,2,0,0,0,0,0
20150105.222143,2817.27,28,761316,-24,0,0,0,0,0
20150105.222144,2817.27,34,761350,24,0,0,0,0,0
20150105.222145,2817.27,18,761368,0,0,0,0,0,0
20150105.222146,2816.65,26,761394,-20,0,0,0,0,0
20150105.222147,2817.64,110,761504,30,0,0,0,0,0
20150105.222148,2817.02,256,761760,36,0,0,0,0,0
20150105.222149,2817.02,4,761764,2,0,0,0,0,0
20150105.22215,2817.02,14,761778,-6,0,0,0,0,0
20150105.222151,2818.02,6,761784,4,0,0,0,0,0
20150105.222152,2818.02,6,761790,0,0,0,0,0,0
20150105.222153,2817.64,14,761804,-8,0,0,0,0,0
20150105.222154,2817.02,26,761830,-22,0,0,0,0,0
20150105.222155,2817.4,16,761846,16,0,0,0,0,0
20150105.222156,2817.02,30,761876,0,0,0,0,0,0
20150105.222157,2817.02,6,761882,0,0,0,0,0,0
20150105.222158,2817.02,6,761888,4,0,0,0,0,0
20150105.222159,2817.64,204,762092,18,0,0,0,0,0
20150105.2222,2817.64,6,762098,4,0,0,0,0,0
20150105.222201,2817.02,4,762102,2,0,0,0,0,0
20150105.222202,2817.64,6,762108,2,0,0,0,0,0
20150105.222203,2817.02,12,762120,12,0,0,0,0,0
20150105.222204,2816.65,1002,763122,-642,0,0,0,0,0
20150105.222205,2817.02,10,763132,2,0,0,0,0,0
20150105.222206,2817.02,484,763616,168,0,0,0,0,0
20150105.222207,2816.65,8,763624,-2,0,0,0,0,0
20150105.222208,2817.02,26,763650,8,0,0,0,0,0
20150105.222209,2817.4,290,763940,150,0,0,0,0,0
20150105.22221,2817.4,258,764198,216,0,0,0,0,0
20150105.222211,2817.02,104,764302,90,0,0,0,0,0
20150105.222212,2817.02,78,764380,44,0,0,0,0,0
20150105.222213,2817.02,1206,765586,-38,0,0,0,0,0
20150105.222214,2817.4,104,765690,-98,0,0,0,0,0
20150105.222215,2817.4,20,765710,-2,0,0,0,0,0
20150105.222216,2817.4,84,765794,46,0,0,0,0,0
20150105.222217,2817.4,48,765842,20,0,0,0,0,0
20150105.222218,2817.02,48,765890,-2,0,0,0,0,0
20150105.222219,2817.02,1022,766912,0,0,0,0,0,0
20150105.22222,2817.02,42,766954,-2,0,0,0,0,0
20150105.222221,2817.4,72,767026,-30,0,0,0,0,0
20150105.222222,2817.4,1120,768146,-82,0,0,0,0,0
20150105.222223,2817.4,20,768166,6,0,0,0,0,0
20150105.222224,2817.77,40,768206,8,0,0,0,0,0
20150105.222225,2817.77,14,768220,10,0,0,0,0,0
20150105.222226,2817.77,18,768238,-10,0,0,0,0,0
20150105.222227,2817.77,22,768260,-2,0,0,0,0,0
20150105.222228,2817.4,108,768368,24,0,0,0,0,0
20150105.222229,2817.77,20,768388,-10,0,0,0,0,0
20150105.22223,2817.4,6,768394,2,0,0,0,0,0
20150105.222231,2817.4,16,768410,0,0,0,0,0,0
20150105.222232,2817.4,14,768424,-2,0,0,0,0,0
20150105.222233,2817.4,22,768446,0,0,0,0,0,0
20150105.222234,2818.02,30,768476,-2,0,0,0,0,0
20150105.222235,2817.4,12,768488,-6,0,0,0,0,0
20150105.222236,2817.4,12,768500,0,0,0,0,0,0
20150105.222237,2818.02,12,768512,8,0,0,0,0,0
20150105.222238,2818.39,6,768518,-2,0,0,0,0,0
20150105.222239,2818.02,34,768552,6,0,0,0,0,0
20150105.22224,2817.4,18,768570,-4,0,0,0,0,0
20150105.222241,2817.4,8,768578,0,0,0,0,0,0
20150105.222242,2817.77,16,768594,0,0,0,0,0,0
20150105.222243,2817.77,42,768636,34,0,0,0,0,0
20150105.222244,2817.4,52,768688,0,0,0,0,0,0
20150105.222245,2817.4,30,768718,2,0,0,0,0,0
20150105.222246,2818.02,4,768722,4,0,0,0,0,0
20150105.222247,2817.77,16,768738,2,0,0,0,0,0
20150105.222248,2818.39,4,768742,4,0,0,0,0,0
20150105.222249,2817.77,14,768756,-2,0,0,0,0,0
20150105.22225,2817.77,30,768786,6,0,0,0,0,0
20150105.222251,2818.39,8,768794,0,0,0,0,0,0
20150105.222252,2818.39,22,768816,0,0,0,0,0,0
20150105.222253,2818.39,604,769420,-466,0,0,0,0,0
20150105.222254,2818.39,102,769522,90,0,0,0,0,0
20150105.222255,2818.77,16,769538,12,0,0,0,0,0
20150105.222256,2818.39,4,769542,2,0,0,0,0,0
20150105.222257,2818.39,4,769546,0,0,0,0,0,0
20150105.222258,2818.39,30,769576,18,0,0,0,0,0
20150105.222259,2818.39,234,769810,-192,0,0,0,0,0
20150105.2223,2818.39,4,769814,0,0,0,0,0,0
20150105.222301,2818.39,16,769830,12,0,0,0,0,0
20150105.222302,2817.77,8,769838,-2,0,0,0,0,0
20150105.222303,2818.02,66,769904,12,0,0,0,0,0
20150105.222304,2817.4,254,770158,-4,0,0,0,0,0
20150105.222305,2818.39,34,770192,6,0,0,0,0,0
20150105.222306,2818.02,4,770196,0,0,0,0,0,0
20150105.222307,2817.4,4,770200,0,0,0,0,0,0
20150105.222308,2818.02,4,770204,0,0,0,0,0,0
20150105.222309,2817.4,64,770268,52,0,0,0,0,0
20150105.22231,2818.02,34,770302,0,0,0,0,0,0
20150105.222311,2818.02,6,770308,2,0,0,0,0,0
20150105.222312,2817.64,144,770452,0,0,0,0,0,0
20150105.222313,2818.02,42,770494,40,0,0,0,0,0
20150105.222314,2818.02,50,770544,-12,0,0,0,0,0
20150105.222315,2818.02,104,770648,80,0,0,0,0,0
20150105.222316,2817.64,40,770688,-32,0,0,0,0,0
20150105.222317,2818.02,10,770698,-2,0,0,0,0,0
20150105.222318,2817.64,786,771484,484,0,0,0,0,0
20150105.222319,2817.64,54,771538,40,0,0,0,0,0
20150105.22232,2817.4,6,771544,2,0,0,0,0,0
20150105.222321,2818.02,10,771554,4,0,0,0,0,0
20150105.222322,2817.4,26,771580,2,0,0,0,0,0
20150105.222323,2818.02,6,771586,2,0,0,0,0,0
20150105.222324,2817.4,4,771590,2,0,0,0,0,0
20150105.222325,2818.02,6,771596,0,0,0,0,0,0
20150105.222326,2818.02,42,771638,-38,0,0,0,0,0
20150105.222327,2818.02,32,771670,-8,0,0,0,0,0
20150105.222328,2817.4,24,771694,4,0,0,0,0,0
20150105.222329,2817.64,22,771716,10,0,0,0,0,0
20150105.22233,2817.64,162,771878,-74,0,0,0,0,0
20150105.222331,2818.02,4,771882,2,0,0,0,0,0
20150105.222332,2817.64,46,771928,-22,0,0,0,0,0
20150105.222333,2817.64,54,771982,-36,0,0,0,0,0
20150105.222334,2817.64,18,772000,0,0,0,0,0,0
20150105.222335,2817.64,6,772006,4,0,0,0,0,0
20150105.222336,2817.27,42,772048,-18,0,0,0,0,0
20150105.222337,2816.65,80,772128,-38,0,0,0,0,0
20150105.222338,2817.64,26,772154,-2,0,0,0,0,0
20150105.222339,2817.64,6,772160,2,0,0,0,0,0
20150105.22234,2817.64,204,772364,14,0,0,0,0,0
20150105.222341,2817.64,8,772372,8,0,0,0,0,0
20150105.222342,2817.02,402,772774,32,0,0,0,0,0
20150105.222343,2817.64,460,773234,240,0,0,0,0,0
20150105.222344,2817.64,4,773238,0,0,0,0,0,0
20150105.222345,2817.64,46,773284,4,0,0,0,0,0
20150105.222346,2817.64,6,773290,2,0,0,0,0,0
20150105.222347,2817.64,20,773310,4,0,0,0,0,0
20150105.222348,2817.64,12,773322,8,0,0,0,0,0
20150105.222349,2817.64,58,773380,2,0,0,0,0,0
20150105.22235,2817.02,82,773462,78,0,0,0,0,0
20150105.222351,2817.64,22,773484,4,0,0,0,0,0
20150105.222352,2817.64,46,773530,4,0,0,0,0,0
20150105.222353,2817.64,4,773534,0,0,0,0,0,0
20150105.222354,2817.64,10,773544,0,0,0,0,0,0
20150105.222355,2817.27,104,773648,58,0,0,0,0,0
20150105.222356,2818.02,26,773674,26,0,0,0,0,0
20150105.222357,2817.64,14,773688,2,0,0,0,0,0
20150105.222358,2817.64,14,773702,14,0,0,0,0,0
20150105.222359,2818.02,54,773756,2,0,0,0,0,0
20150105.2224,2817.64,4,773760,2,0,0,0,0,0
20150105.222401,2817.02,402,774162,132,0,0,0,0,0
20150105.222402,2818.02,16,774178,-8,0,0,0,0,0
20150105.222403,2817.64,50,774228,38,0,0,0,0,0
20150105.222404,2817.27,1202,775430,-38,0,0,0,0,0
20150105.222405,2817.02,16,775446,-12,0,0,0,0,0
20150105.222406,2816.65,1050,776496,72,0,0,0,0,0
20150105.222407,2817.64,1140,777636,110,0,0,0,0,0
20150105.222408,2817.64,10,777646,-2,0,0,0,0,0
20150105.222409,2817.64,12,777658,0,0,0,0,0,0
20150105.22241,2817.27,1002,778660,0,0,0,0,0,0
20150105.222411,2817.02,12,778672,0,0,0,0,0,0
20150105.222412,2816.65,1002,779674,0,0,0,0,0,0
20150105.222413,2817.27,1052,780726,0,0,0,0,0,0
20150105.222414,2817.27,1266,781992,-18,0,0,0,0,0
20150105.222415,2817.27,242,782234,-242,0,0,0,0,0
20150105.222416,2817.27,32,782266,-30,0,0,0,0,0
20150105.222417,2817.64,1692,783958,-298,0,0,0,0,0
20150105.222418,2817.27,180,784138,-80,0,0,0,0,0
20150105.222419,2816.89,8,784146,0,0,0,0,0,0
20150105.22242,2817.89,1174,785320,-24,0,0,0,0,0
20150105.222421,2818.26,4,785324,-2,0,0,0,0,0
20150105.222422,2817.89,1130,786454,-56,0,0,0,0,0
20150105.222423,2817.89,6,786460,0,0,0,0,0,0
20150105.222424,2817.27,30,786490,0,0,0,0,0,0
20150105.222425,2817.27,14,786504,-2,0,0,0,0,0
20150105.222426,2817.27,122,786626,0,0,0,0,0,0
20150105.222427,2818.26,26,786652,0,0,0,0,0,0
20150105.222428,2817.89,64,786716,0,0,0,0,0,0
20150105.222429,2817.89,12,786728,0,0,0,0,0,0
20150105.22243,2817.89,4,786732,2,0,0,0,0,0
20150105.222431,2817.89,126,786858,70,0,0,0,0,0
20150105.222432,2818.26,40,786898,14,0,0,0,0,0
20150105.222433,2817.27,10,786908,4,0,0,0,0,0
20150105.222434,2817.89,4,786912,0,0,0,0,0,0
20150105.222435,2817.51,1006,787918,-440,0,0,0,0,0
20150105.222436,2817.51,218,788136,-178,0,0,0,0,0
20150105.222437,2817.51,72,788208,-44,0,0,0,0,0
20150105.222438,2816.9,666,788874,-478,0,0,0,0,0
20150105.222439,2817.27,120,788994,-2,0,0,0,0,0
20150105.22244,2818.26,100,789094,-66,0,0,0,0,0
20150105.222441,2818.26,236,789330,-48,0,0,0,0,0
20150105.222442,2817.65,54,789384,-44,0,0,0,0,0
20150105.222443,2817.65,12,789396,-6,0,0,0,0,0
20150105.222444,2817.89,1004,790400,-448,0,0,0,0,0
20150105.222445,2817.27,46,790446,-28,0,0,0,0,0
20150105.222446,2817.52,68,790514,-18,0,0,0,0,0
20150105.222447,2816.9,12,790526,-2,0,0,0,0,0
20150105.222448,2817.52,784,791310,-640,0,0,0,0,0
20150105.222449,2817.27,226,791536,4,0,0,0,0,0
20150105.22245,2817.27,4,791540,0,0,0,0,0,0
20150105.222451,2818.27,126,791666,122,0,0,0,0,0
20150105.222452,2817.27,54,791720,0,0,0,0,0,0
20150105.222453,2817.89,8,791728,0,0,0,0,0,0
20150105.222454,2816.9,868,792596,-376,0,0,0,0,0
20150105.222455,2816.9,1544,794140,714,0,0,0,0,0
20150105.222456,2816.9,140,794280,0,0,0,0,0,0
20150105.222457,2817.27,10,794290,6,0,0,0,0,0
20150105.222458,2817.27,14,794304,4,0,0,0,0,0
20150105.222459,2817.27,36,794340,16,0,0,0,0,0
20150105.2225,2816.9,4,794344,4,0,0,0,0,0
20150105.222501,2817.27,20,794364,-2,0,0,0,0,0
20150105.222502,2817.27,12,794376,-6,0,0,0,0,0
20150105.222503,2817.27,42,794418,-2,0,0,0,0,0
20150105.222504,2817.27,4,794422,0,0,0,0,0,0
20150105.222505,2816.9,946,795368,-686,0,0,0,0,0
20150105.222506,2816.28,68,795436,-18,0,0,0,0,0
20150105.222507,2817.28,118,795554,42,0,0,0,0,0
20150105.222508,2816.28,408,795962,-44,0,0,0,0,0
20150105.222509,2816.28,54,796016,-48,0,0,0,0,0
20150105.22251,2816.9,114,796130,10,0,0,0,0,0
20150105.222511,2816.9,16,796146,0,0,0,0,0,0
20150105.222512,2816.9,50,796196,-6,0,0,0,0,0
20150105.222513,2816.9,12,796208,2,0,0,0,0,0
20150105.222514,2816.9,216,796424,2,0,0,0,0,0
20150105.222515,2816.9,110,796534,-2,0,0,0,0,0
20150105.222516,2816.28,62,796596,2,0,0,0,0,0
20150105.222517,2816.28,182,796778,-94,0,0,0,0,0
20150105.222518,2816.28,28,796806,-26,0,0,0,0,0
20150105.222519,2816.28,30,796836,-10,0,0,0,0,0
20150105.22252,2816.9,52,796888,8,0,0,0,0,0
20150105.222521,2816.9,8,796896,4,0,0,0,0,0
20150105.222522,2816.9,16,796912,2,0,0,0,0,0
20150105.222523,2816.28,64,796976,-52,0,0,0,0,0
20150105.222524,2816.9,12,796988,10,0,0,0,0,0
20150105.222525,2816.9,48,797036,18,0,0,0,0,0
20150105.222526,2816.53,202,797238,190,0,0,0,0,0
20150105.222527,2816.28,20,797258,0,0,0,0,0,0
20150105.222528,2816.28,54,797312,0,0,0,0,0,0
20150105.222529,2816.9,6,797318,2,0,0,0,0,0
20150105.22253,2816.28,26,797344,0,0,0,0,0,0
20150105.222531,2816.9,6,797350,4,0,0,0,0,0
20150105.222532,2816.9,4,797354,2,0,0,0,0,0
20150105.222533,2816.53,202,797556,-96,0,0,0,0,0
20150105.222534,2816.9,8,797564,6,0,0,0,0,0
20150105.222535,2816.9,28,797592,20,0,0,0,0,0
20150105.222536,2816.28,232,797824,60,0,0,0,0,0
20150105.222537,2816.28,22,797846,-2,0,0,0,0,0
20150105.222538,2816.53,210,798056,36,0,0,0,0,0
20150105.222539,2816.9,4,798060,2,0,0,0,0,0
20150105.22254,2816.9,8,798068,2,0,0,0,0,0
20150105.222541,2816.28,70,798138,-30,0,0,0,0,0
20150105.222542,2816.9,100,798238,2,0,0,0,0,0
20150105.222543,2816.9,14,798252,0,0,0,0,0,0
20150105.222544,2816.9,228,798480,-172,0,0,0,0,0
20150105.222545,2816.9,148,798628,-30,0,0,0,0,0
20150105.222546,2816.28,66,798694,-60,0,0,0,0,0
20150105.222547,2816.28,22,798716,0,0,0,0,0,0
20150105.222548,2816.9,176,798892,-40,0,0,0,0,0
20150105.222549,2816.9,304,799196,230,0,0,0,0,0
20150105.22255,2816.9,10,799206,-6,0,0,0,0,0
20150105.222551,2816.28,6,799212,-4,0,0,0,0,0
20150105.222552,2816.9,126,799338,0,0,0,0,0,0
20150105.222553,2816.28,130,799468,48,0,0,0,0,0
20150105.222554,2816.28,4,799472,-2,0,0,0,0,0
20150105.222555,2816.28,4,799476,-2,0,0,0,0,0
20150105.222556,2816.9,6,799482,2,0,0,0,0,0
20150105.222557,2816.9,4,799486,2,0,0,0,0,0
20150105.222558,2816.9,6,799492,0,0,0,0,0,0
20150105.222559,2816.28,64,799556,-42,0,0,0,0,0
20150105.2226,2816.28,12,799568,-8,0,0,0,0,0
20150105.222601,2816.28,402,799970,174,0,0,0,0,0
20150105.222602,2816.9,20,799990,6,0,0,0,0,0
20150105.222603,2816.28,18,800008,2,0,0,0,0,0
20150105.222604,2816.28,10,800018,8,0,0,0,0,0
20150105.222605,2815.91,36,800054,26,0,0,0,0,0
20150105.222606,2815.91,156,800210,-34,0,0,0,0,0
20150105.222607,2815.91,4,800214,2,0,0,0,0,0
20150105.222608,2815.91,12,800226,8,0,0,0,0,0
20150105.222609,2815.91,26,800252,16,0,0,0,0,0
20150105.22261,2816.53,12,800264,2,0,0,0,0,0
20150105.222611,2815.91,66,800330,-50,0,0,0,0,0
20150105.222612,2815.91,6,800336,2,0,0,0,0,0
20150105.222613,2815.91,324,800660,274,0,0,0,0,0
20150105.222614,2815.91,4,800664,0,0,0,0,0,0
20150105.222615,2815.91,10,800674,0,0,0,0,0,0
20150105.222616,2816.28,46,800720,40,0,0,0,0,0
20150105.222617,2815.91,8,800728,2,0,0,0,0,0
20150105.222618,2816.28,4,800732,4,0,0,0,0,0
20150105.222619,2816.9,10,800742,10,0,0,0,0,0
20150105.22262,2816.28,14,800756,10,0,0,0,0,0
20150105.222621,2816.28,22,800778,22,0,0,0,0,0
20150105.222622,2816.28,18,800796,16,0,0,0,0,0
20150105.222623,2816.28,48,800844,40,0,0,0,0,0
20150105.222624,2816.28,4,800848,2,0,0,0,0,0
20150105.222625,2816.28,4,800852,2,0,0,0,0,0
20150105.222626,2816.9,186,801038,128,0,0,0,0,0
20150105.222627,2816.28,64,801102,-10,0,0,0,0,0
20150105.222628,2816.28,80,801182,6,0,0,0,0,0
20150105.222629,2816.9,44,801226,40,0,0,0,0,0
20150105.22263,2816.9,82,801308,-4,0,0,0,0,0
20150105.222631,2816.28,1154,802462,782,0,0,0,0,0
20150105.222632,2816.28,16,802478,14,0,0,0,0,0
20150105.222633,2815.91,316,802794,0,0,0,0,0,0
20150105.222634,2815.91,84,802878,82,0,0,0,0,0
20150105.222635,2815.91,202,803080,8,0,0,0,0,0
20150105.222636,2815.54,80,803160,0,0,0,0,0,0
20150105.222637,2815.54,514,803674,20,0,0,0,0,0
20150105.222638,2814.92,618,804292,564,0,0,0,0,0
20150105.222639,2814.92,30,804322,12,0,0,0,0,0
20150105.22264,2815.54,28,804350,0,0,0,0,0,0
20150105.222641,2815.54,16,804366,14,0,0,0,0,0
20150105.222642,2814.92,54,804420,12,0,0,0,0,0
20150105.222643,2815.54,120,804540,14,0,0,0,0,0
20150105.222644,2814.92,628,805168,312,0,0,0,0,0
20150105.222645,2815.54,18,805186,-10,0,0,0,0,0
20150105.222646,2815.29,8,805194,2,0,0,0,0,0
20150105.222647,2814.92,4,805198,2,0,0,0,0,0
20150105.222648,2814.92,30,805228,24,0,0,0,0,0
20150105.222649,2815.29,614,805842,370,0,0,0,0,0
20150105.22265,2814.92,66,805908,-2,0,0,0,0,0
20150105.222651,2814.92,6,805914,-2,0,0,0,0,0
20150105.222652,2815.29,14,805928,-6,0,0,0,0,0
20150105.222653,2814.92,108,806036,-78,0,0,0,0,0
20150105.222654,2814.92,6,806042,-2,0,0,0,0,0
20150105.222655,2814.92,4,806046,-2,0,0,0,0,0
20150105.222656,2814.92,14,806060,-10,0,0,0,0,0
20150105.222657,2814.92,4,806064,0,0,0,0,0,0
20150105.222658,2814.92,24,806088,0,0,0,0,0,0
20150105.222659,2815.54,6,806094,0,0,0,0,0,0
20150105.2227,2814.92,4,806098,0,0,0,0,0,0
20150105.222701,2814.92,6,806104,-2,0,0,0,0,0
20150105.222702,2814.92,6,806110,-4,0,0,0,0,0
20150105.222703,2814.92,22,806132,0,0,0,0,0,0
20150105.222704,2814.92,4,806136,-2,0,0,0,0,0
20150105.222705,2815.54,32,806168,12,0,0,0,0,0
20150105.222706,2815.54,26,806194,20,0,0,0,0,0
20150105.222707,2815.54,98,806292,12,0,0,0,0,0
20150105.222708,2815.54,28,806320,-14,0,0,0,0,0
20150105.222709,2815.54,90,806410,4,0,0,0,0,0
20150105.22271,2815.54,12,806422,4,0,0,0,0,0
20150105.222711,2814.92,84,806506,80,0,0,0,0,0
20150105.222712,2814.92,50,806556,-44,0,0,0,0,0
20150105.222713,2815.54,12,806568,4,0,0,0,0,0
20150105.222714,2814.92,168,806736,-142,0,0,0,0,0
20150105.222715,2814.92,240,806976,10,0,0,0,0,0
20150105.222716,2814.92,316,807292,88,0,0,0,0,0
20150105.222717,2815.29,104,807396,-22,0,0,0,0,0
20150105.222718,2814.92,48,807444,40,0,0,0,0,0
20150105.222719,2814.3,96,807540,-2,0,0,0,0,0
20150105.22272,2814.92,76,807616,2,0,0,0,0,0
20150105.222721,2814.92,4,807620,0,0,0,0,0,0
20150105.222722,2814.92,8,807628,-4,0,0,0,0,0
20150105.222723,2814.92,182,807810,150,0,0,0,0,0
20150105.222724,2814.92,14,807824,-6,0,0,0,0,0
20150105.222725,2814.92,6,807830,4,0,0,0,0,0
20150105.222726,2814.3,266,808096,262,0,0,0,0,0
20150105.222727,2814.3,10,808106,6,0,0,0,0,0
20150105.222728,2815.29,250,808356,-94,0,0,0,0,0
20150105.222729,2815.29,16,808372,-2,0,0,0,0,0
20150105.22273,2814.92,20,808392,-14,0,0,0,0,0
20150105.222731,2815.29,14,808406,0,0,0,0,0,0
20150105.222732,2814.92,4,808410,2,0,0,0,0,0
20150105.222733,2815.29,12,808422,0,0,0,0,0,0
20150105.222734,2815.29,8,808430,2,0,0,0,0,0
20150105.222735,2815.54,24,808454,-10,0,0,0,0,0
20150105.222736,2814.92,202,808656,2,0,0,0,0,0
20150105.222737,2815.29,12,808668,-8,0,0,0,0,0
20150105.222738,2814.92,468,809136,296,0,0,0,0,0
20150105.222739,2814.92,210,809346,136,0,0,0,0,0
20150105.22274,2814.54,24,809370,-2,0,0,0,0,0
20150105.222741,2814.92,32,809402,2,0,0,0,0,0
20150105.222742,2815.54,70,809472,0,0,0,0,0,0
20150105.222743,2814.92,8,809480,-2,0,0,0,0,0
20150105.222744,2815.54,6,809486,2,0,0,0,0,0
20150105.222745,2814.92,40,809526,-2,0,0,0,0,0
20150105.222746,2814.92,256,809782,-50,0,0,0,0,0
20150105.222747,2814.92,4,809786,0,0,0,0,0,0
20150105.222748,2814.92,4,809790,2,0,0,0,0,0
20150105.222749,2814.92,6,809796,4,0,0,0,0,0
20150105.22275,2814.92,80,809876,0,0,0,0,0,0
20150105.222751,2814.92,72,809948,-36,0,0,0,0,0
20150105.222752,2814.92,36,809984,32,0,0,0,0,0
20150105.222753,2814.92,82,810066,4,0,0,0,0,0
20150105.222754,2815.29,46,810112,-2,0,0,0,0,0
20150105.222755,2814.92,136,810248,120,0,0,0,0,0
20150105.222756,2815.16,450,810698,308,0,0,0,0,0
20150105.222757,2815.16,58,810756,16,0,0,0,0,0
20150105.222758,2815.16,6,810762,4,0,0,0,0,0
20150105.222759,2814.54,12,810774,0,0,0,0,0,0
20150105.2228,2814.17,828,811602,556,0,0,0,0,0
20150105.222801,2814.17,342,811944,222,0,0,0,0,0
20150105.222802,2813.79,54,811998,50,0,0,0,0,0
20150105.222803,2814.17,6,812004,0,0,0,0,0,0
20150105.222804,2814.17,160,812164,-76,0,0,0,0,0
20150105.222805,2814.17,14,812178,6,0,0,0,0,0
20150105.222806,2814.17,32,812210,20,0,0,0,0,0
20150105.222807,2814.17,60,812270,50,0,0,0,0,0
20150105.222808,2814.17,22,812292,4,0,0,0,0,0
20150105.222809,2814.54,246,812538,102,0,0,0,0,0
20150105.22281,2815.16,78,812616,4,0,0,0,0,0
20150105.222811,2814.17,4,812620,-2,0,0,0,0,0
20150105.222812,2814.54,6,812626,0,0,0,0,0,0
20150105.222813,2814.54,80,812706,0,0,0,0,0,0
20150105.222814,2814.17,354,813060,-150,0,0,0,0,0
20150105.222815,2814.17,300,813360,-100,0,0,0,0,0
20150105.222816,2814.17,28,813388,24,0,0,0,0,0
20150105.222817,2814.17,8,813396,6,0,0,0,0,0
20150105.222818,2814.17,142,813538,58,0,0,0,0,0
20150105.222819,2813.18,308,813846,-270,0,0,0,0,0
20150105.22282,2814.17,4,813850,0,0,0,0,0,0
20150105.222821,2814.17,4,813854,2,0,0,0,0,0
20150105.222822,2814.54,12,813866,4,0,0,0,0,0
20150105.222823,2814.54,8,813874,2,0,0,0,0,0
20150105.222824,2814.54,4,813878,2,0,0,0,0,0
20150105.222825,2813.92,6,813884,0,0,0,0,0,0
20150105.222826,2814.54,6,813890,-2,0,0,0,0,0
20150105.222827,2814.54,64,813954,-58,0,0,0,0,0
20150105.222828,2813.55,8,813962,0,0,0,0,0,0
20150105.222829,2814.54,12,813974,2,0,0,0,0,0
20150105.22283,2813.92,130,814104,116,0,0,0,0,0
20150105.222831,2814.54,10,814114,8,0,0,0,0,0
20150105.222832,2814.17,6,814120,2,0,0,0,0,0
20150105.222833,2813.92,14,814134,0,0,0,0,0,0
20150105.222834,2814.54,4,814138,2,0,0,0,0,0
20150105.222835,2814.54,34,814172,32,0,0,0,0,0
20150105.222836,2814.54,24,814196,20,0,0,0,0,0
20150105.222837,2813.92,42,814238,-38,0,0,0,0,0
20150105.222838,2814.54,22,814260,-20,0,0,0,0,0
20150105.222839,2814.54,62,814322,0,0,0,0,0,0
20150105.22284,2814.92,310,814632,-262,0,0,0,0,0
20150105.222841,2814.3,126,814758,-62,0,0,0,0,0
20150105.222842,2814.92,92,814850,-50,0,0,0,0,0
20150105.222843,2814.92,194,815044,-48,0,0,0,0,0
20150105.222844,2814.92,6,815050,0,0,0,0,0,0
20150105.222845,2814.3,124,815174,118,0,0,0,0,0
20150105.222846,2814.92,12,815186,0,0,0,0,0,0
20150105.222847,2814.92,22,815208,20,0,0,0,0,0
20150105.222848,2814.92,404,815612,-130,0,0,0,0,0
20150105.222849,2814.92,54,815666,-4,0,0,0,0,0
20150105.22285,2814.92,116,815782,-94,0,0,0,0,0
20150105.222851,2814.92,18,815800,-14,0,0,0,0,0
20150105.222852,2814.92,6,815806,0,0,0,0,0,0
20150105.222853,2814.92,4,815810,0,0,0,0,0,0
20150105.222854,2814.3,46,815856,6,0,0,0,0,0
20150105.222855,2814.3,106,815962,102,0,0,0,0,0
20150105.222856,2814.92,4,815966,2,0,0,0,0,0
20150105.222857,2814.3,4,815970,0,0,0,0,0,0
20150105.222858,2814.3,84,816054,-18,0,0,0,0,0
20150105.222859,2814.3,72,816126,24,0,0,0,0,0
20150105.2229,2814.92,22,816148,2,0,0,0,0,0
20150105.222901,2814.92,26,816174,14,0,0,0,0,0
20150105.222902,2814.54,138,816312,130,0,0,0,0,0
20150105.222903,2814.92,4,816316,2,0,0,0,0,0
20150105.222904,2814.3,52,816368,22,0,0,0,0,0
20150105.222905,2814.92,22,816390,2,0,0,0,0,0
20150105.222906,2814.3,86,816476,82,0,0,0,0,0
20150105.222907,2814.3,102,816578,-12,0,0,0,0,0
20150105.222908,2814.92,106,816684,-18,0,0,0,0,0
20150105.222909,2815.29,118,816802,-112,0,0,0,0,0
20150105.22291,2814.92,50,816852,-38,0,0,0,0,0
20150105.222911,2814.92,20,816872,-16,0,0,0,0,0
20150105.222912,2814.92,8,816880,-2,0,0,0,0,0
20150105.222913,2814.3,22,816902,2,0,0,0,0,0
20150105.222914,2814.92,8,816910,0,0,0,0,0,0
20150105.222915,2814.3,70,816980,68,0,0,0,0,0
20150105.222916,2814.3,12,816992,2,0,0,0,0,0
20150105.222917,2814.3,8,817000,2,0,0,0,0,0
20150105.222918,2814.92,52,817052,0,0,0,0,0,0
20150105.222919,2814.3,22,817074,20,0,0,0,0,0
20150105.22292,2814.3,42,817116,2,0,0,0,0,0
20150105.222921,2814.92,4,817120,-2,0,0,0,0,0
20150105.222922,2814.3,6,817126,6,0,0,0,0,0
20150105.222923,2814.3,72,817198,-38,0,0,0,0,0
20150105.222924,2814.92,8,817206,6,0,0,0,0,0
20150105.222925,2814.3,64,817270,4,0,0,0,0,0
20150105.222926,2814.3,12,817282,8,0,0,0,0,0
20150105.222927,2814.92,6,817288,4,0,0,0,0,0
20150105.222928,2813.92,4,817292,2,0,0,0,0,0
20150105.222929,2814.92,4,817296,4,0,0,0,0,0
20150105.22293,2814.92,4,817300,-2,0,0,0,0,0
20150105.222931,2814.92,82,817382,-78,0,0,0,0,0
20150105.222932,2814.92,12,817394,2,0,0,0,0,0
20150105.222933,2814.3,204,817598,86,0,0,0,0,0
20150105.222934,2815.29,208,817806,-64,0,0,0,0,0
20150105.222935,2814.3,22,817828,-8,0,0,0,0,0
20150105.222936,2814.67,20,817848,-2,0,0,0,0,0
20150105.222937,2814.92,84,817932,12,0,0,0,0,0
20150105.222938,2814.3,24,817956,-8,0,0,0,0,0
20150105.222939,2814.92,10,817966,-2,0,0,0,0,0
20150105.22294,2815.29,4,817970,-2,0,0,0,0,0
20150105.222941,2814.92,6,817976,-4,0,0,0,0,0
20150105.222942,2815.29,22,817998,-14,0,0,0,0,0
20150105.222943,2814.3,4,818002,-2,0,0,0,0,0
20150105.222944,2815.29,132,818134,0,0,0,0,0,0
20150105.222945,2815.29,4,818138,2,0,0,0,0,0
20150105.222946,2814.3,102,818240,-2,0,0,0,0,0
20150105.222947,2814.3,408,818648,244,0,0,0,0,0
20150105.222948,2814.3,80,818728,76,0,0,0,0,0
20150105.222949,2814.3,24,818752,8,0,0,0,0,0
20150105.22295,2814.3,238,818990,228,0,0,0,0,0
20150105.222951,2814.67,6,818996,0,0,0,0,0,0
20150105.222952,2815.29,40,819036,-6,0,0,0,0,0
20150105.222953,2814.3,68,819104,34,0,0,0,0,0
20150105.222954,2815.54,820,819924,-168,0,0,0,0,0
20150105.222955,2814.3,26,819950,14,0,0,0,0,0
20150105.222956,2815.29,56,820006,14,0,0,0,0,0
20150105.222957,2814.92,22,820028,0,0,0,0,0,0
20150105.222958,2814.3,114,820142,64,0,0,0,0,0
20150105.222959,2814.3,156,820298,118,0,0,0,0,0
20150105.223,2814.3,158,820456,88,0,0,0,0,0
20150105.223001,2813.92,152,820608,78,0,0,0,0,0
20150105.223002,2814.3,56,820664,56,0,0,0,0,0
20150105.223003,2813.68,108,820772,-40,0,0,0,0,0
20150105.223004,2813.68,30,820802,10,0,0,0,0,0
20150105.223005,2813.3,60,820862,16,0,0,0,0,0
20150105.223006,2813.68,62,820924,-2,0,0,0,0,0
20150105.223007,2813.68,198,821122,152,0,0,0,0,0
20150105.223008,2814.3,16,821138,2,0,0,0,0,0
20150105.223009,2813.68,12,821150,8,0,0,0,0,0
20150105.22301,2814.3,14,821164,4,0,0,0,0,0
20150105.223011,2814.3,406,821570,-44,0,0,0,0,0
20150105.223012,2814.92,302,821872,-162,0,0,0,0,0
20150105.223013,2813.92,4,821876,-4,0,0,0,0,0
20150105.223014,2813.92,420,822296,268,0,0,0,0,0
20150105.223015,2813.3,36,822332,32,0,0,0,0,0
20150105.223016,2813.92,40,822372,38,0,0,0,0,0
20150105.223017,2813.3,38,822410,0,0,0,0,0,0
20150105.223018,2813.3,20,822430,10,0,0,0,0,0
20150105.223019,2813.3,282,822712,0,0,0,0,0,0
20150105.22302,2813.92,14,822726,-2,0,0,0,0,0
20150105.223021,2813.55,596,823322,194,0,0,0,0,0
20150105.223022,2813.3,2002,825324,1526,0,0,0,0,0
20150105.223023,2812.31,208,825532,-36,0,0,0,0,0
20150105.223024,2812.93,232,825764,26,0,0,0,0,0
20150105.223025,2812.93,266,826030,210,0,0,0,0,0
20150105.223026,2812.93,22,826052,0,0,0,0,0,0
20150105.223027,2813.92,68,826120,-44,0,0,0,0,0
20150105.223028,2812.93,44,826164,-20,0,0,0,0,0
20150105.223029,2812.31,24,826188,4,0,0,0,0,0
20150105.22303,2811.94,74,826262,-2,0,0,0,0,0
20150105.223031,2812.69,226,826488,-92,0,0,0,0,0
20150105.223032,2812.93,16,826504,-2,0,0,0,0,0
20150105.223033,2812.31,204,826708,4,0,0,0,0,0
20150105.223034,2812.31,24,826732,2,0,0,0,0,0
20150105.223035,2813.55,614,827346,-388,0,0,0,0,0
20150105.223036,2811.94,808,828154,-800,0,0,0,0,0
20150105.223037,2812.93,78,828232,46,0,0,0,0,0
20150105.223038,2812.31,8,828240,2,0,0,0,0,0
20150105.223039,2812.93,4,828244,2,0,0,0,0,0
20150105.22304,2812.93,16,828260,-2,0,0,0,0,0
20150105.223041,2811.94,60,828320,56,0,0,0,0,0
20150105.223042,2812.56,10,828330,-6,0,0,0,0,0
20150105.223043,2812.56,42,828372,2,0,0,0,0,0
20150105.223044,2812.93,74,828446,50,0,0,0,0,0
20150105.223045,2812.93,62,828508,-30,0,0,0,0,0
20150105.223046,2812.31,16,828524,0,0,0,0,0,0
20150105.223047,2812.93,16,828540,-6,0,0,0,0,0
20150105.223048,2812.93,14,828554,2,0,0,0,0,0
20150105.223049,2812.93,102,828656,2,0,0,0,0,0
20150105.22305,2812.93,184,828840,-178,0,0,0,0,0
20150105.223051,2812.93,530,829370,-498,0,0,0,0,0
20150105.223052,2812.93,16,829386,8,0,0,0,0,0
20150105.223053,2813.55,44,829430,-2,0,0,0,0,0
20150105.223054,2812.93,62,829492,52,0,0,0,0,0
20150105.223055,2812.93,104,829596,-16,0,0,0,0,0
20150105.223056,2812.93,202,829798,46,0,0,0,0,0
20150105.223057,2813.55,50,829848,-4,0,0,0,0,0
20150105.223058,2813.55,40,829888,2,0,0,0,0,0
20150105.223059,2812.93,166,830054,-2,0,0,0,0,0
20150105.2231,2812.93,14,830068,14,0,0,0,0,0
20150105.223101,2813.55,22,830090,20,0,0,0,0,0
20150105.223102,2812.93,306,830396,-58,0,0,0,0,0
20150105.223103,2812.93,12,830408,8,0,0,0,0,0
20150105.223104,2813.55,26,830434,8,0,0,0,0,0
20150105.223105,2812.93,4,830438,2,0,0,0,0,0
20150105.223106,2812.93,304,830742,-106,0,0,0,0,0
20150105.223107,2813.55,4,830746,2,0,0,0,0,0
20150105.223108,2812.93,42,830788,6,0,0,0,0,0
20150105.223109,2813.55,4,830792,2,0,0,0,0,0
20150105.22311,2813.55,6,830798,0,0,0,0,0,0
20150105.223111,2812.93,18,830816,12,0,0,0,0,0
20150105.223112,2812.93,6,830822,0,0,0,0,0,0
20150105.223113,2813.55,8,830830,0,0,0,0,0,0
20150105.223114,2813.55,44,830874,2,0,0,0,0,0
20150105.223115,2812.93,4,830878,0,0,0,0,0,0
20150105.223116,2813.55,72,830950,54,0,0,0,0,0
20150105.223117,2813.55,10,830960,2,0,0,0,0,0
20150105.223118,2813.18,208,831168,-200,0,0,0,0,0
20150105.223119,2813.55,74,831242,62,0,0,0,0,0
20150105.22312,2812.93,26,831268,22,0,0,0,0,0
20150105.223121,2813.55,8,831276,-2,0,0,0,0,0
20150105.223122,2813.55,196,831472,16,0,0,0,0,0
20150105.223123,2813.55,98,831570,10,0,0,0,0,0
20150105.223124,2813.55,648,832218,388,0,0,0,0,0
20150105.223125,2813.8,46,832264,-4,0,0,0,0,0
20150105.223126,2813.55,4,832268,2,0,0,0,0,0
20150105.223127,2814.17,16,832284,4,0,0,0,0,0
20150105.223128,2814.17,46,832330,30,0,0,0,0,0
20150105.223129,2814.17,20,832350,10,0,0,0,0,0
20150105.22313,2814.17,34,832384,14,0,0,0,0,0
20150105.223131,2814.17,14,832398,10,0,0,0,0,0
20150105.223132,2813.55,486,832884,-252,0,0,0,0,0
20150105.223133,2813.55,172,833056,150,0,0,0,0,0
20150105.223134,2813.55,18,833074,6,0,0,0,0,0
20150105.223135,2813.55,8,833082,8,0,0,0,0,0
20150105.223136,2813.55,4,833086,4,0,0,0,0,0
20150105.223137,2812.93,220,833306,-146,0,0,0,0,0
20150105.223138,2812.93,140,833446,42,0,0,0,0,0
20150105.223139,2813.55,8,833454,4,0,0,0,0,0
20150105.22314,2813.18,18,833472,0,0,0,0,0,0
20150105.223141,2812.93,12,833484,-10,0,0,0,0,0
20150105.223142,2813.55,16,833500,4,0,0,0,0,0
20150105.223143,2813.55,10,833510,4,0,0,0,0,0
20150105.223144,2813.55,106,833616,54,0,0,0,0,0
20150105.223145,2812.93,32,833648,0,0,0,0,0,0
20150105.223146,2813.55,8,833656,0,0,0,0,0,0
20150105.223147,2813.55,6,833662,0,0,0,0,0,0
20150105.223148,2812.93,34,833696,-2,0,0,0,0,0
20150105.223149,2812.93,48,833744,6,0,0,0,0,0
20150105.22315,2813.55,4,833748,2,0,0,0,0,0
20150105.223151,2813.18,8,833756,-6,0,0,0,0,0
20150105.223152,2813.55,16,833772,4,0,0,0,0,0
20150105.223153,2812.93,16,833788,-2,0,0,0,0,0
20150105.223154,2813.55,16,833804,-10,0,0,0,0,0
20150105.223155,2812.93,108,833912,92,0,0,0,0,0
20150105.223156,2813.55,20,833932,16,0,0,0,0,0
20150105.223157,2813.55,10,833942,-2,0,0,0,0,0
20150105.223158,2812.93,20,833962,-10,0,0,0,0,0
20150105.223159,2812.93,14,833976,-10,0,0,0,0,0
20150105.2232,2813.55,132,834108,2,0,0,0,0,0
20150105.223201,2813.55,6,834114,0,0,0,0,0,0
20150105.223202,2813.55,16,834130,2,0,0,0,0,0
20150105.223203,2813.55,742,834872,430,0,0,0,0,0
20150105.223204,2813.55,32,834904,-2,0,0,0,0,0
20150105.223205,2812.93,36,834940,26,0,0,0,0,0
20150105.223206,2813.55,16,834956,16,0,0,0,0,0
20150105.223207,2813.55,164,835120,164,0,0,0,0,0
20150105.223208,2813.55,70,835190,-36,0,0,0,0,0
20150105.223209,2812.93,36,835226,4,0,0,0,0,0
20150105.22321,2813.55,14,835240,12,0,0,0,0,0
20150105.223211,2813.55,16,835256,12,0,0,0,0,0
20150105.223212,2812.93,402,835658,2,0,0,0,0,0
20150105.223213,2813.55,110,835768,50,0,0,0,0,0
20150105.223214,2812.93,14,835782,-2,0,0,0,0,0
20150105.223215,2813.55,52,835834,0,0,0,0,0,0
20150105.223216,2813.55,4,835838,4,0,0,0,0,0
20150105.223217,2812.56,48,835886,16,0,0,0,0,0
20150105.223218,2812.93,264,836150,242,0,0,0,0,0
20150105.223219,2813.55,8,836158,0,0,0,0,0,0
20150105.22322,2813.55,4,836162,2,0,0,0,0,0
20150105.223221,2813.55,22,836184,18,0,0,0,0,0
20150105.223222,2813.55,22,836206,0,0,0,0,0,0
20150105.223223,2813.55,606,836812,586,0,0,0,0,0
20150105.223224,2813.55,6,836818,6,0,0,0,0,0
20150105.223225,2812.93,530,837348,282,0,0,0,0,0
20150105.223226,2812.93,42,837390,22,0,0,0,0,0
20150105.223227,2812.93,6,837396,4,0,0,0,0,0
20150105.223228,2812.93,10,837406,10,0,0,0,0,0
20150105.223229,2812.93,6,837412,6,0,0,0,0,0
20150105.22323,2812.93,44,837456,44,0,0,0,0,0
20150105.223231,2812.93,14,837470,4,0,0,0,0,0
20150105.223232,2812.93,8,837478,8,0,0,0,0,0
20150105.223233,2812.93,14,837492,8,0,0,0,0,0
20150105.223234,2812.93,216,837708,-18,0,0,0,0,0
20150105.223235,2812.93,6,837714,6,0,0,0,0,0
20150105.223236,2812.56,24,837738,-20,0,0,0,0,0
20150105.223237,2812.93,14,837752,12,0,0,0,0,0
20150105.223238,2812.93,24,837776,24,0,0,0,0,0
20150105.223239,2812.93,156,837932,156,0,0,0,0,0
20150105.22324,2812.93,6,837938,2,0,0,0,0,0
20150105.223241,2812.93,20,837958,20,0,0,0,0,0
20150105.223242,2812.93,4,837962,2,0,0,0,0,0
20150105.223243,2812.93,14,837976,14,0,0,0,0,0
20150105.223244,2812.93,100,838076,82,0,0,0,0,0
20150105.223245,2812.93,104,838180,64,0,0,0,0,0
20150105.223246,2812.93,158,838338,-12,0,0,0,0,0
20150105.223247,2812.31,72,838410,-26,0,0,0,0,0
20150105.223248,2812.93,22,838432,-22,0,0,0,0,0
20150105.223249,2812.93,38,838470,-38,0,0,0,0,0
20150105.22325,2812.31,6,838476,-6,0,0,0,0,0
20150105.223251,2812.31,602,839078,298,0,0,0,0,0
20150105.223252,2813.3,12,839090,-6,0,0,0,0,0
20150105.223253,2812.31,4,839094,2,0,0,0,0,0
20150105.223254,2813.3,8,839102,-6,0,0,0,0,0
20150105.223255,2812.68,10,839112,6,0,0,0,0,0
20150105.223256,2812.31,96,839208,14,0,0,0,0,0
20150105.223257,2812.31,4,839212,2,0,0,0,0,0
20150105.223258,2812.93,4,839216,2,0,0,0,0,0
20150105.223259,2812.93,80,839296,54,0,0,0,0,0
20150105.2233,2812.31,202,839498,104,0,0,0,0,0
20150105.223301,2812.93,26,839524,18,0,0,0,0,0
20150105.223302,2812.31,206,839730,-174,0,0,0,0,0
20150105.223303,2812.31,8,839738,4,0,0,0,0,0
20150105.223304,2811.94,10,839748,-8,0,0,0,0,0
20150105.223305,2812.93,156,839904,-10,0,0,0,0,0
20150105.223306,2812.31,12,839916,0,0,0,0,0,0
20150105.223307,2812.31,14,839930,2,0,0,0,0,0
20150105.223308,2812.31,12,839942,-4,0,0,0,0,0
20150105.223309,2811.94,4,839946,0,0,0,0,0,0
20150105.22331,2812.93,224,840170,-190,0,0,0,0,0
20150105.223311,2812.31,6,840176,-4,0,0,0,0,0
20150105.223312,2812.31,240,840416,-36,0,0,0,0,0
20150105.223313,2812.31,390,840806,-56,0,0,0,0,0
20150105.223314,2812.56,68,840874,16,0,0,0,0,0
20150105.223315,2812.93,4,840878,2,0,0,0,0,0
20150105.223316,2812.93,18,840896,2,0,0,0,0,0
20150105.223317,2812.93,232,841128,-6,0,0,0,0,0
20150105.223318,2812.31,8,841136,2,0,0,0,0,0
20150105.223319,2812.93,44,841180,10,0,0,0,0,0
20150105.22332,2812.93,10,841190,-2,0,0,0,0,0
20150105.223321,2812.31,322,841512,68,0,0,0,0,0
20150105.223322,2812.93,330,841842,-172,0,0,0,0,0
20150105.223323,2812.93,38,841880,2,0,0,0,0,0
20150105.223324,2812.93,100,841980,2,0,0,0,0,0
20150105.223325,2812.56,562,842542,52,0,0,0,0,0
20150105.223326,2812.93,320,842862,-4,0,0,0,0,0
20150105.223327,2812.93,118,842980,56,0,0,0,0,0
20150105.223328,2812.93,4,842984,4,0,0,0,0,0
20150105.223329,2812.93,6,842990,4,0,0,0,0,0
20150105.22333,2812.56,100,843090,12,0,0,0,0,0
20150105.223331,2812.93,192,843282,2,0,0,0,0,0
20150105.223332,2812.93,42,843324,20,0,0,0,0,0
20150105.223333,2812.93,142,843466,-32,0,0,0,0,0
20150105.223334,2812.93,34,843500,6,0,0,0,0,0
20150105.223335,2812.93,16,843516,10,0,0,0,0,0
20150105.223336,2812.56,12,843528,-10,0,0,0,0,0
20150105.223337,2812.31,28,843556,-14,0,0,0,0,0
20150105.223338,2812.93,12,843568,2,0,0,0,0,0
20150105.223339,2812.93,12,843580,2,0,0,0,0,0
20150105.22334,2812.93,10,843590,4,0,0,0,0,0
20150105.223341,2812.93,32,843622,8,0,0,0,0,0
20150105.223342,2812.93,22,843644,16,0,0,0,0,0
20150105.223343,2812.93,12,843656,12,0,0,0,0,0
20150105.223344,2812.93,64,843720,-4,0,0,0,0,0
20150105.223345,2812.93,4,843724,2,0,0,0,0,0
20150105.223346,2812.93,108,843832,106,0,0,0,0,0
20150105.223347,2812.93,42,843874,2,0,0,0,0,0
20150105.223348,2812.56,8,843882,4,0,0,0,0,0
20150105.223349,2812.31,8,843890,6,0,0,0,0,0
20150105.22335,2812.31,4,843894,4,0,0,0,0,0
20150105.223351,2812.93,6,843900,2,0,0,0,0,0
20150105.223352,2812.93,4,843904,4,0,0,0,0,0
20150105.223353,2812.93,22,843926,22,0,0,0,0,0
20150105.223354,2812.93,6,843932,6,0,0,0,0,0
20150105.223355,2812.31,4,843936,2,0,0,0,0,0
20150105.223356,2812.31,8,843944,8,0,0,0,0,0
20150105.223357,2812.31,502,844446,16,0,0,0,0,0
20150105.223358,2812.31,12,844458,0,0,0,0,0,0
20150105.223359,2812.56,40,844498,0,0,0,0,0,0
20150105.2234,2812.93,12,844510,8,0,0,0,0,0
20150105.223401,2812.31,424,844934,18,0,0,0,0,0
20150105.223402,2812.31,6,844940,6,0,0,0,0,0
20150105.223403,2812.93,12,844952,4,0,0,0,0,0
20150105.223404,2812.56,90,845042,10,0,0,0,0,0
20150105.223405,2812.56,6,845048,-2,0,0,0,0,0
20150105.223406,2812.93,12,845060,2,0,0,0,0,0
20150105.223407,2812.93,28,845088,8,0,0,0,0,0
20150105.223408,2812.93,6,845094,2,0,0,0,0,0
20150105.223409,2812.93,20,845114,16,0,0,0,0,0
20150105.22341,2812.31,36,845150,20,0,0,0,0,0
20150105.223411,2812.31,4,845154,2,0,0,0,0,0
20150105.223412,2812.56,736,845890,-238,0,0,0,0,0
20150105.223413,2811.94,884,846774,-226,0,0,0,0,0
20150105.223414,2812.56,170,846944,-46,0,0,0,0,0
20150105.223415,2812.56,142,847086,-36,0,0,0,0,0
20150105.223416,2811.94,262,847348,56,0,0,0,0,0
20150105.223417,2811.94,104,847452,-94,0,0,0,0,0
20150105.223418,2812.56,40,847492,0,0,0,0,0,0
20150105.223419,2812.56,114,847606,38,0,0,0,0,0
20150105.22342,2811.94,6,847612,0,0,0,0,0,0
20150105.223421,2812.56,210,847822,4,0,0,0,0,0
20150105.223422,2812.56,132,847954,-26,0,0,0,0,0
20150105.223423,2811.94,6,847960,-2,0,0,0,0,0
20150105.223424,2812.56,22,847982,0,0,0,0,0,0
20150105.223425,2811.94,34,848016,2,0,0,0,0,0
20150105.223426,2812.56,4,848020,2,0,0,0,0,0
20150105.223427,2812.31,24,848044,20,0,0,0,0,0
20150105.223428,2812.56,12,848056,0,0,0,0,0,0
20150105.223429,2812.56,552,848608,-12,0,0,0,0,0
20150105.22343,2811.94,44,848652,8,0,0,0,0,0
20150105.223431,2812.56,62,848714,0,0,0,0,0,0
20150105.223432,2812.56,208,848922,0,0,0,0,0,0
20150105.223433,2812.56,70,848992,2,0,0,0,0,0
20150105.223434,2811.94,18,849010,-8,0,0,0,0,0
20150105.223435,2811.94,12,849022,-8,0,0,0,0,0
20150105.223436,2812.56,16,849038,16,0,0,0,0,0
20150105.223437,2811.94,24,849062,2,0,0,0,0,0
20150105.223438,2812.56,140,849202,-8,0,0,0,0,0
20150105.223439,2812.56,10,849212,4,0,0,0,0,0
20150105.22344,2812.56,70,849282,2,0,0,0,0,0
20150105.223441,2811.94,4,849286,0,0,0,0,0,0
20150105.223442,2811.94,56,849342,-2,0,0,0,0,0
20150105.223443,2811.94,118,849460,-4,0,0,0,0,0
20150105.223444,2811.94,82,849542,-82,0,0,0,0,0
20150105.223445,2812.56,298,849840,-2,0,0,0,0,0
20150105.223446,2812.56,12,849852,-6,0,0,0,0,0
20150105.223447,2812.56,222,850074,28,0,0,0,0,0
20150105.223448,2812.31,18,850092,4,0,0,0,0,0
20150105.223449,2811.94,22,850114,0,0,0,0,0,0
20150105.22345,2811.94,18,850132,2,0,0,0,0,0
20150105.223451,2812.56,24,850156,-2,0,0,0,0,0
20150105.223452,2812.56,30,850186,16,0,0,0,0,0
20150105.223453,2812.31,8,850194,-2,0,0,0,0,0
20150105.223454,2812.56,4,850198,-2,0,0,0,0,0
20150105.223455,2812.56,324,850522,2,0,0,0,0,0
20150105.223456,2811.94,26,850548,18,0,0,0,0,0
20150105.223457,2811.94,56,850604,4,0,0,0,0,0
20150105.223458,2812.56,6,850610,2,0,0,0,0,0
20150105.223459,2812.56,22,850632,2,0,0,0,0,0
20150105.2235,2812.56,1998,852630,296,0,0,0,0,0
20150105.223501,2811.94,426,853056,98,0,0,0,0,0
20150105.223502,2811.94,348,853404,280,0,0,0,0,0
20150105.223503,2811.94,396,853800,204,0,0,0,0,0
20150105.223504,2811.94,50,853850,18,0,0,0,0,0
20150105.223505,2811.94,140,853990,102,0,0,0,0,0
20150105.223506,2812.56,66,854056,64,0,0,0,0,0
20150105.223507,2811.94,56,854112,48,0,0,0,0,0
20150105.223508,2811.94,10,854122,4,0,0,0,0,0
20150105.223509,2812.56,104,854226,2,0,0,0,0,0
20150105.22351,2811.94,48,854274,-14,0,0,0,0,0
20150105.223511,2812.56,24,854298,22,0,0,0,0,0
20150105.223512,2811.94,10,854308,-4,0,0,0,0,0
20150105.223513,2811.94,12,854320,0,0,0,0,0,0
20150105.223514,2811.94,22,854342,-18,0,0,0,0,0
20150105.223515,2811.94,50,854392,-38,0,0,0,0,0
20150105.223516,2811.94,34,854426,-26,0,0,0,0,0
20150105.223517,2812.56,50,854476,0,0,0,0,0,0
20150105.223518,2811.94,46,854522,20,0,0,0,0,0
20150105.223519,2812.56,44,854566,40,0,0,0,0,0
20150105.22352,2812.56,72,854638,8,0,0,0,0,0
20150105.223521,2812.56,10,854648,-2,0,0,0,0,0
20150105.223522,2812.31,292,854940,222,0,0,0,0,0
20150105.223523,2812.56,70,855010,66,0,0,0,0,0
20150105.223524,2811.94,16,855026,12,0,0,0,0,0
20150105.223525,2811.94,8,855034,-4,0,0,0,0,0
20150105.223526,2812.93,24,855058,-6,0,0,0,0,0
20150105.223527,2812.56,282,855340,-202,0,0,0,0,0
20150105.223528,2812.31,16,855356,6,0,0,0,0,0
20150105.223529,2812.93,22,855378,2,0,0,0,0,0
20150105.22353,2812.93,422,855800,222,0,0,0,0,0
20150105.223531,2811.94,20,855820,4,0,0,0,0,0
20150105.223532,2811.94,40,855860,28,0,0,0,0,0
20150105.223533,2812.93,42,855902,32,0,0,0,0,0
20150105.223534,2812.93,88,855990,6,0,0,0,0,0
20150105.223535,2812.93,50,856040,12,0,0,0,0,0
20150105.223536,2812.93,54,856094,0,0,0,0,0,0
20150105.223537,2812.93,4,856098,2,0,0,0,0,0
20150105.223538,2812.56,24,856122,6,0,0,0,0,0
20150105.223539,2812.93,348,856470,308,0,0,0,0,0
20150105.22354,2812.56,118,856588,0,0,0,0,0,0
20150105.223541,2812.56,32,856620,-6,0,0,0,0,0
20150105.223542,2812.56,16,856636,0,0,0,0,0,0
20150105.223543,2813.18,6,856642,0,0,0,0,0,0
20150105.223544,2813.18,450,857092,182,0,0,0,0,0
20150105.223545,2812.56,4,857096,2,0,0,0,0,0
20150105.223546,2813.18,34,857130,-32,0,0,0,0,0
20150105.223547,2813.18,42,857172,26,0,0,0,0,0
20150105.223548,2812.56,16,857188,14,0,0,0,0,0
20150105.223549,2813.18,14,857202,12,0,0,0,0,0
20150105.22355,2812.8,36,857238,36,0,0,0,0,0
20150105.223551,2812.18,6,857244,0,0,0,0,0,0
20150105.223552,2812.8,28,857272,2,0,0,0,0,0
20150105.223553,2813.18,6,857278,2,0,0,0,0,0
20150105.223554,2812.18,4,857282,4,0,0,0,0,0
20150105.223555,2813.18,76,857358,74,0,0,0,0,0
20150105.223556,2812.18,34,857392,34,0,0,0,0,0
20150105.223557,2812.18,272,857664,230,0,0,0,0,0
20150105.223558,2813.18,6,857670,2,0,0,0,0,0
20150105.223559,2812.56,32,857702,8,0,0,0,0,0
20150105.2236,2812.18,4,857706,4,0,0,0,0,0
20150105.223601,2812.8,4,857710,2,0,0,0,0,0
20150105.223602,2812.18,12,857722,10,0,0,0,0,0
20150105.223603,2812.19,10,857732,10,0,0,0,0,0
20150105.223604,2812.56,20,857752,14,0,0,0,0,0
20150105.223605,2812.8,4,857756,2,0,0,0,0,0
20150105.223606,2812.8,12,857768,2,0,0,0,0,0
20150105.223607,2812.8,10,857778,2,0,0,0,0,0
20150105.223608,2812.19,6,857784,0,0,0,0,0,0
20150105.223609,2812.8,84,857868,4,0,0,0,0,0
20150105.22361,2812.8,80,857948,-36,0,0,0,0,0
20150105.223611,2812.19,16,857964,12,0,0,0,0,0
20150105.223612,2812.8,12,857976,2,0,0,0,0,0
20150105.223613,2812.8,362,858338,100,0,0,0,0,0
20150105.223614,2812.8,106,858444,-2,0,0,0,0,0
20150105.223615,2812.8,268,858712,86,0,0,0,0,0
20150105.223616,2812.8,384,859096,174,0,0,0,0,0
20150105.223617,2812.8,262,859358,50,0,0,0,0,0
20150105.223618,2812.18,62,859420,44,0,0,0,0,0
20150105.223619,2812.43,4,859424,0,0,0,0,0,0
20150105.22362,2812.43,236,859660,196,0,0,0,0,0
20150105.223621,2812.8,416,860076,-60,0,0,0,0,0
20150105.223622,2812.43,6,860082,2,0,0,0,0,0
20150105.223623,2812.43,4,860086,-2,0,0,0,0,0
20150105.223624,2811.81,206,860292,146,0,0,0,0,0
20150105.223625,2812.43,12,860304,4,0,0,0,0,0
20150105.223626,2812.43,4,860308,4,0,0,0,0,0
20150105.223627,2811.81,420,860728,-170,0,0,0,0,0
20150105.223628,2811.81,6,860734,4,0,0,0,0,0
20150105.223629,2812.06,8,860742,0,0,0,0,0,0
20150105.22363,2812.8,10,860752,0,0,0,0,0,0
20150105.223631,2811.81,4,860756,0,0,0,0,0,0
20150105.223632,2812.43,26,860782,-20,0,0,0,0,0
20150105.223633,2811.81,4,860786,0,0,0,0,0,0
20150105.223634,2812.43,24,860810,-24,0,0,0,0,0
20150105.223635,2812.43,12,860822,0,0,0,0,0,0
20150105.223636,2812.43,10,860832,-8,0,0,0,0,0
20150105.223637,2812.43,18,860850,-8,0,0,0,0,0
20150105.223638,2812.43,96,860946,-92,0,0,0,0,0
20150105.223639,2812.43,52,860998,2,0,0,0,0,0
20150105.22364,2812.43,10,861008,0,0,0,0,0,0
20150105.223641,2811.81,22,861030,-18,0,0,0,0,0
20150105.223642,2812.43,24,861054,-16,0,0,0,0,0
20150105.223643,2812.18,144,861198,52,0,0,0,0,0
20150105.223644,2812.43,6,861204,-4,0,0,0,0,0
20150105.223645,2812.18,12,861216,-2,0,0,0,0,0
20150105.223646,2811.81,32,861248,0,0,0,0,0,0
20150105.223647,2811.81,34,861282,-2,0,0,0,0,0
20150105.223648,2812.8,50,861332,14,0,0,0,0,0
20150105.223649,2812.8,12,861344,2,0,0,0,0,0
20150105.22365,2811.81,6,861350,-4,0,0,0,0,0
20150105.223651,2812.8,48,861398,18,0,0,0,0,0
20150105.223652,2812.43,6,861404,4,0,0,0,0,0
20150105.223653,2812.8,8,861412,4,0,0,0,0,0
20150105.223654,2812.43,16,861428,0,0,0,0,0,0
20150105.223655,2812.43,16,861444,0,0,0,0,0,0
20150105.223656,2812.43,10,861454,4,0,0,0,0,0
20150105.223657,2812.8,288,861742,44,0,0,0,0,0
20150105.223658,2812.19,96,861838,10,0,0,0,0,0
20150105.223659,2812.43,68,861906,-36,0,0,0,0,0
20150105.2237,2812.8,10,861916,0,0,0,0,0,0
20150105.223701,2812.8,18,861934,-16,0,0,0,0,0
20150105.223702,2812.43,6,861940,0,0,0,0,0,0
20150105.223703,2812.8,8,861948,8,0,0,0,0,0
20150105.223704,2812.8,144,862092,138,0,0,0,0,0
20150105.223705,2812.8,10,862102,6,0,0,0,0,0
20150105.223706,2812.8,14,862116,14,0,0,0,0,0
20150105.223707,2812.8,20,862136,12,0,0,0,0,0
20150105.223708,2812.8,104,862240,102,0,0,0,0,0
20150105.223709,2812.8,70,862310,34,0,0,0,0,0
20150105.22371,2812.8,10,862320,2,0,0,0,0,0
20150105.223711,2812.43,4,862324,2,0,0,0,0,0
20150105.223712,2813.42,4,862328,4,0,0,0,0,0
20150105.223713,2812.43,152,862480,-82,0,0,0,0,0
20150105.223714,2813.05,6,862486,2,0,0,0,0,0
20150105.223715,2812.43,102,862588,-64,0,0,0,0,0
20150105.223716,2813.05,14,862602,12,0,0,0,0,0
20150105.223717,2812.43,104,862706,12,0,0,0,0,0
20150105.223718,2812.8,6,862712,-2,0,0,0,0,0
20150105.223719,2813.43,10,862722,6,0,0,0,0,0
20150105.22372,2812.8,118,862840,46,0,0,0,0,0
20150105.223721,2813.42,84,862924,36,0,0,0,0,0
20150105.223722,2812.43,6,862930,4,0,0,0,0,0
20150105.223723,2812.8,18,862948,0,0,0,0,0,0
20150105.223724,2812.56,106,863054,12,0,0,0,0,0
20150105.223725,2813.18,20,863074,0,0,0,0,0,0
20150105.223726,2813.18,316,863390,-96,0,0,0,0,0
20150105.223727,2812.18,88,863478,-32,0,0,0,0,0
20150105.223728,2812.8,104,863582,0,0,0,0,0,0
20150105.223729,2812.43,22,863604,0,0,0,0,0,0
20150105.22373,2812.8,6,863610,4,0,0,0,0,0
20150105.223731,2812.8,18,863628,-6,0,0,0,0,0
20150105.223732,2812.8,20,863648,-18,0,0,0,0,0
20150105.223733,2813.42,18,863666,14,0,0,0,0,0
20150105.223734,2812.43,18,863684,12,0,0,0,0,0
20150105.223735,2813.42,28,863712,6,0,0,0,0,0
20150105.223736,2813.42,4,863716,2,0,0,0,0,0
20150105.223737,2813.42,6,863722,0,0,0,0,0,0
20150105.223738,2813.42,88,863810,-10,0,0,0,0,0
20150105.223739,2813.18,22,863832,0,0,0,0,0,0
20150105.22374,2812.8,104,863936,-40,0,0,0,0,0
20150105.223741,2812.8,4,863940,-2,0,0,0,0,0
20150105.223742,2813.42,6,863946,2,0,0,0,0,0
20150105.223743,2812.8,12,863958,0,0,0,0,0,0
20150105.223744,2812.8,42,864000,-2,0,0,0,0,0
20150105.223745,2813.42,6,864006,2,0,0,0,0,0
20150105.223746,2812.8,6,864012,-2,0,0,0,0,0
20150105.223747,2812.81,852,864864,70,0,0,0,0,0
20150105.223748,2812.81,232,865096,-164,0,0,0,0,0
20150105.223749,2812.81,468,865564,268,0,0,0,0,0
20150105.22375,2813.43,98,865662,86,0,0,0,0,0
20150105.223751,2812.81,14,865676,-2,0,0,0,0,0
20150105.223752,2812.81,26,865702,-8,0,0,0,0,0
20150105.223753,2812.81,18,865720,0,0,0,0,0,0
20150105.223754,2812.81,10,865730,4,0,0,0,0,0
20150105.223755,2812.81,12,865742,4,0,0,0,0,0
20150105.223756,2812.81,4,865746,-2,0,0,0,0,0
20150105.223757,2813.05,12,865758,0,0,0,0,0,0
20150105.223758,2812.81,8,865766,-4,0,0,0,0,0
20150105.223759,2812.81,6,865772,2,0,0,0,0,0
20150105.2238,2813.43,14,865786,0,0,0,0,0,0
20150105.223801,2812.81,10,865796,-10,0,0,0,0,0
20150105.223802,2812.81,12,865808,4,0,0,0,0,0
20150105.223803,2812.43,526,866334,224,0,0,0,0,0
20150105.223804,2813.05,12,866346,12,0,0,0,0,0
20150105.223805,2812.81,22,866368,0,0,0,0,0,0
20150105.223806,2812.81,120,866488,24,0,0,0,0,0
20150105.223807,2813.05,104,866592,4,0,0,0,0,0
20150105.223808,2812.81,20,866612,16,0,0,0,0,0
20150105.223809,2812.81,4,866616,4,0,0,0,0,0
20150105.22381,2813.43,4,866620,2,0,0,0,0,0
20150105.223811,2812.43,36,866656,14,0,0,0,0,0
20150105.223812,2812.43,90,866746,0,0,0,0,0,0
20150105.223813,2812.81,208,866954,48,0,0,0,0,0
20150105.223814,2812.81,24,866978,-2,0,0,0,0,0
20150105.223815,2812.81,36,867014,12,0,0,0,0,0
20150105.223816,2812.81,94,867108,-24,0,0,0,0,0
20150105.223817,2813.42,208,867316,204,0,0,0,0,0
20150105.223818,2812.8,4,867320,2,0,0,0,0,0
20150105.223819,2813.43,102,867422,100,0,0,0,0,0
20150105.22382,2812.81,30,867452,28,0,0,0,0,0
20150105.223821,2812.43,6,867458,4,0,0,0,0,0
20150105.223822,2813.18,8,867466,-2,0,0,0,0,0
20150105.223823,2812.43,44,867510,40,0,0,0,0,0
20150105.223824,2812.43,4,867514,2,0,0,0,0,0
20150105.223825,2812.43,36,867550,26,0,0,0,0,0
20150105.223826,2813.18,14,867564,-10,0,0,0,0,0
20150105.223827,2812.81,4,867568,2,0,0,0,0,0
20150105.223828,2813.18,26,867594,20,0,0,0,0,0
20150105.223829,2812.81,38,867632,-30,0,0,0,0,0
20150105.22383,2813.43,14,867646,10,0,0,0,0,0
20150105.223831,2813.18,6,867652,4,0,0,0,0,0
20150105.223832,2813.43,414,868066,-84,0,0,0,0,0
20150105.223833,2812.81,196,868262,132,0,0,0,0,0
20150105.223834,2813.18,22,868284,2,0,0,0,0,0
20150105.223835,2812.81,26,868310,-24,0,0,0,0,0
20150105.223836,2813.43,42,868352,-8,0,0,0,0,0
20150105.223837,2812.81,10,868362,2,0,0,0,0,0
20150105.223838,2813.18,34,868396,2,0,0,0,0,0
20150105.223839,2813.43,6,868402,0,0,0,0,0,0
20150105.22384,2813.8,4,868406,0,0,0,0,0,0
20150105.223841,2813.8,16,868422,8,0,0,0,0,0
20150105.223842,2813.18,10,868432,2,0,0,0,0,0
20150105.223843,2813.18,432,868864,-246,0,0,0,0,0
20150105.223844,2813.18,338,869202,-232,0,0,0,0,0
20150105.223845,2814.17,42,869244,-12,0,0,0,0,0
20150105.223846,2814.17,14,869258,2,0,0,0,0,0
20150105.223847,2813.55,16,869274,4,0,0,0,0,0
20150105.223848,2813.55,18,869292,0,0,0,0,0,0
20150105.223849,2814.17,102,869394,80,0,0,0,0,0
20150105.22385,2813.55,38,869432,16,0,0,0,0,0
20150105.223851,2813.55,26,869458,-4,0,0,0,0,0
20150105.223852,2814.17,12,869470,0,0,0,0,0,0
20150105.223853,2813.55,34,869504,0,0,0,0,0,0
20150105.223854,2813.8,32,869536,22,0,0,0,0,0
20150105.223855,2813.55,202,869738,-60,0,0,0,0,0
20150105.223856,2813.18,4,869742,2,0,0,0,0,0
20150105.223857,2813.55,42,869784,-2,0,0,0,0,0
20150105.223858,2813.55,4,869788,-2,0,0,0,0,0
20150105.223859,2813.55,8,869796,0,0,0,0,0,0
20150105.2239,2814.17,754,870550,-14,0,0,0,0,0
20150105.223901,2814.17,12,870562,4,0,0,0,0,0
20150105.223902,2814.17,4,870566,0,0,0,0,0,0
20150105.223903,2813.8,148,870714,-16,0,0,0,0,0
20150105.223904,2813.55,8,870722,-2,0,0,0,0,0
20150105.223905,2814.17,48,870770,0,0,0,0,0,0
20150105.223906,2813.55,14,870784,4,0,0,0,0,0
20150105.223907,2813.55,8,870792,6,0,0,0,0,0
20150105.223908,2813.55,820,871612,-10,0,0,0,0,0
20150105.223909,2814.17,20,871632,0,0,0,0,0,0
20150105.22391,2814.17,242,871874,174,0,0,0,0,0
20150105.223911,2813.8,12,871886,2,0,0,0,0,0
20150105.223912,2813.8,64,871950,-8,0,0,0,0,0
20150105.223913,2814.42,992,872942,676,0,0,0,0,0
20150105.223914,2814.42,262,873204,16,0,0,0,0,0
20150105.223915,2814.05,202,873406,150,0,0,0,0,0
20150105.223916,2814.05,288,873694,172,0,0,0,0,0
20150105.223917,2813.05,10,873704,6,0,0,0,0,0
20150105.223918,2814.05,8,873712,6,0,0,0,0,0
20150105.223919,2814.05,32,873744,0,0,0,0,0,0
20150105.22392,2813.43,14,873758,2,0,0,0,0,0
20150105.223921,2813.43,36,873794,28,0,0,0,0,0
20150105.223922,2814.42,4,873798,2,0,0,0,0,0
20150105.223923,2813.8,124,873922,-48,0,0,0,0,0
20150105.223924,2814.42,262,874184,-180,0,0,0,0,0
20150105.223925,2813.8,38,874222,10,0,0,0,0,0
20150105.223926,2813.43,6,874228,4,0,0,0,0,0
20150105.223927,2813.8,166,874394,78,0,0,0,0,0
20150105.223928,2813.8,14,874408,6,0,0,0,0,0
20150105.223929,2814.42,176,874584,-10,0,0,0,0,0
20150105.22393,2814.05,14,874598,-8,0,0,0,0,0
20150105.223931,2813.43,248,874846,54,0,0,0,0,0
20150105.223932,2814.42,10,874856,2,0,0,0,0,0
20150105.223933,2814.42,10,874866,0,0,0,0,0,0
20150105.223934,2813.8,14,874880,4,0,0,0,0,0
20150105.223935,2814.05,162,875042,-116,0,0,0,0,0
20150105.223936,2814.42,14,875056,0,0,0,0,0,0
20150105.223937,2813.43,442,875498,-202,0,0,0,0,0
20150105.223938,2812.81,28,875526,-6,0,0,0,0,0
20150105.223939,2813.43,56,875582,6,0,0,0,0,0
20150105.22394,2813.8,4,875586,2,0,0,0,0,0
20150105.223941,2813.43,48,875634,-24,0,0,0,0,0
20150105.223942,2813.18,20,875654,10,0,0,0,0,0
20150105.223943,2813.06,20,875674,10,0,0,0,0,0
20150105.223944,2813.8,54,875728,0,0,0,0,0,0
20150105.223945,2813.43,144,875872,70,0,0,0,0,0
20150105.223946,2813.43,22,875894,0,0,0,0,0,0
20150105.223947,2813.43,46,875940,-4,0,0,0,0,0
20150105.223948,2813.43,4,875944,-4,0,0,0,0,0
20150105.223949,2814.05,14,875958,-4,0,0,0,0,0
20150105.22395,2813.43,22,875980,-2,0,0,0,0,0
20150105.223951,2813.43,4,875984,0,0,0,0,0,0
20150105.223952,2813.43,60,876044,-18,0,0,0,0,0
20150105.223953,2813.43,80,876124,-38,0,0,0,0,0
20150105.223954,2813.43,6,876130,4,0,0,0,0,0
20150105.223955,2814.05,6,876136,4,0,0,0,0,0
20150105.223956,2814.05,4,876140,2,0,0,0,0,0
20150105.223957,2814.05,194,876334,80,0,0,0,0,0
20150105.223958,2813.06,8,876342,0,0,0,0,0,0
20150105.223959,2813.43,6,876348,6,0,0,0,0,0
20150105.224,2813.43,28,876376,-6,0,0,0,0,0
20150105.224001,2814.05,22,876398,22,0,0,0,0,0
20150105.224002,2813.43,60,876458,56,0,0,0,0,0
20150105.224003,2814.05,22,876480,18,0,0,0,0,0
20150105.224004,2813.43,44,876524,4,0,0,0,0,0
20150105.224005,2813.68,106,876630,0,0,0,0,0,0
20150105.224006,2813.43,6,876636,0,0,0,0,0,0
20150105.224007,2813.06,320,876956,28,0,0,0,0,0
20150105.224008,2813.05,234,877190,214,0,0,0,0,0
20150105.224009,2813.05,82,877272,-60,0,0,0,0,0
20150105.22401,2813.05,12,877284,8,0,0,0,0,0
20150105.224011,2812.43,20,877304,16,0,0,0,0,0
20150105.224012,2812.43,6,877310,4,0,0,0,0,0
20150105.224013,2813.05,28,877338,-16,0,0,0,0,0
20150105.224014,2813.05,36,877374,6,0,0,0,0,0
20150105.224015,2812.68,4,877378,4,0,0,0,0,0
20150105.224016,2813.05,160,877538,-86,0,0,0,0,0
20150105.224017,2813.05,22,877560,0,0,0,0,0,0
20150105.224018,2812.68,30,877590,2,0,0,0,0,0
20150105.224019,2812.43,204,877794,34,0,0,0,0,0
20150105.22402,2813.05,26,877820,6,0,0,0,0,0
20150105.224021,2813.05,20,877840,-10,0,0,0,0,0
20150105.224022,2813.05,14,877854,-8,0,0,0,0,0
20150105.224023,2812.43,14,877868,0,0,0,0,0,0
20150105.224024,2813.05,6,877874,0,0,0,0,0,0
20150105.224025,2813.43,4,877878,0,0,0,0,0,0
20150105.224026,2812.81,4,877882,2,0,0,0,0,0
20150105.224027,2813.05,20,877902,-10,0,0,0,0,0
20150105.224028,2813.43,24,877926,0,0,0,0,0,0
20150105.224029,2812.81,8,877934,0,0,0,0,0,0
20150105.22403,2813.43,4,877938,2,0,0,0,0,0
20150105.224031,2813.05,4,877942,-2,0,0,0,0,0
20150105.224032,2813.43,12,877954,2,0,0,0,0,0
20150105.224033,2812.43,6,877960,0,0,0,0,0,0
20150105.224034,2813.05,420,878380,-156,0,0,0,0,0
20150105.224035,2813.05,4,878384,0,0,0,0,0,0
20150105.224036,2812.44,416,878800,212,0,0,0,0,0
20150105.224037,2813.06,80,878880,-52,0,0,0,0,0
20150105.224038,2813.06,320,879200,-148,0,0,0,0,0
20150105.224039,2813.06,246,879446,-24,0,0,0,0,0
20150105.22404,2813.43,130,879576,-110,0,0,0,0,0
20150105.224041,2813.43,82,879658,-10,0,0,0,0,0
20150105.224042,2813.18,116,879774,10,0,0,0,0,0
20150105.224043,2813.43,46,879820,-10,0,0,0,0,0
20150105.224044,2813.8,16,879836,8,0,0,0,0,0
20150105.224045,2812.44,904,880740,-902,0,0,0,0,0
20150105.224046,2812.81,92,880832,-28,0,0,0,0,0
20150105.224047,2813.06,46,880878,0,0,0,0,0,0
20150105.224048,2812.81,6,880884,2,0,0,0,0,0
20150105.224049,2813.43,4,880888,2,0,0,0,0,0
20150105.22405,2812.81,8,880896,0,0,0,0,0,0
20150105.224051,2812.81,16,880912,0,0,0,0,0,0
20150105.224052,2813.18,110,881022,2,0,0,0,0,0
20150105.224053,2812.81,152,881174,-152,0,0,0,0,0
20150105.224054,2813.05,8,881182,-6,0,0,0,0,0
20150105.224055,2813.8,366,881548,86,0,0,0,0,0
20150105.224056,2813.43,124,881672,-100,0,0,0,0,0
20150105.224057,2812.81,12,881684,0,0,0,0,0,0
20150105.224058,2812.81,12,881696,0,0,0,0,0,0
20150105.224059,2812.81,4,881700,0,0,0,0,0,0
20150105.2241,2812.44,6,881706,-2,0,0,0,0,0
20150105.224101,2812.44,388,882094,-20,0,0,0,0,0
20150105.224102,2812.44,220,882314,98,0,0,0,0,0
20150105.224103,2812.44,26,882340,0,0,0,0,0,0
20150105.224104,2812.44,32,882372,22,0,0,0,0,0
20150105.224105,2812.44,10,882382,6,0,0,0,0,0
20150105.224106,2812.44,14,882396,4,0,0,0,0,0
20150105.224107,2813.06,10,882406,4,0,0,0,0,0
20150105.224108,2812.81,10,882416,4,0,0,0,0,0
20150105.224109,2812.81,18,882434,0,0,0,0,0,0
20150105.22411,2812.44,16,882450,-8,0,0,0,0,0
20150105.224111,2812.81,36,882486,-16,0,0,0,0,0
20150105.224112,2812.19,128,882614,-82,0,0,0,0,0
20150105.224113,2812.81,32,882646,20,0,0,0,0,0
20150105.224114,2812.81,58,882704,-16,0,0,0,0,0
20150105.224115,2812.44,94,882798,40,0,0,0,0,0
20150105.224116,2812.44,4,882802,2,0,0,0,0,0
20150105.224117,2812.81,62,882864,2,0,0,0,0,0
20150105.224118,2812.44,10,882874,2,0,0,0,0,0
20150105.224119,2812.44,90,882964,-56,0,0,0,0,0
20150105.22412,2812.44,4,882968,0,0,0,0,0,0
20150105.224121,2812.81,6,882974,-2,0,0,0,0,0
20150105.224122,2812.81,30,883004,8,0,0,0,0,0
20150105.224123,2811.82,50,883054,-22,0,0,0,0,0
20150105.224124,2812.19,604,883658,378,0,0,0,0,0
20150105.224125,2811.82,8,883666,2,0,0,0,0,0
20150105.224126,2812.44,6,883672,2,0,0,0,0,0
20150105.224127,2812.19,6,883678,-4,0,0,0,0,0
20150105.224128,2812.81,4,883682,2,0,0,0,0,0
20150105.224129,2812.44,26,883708,24,0,0,0,0,0
20150105.22413,2812.19,16,883724,-10,0,0,0,0,0
20150105.224131,2812.44,6,883730,2,0,0,0,0,0
20150105.224132,2812.44,6,883736,2,0,0,0,0,0
20150105.224133,2812.44,4,883740,0,0,0,0,0,0
20150105.224134,2812.19,12,883752,0,0,0,0,0,0
20150105.224135,2812.81,66,883818,-38,0,0,0,0,0
20150105.224136,2812.44,8,883826,4,0,0,0,0,0
20150105.224137,2812.44,10,883836,-6,0,0,0,0,0
20150105.224138,2812.19,8,883844,2,0,0,0,0,0
20150105.224139,2812.19,4,883848,0,0,0,0,0,0
20150105.22414,2812.19,22,883870,18,0,0,0,0,0
20150105.224141,2812.44,12,883882,-2,0,0,0,0,0
20150105.224142,2812.19,1124,885006,770,0,0,0,0,0
20150105.224143,2811.82,8,885014,4,0,0,0,0,0
20150105.224144,2812.19,22,885036,20,0,0,0,0,0
20150105.224145,2812.19,48,885084,0,0,0,0,0,0
20150105.224146,2812.19,8,885092,6,0,0,0,0,0
20150105.224147,2812.19,4,885096,2,0,0,0,0,0
20150105.224148,2812.19,22,885118,18,0,0,0,0,0
20150105.224149,2812.19,8,885126,6,0,0,0,0,0
20150105.22415,2812.19,22,885148,20,0,0,0,0,0
20150105.224151,2811.2,12,885160,0,0,0,0,0,0
20150105.224152,2812.19,4,885164,0,0,0,0,0,0
20150105.224153,2812.19,24,885188,-16,0,0,0,0,0
20150105.224154,2812.19,448,885636,-182,0,0,0,0,0
20150105.224155,2812.19,24,885660,4,0,0,0,0,0
20150105.224156,2811.94,6,885666,6,0,0,0,0,0
20150105.224157,2812.56,16,885682,2,0,0,0,0,0
20150105.224158,2812.19,260,885942,130,0,0,0,0,0
20150105.224159,2812.56,4,885946,4,0,0,0,0,0
20150105.2242,2811.57,20,885966,0,0,0,0,0,0
20150105.224201,2811.57,6,885972,0,0,0,0,0,0
20150105.224202,2812.56,58,886030,58,0,0,0,0,0
20150105.224203,2812.56,112,886142,100,0,0,0,0,0
20150105.224204,2812.19,6,886148,2,0,0,0,0,0
20150105.224205,2811.82,168,886316,12,0,0,0,0,0
20150105.224206,2812.19,6,886322,4,0,0,0,0,0
20150105.224207,2812.81,12,886334,2,0,0,0,0,0
20150105.224208,2812.56,6,886340,6,0,0,0,0,0
20150105.224209,2812.81,12,886352,6,0,0,0,0,0
20150105.22421,2812.81,4,886356,4,0,0,0,0,0
20150105.224211,2812.19,210,886566,206,0,0,0,0,0
20150105.224212,2811.82,256,886822,66,0,0,0,0,0
20150105.224213,2811.82,4,886826,0,0,0,0,0,0
20150105.224214,2811.82,6,886832,-4,0,0,0,0,0
20150105.224215,2811.82,6,886838,0,0,0,0,0,0
20150105.224216,2812.44,72,886910,60,0,0,0,0,0
20150105.224217,2811.82,4,886914,0,0,0,0,0,0
20150105.224218,2811.82,104,887018,36,0,0,0,0,0
20150105.224219,2811.82,14,887032,-10,0,0,0,0,0
20150105.22422,2811.82,4,887036,0,0,0,0,0,0
20150105.224221,2812.06,16,887052,0,0,0,0,0,0
20150105.224222,2811.82,102,887154,-66,0,0,0,0,0
20150105.224223,2811.44,14,887168,0,0,0,0,0,0
20150105.224224,2812.44,14,887182,10,0,0,0,0,0
20150105.224225,2811.82,12,887194,2,0,0,0,0,0
20150105.224226,2811.44,4,887198,-4,0,0,0,0,0
20150105.224227,2812.07,32,887230,-32,0,0,0,0,0
20150105.224228,2811.44,106,887336,54,0,0,0,0,0
20150105.224229,2812.44,4,887340,-2,0,0,0,0,0
20150105.22423,2811.82,4,887344,0,0,0,0,0,0
20150105.224231,2812.44,142,887486,-140,0,0,0,0,0
20150105.224232,2812.19,82,887568,42,0,0,0,0,0
20150105.224233,2812.81,4,887572,2,0,0,0,0,0
20150105.224234,2812.19,4,887576,2,0,0,0,0,0
20150105.224235,2811.82,16,887592,2,0,0,0,0,0
20150105.224236,2812.44,12,887604,10,0,0,0,0,0
20150105.224237,2812.44,148,887752,-4,0,0,0,0,0
20150105.224238,2812.44,14,887766,-10,0,0,0,0,0
20150105.224239,2812.44,4,887770,0,0,0,0,0,0
20150105.22424,2811.45,22,887792,0,0,0,0,0,0
20150105.224241,2812.07,4,887796,2,0,0,0,0,0
20150105.224242,2812.44,24,887820,16,0,0,0,0,0
20150105.224243,2811.82,102,887922,100,0,0,0,0,0
20150105.224244,2812.19,8,887930,2,0,0,0,0,0
20150105.224245,2812.19,18,887948,0,0,0,0,0,0
20150105.224246,2812.19,12,887960,12,0,0,0,0,0
20150105.224247,2812.81,10,887970,10,0,0,0,0,0
20150105.224248,2812.19,14,887984,10,0,0,0,0,0
20150105.224249,2812.44,72,888056,70,0,0,0,0,0
20150105.22425,2812.44,4,888060,0,0,0,0,0,0
20150105.224251,2812.44,62,888122,-58,0,0,0,0,0
20150105.224252,2812.44,4,888126,2,0,0,0,0,0
20150105.224253,2811.82,288,888414,88,0,0,0,0,0
20150105.224254,2812.07,24,888438,4,0,0,0,0,0
20150105.224255,2812.44,106,888544,40,0,0,0,0,0
20150105.224256,2812.44,14,888558,-4,0,0,0,0,0
20150105.224257,2811.82,12,888570,0,0,0,0,0,0
20150105.224258,2812.44,4,888574,0,0,0,0,0,0
20150105.224259,2812.07,4,888578,-2,0,0,0,0,0
20150105.2243,2811.82,10,888588,10,0,0,0,0,0
20150105.224301,2811.82,132,888720,-12,0,0,0,0,0
20150105.224302,2811.45,54,888774,26,0,0,0,0,0
20150105.224303,2812.81,8,888782,-2,0,0,0,0,0
20150105.224304,2812.19,6,888788,6,0,0,0,0,0
20150105.224305,2812.81,10,888798,-2,0,0,0,0,0
20150105.224306,2812.19,8,888806,8,0,0,0,0,0
20150105.224307,2812.19,94,888900,62,0,0,0,0,0
20150105.224308,2812.19,12,888912,0,0,0,0,0,0
20150105.224309,2812.19,22,888934,18,0,0,0,0,0
20150105.22431,2812.81,22,888956,0,0,0,0,0,0
20150105.224311,2812.81,106,889062,46,0,0,0,0,0
20150105.224312,2812.81,24,889086,-2,0,0,0,0,0
20150105.224313,2811.82,120,889206,16,0,0,0,0,0
20150105.224314,2812.81,24,889230,0,0,0,0,0,0
20150105.224315,2811.82,142,889372,138,0,0,0,0,0
20150105.224316,2812.44,22,889394,12,0,0,0,0,0
20150105.224317,2811.82,14,889408,2,0,0,0,0,0
20150105.224318,2811.82,4,889412,2,0,0,0,0,0
20150105.224319,2812.44,28,889440,28,0,0,0,0,0
20150105.22432,2811.82,4,889444,2,0,0,0,0,0
20150105.224321,2811.45,10,889454,-8,0,0,0,0,0
20150105.224322,2812.44,216,889670,200,0,0,0,0,0
20150105.224323,2812.44,30,889700,2,0,0,0,0,0
20150105.224324,2812.44,4,889704,0,0,0,0,0,0
20150105.224325,2812.44,26,889730,0,0,0,0,0,0
20150105.224326,2811.82,6,889736,6,0,0,0,0,0
20150105.224327,2812.44,80,889816,8,0,0,0,0,0
20150105.224328,2811.82,6,889822,2,0,0,0,0,0
20150105.224329,2812.44,6,889828,0,0,0,0,0,0
20150105.22433,2811.82,4,889832,2,0,0,0,0,0
20150105.224331,2812.44,22,889854,18,0,0,0,0,0
20150105.224332,2811.82,10,889864,10,0,0,0,0,0
20150105.224333,2811.82,20,889884,20,0,0,0,0,0
20150105.224334,2812.44,104,889988,-46,0,0,0,0,0
20150105.224335,2811.82,16,890004,14,0,0,0,0,0
20150105.224336,2811.82,6,890010,2,0,0,0,0,0
20150105.224337,2812.44,30,890040,-10,0,0,0,0,0
20150105.224338,2811.82,4,890044,4,0,0,0,0,0
20150105.224339,2812.07,10,890054,0,0,0,0,0,0
20150105.22434,2811.82,6,890060,6,0,0,0,0,0
20150105.224341,2811.82,122,890182,122,0,0,0,0,0
20150105.224342,2812.44,12,890194,12,0,0,0,0,0
20150105.224343,2812.44,62,890256,50,0,0,0,0,0
20150105.224344,2811.82,30,890286,20,0,0,0,0,0
20150105.224345,2812.44,104,890390,2,0,0,0,0,0
20150105.224346,2812.07,194,890584,36,0,0,0,0,0
20150105.224347,2812.07,450,891034,24,0,0,0,0,0
20150105.224348,2812.06,448,891482,282,0,0,0,0,0
20150105.224349,2812.06,572,892054,490,0,0,0,0,0
20150105.22435,2812.06,8,892062,-4,0,0,0,0,0
20150105.224351,2812.06,30,892092,-24,0,0,0,0,0
20150105.224352,2812.06,134,892226,-124,0,0,0,0,0
20150105.224353,2811.44,4,892230,2,0,0,0,0,0
20150105.224354,2811.82,12,892242,-2,0,0,0,0,0
20150105.224355,2812.06,10,892252,6,0,0,0,0,0
20150105.224356,2811.44,12,892264,4,0,0,0,0,0
20150105.224357,2811.44,22,892286,-12,0,0,0,0,0
20150105.224358,2811.07,6,892292,4,0,0,0,0,0
20150105.224359,2811.07,68,892360,12,0,0,0,0,0
20150105.2244,2811.69,18,892378,-2,0,0,0,0,0
20150105.224401,2811.44,6,892384,2,0,0,0,0,0
20150105.224402,2811.44,8,892392,8,0,0,0,0,0
20150105.224403,2812.44,10,892402,2,0,0,0,0,0
20150105.224404,2811.07,214,892616,206,0,0,0,0,0
20150105.224405,2811.44,46,892662,38,0,0,0,0,0
20150105.224406,2811.44,44,892706,44,0,0,0,0,0
20150105.224407,2811.69,14,892720,2,0,0,0,0,0
20150105.224408,2812.06,18,892738,14,0,0,0,0,0
20150105.224409,2811.69,18,892756,-10,0,0,0,0,0
20150105.22441,2811.44,10,892766,0,0,0,0,0,0
20150105.224411,2811.44,6,892772,-2,0,0,0,0,0
20150105.224412,2811.44,6,892778,-2,0,0,0,0,0
20150105.224413,2812.06,14,892792,-6,0,0,0,0,0
20150105.224414,2811.44,210,893002,174,0,0,0,0,0
20150105.224415,2812.06,4,893006,0,0,0,0,0,0
20150105.224416,2812.06,126,893132,-108,0,0,0,0,0
20150105.224417,2812.06,10,893142,6,0,0,0,0,0
20150105.224418,2811.44,44,893186,-10,0,0,0,0,0
20150105.224419,2812.06,4,893190,4,0,0,0,0,0
20150105.22442,2811.44,110,893300,86,0,0,0,0,0
20150105.224421,2811.82,16,893316,4,0,0,0,0,0
20150105.224422,2811.82,18,893334,14,0,0,0,0,0
20150105.224423,2811.44,4,893338,2,0,0,0,0,0
20150105.224424,2811.82,160,893498,98,0,0,0,0,0
20150105.224425,2812.44,8,893506,6,0,0,0,0,0
20150105.224426,2812.06,12,893518,8,0,0,0,0,0
20150105.224427,2812.06,36,893554,18,0,0,0,0,0
20150105.224428,2812.44,4,893558,2,0,0,0,0,0
20150105.224429,2811.44,6,893564,2,0,0,0,0,0
20150105.22443,2812.06,406,893970,-98,0,0,0,0,0
20150105.224431,2811.82,102,894072,80,0,0,0,0,0
20150105.224432,2811.82,26,894098,0,0,0,0,0,0
20150105.224433,2811.82,22,894120,20,0,0,0,0,0
20150105.224434,2811.82,6,894126,0,0,0,0,0,0
20150105.224435,2812.44,472,894598,-112,0,0,0,0,0
20150105.224436,2811.82,10,894608,-2,0,0,0,0,0
20150105.224437,2811.82,132,894740,130,0,0,0,0,0
20150105.224438,2811.44,102,894842,66,0,0,0,0,0
20150105.224439,2811.44,134,894976,30,0,0,0,0,0
20150105.22444,2811.82,6,894982,0,0,0,0,0,0
20150105.224441,2811.82,4,894986,4,0,0,0,0,0
20150105.224442,2812.06,26,895012,-18,0,0,0,0,0
20150105.224443,2811.82,62,895074,60,0,0,0,0,0
20150105.224444,2811.44,144,895218,144,0,0,0,0,0
20150105.224445,2811.82,4,895222,-2,0,0,0,0,0
20150105.224446,2811.44,542,895764,196,0,0,0,0,0
20150105.224447,2810.82,190,895954,-138,0,0,0,0,0
20150105.224448,2812.06,440,896394,306,0,0,0,0,0
20150105.224449,2812.44,42,896436,40,0,0,0,0,0
20150105.22445,2812.06,6,896442,6,0,0,0,0,0
20150105.224451,2812.44,4,896446,2,0,0,0,0,0
20150105.224452,2811.82,62,896508,36,0,0,0,0,0
20150105.224453,2812.07,820,897328,752,0,0,0,0,0
20150105.224454,2812.07,160,897488,126,0,0,0,0,0
20150105.224455,2812.07,6,897494,0,0,0,0,0,0
20150105.224456,2812.44,6,897500,2,0,0,0,0,0
20150105.224457,2812.44,74,897574,0,0,0,0,0,0
20150105.224458,2812.44,4,897578,2,0,0,0,0,0
20150105.224459,2811.44,104,897682,18,0,0,0,0,0
20150105.2245,2812.07,12,897694,-8,0,0,0,0,0
20150105.224501,2812.07,4,897698,0,0,0,0,0,0
20150105.224502,2811.44,150,897848,138,0,0,0,0,0
20150105.224503,2812.06,92,897940,2,0,0,0,0,0
20150105.224504,2812.06,4,897944,2,0,0,0,0,0
20150105.224505,2812.06,22,897966,-16,0,0,0,0,0
20150105.224506,2812.06,22,897988,2,0,0,0,0,0
20150105.224507,2811.44,6,897994,-4,0,0,0,0,0
20150105.224508,2812.06,12,898006,4,0,0,0,0,0
20150105.224509,2812.07,14,898020,-8,0,0,0,0,0
20150105.22451,2811.45,110,898130,94,0,0,0,0,0
20150105.224511,2812.07,16,898146,2,0,0,0,0,0
20150105.224512,2811.45,430,898576,294,0,0,0,0,0
20150105.224513,2811.45,10,898586,6,0,0,0,0,0
20150105.224514,2811.45,174,898760,166,0,0,0,0,0
20150105.224515,2812.44,46,898806,6,0,0,0,0,0
20150105.224516,2811.45,22,898828,4,0,0,0,0,0
20150105.224517,2811.45,140,898968,106,0,0,0,0,0
20150105.224518,2811.45,36,899004,12,0,0,0,0,0
20150105.224519,2812.07,132,899136,36,0,0,0,0,0
20150105.22452,2811.45,4,899140,2,0,0,0,0,0
20150105.224521,2812.07,6,899146,2,0,0,0,0,0
20150105.224522,2811.45,74,899220,-44,0,0,0,0,0
20150105.224523,2812.07,150,899370,94,0,0,0,0,0
20150105.224524,2812.07,130,899500,-92,0,0,0,0,0
20150105.224525,2811.45,14,899514,0,0,0,0,0,0
20150105.224526,2812.07,4,899518,4,0,0,0,0,0
20150105.224527,2812.07,24,899542,0,0,0,0,0,0
20150105.224528,2812.07,42,899584,14,0,0,0,0,0
20150105.224529,2812.44,410,899994,-222,0,0,0,0,0
20150105.22453,2811.45,142,900136,140,0,0,0,0,0
20150105.224531,2812.44,6,900142,4,0,0,0,0,0
20150105.224532,2812.44,124,900266,76,0,0,0,0,0
20150105.224533,2811.82,6,900272,4,0,0,0,0,0
20150105.224534,2812.44,6,900278,6,0,0,0,0,0
20150105.224535,2812.44,50,900328,42,0,0,0,0,0
20150105.224536,2812.44,108,900436,8,0,0,0,0,0
20150105.224537,2812.44,88,900524,86,0,0,0,0,0
20150105.224538,2812.44,352,900876,186,0,0,0,0,0
20150105.224539,2812.44,14,900890,14,0,0,0,0,0
20150105.22454,2812.44,332,901222,-100,0,0,0,0,0
20150105.224541,2812.69,282,901504,26,0,0,0,0,0
20150105.224542,2813.06,16,901520,2,0,0,0,0,0
20150105.224543,2812.44,26,901546,-4,0,0,0,0,0
20150105.224544,2812.69,14,901560,2,0,0,0,0,0
20150105.224545,2812.44,4,901564,0,0,0,0,0,0
20150105.224546,2813.06,228,901792,-170,0,0,0,0,0
20150105.224547,2813.06,6,901798,4,0,0,0,0,0
20150105.224548,2813.06,612,902410,-240,0,0,0,0,0
20150105.224549,2813.06,12,902422,-2,0,0,0,0,0
20150105.22455,2813.06,4,902426,-4,0,0,0,0,0
20150105.224551,2813.06,4,902430,-2,0,0,0,0,0
20150105.224552,2813.06,8,902438,-2,0,0,0,0,0
20150105.224553,2813.06,8,902446,-8,0,0,0,0,0
20150105.224554,2812.69,150,902596,140,0,0,0,0,0
20150105.224555,2813.06,6,902602,0,0,0,0,0,0
20150105.224556,2813.06,112,902714,88,0,0,0,0,0
20150105.224557,2813.06,44,902758,26,0,0,0,0,0
20150105.224558,2813.06,42,902800,40,0,0,0,0,0
20150105.224559,2813.06,4,902804,2,0,0,0,0,0
20150105.2246,2812.69,18,902822,0,0,0,0,0,0
20150105.224601,2812.69,144,902966,144,0,0,0,0,0
20150105.224602,2812.69,142,903108,136,0,0,0,0,0
20150105.224603,2812.69,6,903114,4,0,0,0,0,0
20150105.224604,2813.06,6,903120,2,0,0,0,0,0
20150105.224605,2813.06,204,903324,-136,0,0,0,0,0
20150105.224606,2812.69,6,903330,0,0,0,0,0,0
20150105.224607,2813.31,248,903578,142,0,0,0,0,0
20150105.224608,2812.69,24,903602,20,0,0,0,0,0
20150105.224609,2812.69,52,903654,4,0,0,0,0,0
20150105.22461,2813.68,10,903664,8,0,0,0,0,0
20150105.224611,2812.68,422,904086,274,0,0,0,0,0
20150105.224612,2812.68,438,904524,348,0,0,0,0,0
20150105.224613,2812.06,50,904574,28,0,0,0,0,0
20150105.224614,2813.06,6,904580,2,0,0,0,0,0
20150105.224615,2812.68,42,904622,12,0,0,0,0,0
20150105.224616,2813.06,12,904634,2,0,0,0,0,0
20150105.224617,2812.69,10,904644,6,0,0,0,0,0
20150105.224618,2812.69,114,904758,4,0,0,0,0,0
20150105.224619,2812.68,110,904868,70,0,0,0,0,0
20150105.22462,2812.68,4,904872,2,0,0,0,0,0
20150105.224621,2812.06,12,904884,-10,0,0,0,0,0
20150105.224622,2812.69,6,904890,4,0,0,0,0,0
20150105.224623,2813.06,4,904894,2,0,0,0,0,0
20150105.224624,2812.44,32,904926,-30,0,0,0,0,0
20150105.224625,2812.06,102,905028,42,0,0,0,0,0
20150105.224626,2811.69,8,905036,-2,0,0,0,0,0
20150105.224627,2812.68,24,905060,20,0,0,0,0,0
20150105.224628,2812.06,8,905068,-6,0,0,0,0,0
20150105.224629,2812.06,190,905258,144,0,0,0,0,0
20150105.22463,2812.68,72,905330,46,0,0,0,0,0
20150105.224631,2812.68,20,905350,14,0,0,0,0,0
20150105.224632,2812.68,4,905354,0,0,0,0,0,0
20150105.224633,2812.44,14,905368,-2,0,0,0,0,0
20150105.224634,2812.68,8,905376,0,0,0,0,0,0
20150105.224635,2812.68,250,905626,98,0,0,0,0,0
20150105.224636,2812.68,12,905638,10,0,0,0,0,0
20150105.224637,2812.06,12,905650,-8,0,0,0,0,0
20150105.224638,2812.68,108,905758,-46,0,0,0,0,0
20150105.224639,2813.06,24,905782,6,0,0,0,0,0
20150105.22464,2812.68,14,905796,12,0,0,0,0,0
20150105.224641,2812.31,170,905966,168,0,0,0,0,0
20150105.224642,2812.68,60,906026,30,0,0,0,0,0
20150105.224643,2812.68,48,906074,46,0,0,0,0,0
20150105.224644,2812.68,32,906106,22,0,0,0,0,0
20150105.224645,2812.06,4,906110,0,0,0,0,0,0
20150105.224646,2812.06,54,906164,54,0,0,0,0,0
20150105.224647,2812.68,162,906326,74,0,0,0,0,0
20150105.224648,2812.68,268,906594,-140,0,0,0,0,0
20150105.224649,2812.69,490,907084,198,0,0,0,0,0
20150105.22465,2812.44,28,907112,28,0,0,0,0,0
20150105.224651,2812.69,10,907122,10,0,0,0,0,0
20150105.224652,2812.69,22,907144,14,0,0,0,0,0
20150105.224653,2812.06,28,907172,26,0,0,0,0,0
20150105.224654,2812.69,6,907178,6,0,0,0,0,0
20150105.224655,2812.69,282,907460,262,0,0,0,0,0
20150105.224656,2812.06,260,907720,196,0,0,0,0,0
20150105.224657,2812.07,1048,908768,-674,0,0,0,0,0
20150105.224658,2812.69,10,908778,8,0,0,0,0,0
20150105.224659,2812.69,4,908782,4,0,0,0,0,0
20150105.2247,2812.07,28,908810,14,0,0,0,0,0
20150105.224701,2812.07,24,908834,18,0,0,0,0,0
20150105.224702,2812.69,330,909164,6,0,0,0,0,0
20150105.224703,2812.69,4,909168,2,0,0,0,0,0
20150105.224704,2812.69,8,909176,6,0,0,0,0,0
20150105.224705,2812.69,4,909180,4,0,0,0,0,0
20150105.224706,2812.69,6,909186,6,0,0,0,0,0
20150105.224707,2812.69,404,909590,4,0,0,0,0,0
20150105.224708,2812.69,6,909596,6,0,0,0,0,0
20150105.224709,2812.69,122,909718,100,0,0,0,0,0
20150105.22471,2812.69,458,910176,14,0,0,0,0,0
20150105.224711,2812.69,22,910198,22,0,0,0,0,0
20150105.224712,2812.69,26,910224,4,0,0,0,0,0
20150105.224713,2812.69,6,910230,4,0,0,0,0,0
20150105.224714,2812.69,112,910342,106,0,0,0,0,0
20150105.224715,2812.69,14,910356,2,0,0,0,0,0
20150105.224716,2812.69,10,910366,0,0,0,0,0,0
20150105.224717,2812.69,22,910388,2,0,0,0,0,0
20150105.224718,2812.69,24,910412,2,0,0,0,0,0
20150105.224719,2812.69,12,910424,12,0,0,0,0,0
20150105.22472,2812.69,12,910436,2,0,0,0,0,0
20150105.224721,2812.69,76,910512,72,0,0,0,0,0
20150105.224722,2812.69,22,910534,20,0,0,0,0,0
20150105.224723,2812.69,6,910540,4,0,0,0,0,0
20150105.224724,2812.31,22,910562,0,0,0,0,0,0
20150105.224725,2812.69,6,910568,4,0,0,0,0,0
20150105.224726,2812.69,34,910602,4,0,0,0,0,0
20150105.224727,2812.69,12,910614,8,0,0,0,0,0
20150105.224728,2812.31,4,910618,0,0,0,0,0,0
20150105.224729,2812.69,6,910624,6,0,0,0,0,0
20150105.22473,2812.69,10,910634,2,0,0,0,0,0
20150105.224731,2812.69,44,910678,44,0,0,0,0,0
20150105.224732,2812.69,4,910682,4,0,0,0,0,0
20150105.224733,2812.07,4,910686,0,0,0,0,0,0
20150105.224734,2812.69,42,910728,2,0,0,0,0,0
20150105.224735,2812.69,8,910736,4,0,0,0,0,0
20150105.224736,2812.31,24,910760,22,0,0,0,0,0
20150105.224737,2812.69,404,911164,-16,0,0,0,0,0
20150105.224738,2812.69,22,911186,14,0,0,0,0,0
20150105.224739,2812.69,12,911198,12,0,0,0,0,0
20150105.22474,2812.69,236,911434,76,0,0,0,0,0
20150105.224741,2812.69,24,911458,4,0,0,0,0,0
20150105.224742,2812.69,86,911544,80,0,0,0,0,0
20150105.224743,2812.69,6,911550,0,0,0,0,0,0
20150105.224744,2812.69,120,911670,-38,0,0,0,0,0
20150105.224745,2812.69,204,911874,52,0,0,0,0,0
20150105.224746,2812.69,42,911916,10,0,0,0,0,0
20150105.224747,2812.69,26,911942,-2,0,0,0,0,0
20150105.224748,2812.69,4,911946,2,0,0,0,0,0
20150105.224749,2812.69,30,911976,24,0,0,0,0,0
20150105.22475,2812.69,12,911988,4,0,0,0,0,0
20150105.224751,2812.69,26,912014,14,0,0,0,0,0
20150105.224752,2812.69,4,912018,2,0,0,0,0,0
20150105.224753,2812.69,98,912116,-84,0,0,0,0,0
20150105.224754,2812.69,8,912124,6,0,0,0,0,0
20150105.224755,2812.69,24,912148,-20,0,0,0,0,0
20150105.224756,2812.07,52,912200,30,0,0,0,0,0
20150105.224757,2812.31,346,912546,-174,0,0,0,0,0
20150105.224758,2812.69,20,912566,6,0,0,0,0,0
20150105.224759,2812.69,8,912574,-4,0,0,0,0,0
20150105.2248,2812.69,132,912706,120,0,0,0,0,0
20150105.224801,2812.69,4,912710,2,0,0,0,0,0
20150105.224802,2813.31,10,912720,6,0,0,0,0,0
20150105.224803,2813.31,10,912730,8,0,0,0,0,0
20150105.224804,2812.93,4,912734,0,0,0,0,0,0
20150105.224805,2813.31,16,912750,16,0,0,0,0,0
20150105.224806,2812.69,54,912804,2,0,0,0,0,0
20150105.224807,2812.69,8,912812,-6,0,0,0,0,0
20150105.224808,2813.31,84,912896,64,0,0,0,0,0
20150105.224809,2812.93,12,912908,8,0,0,0,0,0
20150105.22481,2812.69,20,912928,0,0,0,0,0,0
20150105.224811,2813.31,6,912934,2,0,0,0,0,0
20150105.224812,2813.31,56,912990,-8,0,0,0,0,0
20150105.224813,2813.31,6,912996,0,0,0,0,0,0
20150105.224814,2813.31,44,913040,40,0,0,0,0,0
20150105.224815,2812.69,4,913044,-2,0,0,0,0,0
20150105.224816,2813.31,206,913250,-38,0,0,0,0,0
20150105.224817,2812.93,422,913672,-268,0,0,0,0,0
20150105.224818,2813.31,16,913688,-12,0,0,0,0,0
20150105.224819,2813.3,224,913912,-68,0,0,0,0,0
20150105.22482,2813.3,4,913916,-2,0,0,0,0,0
20150105.224821,2813.3,6,913922,-2,0,0,0,0,0
20150105.224822,2813.3,28,913950,0,0,0,0,0,0
20150105.224823,2813.3,210,914160,4,0,0,0,0,0
20150105.224824,2813.3,206,914366,188,0,0,0,0,0
20150105.224825,2812.93,4,914370,0,0,0,0,0,0
20150105.224826,2813.3,12,914382,8,0,0,0,0,0
20150105.224827,2813.68,12,914394,6,0,0,0,0,0
20150105.224828,2812.68,316,914710,112,0,0,0,0,0
20150105.224829,2813.3,22,914732,0,0,0,0,0,0
20150105.22483,2813.3,22,914754,8,0,0,0,0,0
20150105.224831,2813.06,4,914758,0,0,0,0,0,0
20150105.224832,2813.3,672,915430,380,0,0,0,0,0
20150105.224833,2813.68,10,915440,2,0,0,0,0,0
20150105.224834,2813.68,6,915446,-2,0,0,0,0,0
20150105.224835,2813.3,6,915452,0,0,0,0,0,0
20150105.224836,2813.68,4,915456,-2,0,0,0,0,0
20150105.224837,2812.68,256,915712,-96,0,0,0,0,0
20150105.224838,2812.93,60,915772,-30,0,0,0,0,0
20150105.224839,2813.3,116,915888,0,0,0,0,0,0
20150105.22484,2813.3,44,915932,32,0,0,0,0,0
20150105.224841,2813.3,8,915940,0,0,0,0,0,0
20150105.224842,2813.3,20,915960,-20,0,0,0,0,0
20150105.224843,2813.3,408,916368,-168,0,0,0,0,0
20150105.224844,2813.3,74,916442,48,0,0,0,0,0
20150105.224845,2813.3,516,916958,170,0,0,0,0,0
20150105.224846,2813.3,44,917002,-40,0,0,0,0,0
20150105.224847,2812.68,12,917014,-4,0,0,0,0,0
20150105.224848,2813.3,4,917018,0,0,0,0,0,0
20150105.224849,2813.3,136,917154,-122,0,0,0,0,0
20150105.22485,2813.3,4,917158,0,0,0,0,0,0
20150105.224851,2813.3,20,917178,0,0,0,0,0,0
20150105.224852,2813.3,62,917240,-22,0,0,0,0,0
20150105.224853,2812.93,8,917248,4,0,0,0,0,0
20150105.224854,2813.3,26,917274,-12,0,0,0,0,0
20150105.224855,2813.3,66,917340,-18,0,0,0,0,0
20150105.224856,2813.3,16,917356,8,0,0,0,0,0
20150105.224857,2813.3,124,917480,0,0,0,0,0,0
20150105.224858,2813.3,218,917698,-208,0,0,0,0,0
20150105.224859,2812.93,22,917720,0,0,0,0,0,0
20150105.2249,2812.93,10,917730,-6,0,0,0,0,0
20150105.224901,2812.68,54,917784,-22,0,0,0,0,0
20150105.224902,2813.3,12,917796,-2,0,0,0,0,0
20150105.224903,2812.68,4,917800,-2,0,0,0,0,0
20150105.224904,2813.3,22,917822,10,0,0,0,0,0
20150105.224905,2813.3,10,917832,6,0,0,0,0,0
20150105.224906,2812.31,160,917992,76,0,0,0,0,0
20150105.224907,2812.93,10,918002,2,0,0,0,0,0
20150105.224908,2813.3,6,918008,-2,0,0,0,0,0
20150105.224909,2813.3,52,918060,-48,0,0,0,0,0
20150105.22491,2812.93,4,918064,0,0,0,0,0,0
20150105.224911,2812.93,22,918086,0,0,0,0,0,0
20150105.224912,2813.3,4,918090,-4,0,0,0,0,0
20150105.224913,2813.3,150,918240,-38,0,0,0,0,0
20150105.224914,2813.3,14,918254,4,0,0,0,0,0
20150105.224915,2813.3,4,918258,2,0,0,0,0,0
20150105.224916,2813.3,4,918262,4,0,0,0,0,0
20150105.224917,2813.3,6,918268,6,0,0,0,0,0
20150105.224918,2813.3,38,918306,22,0,0,0,0,0
20150105.224919,2813.3,6,918312,6,0,0,0,0,0
20150105.22492,2813.3,4,918316,4,0,0,0,0,0
20150105.224921,2813.3,4,918320,0,0,0,0,0,0
20150105.224922,2813.3,30,918350,20,0,0,0,0,0
20150105.224923,2812.68,10,918360,6,0,0,0,0,0
20150105.224924,2813.3,4,918364,2,0,0,0,0,0
20150105.224925,2812.93,20,918384,2,0,0,0,0,0
20150105.224926,2813.3,4,918388,2,0,0,0,0,0
20150105.224927,2813.3,6,918394,6,0,0,0,0,0
20150105.224928,2813.3,8,918402,8,0,0,0,0,0
20150105.224929,2813.3,12,918414,8,0,0,0,0,0
20150105.22493,2812.68,8,918422,2,0,0,0,0,0
20150105.224931,2813.3,8,918430,2,0,0,0,0,0
20150105.224932,2812.68,10,918440,-4,0,0,0,0,0
20150105.224933,2812.93,12,918452,0,0,0,0,0,0
20150105.224934,2812.68,4,918456,0,0,0,0,0,0
20150105.224935,2813.3,62,918518,-8,0,0,0,0,0
20150105.224936,2812.93,4,918522,4,0,0,0,0,0
20150105.224937,2813.3,6,918528,6,0,0,0,0,0
20150105.224938,2813.3,6,918534,4,0,0,0,0,0
20150105.224939,2813.3,72,918606,60,0,0,0,0,0
20150105.22494,2813.3,38,918644,2,0,0,0,0,0
20150105.224941,2813.3,6,918650,6,0,0,0,0,0
20150105.224942,2813.3,6,918656,4,0,0,0,0,0
20150105.224943,2813.3,8,918664,4,0,0,0,0,0
20150105.224944,2813.3,326,918990,310,0,0,0,0,0
20150105.224945,2812.31,6,918996,0,0,0,0,0,0
20150105.224946,2812.93,8,919004,8,0,0,0,0,0
20150105.224947,2812.68,6,919010,4,0,0,0,0,0
20150105.224948,2812.68,6,919016,6,0,0,0,0,0
20150105.224949,2813.3,16,919032,4,0,0,0,0,0
20150105.22495,2813.3,4,919036,0,0,0,0,0,0
20150105.224951,2813.3,4,919040,4,0,0,0,0,0
20150105.224952,2813.3,6,919046,6,0,0,0,0,0
20150105.224953,2813.3,34,919080,0,0,0,0,0,0
20150105.224954,2813.3,712,919792,-302,0,0,0,0,0
20150105.224955,2813.3,116,919908,4,0,0,0,0,0
20150105.224956,2813.3,218,920126,138,0,0,0,0,0
20150105.224957,2813.3,22,920148,10,0,0,0,0,0
20150105.224958,2813.67,12,920160,12,0,0,0,0,0
20150105.224959,2813.3,6,920166,2,0,0,0,0,0
20150105.225,2813.05,16,920182,4,0,0,0,0,0
20150105.225001,2813.67,102,920284,0,0,0,0,0,0
20150105.225002,2813.05,22,920306,2,0,0,0,0,0
20150105.225003,2813.67,6,920312,6,0,0,0,0,0
20150105.225004,2813.3,112,920424,4,0,0,0,0,0
20150105.225005,2813.3,32,920456,16,0,0,0,0,0
20150105.225006,2813.3,14,920470,12,0,0,0,0,0
20150105.225007,2813.67,4,920474,4,0,0,0,0,0
20150105.225008,2813.3,4,920478,2,0,0,0,0,0
20150105.225009,2813.3,90,920568,22,0,0,0,0,0
20150105.22501,2813.3,28,920596,4,0,0,0,0,0
20150105.225011,2813.67,24,920620,10,0,0,0,0,0
20150105.225012,2813.05,8,920628,6,0,0,0,0,0
20150105.225013,2813.67,6,920634,2,0,0,0,0,0
20150105.225014,2813.3,34,920668,-26,0,0,0,0,0
20150105.225015,2813.3,86,920754,-60,0,0,0,0,0
20150105.225016,2813.3,288,921042,-18,0,0,0,0,0
20150105.225017,2813.3,182,921224,-180,0,0,0,0,0
20150105.225018,2813.3,8,921232,-6,0,0,0,0,0
20150105.225019,2813.05,26,921258,-2,0,0,0,0,0
20150105.22502,2813.67,4,921262,2,0,0,0,0,0
20150105.225021,2813.67,26,921288,-14,0,0,0,0,0
20150105.225022,2813.67,6,921294,0,0,0,0,0,0
20150105.225023,2813.67,4,921298,2,0,0,0,0,0
20150105.225024,2813.3,12,921310,8,0,0,0,0,0
20150105.225025,2813.3,8,921318,-6,0,0,0,0,0
20150105.225026,2813.3,6,921324,0,0,0,0,0,0
20150105.225027,2813.05,42,921366,-2,0,0,0,0,0
20150105.225028,2813.67,22,921388,-18,0,0,0,0,0
20150105.225029,2813.05,6,921394,-4,0,0,0,0,0
20150105.22503,2813.05,54,921448,-54,0,0,0,0,0
20150105.225031,2813.67,4,921452,2,0,0,0,0,0
20150105.225032,2812.68,72,921524,-6,0,0,0,0,0
20150105.225033,2813.3,4,921528,0,0,0,0,0,0
20150105.225034,2813.3,4,921532,2,0,0,0,0,0
20150105.225035,2813.67,24,921556,-20,0,0,0,0,0
20150105.225036,2813.67,38,921594,-4,0,0,0,0,0
20150105.225037,2813.3,12,921606,10,0,0,0,0,0
20150105.225038,2813.67,6,921612,2,0,0,0,0,0
20150105.225039,2813.3,4,921616,0,0,0,0,0,0
20150105.22504,2812.68,4,921620,0,0,0,0,0,0
20150105.225041,2813.05,12,921632,0,0,0,0,0,0
20150105.225042,2813.3,4,921636,0,0,0,0,0,0
20150105.225043,2812.68,4,921640,-4,0,0,0,0,0
20150105.225044,2813.67,536,922176,-474,0,0,0,0,0
20150105.225045,2813.67,4,922180,2,0,0,0,0,0
20150105.225046,2813.05,26,922206,-24,0,0,0,0,0
20150105.225047,2813.67,12,922218,-8,0,0,0,0,0
20150105.225048,2813.05,22,922240,16,0,0,0,0,0
20150105.225049,2813.05,6,922246,-2,0,0,0,0,0
20150105.22505,2812.68,4,922250,-2,0,0,0,0,0
20150105.225051,2813.67,22,922272,22,0,0,0,0,0
20150105.225052,2813.67,80,922352,-28,0,0,0,0,0
20150105.225053,2813.05,4,922356,0,0,0,0,0,0
20150105.225054,2813.05,112,922468,-100,0,0,0,0,0
20150105.225055,2813.05,332,922800,140,0,0,0,0,0
20150105.225056,2813.43,4,922804,0,0,0,0,0,0
20150105.225057,2813.43,72,922876,-2,0,0,0,0,0
20150105.225058,2813.05,6,922882,-6,0,0,0,0,0
20150105.225059,2814.05,10,922892,0,0,0,0,0,0
20150105.2251,2813.67,22,922914,-2,0,0,0,0,0
20150105.225101,2813.67,16,922930,-16,0,0,0,0,0
20150105.225102,2814.05,22,922952,12,0,0,0,0,0
20150105.225103,2813.67,350,923302,-140,0,0,0,0,0
20150105.225104,2813.67,212,923514,-118,0,0,0,0,0
20150105.225105,2814.05,10,923524,0,0,0,0,0,0
20150105.225106,2813.67,4,923528,2,0,0,0,0,0
20150105.225107,2813.67,4,923532,2,0,0,0,0,0
20150105.225108,2813.05,52,923584,-30,0,0,0,0,0
20150105.225109,2813.67,202,923786,184,0,0,0,0,0
20150105.22511,2813.05,30,923816,0,0,0,0,0,0
20150105.225111,2813.67,8,923824,6,0,0,0,0,0
20150105.225112,2813.67,4,923828,0,0,0,0,0,0
20150105.225113,2813.67,214,924042,0,0,0,0,0,0
20150105.225114,2814.05,22,924064,2,0,0,0,0,0
20150105.225115,2813.67,4,924068,-2,0,0,0,0,0
20150105.225116,2814.05,6,924074,2,0,0,0,0,0
20150105.225117,2813.67,102,924176,-94,0,0,0,0,0
20150105.225118,2814.05,6,924182,0,0,0,0,0,0
20150105.225119,2813.05,80,924262,-4,0,0,0,0,0
20150105.22512,2813.67,48,924310,28,0,0,0,0,0
20150105.225121,2813.05,102,924412,40,0,0,0,0,0
20150105.225122,2812.68,62,924474,-62,0,0,0,0,0
20150105.225123,2813.67,4,924478,2,0,0,0,0,0
20150105.225124,2813.67,76,924554,-2,0,0,0,0,0
20150105.225125,2813.67,518,925072,-48,0,0,0,0,0
20150105.225126,2813.3,8,925080,-4,0,0,0,0,0
20150105.225127,2813.3,8,925088,-2,0,0,0,0,0
20150105.225128,2813.67,12,925100,10,0,0,0,0,0
20150105.225129,2813.68,328,925428,-26,0,0,0,0,0
20150105.22513,2813.05,38,925466,0,0,0,0,0,0
20150105.225131,2813.3,16,925482,4,0,0,0,0,0
20150105.225132,2812.68,12,925494,-12,0,0,0,0,0
20150105.225133,2813.68,22,925516,-18,0,0,0,0,0
20150105.225134,2813.05,12,925528,-2,0,0,0,0,0
20150105.225135,2813.05,52,925580,-50,0,0,0,0,0
20150105.225136,2813.67,4,925584,2,0,0,0,0,0
20150105.225137,2813.05,52,925636,-32,0,0,0,0,0
20150105.225138,2813.68,126,925762,-80,0,0,0,0,0
20150105.225139,2813.68,56,925818,2,0,0,0,0,0
20150105.22514,2813.68,82,925900,-38,0,0,0,0,0
20150105.225141,2813.06,14,925914,2,0,0,0,0,0
20150105.225142,2812.68,80,925994,-30,0,0,0,0,0
20150105.225143,2813.3,86,926080,0,0,0,0,0,0
20150105.225144,2813.06,6,926086,-6,0,0,0,0,0
20150105.225145,2813.3,8,926094,4,0,0,0,0,0
20150105.225146,2813.3,10,926104,0,0,0,0,0,0
20150105.225147,2813.68,404,926508,346,0,0,0,0,0
20150105.225148,2813.3,14,926522,2,0,0,0,0,0
20150105.225149,2813.68,58,926580,-26,0,0,0,0,0
20150105.22515,2813.68,10,926590,6,0,0,0,0,0
20150105.225151,2813.68,72,926662,-48,0,0,0,0,0
20150105.225152,2813.68,8,926670,4,0,0,0,0,0
20150105.225153,2813.68,22,926692,0,0,0,0,0,0
20150105.225154,2813.68,4,926696,4,0,0,0,0,0
20150105.225155,2813.68,24,926720,20,0,0,0,0,0
20150105.225156,2813.3,66,926786,-10,0,0,0,0,0
20150105.225157,2813.3,16,926802,-12,0,0,0,0,0
20150105.225158,2813.3,224,927026,-62,0,0,0,0,0
20150105.225159,2813.68,134,927160,10,0,0,0,0,0
20150105.2252,2813.68,6,927166,2,0,0,0,0,0
20150105.225201,2813.3,20,927186,12,0,0,0,0,0
20150105.225202,2813.92,66,927252,2,0,0,0,0,0
20150105.225203,2814.3,14,927266,2,0,0,0,0,0
20150105.225204,2814.3,18,927284,2,0,0,0,0,0
20150105.225205,2813.68,14,927298,2,0,0,0,0,0
20150105.225206,2813.3,22,927320,2,0,0,0,0,0
20150105.225207,2813.3,20,927340,20,0,0,0,0,0
20150105.225208,2813.92,14,927354,-4,0,0,0,0,0
20150105.225209,2813.68,38,927392,12,0,0,0,0,0
20150105.22521,2813.68,6,927398,2,0,0,0,0,0
20150105.225211,2813.3,30,927428,0,0,0,0,0,0
20150105.225212,2814.3,6,927434,-2,0,0,0,0,0
20150105.225213,2814.3,26,927460,0,0,0,0,0,0
20150105.225214,2813.3,122,927582,0,0,0,0,0,0
20150105.225215,2813.92,24,927606,-4,0,0,0,0,0
20150105.225216,2814.3,22,927628,20,0,0,0,0,0
20150105.225217,2813.3,22,927650,0,0,0,0,0,0
20150105.225218,2813.92,12,927662,-10,0,0,0,0,0
20150105.225219,2813.68,14,927676,0,0,0,0,0,0
20150105.22522,2814.3,12,927688,-10,0,0,0,0,0
20150105.225221,2813.68,4,927692,0,0,0,0,0,0
20150105.225222,2813.31,1020,928712,-582,0,0,0,0,0
20150105.225223,2813.68,22,928734,-18,0,0,0,0,0
20150105.225224,2814.3,808,929542,-346,0,0,0,0,0
20150105.225225,2814.3,48,929590,-16,0,0,0,0,0
20150105.225226,2813.68,4,929594,-4,0,0,0,0,0
20150105.225227,2814.3,102,929696,56,0,0,0,0,0
20150105.225228,2813.06,6,929702,-6,0,0,0,0,0
20150105.225229,2813.68,210,929912,-208,0,0,0,0,0
20150105.22523,2813.68,20,929932,-4,0,0,0,0,0
20150105.225231,2813.68,44,929976,-34,0,0,0,0,0
20150105.225232,2813.68,1080,931056,-1042,0,0,0,0,0
20150105.225233,2813.06,12,931068,-10,0,0,0,0,0
20150105.225234,2813.68,36,931104,0,0,0,0,0,0
20150105.225235,2812.94,1026,932130,-292,0,0,0,0,0
20150105.225236,2813.68,8,932138,-2,0,0,0,0,0
20150105.225237,2813.68,34,932172,0,0,0,0,0,0
20150105.225238,2812.32,1002,933174,-48,0,0,0,0,0
20150105.225239,2813.31,62,933236,-12,0,0,0,0,0
20150105.22524,2812.94,1004,934240,-994,0,0,0,0,0
20150105.225241,2812.94,50,934290,0,0,0,0,0,0
20150105.225242,2812.94,132,934422,-88,0,0,0,0,0
20150105.225243,2812.69,228,934650,-206,0,0,0,0,0
20150105.225244,2813.31,10,934660,-8,0,0,0,0,0
20150105.225245,2812.95,1004,935664,-976,0,0,0,0,0
20150105.225246,2812.95,162,935826,-160,0,0,0,0,0
20150105.225247,2813.32,4,935830,2,0,0,0,0,0
20150105.225248,2813.32,18,935848,2,0,0,0,0,0
20150105.225249,2812.33,16,935864,-6,0,0,0,0,0
20150105.22525,2812.7,6,935870,4,0,0,0,0,0
20150105.225251,2812.33,4,935874,-4,0,0,0,0,0
20150105.225252,2812.33,592,936466,116,0,0,0,0,0
20150105.225253,2812.95,8,936474,6,0,0,0,0,0
20150105.225254,2812.33,4,936478,2,0,0,0,0,0
20150105.225255,2812.33,14,936492,-2,0,0,0,0,0
20150105.225256,2812.33,8,936500,-2,0,0,0,0,0
20150105.225257,2812.95,206,936706,160,0,0,0,0,0
20150105.225258,2812.94,274,936980,266,0,0,0,0,0
20150105.225259,2812.94,28,937008,-14,0,0,0,0,0
20150105.2253,2812.32,246,937254,-62,0,0,0,0,0
20150105.225301,2812.32,18,937272,-16,0,0,0,0,0
20150105.225302,2812.94,814,938086,188,0,0,0,0,0
20150105.225303,2812.94,206,938292,0,0,0,0,0,0
20150105.225304,2812.32,10,938302,-2,0,0,0,0,0
20150105.225305,2812.7,24,938326,-8,0,0,0,0,0
20150105.225306,2813.32,130,938456,-12,0,0,0,0,0
20150105.225307,2812.32,4,938460,-2,0,0,0,0,0
20150105.225308,2812.7,32,938492,2,0,0,0,0,0
20150105.225309,2812.32,16,938508,4,0,0,0,0,0
20150105.22531,2812.32,10,938518,-2,0,0,0,0,0
20150105.225311,2812.7,24,938542,2,0,0,0,0,0
20150105.225312,2812.32,4,938546,2,0,0,0,0,0
20150105.225313,2812.69,1374,939920,194,0,0,0,0,0
20150105.225314,2812.32,10,939930,8,0,0,0,0,0
20150105.225315,2813.31,36,939966,-6,0,0,0,0,0
20150105.225316,2812.32,48,940014,-44,0,0,0,0,0
20150105.225317,2812.32,8,940022,-2,0,0,0,0,0
20150105.225318,2812.32,20,940042,6,0,0,0,0,0
20150105.225319,2812.32,12,940054,4,0,0,0,0,0
20150105.22532,2812.32,22,940076,14,0,0,0,0,0
20150105.225321,2812.32,60,940136,32,0,0,0,0,0
20150105.225322,2812.32,26,940162,-8,0,0,0,0,0
20150105.225323,2812.32,862,941024,22,0,0,0,0,0
20150105.225324,2812.32,4,941028,-2,0,0,0,0,0
20150105.225325,2812.57,34,941062,-4,0,0,0,0,0
20150105.225326,2812.94,6,941068,0,0,0,0,0,0
20150105.225327,2811.95,52,941120,0,0,0,0,0,0
20150105.225328,2812.32,18,941138,12,0,0,0,0,0
20150105.225329,2812.32,64,941202,4,0,0,0,0,0
20150105.22533,2812.32,108,941310,-48,0,0,0,0,0
20150105.225331,2812.32,306,941616,-72,0,0,0,0,0
20150105.225332,2812.32,16,941632,6,0,0,0,0,0
20150105.225333,2812.32,18,941650,18,0,0,0,0,0
20150105.225334,2812.32,4,941654,2,0,0,0,0,0
20150105.225335,2812.32,48,941702,16,0,0,0,0,0
20150105.225336,2812.94,582,942284,118,0,0,0,0,0
20150105.225337,2812.32,6,942290,6,0,0,0,0,0
20150105.225338,2811.95,24,942314,0,0,0,0,0,0
20150105.225339,2812.32,746,943060,286,0,0,0,0,0
20150105.22534,2812.32,34,943094,-6,0,0,0,0,0
20150105.225341,2811.95,18,943112,-2,0,0,0,0,0
20150105.225342,2812.32,26,943138,0,0,0,0,0,0
20150105.225343,2812.32,32,943170,-26,0,0,0,0,0
20150105.225344,2812.32,18,943188,-2,0,0,0,0,0
20150105.225345,2812.32,92,943280,46,0,0,0,0,0
20150105.225346,2811.95,18,943298,6,0,0,0,0,0
20150105.225347,2812.32,6,943304,4,0,0,0,0,0
20150105.225348,2812.32,10,943314,0,0,0,0,0,0
20150105.225349,2812.32,22,943336,2,0,0,0,0,0
20150105.22535,2812.32,4,943340,2,0,0,0,0,0
20150105.225351,2812.32,4,943344,0,0,0,0,0,0
20150105.225352,2812.94,22,943366,18,0,0,0,0,0
20150105.225353,2812.32,6,943372,4,0,0,0,0,0
20150105.225354,2812.57,54,943426,4,0,0,0,0,0
20150105.225355,2812.32,186,943612,164,0,0,0,0,0
20150105.225356,2812.32,20,943632,-2,0,0,0,0,0
20150105.225357,2812.32,144,943776,144,0,0,0,0,0
20150105.225358,2812.94,10,943786,0,0,0,0,0,0
20150105.225359,2812.32,12,943798,12,0,0,0,0,0
20150105.2254,2811.95,10,943808,0,0,0,0,0,0
20150105.225401,2812.57,14,943822,4,0,0,0,0,0
20150105.225402,2811.95,58,943880,4,0,0,0,0,0
20150105.225403,2811.95,124,944004,0,0,0,0,0,0
20150105.225404,2812.32,16,944020,10,0,0,0,0,0
20150105.225405,2811.95,4,944024,4,0,0,0,0,0
20150105.225406,2812.32,14,944038,10,0,0,0,0,0
20150105.225407,2812.57,50,944088,-28,0,0,0,0,0
20150105.225408,2812.32,12,944100,-2,0,0,0,0,0
20150105.225409,2812.32,44,944144,0,0,0,0,0,0
20150105.22541,2811.95,36,944180,0,0,0,0,0,0
20150105.225411,2811.95,4,944184,-2,0,0,0,0,0
20150105.225412,2812.32,24,944208,20,0,0,0,0,0
20150105.225413,2811.95,142,944350,28,0,0,0,0,0
20150105.225414,2811.95,44,944394,4,0,0,0,0,0
20150105.225415,2812.57,10,944404,2,0,0,0,0,0
20150105.225416,2811.95,3456,947860,-426,0,0,0,0,0
20150105.225417,2812.94,286,948146,174,0,0,0,0,0
20150105.225418,2812.57,366,948512,128,0,0,0,0,0
20150105.225419,2812.57,310,948822,270,0,0,0,0,0
20150105.22542,2811.95,1458,950280,-244,0,0,0,0,0
20150105.225421,2812.57,12,950292,0,0,0,0,0,0
20150105.225422,2811.95,180,950472,2,0,0,0,0,0
20150105.225423,2812.57,204,950676,0,0,0,0,0,0
20150105.225424,2811.95,14,950690,-2,0,0,0,0,0
20150105.225425,2811.58,56,950746,22,0,0,0,0,0
20150105.225426,2811.95,6,950752,-2,0,0,0,0,0
20150105.225427,2811.95,22,950774,0,0,0,0,0,0
20150105.225428,2811.95,20,950794,-2,0,0,0,0,0
20150105.225429,2811.95,42,950836,0,0,0,0,0,0
20150105.22543,2811.58,36,950872,6,0,0,0,0,0
20150105.225431,2812.57,4,950876,2,0,0,0,0,0
20150105.225432,2811.95,8,950884,-2,0,0,0,0,0
20150105.225433,2811.58,202,951086,-96,0,0,0,0,0
20150105.225434,2811.58,118,951204,2,0,0,0,0,0
20150105.225435,2812.2,18,951222,-8,0,0,0,0,0
20150105.225436,2811.58,28,951250,-16,0,0,0,0,0
20150105.225437,2811.58,4,951254,-4,0,0,0,0,0
20150105.225438,2811.58,10,951264,-4,0,0,0,0,0
20150105.225439,2811.58,8,951272,0,0,0,0,0,0
20150105.22544,2811.58,24,951296,-20,0,0,0,0,0
20150105.225441,2811.58,4,951300,-2,0,0,0,0,0
20150105.225442,2811.95,14,951314,-2,0,0,0,0,0
20150105.225443,2811.58,18,951332,-8,0,0,0,0,0
20150105.225444,2811.58,6,951338,0,0,0,0,0,0
20150105.225445,2812.2,10,951348,0,0,0,0,0,0
20150105.225446,2812.2,18,951366,-10,0,0,0,0,0
20150105.225447,2811.58,52,951418,0,0,0,0,0,0
20150105.225448,2811.58,46,951464,-40,0,0,0,0,0
20150105.225449,2811.58,34,951498,-16,0,0,0,0,0
20150105.22545,2811.58,26,951524,-12,0,0,0,0,0
20150105.225451,2811.58,4,951528,-2,0,0,0,0,0
20150105.225452,2811.58,10,951538,0,0,0,0,0,0
20150105.225453,2811.58,4,951542,0,0,0,0,0,0
20150105.225454,2811.95,4,951546,0,0,0,0,0,0
20150105.225455,2811.58,12,951558,0,0,0,0,0,0
20150105.225456,2811.58,10,951568,-10,0,0,0,0,0
20150105.225457,2811.58,4,951572,-4,0,0,0,0,0
20150105.225458,2811.95,6,951578,0,0,0,0,0,0
20150105.225459,2811.58,48,951626,-34,0,0,0,0,0
20150105.2255,2811.95,6,951632,-2,0,0,0,0,0
20150105.225501,2811.58,26,951658,0,0,0,0,0,0
20150105.225502,2812.57,40,951698,16,0,0,0,0,0
20150105.225503,2811.58,8,951706,0,0,0,0,0,0
20150105.225504,2811.58,6,951712,-2,0,0,0,0,0
20150105.225505,2811.58,144,951856,-10,0,0,0,0,0
20150105.225506,2811.58,8,951864,6,0,0,0,0,0
20150105.225507,2811.58,10,951874,-2,0,0,0,0,0
20150105.225508,2811.58,36,951910,20,0,0,0,0,0
20150105.225509,2811.58,50,951960,-24,0,0,0,0,0
20150105.22551,2811.95,4,951964,0,0,0,0,0,0
20150105.225511,2811.58,6,951970,0,0,0,0,0,0
20150105.225512,2811.95,34,952004,8,0,0,0,0,0
20150105.225513,2812.57,30,952034,-20,0,0,0,0,0
20150105.225514,2811.58,22,952056,-4,0,0,0,0,0
20150105.225515,2811.58,4,952060,0,0,0,0,0,0
20150105.225516,2811.58,216,952276,116,0,0,0,0,0
20150105.225517,2812.2,42,952318,0,0,0,0,0,0
20150105.225518,2811.58,22,952340,-2,0,0,0,0,0
20150105.225519,2811.58,42,952382,2,0,0,0,0,0
20150105.22552,2812.2,8,952390,0,0,0,0,0,0
20150105.225521,2811.58,40,952430,-2,0,0,0,0,0
20150105.225522,2811.58,146,952576,12,0,0,0,0,0
20150105.225523,2811.58,6,952582,4,0,0,0,0,0
20150105.225524,2811.58,102,952684,38,0,0,0,0,0
20150105.225525,2811.58,148,952832,20,0,0,0,0,0
20150105.225526,2811.58,16,952848,8,0,0,0,0,0
20150105.225527,2811.58,60,952908,54,0,0,0,0,0
20150105.225528,2811.58,68,952976,-14,0,0,0,0,0
20150105.225529,2811.58,42,953018,-30,0,0,0,0,0
20150105.22553,2811.58,10,953028,-4,0,0,0,0,0
20150105.225531,2812.2,6,953034,-4,0,0,0,0,0
20150105.225532,2811.58,10,953044,0,0,0,0,0,0
20150105.225533,2811.58,32,953076,0,0,0,0,0,0
20150105.225534,2812.2,16,953092,-2,0,0,0,0,0
20150105.225535,2811.58,52,953144,0,0,0,0,0,0
20150105.225536,2811.58,128,953272,-116,0,0,0,0,0
20150105.225537,2811.58,196,953468,16,0,0,0,0,0
20150105.225538,2811.58,22,953490,-2,0,0,0,0,0
20150105.225539,2811.58,12,953502,4,0,0,0,0,0
20150105.22554,2810.96,66,953568,0,0,0,0,0,0
20150105.225541,2810.96,36,953604,0,0,0,0,0,0
20150105.225542,2810.96,116,953720,22,0,0,0,0,0
20150105.225543,2810.96,66,953786,-58,0,0,0,0,0
20150105.225544,2810.58,52,953838,12,0,0,0,0,0
20150105.225545,2810.96,238,954076,224,0,0,0,0,0
20150105.225546,2810.96,588,954664,84,0,0,0,0,0
20150105.225547,2810.34,730,955394,564,0,0,0,0,0
20150105.225548,2810.96,28,955422,10,0,0,0,0,0
20150105.225549,2809.96,6,955428,2,0,0,0,0,0
20150105.22555,2810.34,6,955434,4,0,0,0,0,0
20150105.225551,2809.96,16,955450,-2,0,0,0,0,0
20150105.225552,2810.34,10,955460,0,0,0,0,0,0
20150105.225553,2810.34,10,955470,4,0,0,0,0,0
20150105.225554,2809.96,62,955532,20,0,0,0,0,0
20150105.225555,2810.34,278,955810,-176,0,0,0,0,0
20150105.225556,2810.34,226,956036,-4,0,0,0,0,0
20150105.225557,2810.34,22,956058,-14,0,0,0,0,0
20150105.225558,2810.71,240,956298,-186,0,0,0,0,0
20150105.225559,2810.34,132,956430,-124,0,0,0,0,0
20150105.2256,2810.34,1206,957636,408,0,0,0,0,0
20150105.225601,2810.71,4,957640,0,0,0,0,0,0
20150105.225602,2810.34,78,957718,18,0,0,0,0,0
20150105.225603,2810.34,228,957946,0,0,0,0,0,0
20150105.225604,2810.34,8,957954,0,0,0,0,0,0
20150105.225605,2810.34,6,957960,-2,0,0,0,0,0
20150105.225606,2810.71,22,957982,-2,0,0,0,0,0
20150105.225607,2810.34,16,957998,2,0,0,0,0,0
20150105.225608,2810.34,10,958008,-4,0,0,0,0,0
20150105.225609,2810.71,22,958030,2,0,0,0,0,0
20150105.22561,2810.34,8,958038,4,0,0,0,0,0
20150105.225611,2810.34,6,958044,2,0,0,0,0,0
20150105.225612,2810.34,40,958084,6,0,0,0,0,0
20150105.225613,2810.34,40,958124,-18,0,0,0,0,0
20150105.225614,2810.34,8,958132,-8,0,0,0,0,0
20150105.225615,2810.34,104,958236,36,0,0,0,0,0
20150105.225616,2809.97,28,958264,-14,0,0,0,0,0
20150105.225617,2810.34,34,958298,24,0,0,0,0,0
20150105.225618,2810.34,24,958322,20,0,0,0,0,0
20150105.225619,2810.34,10,958332,4,0,0,0,0,0
20150105.22562,2810.34,22,958354,-14,0,0,0,0,0
20150105.225621,2810.34,90,958444,90,0,0,0,0,0
20150105.225622,2810.34,20,958464,14,0,0,0,0,0
20150105.225623,2810.34,1196,959660,866,0,0,0,0,0
20150105.225624,2810.33,42,959702,26,0,0,0,0,0
20150105.225625,2810.58,202,959904,186,0,0,0,0,0
20150105.225626,2809.96,166,960070,64,0,0,0,0,0
20150105.225627,2809.96,148,960218,98,0,0,0,0,0
20150105.225628,2810.58,92,960310,76,0,0,0,0,0
20150105.225629,2809.96,30,960340,14,0,0,0,0,0
20150105.22563,2809.96,200,960540,-84,0,0,0,0,0
20150105.225631,2809.96,14,960554,4,0,0,0,0,0
20150105.225632,2809.96,52,960606,14,0,0,0,0,0
20150105.225633,2809.96,20,960626,12,0,0,0,0,0
20150105.225634,2809.96,86,960712,70,0,0,0,0,0
20150105.225635,2809.96,6,960718,-2,0,0,0,0,0
20150105.225636,2809.96,12,960730,8,0,0,0,0,0
20150105.225637,2809.96,4,960734,0,0,0,0,0,0
20150105.225638,2809.96,92,960826,28,0,0,0,0,0
20150105.225639,2809.96,124,960950,84,0,0,0,0,0
20150105.22564,2809.96,256,961206,22,0,0,0,0,0
20150105.225641,2809.96,46,961252,44,0,0,0,0,0
20150105.225642,2809.96,40,961292,38,0,0,0,0,0
20150105.225643,2809.59,314,961606,-138,0,0,0,0,0
20150105.225644,2809.96,64,961670,14,0,0,0,0,0
20150105.225645,2809.59,172,961842,64,0,0,0,0,0
20150105.225646,2809.96,14,961856,10,0,0,0,0,0
20150105.225647,2809.34,46,961902,2,0,0,0,0,0
20150105.225648,2809.34,50,961952,-30,0,0,0,0,0
20150105.225649,2809.96,20,961972,-6,0,0,0,0,0
20150105.22565,2809.59,228,962200,52,0,0,0,0,0
20150105.225651,2809.96,334,962534,-10,0,0,0,0,0
20150105.225652,2809.96,10,962544,4,0,0,0,0,0
20150105.225653,2809.59,4,962548,4,0,0,0,0,0
20150105.225654,2809.59,28,962576,6,0,0,0,0,0
20150105.225655,2809.59,216,962792,68,0,0,0,0,0
20150105.225656,2809.96,206,962998,100,0,0,0,0,0
20150105.225657,2809.96,12,963010,0,0,0,0,0,0
20150105.225658,2809.59,10,963020,2,0,0,0,0,0
20150105.225659,2809.59,66,963086,16,0,0,0,0,0
20150105.2257,2809.96,70,963156,70,0,0,0,0,0
20150105.225701,2810.21,22,963178,16,0,0,0,0,0
20150105.225702,2809.59,104,963282,-36,0,0,0,0,0
20150105.225703,2809.96,4,963286,2,0,0,0,0,0
20150105.225704,2809.59,74,963360,-40,0,0,0,0,0
20150105.225705,2809.96,20,963380,6,0,0,0,0,0
20150105.225706,2809.59,14,963394,6,0,0,0,0,0
20150105.225707,2808.97,74,963468,34,0,0,0,0,0
20150105.225708,2809.34,24,963492,14,0,0,0,0,0
20150105.225709,2808.97,74,963566,4,0,0,0,0,0
20150105.22571,2809.59,6,963572,0,0,0,0,0,0
20150105.225711,2809.59,28,963600,0,0,0,0,0,0
20150105.225712,2808.59,92,963692,18,0,0,0,0,0
20150105.225713,2808.97,20,963712,12,0,0,0,0,0
20150105.225714,2809.22,114,963826,100,0,0,0,0,0
20150105.225715,2809.34,42,963868,14,0,0,0,0,0
20150105.225716,2809.34,76,963944,8,0,0,0,0,0
20150105.225717,2809.59,196,964140,114,0,0,0,0,0
20150105.225718,2809.59,12,964152,-6,0,0,0,0,0
20150105.225719,2809.34,24,964176,-8,0,0,0,0,0
20150105.22572,2809.59,8,964184,2,0,0,0,0,0
20150105.225721,2809.96,30,964214,-8,0,0,0,0,0
20150105.225722,2809.59,18,964232,2,0,0,0,0,0
20150105.225723,2809.96,12,964244,4,0,0,0,0,0
20150105.225724,2808.97,64,964308,34,0,0,0,0,0
20150105.225725,2809.59,22,964330,22,0,0,0,0,0
20150105.225726,2808.97,2,964332,0,0,0,0,0,0
20150105.225727,2808.97,18,964350,-2,0,0,0,0,0
20150105.225728,2808.97,8,964358,0,0,0,0,0,0
20150105.225729,2808.97,4,964362,4,0,0,0,0,0
20150105.22573,2808.97,10,964372,0,0,0,0,0,0
20150105.225731,2809.59,10,964382,10,0,0,0,0,0
20150105.225732,2809.59,2,964384,2,0,0,0,0,0
20150105.225733,2808.97,22,964406,20,0,0,0,0,0
20150105.225734,2809.59,2,964408,2,0,0,0,0,0
20150105.225735,2809.59,2,964410,2,0,0,0,0,0
20150105.225736,2809.59,10,964420,-6,0,0,0,0,0
20150105.225737,2808.97,4,964424,0,0,0,0,0,0
20150105.225738,2808.97,10,964434,0,0,0,0,0,0
20150105.225739,2808.97,8,964442,-8,0,0,0,0,0
20150105.22574,2808.97,22,964464,-18,0,0,0,0,0
20150105.225741,2809.59,6,964470,0,0,0,0,0,0
20150105.225742,2809.59,354,964824,-14,0,0,0,0,0
20150105.225743,2809.59,14,964838,0,0,0,0,0,0
20150105.225744,2809.59,2,964840,0,0,0,0,0,0
20150105.225745,2809.59,8,964848,-2,0,0,0,0,0
20150105.225746,2810.21,2,964850,2,0,0,0,0,0
20150105.225747,2809.59,2,964852,-2,0,0,0,0,0
20150105.225748,2809.59,8,964860,-6,0,0,0,0,0
20150105.225749,2809.59,4,964864,-2,0,0,0,0,0
20150105.22575,2809.59,8,964872,0,0,0,0,0,0
20150105.225751,2810.21,2,964874,0,0,0,0,0,0
20150105.225752,2809.59,24,964898,-24,0,0,0,0,0
20150105.225753,2809.59,18,964916,0,0,0,0,0,0
20150105.225754,2809.59,36,964952,36,0,0,0,0,0
20150105.225755,2809.59,24,964976,24,0,0,0,0,0
20150105.225756,2809.59,2,964978,0,0,0,0,0,0
20150105.225757,2809.59,2,964980,2,0,0,0,0,0
20150105.225758,2810.21,8,964988,8,0,0,0,0,0
20150105.225759,2809.59,22,965010,4,0,0,0,0,0
20150105.2258,2810.21,6,965016,6,0,0,0,0,0
20150105.225801,2809.59,2,965018,2,0,0,0,0,0
20150105.225802,2810.21,154,965172,-18,0,0,0,0,0
20150105.225803,2809.59,10,965182,-10,0,0,0,0,0
20150105.225804,2810.21,2,965184,0,0,0,0,0,0
20150105.225805,2810.21,2,965186,0,0,0,0,0,0
20150105.225806,2809.59,2,965188,0,0,0,0,0,0
20150105.225807,2809.59,24,965212,0,0,0,0,0,0
20150105.225808,2809.59,60,965272,-46,0,0,0,0,0
20150105.225809,2809.59,150,965422,-64,0,0,0,0,0
20150105.22581,2809.59,2,965424,-2,0,0,0,0,0
20150105.225811,2809.59,16,965440,-16,0,0,0,0,0
20150105.225812,2809.59,20,965460,-20,0,0,0,0,0
20150105.225813,2809.59,4,965464,0,0,0,0,0,0
20150105.225814,2809.59,102,965566,-102,0,0,0,0,0
20150105.225815,2809.59,312,965878,16,0,0,0,0,0
20150105.225816,2809.59,2,965880,0,0,0,0,0,0
20150105.225817,2809.59,18,965898,0,0,0,0,0,0
20150105.225818,2808.97,2,965900,0,0,0,0,0,0
20150105.225819,2809.59,176,966076,-34,0,0,0,0,0
20150105.22582,2809.59,4,966080,4,0,0,0,0,0
20150105.225821,2809.59,12,966092,8,0,0,0,0,0
20150105.225822,2809.59,4,966096,0,0,0,0,0,0
20150105.225823,2809.59,10,966106,-6,0,0,0,0,0
20150105.225824,2808.97,40,966146,-40,0,0,0,0,0
20150105.225825,2808.97,2,966148,0,0,0,0,0,0
20150105.225826,2809.59,100,966248,100,0,0,0,0,0
20150105.225827,2809.59,10,966258,10,0,0,0,0,0
20150105.225828,2809.59,164,966422,164,0,0,0,0,0
20150105.225829,2809.59,178,966600,158,0,0,0,0,0
20150105.22583,2809.59,4,966604,0,0,0,0,0,0
20150105.225831,2809.59,2,966606,0,0,0,0,0,0
20150105.225832,2809.59,2,966608,-2,0,0,0,0,0
20150105.225833,2810.21,34,966642,-34,0,0,0,0,0
20150105.225834,2809.59,4,966646,-4,0,0,0,0,0
20150105.225835,2810.21,10,966656,-10,0,0,0,0,0
20150105.225836,2809.59,4,966660,-2,0,0,0,0,0
20150105.225837,2809.59,56,966716,-56,0,0,0,0,0
20150105.225838,2809.59,14,966730,-4,0,0,0,0,0
20150105.225839,2809.59,2,966732,0,0,0,0,0,0
20150105.22584,2809.59,2,966734,0,0,0,0,0,0
20150105.225841,2809.59,2,966736,-2,0,0,0,0,0
20150105.225842,2809.59,8,966744,0,0,0,0,0,0
20150105.225843,2809.59,2,966746,-2,0,0,0,0,0
20150105.225844,2810.21,20,966766,-20,0,0,0,0,0
20150105.225845,2809.59,172,966938,-32,0,0,0,0,0
20150105.225846,2809.59,4,966942,0,0,0,0,0,0
20150105.225847,2809.59,2,966944,0,0,0,0,0,0
20150105.225848,2809.59,94,967038,0,0,0,0,0,0
20150105.225849,2809.59,364,967402,-152,0,0,0,0,0
20150105.22585,2809.59,8,967410,0,0,0,0,0,0
20150105.225851,2808.97,12,967422,2,0,0,0,0,0
20150105.225852,2808.97,22,967444,0,0,0,0,0,0
20150105.225853,2809.59,4,967448,2,0,0,0,0,0
20150105.225854,2809.59,10,967458,10,0,0,0,0,0
20150105.225855,2809.59,20,967478,20,0,0,0,0,0
20150105.225856,2809.59,10,967488,10,0,0,0,0,0
20150105.225857,2809.59,452,967940,-134,0,0,0,0,0
20150105.225858,2809.59,58,967998,8,0,0,0,0,0
20150105.225859,2809.59,46,968044,0,0,0,0,0,0
20150105.2259,2809.59,12,968056,2,0,0,0,0,0
20150105.225901,2809.59,2,968058,0,0,0,0,0,0
20150105.225902,2809.59,4,968062,0,0,0,0,0,0
20150105.225903,2809.59,6,968068,0,0,0,0,0,0
20150105.225904,2809.59,82,968150,-82,0,0,0,0,0
20150105.225905,2810.21,2,968152,-2,0,0,0,0,0
20150105.225906,2809.59,6,968158,0,0,0,0,0,0
20150105.225907,2810.21,2,968160,0,0,0,0,0,0
20150105.225908,2809.59,2,968162,-2,0,0,0,0,0
20150105.225909,2809.59,200,968362,-58,0,0,0,0,0
20150105.22591,2810.21,4,968366,2,0,0,0,0,0
20150105.225911,2809.59,6,968372,0,0,0,0,0,0
20150105.225912,2809.59,20,968392,0,0,0,0,0,0
20150105.225913,2809.59,2,968394,2,0,0,0,0,0
20150105.225914,2809.59,6,968400,6,0,0,0,0,0
20150105.225915,2809.59,4,968404,4,0,0,0,0,0
20150105.225916,2809.59,4,968408,0,0,0,0,0,0
20150105.225917,2810.21,2,968410,-2,0,0,0,0,0
20150105.225918,2809.59,16,968426,10,0,0,0,0,0
20150105.225919,2810.21,200,968626,124,0,0,0,0,0
20150105.22592,2810.21,2,968628,0,0,0,0,0,0
20150105.225921,2810.21,2,968630,0,0,0,0,0,0
20150105.225922,2810.21,2,968632,0,0,0,0,0,0
20150105.225923,2809.59,8,968640,-4,0,0,0,0,0
20150105.225924,2810.21,8,968648,-4,0,0,0,0,0
20150105.225925,2810.21,8,968656,-4,0,0,0,0,0
20150105.225926,2810.21,2,968658,0,0,0,0,0,0
20150105.225927,2810.21,2,968660,0,0,0,0,0,0
20150105.225928,2810.21,2,968662,0,0,0,0,0,0
20150105.225929,2810.21,4,968666,-2,0,0,0,0,0
20150105.22593,2810.21,22,968688,-20,0,0,0,0,0
20150105.225931,2809.59,20,968708,8,0,0,0,0,0
20150105.225932,2810.21,10,968718,-8,0,0,0,0,0
20150105.225933,2810.21,2,968720,0,0,0,0,0,0
20150105.225934,2809.59,6,968726,0,0,0,0,0,0
20150105.225935,2810.21,2,968728,0,0,0,0,0,0
20150105.225936,2810.21,4,968732,0,0,0,0,0,0
20150105.225937,2810.21,2,968734,0,0,0,0,0,0
20150105.225938,2810.21,132,968866,16,0,0,0,0,0
20150105.225939,2810.21,6,968872,2,0,0,0,0,0
20150105.22594,2810.21,2,968874,0,0,0,0,0,0
20150105.225941,2810.21,4,968878,0,0,0,0,0,0
20150105.225942,2810.21,2,968880,0,0,0,0,0,0
20150105.225943,2810.21,2,968882,-2,0,0,0,0,0
20150105.225944,2810.21,2,968884,0,0,0,0,0,0
20150105.225945,2810.21,20,968904,0,0,0,0,0,0
20150105.225946,2810.21,2,968906,0,0,0,0,0,0
20150105.225947,2809.59,106,969012,-74,0,0,0,0,0
20150105.225948,2810.21,20,969032,20,0,0,0,0,0
20150105.225949,2810.21,4,969036,0,0,0,0,0,0
20150105.22595,2810.21,2,969038,0,0,0,0,0,0
20150105.225951,2810.21,62,969100,-22,0,0,0,0,0
20150105.225952,2810.21,2,969102,2,0,0,0,0,0
20150105.225953,2810.21,2,969104,2,0,0,0,0,0
20150105.225954,2810.21,2,969106,2,0,0,0,0,0
20150105.225955,2809.59,60,969166,-60,0,0,0,0,0
20150105.225956,2810.21,2,969168,2,0,0,0,0,0
20150105.225957,2809.59,2,969170,-2,0,0,0,0,0
20150105.225958,2810.21,14,969184,0,0,0,0,0,0
20150105.225959,2810.21,2,969186,0,0,0,0,0,0
20150105.23,2809.59,172,969358,-148,0,0,0,0,0
20150105.230001,2810.21,4,969362,2,0,0,0,0,0
20150105.230002,2809.59,100,969462,-26,0,0,0,0,0
20150105.230003,2810.21,2,969464,0,0,0,0,0,0
20150105.230004,2810.21,2,969466,-2,0,0,0,0,0
20150105.230005,2809.59,4,969470,0,0,0,0,0,0
20150105.230006,2809.59,150,969620,-14,0,0,0,0,0
20150105.230007,2810.21,200,969820,-90,0,0,0,0,0
20150105.230008,2809.59,12,969832,-12,0,0,0,0,0
20150105.230009,2809.59,2,969834,0,0,0,0,0,0
20150105.23001,2809.59,104,969938,16,0,0,0,0,0
20150105.230011,2810.21,4,969942,0,0,0,0,0,0
20150105.230012,2809.59,2,969944,0,0,0,0,0,0
20150105.230013,2809.59,2,969946,-2,0,0,0,0,0
20150105.230014,2810.21,2,969948,0,0,0,0,0,0
20150105.230015,2810.21,20,969968,6,0,0,0,0,0
20150105.230016,2809.59,92,970060,-92,0,0,0,0,0
20150105.230017,2810.21,2,970062,2,0,0,0,0,0
20150105.230018,2810.21,8,970070,0,0,0,0,0,0
20150105.230019,2809.59,2,970072,0,0,0,0,0,0
20150105.23002,2809.59,58,970130,-58,0,0,0,0,0
20150105.230021,2809.59,2,970132,0,0,0,0,0,0
20150105.230022,2810.21,6,970138,2,0,0,0,0,0
20150105.230023,2810.21,4,970142,4,0,0,0,0,0
20150105.230024,2809.59,2,970144,0,0,0,0,0,0
20150105.230025,2809.59,86,970230,-64,0,0,0,0,0
20150105.230026,2809.59,76,970306,-44,0,0,0,0,0
20150105.230027,2809.59,42,970348,-2,0,0,0,0,0
20150105.230028,2809.59,4,970352,-2,0,0,0,0,0
20150105.230029,2809.59,86,970438,36,0,0,0,0,0
20150105.23003,2809.59,2,970440,2,0,0,0,0,0
20150105.230031,2809.59,14,970454,4,0,0,0,0,0
20150105.230032,2809.59,2,970456,0,0,0,0,0,0
20150105.230033,2809.59,2,970458,2,0,0,0,0,0
20150105.230034,2809.59,2,970460,2,0,0,0,0,0
20150105.230035,2809.59,2,970462,0,0,0,0,0,0
20150105.230036,2809.59,40,970502,8,0,0,0,0,0
20150105.230037,2809.59,2,970504,0,0,0,0,0,0
20150105.230038,2809.59,10,970514,0,0,0,0,0,0
20150105.230039,2809.59,4,970518,2,0,0,0,0,0
20150105.23004,2810.21,200,970718,-166,0,0,0,0,0
20150105.230041,2809.58,2,970720,0,0,0,0,0,0
20150105.230042,2809.58,8,970728,-4,0,0,0,0,0
20150105.230043,2810.21,10,970738,0,0,0,0,0,0
20150105.230044,2810.21,2,970740,2,0,0,0,0,0
20150105.230045,2809.59,2,970742,0,0,0,0,0,0
20150105.230046,2809.59,20,970762,0,0,0,0,0,0
20150105.230047,2809.58,14,970776,-10,0,0,0,0,0
20150105.230048,2809.58,2,970778,0,0,0,0,0,0
20150105.230049,2809.58,30,970808,0,0,0,0,0,0
20150105.23005,2809.58,2,970810,0,0,0,0,0,0
20150105.230051,2810.21,4,970814,0,0,0,0,0,0
20150105.230052,2809.58,108,970922,20,0,0,0,0,0
20150105.230053,2809.59,2,970924,-2,0,0,0,0,0
20150105.230054,2809.59,8,970932,-8,0,0,0,0,0
20150105.230055,2809.59,14,970946,0,0,0,0,0,0
20150105.230056,2809.59,120,971066,4,0,0,0,0,0
20150105.230057,2809.59,2,971068,0,0,0,0,0,0
20150105.230058,2809.58,10,971078,6,0,0,0,0,0
20150105.230059,2809.58,16,971094,8,0,0,0,0,0
20150105.2301,2810.21,2,971096,0,0,0,0,0,0
20150105.230101,2810.21,2,971098,0,0,0,0,0,0
20150105.230102,2810.21,2,971100,0,0,0,0,0,0
20150105.230103,2809.58,94,971194,16,0,0,0,0,0
20150105.230104,2810.21,6,971200,-4,0,0,0,0,0
20150105.230105,2810.21,6,971206,0,0,0,0,0,0
20150105.230106,2810.21,2,971208,0,0,0,0,0,0
20150105.230107,2809.58,10,971218,0,0,0,0,0,0
20150105.230108,2810.21,2,971220,-2,0,0,0,0,0
20150105.230109,2810.21,2,971222,-2,0,0,0,0,0
20150105.23011,2810.21,12,971234,0,0,0,0,0,0
20150105.230111,2810.21,48,971282,0,0,0,0,0,0
20150105.230112,2810.21,2,971284,0,0,0,0,0,0
20150105.230113,2810.21,2,971286,-2,0,0,0,0,0
20150105.230114,2809.58,30,971316,-30,0,0,0,0,0
20150105.230115,2810.21,8,971324,-6,0,0,0,0,0
20150105.230116,2810.21,400,971724,-160,0,0,0,0,0
20150105.230117,2809.58,2,971726,-2,0,0,0,0,0
20150105.230118,2810.21,2,971728,0,0,0,0,0,0
20150105.230119,2810.21,4,971732,4,0,0,0,0,0
20150105.23012,2810.21,4,971736,4,0,0,0,0,0
20150105.230121,2810.21,6,971742,6,0,0,0,0,0
20150105.230122,2809.58,200,971942,0,0,0,0,0,0
20150105.230123,2810.21,2,971944,2,0,0,0,0,0
20150105.230124,2810.21,12,971956,12,0,0,0,0,0
20150105.230125,2810.21,4,971960,4,0,0,0,0,0
20150105.230126,2809.58,2,971962,0,0,0,0,0,0
20150105.230127,2809.58,2,971964,-2,0,0,0,0,0
20150105.230128,2810.21,102,972066,-54,0,0,0,0,0
20150105.230129,2810.21,4,972070,-4,0,0,0,0,0
20150105.23013,2810.21,2,972072,-2,0,0,0,0,0
20150105.230131,2810.21,2,972074,0,0,0,0,0,0
20150105.230132,2810.21,8,972082,0,0,0,0,0,0
20150105.230133,2810.21,2,972084,-2,0,0,0,0,0
20150105.230134,2810.21,4,972088,2,0,0,0,0,0
20150105.230135,2810.21,4,972092,-2,0,0,0,0,0
20150105.230136,2810.21,8,972100,-4,0,0,0,0,0
20150105.230137,2810.21,2,972102,2,0,0,0,0,0
20150105.230138,2810.21,2,972104,0,0,0,0,0,0
20150105.230139,2810.21,2,972106,0,0,0,0,0,0
20150105.23014,2810.21,2,972108,2,0,0,0,0,0
20150105.230141,2810.21,2,972110,0,0,0,0,0,0
20150105.230142,2810.21,2,972112,0,0,0,0,0,0
20150105.230143,2809.58,2,972114,0,0,0,0,0,0
20150105.230144,2809.58,2,972116,-2,0,0,0,0,0
20150105.230145,2810.21,2,972118,2,0,0,0,0,0
20150105.230146,2810.21,2,972120,2,0,0,0,0,0
20150105.230147,2809.58,4,972124,-4,0,0,0,0,0
20150105.230148,2809.58,4,972128,0,0,0,0,0,0
20150105.230149,2810.21,10,972138,10,0,0,0,0,0
20150105.23015,2809.58,240,972378,22,0,0,0,0,0
20150105.230151,2809.58,40,972418,38,0,0,0,0,0
20150105.230152,2810.21,38,972456,0,0,0,0,0,0
20150105.230153,2810.21,26,972482,20,0,0,0,0,0
20150105.230154,2810.21,2,972484,2,0,0,0,0,0
20150105.230155,2810.21,4,972488,0,0,0,0,0,0
20150105.230156,2810.21,2,972490,-2,0,0,0,0,0
20150105.230157,2810.21,4,972494,0,0,0,0,0,0
20150105.230158,2810.21,6,972500,0,0,0,0,0,0
20150105.230159,2810.21,20,972520,0,0,0,0,0,0
20150105.2302,2810.21,2,972522,0,0,0,0,0,0
20150105.230201,2810.21,62,972584,6,0,0,0,0,0
20150105.230202,2809.58,206,972790,146,0,0,0,0,0
20150105.230203,2810.21,40,972830,-14,0,0,0,0,0
20150105.230204,2809.59,488,973318,152,0,0,0,0,0
20150105.230205,2810.21,6,973324,2,0,0,0,0,0
20150105.230206,2810.21,12,973336,12,0,0,0,0,0
20150105.230207,2809.59,4,973340,2,0,0,0,0,0
20150105.230208,2810.21,4,973344,4,0,0,0,0,0
20150105.230209,2810.21,34,973378,-20,0,0,0,0,0
20150105.23021,2809.59,2,973380,0,0,0,0,0,0
20150105.230211,2809.59,2,973382,0,0,0,0,0,0
20150105.230212,2809.59,480,973862,460,0,0,0,0,0
20150105.230213,2809.59,20,973882,6,0,0,0,0,0
20150105.230214,2809.59,4,973886,-2,0,0,0,0,0
20150105.230215,2809.59,4,973890,0,0,0,0,0,0
20150105.230216,2809.59,42,973932,-2,0,0,0,0,0
20150105.230217,2809.59,34,973966,-34,0,0,0,0,0
20150105.230218,2809.59,2,973968,0,0,0,0,0,0
20150105.230219,2808.97,2,973970,0,0,0,0,0,0
20150105.23022,2809.59,4,973974,2,0,0,0,0,0
20150105.230221,2809.59,12,973986,2,0,0,0,0,0
20150105.230222,2810.21,200,974186,-102,0,0,0,0,0
20150105.230223,2809.59,102,974288,6,0,0,0,0,0
20150105.230224,2808.97,28,974316,2,0,0,0,0,0
20150105.230225,2809.59,90,974406,0,0,0,0,0,0
20150105.230226,2809.59,202,974608,-202,0,0,0,0,0
20150105.230227,2809.59,106,974714,100,0,0,0,0,0
20150105.230228,2809.59,12,974726,8,0,0,0,0,0
20150105.230229,2809.59,12,974738,12,0,0,0,0,0
20150105.23023,2809.59,4,974742,4,0,0,0,0,0
20150105.230231,2809.59,70,974812,-4,0,0,0,0,0
20150105.230232,2809.59,2,974814,2,0,0,0,0,0
20150105.230233,2809.59,2,974816,0,0,0,0,0,0
20150105.230234,2809.59,46,974862,38,0,0,0,0,0
20150105.230235,2809.59,52,974914,20,0,0,0,0,0
20150105.230236,2809.59,2,974916,2,0,0,0,0,0
20150105.230237,2808.97,14,974930,4,0,0,0,0,0
20150105.230238,2809.59,2,974932,2,0,0,0,0,0
20150105.230239,2809.59,242,975174,112,0,0,0,0,0
20150105.23024,2809.59,10,975184,10,0,0,0,0,0
20150105.230241,2808.97,240,975424,42,0,0,0,0,0
20150105.230242,2809.59,10,975434,0,0,0,0,0,0
20150105.230243,2808.97,34,975468,0,0,0,0,0,0
20150105.230244,2808.97,26,975494,22,0,0,0,0,0
20150105.230245,2809.59,26,975520,16,0,0,0,0,0
20150105.230246,2808.97,4,975524,4,0,0,0,0,0
20150105.230247,2809.59,52,975576,4,0,0,0,0,0
20150105.230248,2808.97,4,975580,-4,0,0,0,0,0
20150105.230249,2809.59,4,975584,0,0,0,0,0,0
20150105.23025,2809.59,2,975586,0,0,0,0,0,0
20150105.230251,2809.59,4,975590,0,0,0,0,0,0
20150105.230252,2808.97,12,975602,0,0,0,0,0,0
20150105.230253,2808.97,4,975606,0,0,0,0,0,0
20150105.230254,2809.59,10,975616,0,0,0,0,0,0
20150105.230255,2808.97,148,975764,34,0,0,0,0,0
20150105.230256,2809.59,12,975776,0,0,0,0,0,0
20150105.230257,2809.59,6,975782,0,0,0,0,0,0
20150105.230258,2808.97,4,975786,0,0,0,0,0,0
20150105.230259,2808.97,36,975822,0,0,0,0,0,0
20150105.2303,2809.59,4,975826,0,0,0,0,0,0
20150105.230301,2808.97,20,975846,-16,0,0,0,0,0
20150105.230302,2809.59,50,975896,-24,0,0,0,0,0
20150105.230303,2809.59,2,975898,2,0,0,0,0,0
20150105.230304,2808.97,20,975918,-20,0,0,0,0,0
20150105.230305,2808.97,480,976398,68,0,0,0,0,0
20150105.230306,2808.97,32,976430,32,0,0,0,0,0
20150105.230307,2808.97,2,976432,2,0,0,0,0,0
20150105.230308,2808.97,6,976438,0,0,0,0,0,0
20150105.230309,2808.97,480,976918,228,0,0,0,0,0
20150105.23031,2808.97,88,977006,-84,0,0,0,0,0
20150105.230311,2808.97,2,977008,-2,0,0,0,0,0
20150105.230312,2808.97,2,977010,0,0,0,0,0,0
20150105.230313,2808.97,180,977190,-84,0,0,0,0,0
20150105.230314,2808.97,12,977202,-4,0,0,0,0,0
20150105.230315,2808.97,4,977206,0,0,0,0,0,0
20150105.230316,2808.97,108,977314,28,0,0,0,0,0
20150105.230317,2808.97,2,977316,2,0,0,0,0,0
20150105.230318,2808.97,144,977460,126,0,0,0,0,0
20150105.230319,2808.97,246,977706,-78,0,0,0,0,0
20150105.23032,2808.35,238,977944,126,0,0,0,0,0
20150105.230321,2808.35,588,978532,446,0,0,0,0,0
20150105.230322,2808.35,74,978606,-66,0,0,0,0,0
20150105.230323,2808.35,122,978728,0,0,0,0,0,0
20150105.230324,2808.35,2,978730,-2,0,0,0,0,0
20150105.230325,2808.35,6,978736,-4,0,0,0,0,0
20150105.230326,2808.97,228,978964,152,0,0,0,0,0
20150105.230327,2808.97,6,978970,-2,0,0,0,0,0
20150105.230328,2808.97,4,978974,2,0,0,0,0,0
20150105.230329,2808.97,4,978978,-4,0,0,0,0,0
20150105.23033,2808.97,16,978994,0,0,0,0,0,0
20150105.230331,2808.97,100,979094,24,0,0,0,0,0
20150105.230332,2808.97,22,979116,-10,0,0,0,0,0
20150105.230333,2808.97,146,979262,-144,0,0,0,0,0
20150105.230334,2808.97,4,979266,0,0,0,0,0,0
20150105.230335,2808.97,2,979268,-2,0,0,0,0,0
20150105.230336,2808.97,12,979280,-6,0,0,0,0,0
20150105.230337,2808.97,8,979288,2,0,0,0,0,0
20150105.230338,2808.97,10,979298,0,0,0,0,0,0
20150105.230339,2808.97,4,979302,0,0,0,0,0,0
20150105.23034,2808.97,10,979312,0,0,0,0,0,0
20150105.230341,2808.97,10,979322,-4,0,0,0,0,0
20150105.230342,2808.97,4,979326,0,0,0,0,0,0
20150105.230343,2808.97,2,979328,0,0,0,0,0,0
20150105.230344,2808.97,4,979332,-4,0,0,0,0,0
20150105.230345,2808.97,102,979434,24,0,0,0,0,0
20150105.230346,2808.97,86,979520,-48,0,0,0,0,0
20150105.230347,2808.97,2,979522,0,0,0,0,0,0
20150105.230348,2808.97,6,979528,-2,0,0,0,0,0
20150105.230349,2808.97,20,979548,0,0,0,0,0,0
20150105.23035,2808.97,34,979582,-32,0,0,0,0,0
20150105.230351,2808.35,30,979612,-18,0,0,0,0,0
20150105.230352,2808.97,26,979638,-6,0,0,0,0,0
20150105.230353,2808.97,2,979640,-2,0,0,0,0,0
20150105.230354,2808.97,414,980054,80,0,0,0,0,0
20150105.230355,2808.97,106,980160,-10,0,0,0,0,0
20150105.230356,2808.35,2,980162,-2,0,0,0,0,0
20150105.230357,2808.97,2,980164,0,0,0,0,0,0
20150105.230358,2808.97,14,980178,-2,0,0,0,0,0
20150105.230359,2808.35,12,980190,-2,0,0,0,0,0
20150105.2304,2808.97,22,980212,0,0,0,0,0,0
20150105.230401,2808.35,88,980300,-24,0,0,0,0,0
20150105.230402,2808.35,544,980844,-86,0,0,0,0,0
20150105.230403,2808.97,14,980858,2,0,0,0,0,0
20150105.230404,2808.35,16,980874,-6,0,0,0,0,0
20150105.230405,2808.35,42,980916,2,0,0,0,0,0
20150105.230406,2808.97,6,980922,-2,0,0,0,0,0
20150105.230407,2808.35,2,980924,2,0,0,0,0,0
20150105.230408,2808.35,12,980936,12,0,0,0,0,0
20150105.230409,2808.35,4,980940,4,0,0,0,0,0
20150105.23041,2808.35,4,980944,4,0,0,0,0,0
20150105.230411,2808.35,2,980946,2,0,0,0,0,0
20150105.230412,2808.35,594,981540,-190,0,0,0,0,0
20150105.230413,2807.73,4,981544,-2,0,0,0,0,0
20150105.230414,2807.73,22,981566,-20,0,0,0,0,0
20150105.230415,2807.73,198,981764,64,0,0,0,0,0
20150105.230416,2808.35,242,982006,62,0,0,0,0,0
20150105.230417,2807.73,302,982308,302,0,0,0,0,0
20150105.230418,2807.73,2,982310,2,0,0,0,0,0
20150105.230419,2807.73,698,983008,194,0,0,0,0,0
20150105.23042,2807.73,4,983012,0,0,0,0,0,0
20150105.230421,2807.73,210,983222,158,0,0,0,0,0
20150105.230422,2807.11,90,983312,-30,0,0,0,0,0
20150105.230423,2807.11,56,983368,-38,0,0,0,0,0
20150105.230424,2807.73,112,983480,-104,0,0,0,0,0
20150105.230425,2807.73,90,983570,40,0,0,0,0,0
20150105.230426,2807.73,118,983688,-52,0,0,0,0,0
20150105.230427,2807.73,324,984012,68,0,0,0,0,0
20150105.230428,2807.73,118,984130,-90,0,0,0,0,0
20150105.230429,2807.73,180,984310,-180,0,0,0,0,0
20150105.23043,2807.11,426,984736,-24,0,0,0,0,0
20150105.230431,2807.73,4,984740,0,0,0,0,0,0
20150105.230432,2807.73,496,985236,-88,0,0,0,0,0
20150105.230433,2807.73,862,986098,-6,0,0,0,0,0
20150105.230434,2807.73,10,986108,4,0,0,0,0,0
20150105.230435,2807.1,40,986148,-40,0,0,0,0,0
20150105.230436,2807.73,48,986196,6,0,0,0,0,0
20150105.230437,2807.73,98,986294,-24,0,0,0,0,0
20150105.230438,2807.1,104,986398,-96,0,0,0,0,0
20150105.230439,2807.73,104,986502,-22,0,0,0,0,0
20150105.23044,2807.73,32,986534,30,0,0,0,0,0
20150105.230441,2807.73,48,986582,26,0,0,0,0,0
20150105.230442,2807.1,94,986676,16,0,0,0,0,0
20150105.230443,2807.73,136,986812,-86,0,0,0,0,0
20150105.230444,2807.73,12,986824,4,0,0,0,0,0
20150105.230445,2807.73,16,986840,6,0,0,0,0,0
20150105.230446,2807.73,12,986852,-2,0,0,0,0,0
20150105.230447,2807.73,42,986894,0,0,0,0,0,0
20150105.230448,2807.73,324,987218,128,0,0,0,0,0
20150105.230449,2807.73,6,987224,4,0,0,0,0,0
20150105.23045,2807.73,6,987230,0,0,0,0,0,0
20150105.230451,2807.73,48,987278,0,0,0,0,0,0
20150105.230452,2807.11,406,987684,274,0,0,0,0,0
20150105.230453,2807.73,128,987812,98,0,0,0,0,0
20150105.230454,2807.73,64,987876,22,0,0,0,0,0
20150105.230455,2807.73,52,987928,12,0,0,0,0,0
20150105.230456,2807.73,86,988014,0,0,0,0,0,0
20150105.230457,2807.73,4,988018,0,0,0,0,0,0
20150105.230458,2807.73,28,988046,4,0,0,0,0,0
20150105.230459,2807.73,6,988052,4,0,0,0,0,0
20150105.2305,2807.73,476,988528,-68,0,0,0,0,0
20150105.230501,2807.11,240,988768,120,0,0,0,0,0
20150105.230502,2807.73,118,988886,104,0,0,0,0,0
20150105.230503,2807.73,308,989194,202,0,0,0,0,0
20150105.230504,2807.73,4,989198,4,0,0,0,0,0
20150105.230505,2807.73,44,989242,44,0,0,0,0,0
20150105.230506,2807.73,2,989244,2,0,0,0,0,0
20150105.230507,2807.73,4,989248,0,0,0,0,0,0
20150105.230508,2808.35,22,989270,2,0,0,0,0,0
20150105.230509,2807.73,404,989674,-208,0,0,0,0,0
20150105.23051,2807.73,56,989730,-2,0,0,0,0,0
20150105.230511,2807.73,18,989748,-2,0,0,0,0,0
20150105.230512,2808.35,18,989766,2,0,0,0,0,0
20150105.230513,2808.35,66,989832,0,0,0,0,0,0
20150105.230514,2807.73,2,989834,0,0,0,0,0,0
20150105.230515,2807.73,6,989840,0,0,0,0,0,0
20150105.230516,2808.35,2,989842,0,0,0,0,0,0
20150105.230517,2807.73,22,989864,0,0,0,0,0,0
20150105.230518,2807.73,6,989870,0,0,0,0,0,0
20150105.230519,2807.73,204,990074,0,0,0,0,0,0
20150105.23052,2808.35,56,990130,6,0,0,0,0,0
20150105.230521,2807.73,12,990142,0,0,0,0,0,0
20150105.230522,2807.73,20,990162,0,0,0,0,0,0
20150105.230523,2807.73,814,990976,374,0,0,0,0,0
20150105.230524,2808.35,2,990978,0,0,0,0,0,0
20150105.230525,2807.73,32,991010,26,0,0,0,0,0
20150105.230526,2807.73,102,991112,98,0,0,0,0,0
20150105.230527,2808.35,112,991224,-28,0,0,0,0,0
20150105.230528,2808.35,116,991340,30,0,0,0,0,0
20150105.230529,2807.73,2,991342,2,0,0,0,0,0
20150105.23053,2807.73,4,991346,4,0,0,0,0,0
20150105.230531,2807.73,4,991350,0,0,0,0,0,0
20150105.230532,2808.35,824,992174,-548,0,0,0,0,0
20150105.230533,2808.35,8,992182,6,0,0,0,0,0
20150105.230534,2807.73,2,992184,2,0,0,0,0,0
20150105.230535,2807.73,4,992188,0,0,0,0,0,0
20150105.230536,2808.35,14,992202,0,0,0,0,0,0
20150105.230537,2808.35,6,992208,-6,0,0,0,0,0
20150105.230538,2808.35,2,992210,-2,0,0,0,0,0
20150105.230539,2808.35,4,992214,-4,0,0,0,0,0
20150105.23054,2808.35,102,992316,98,0,0,0,0,0
20150105.230541,2807.73,30,992346,0,0,0,0,0,0
20150105.230542,2807.73,6,992352,4,0,0,0,0,0
20150105.230543,2808.35,100,992452,2,0,0,0,0,0
20150105.230544,2808.35,12,992464,-12,0,0,0,0,0
20150105.230545,2808.35,10,992474,0,0,0,0,0,0
20150105.230546,2807.73,20,992494,20,0,0,0,0,0
20150105.230547,2808.35,10,992504,0,0,0,0,0,0
20150105.230548,2808.35,52,992556,-36,0,0,0,0,0
20150105.230549,2808.35,34,992590,26,0,0,0,0,0
20150105.23055,2807.73,2,992592,2,0,0,0,0,0
20150105.230551,2807.73,100,992692,80,0,0,0,0,0
20150105.230552,2808.35,4,992696,-4,0,0,0,0,0
20150105.230553,2808.35,10,992706,-8,0,0,0,0,0
20150105.230554,2807.73,2,992708,0,0,0,0,0,0
20150105.230555,2808.35,2,992710,2,0,0,0,0,0
20150105.230556,2808.35,2,992712,0,0,0,0,0,0
20150105.230557,2807.73,276,992988,134,0,0,0,0,0
20150105.230558,2807.73,2,992990,2,0,0,0,0,0
20150105.230559,2807.73,4,992994,4,0,0,0,0,0
20150105.2306,2807.73,4,992998,4,0,0,0,0,0
20150105.230601,2807.11,6,993004,6,0,0,0,0,0
20150105.230602,2807.73,4,993008,4,0,0,0,0,0
20150105.230603,2807.73,92,993100,90,0,0,0,0,0
20150105.230604,2807.73,18,993118,2,0,0,0,0,0
20150105.230605,2807.11,4,993122,2,0,0,0,0,0
20150105.230606,2807.73,2,993124,2,0,0,0,0,0
20150105.230607,2807.73,20,993144,20,0,0,0,0,0
20150105.230608,2807.73,2,993146,2,0,0,0,0,0
20150105.230609,2807.11,2,993148,2,0,0,0,0,0
20150105.23061,2807.73,114,993262,102,0,0,0,0,0
20150105.230611,2807.73,64,993326,62,0,0,0,0,0
20150105.230612,2807.11,14,993340,2,0,0,0,0,0
20150105.230613,2807.11,4,993344,-2,0,0,0,0,0
20150105.230614,2807.11,2,993346,0,0,0,0,0,0
20150105.230615,2807.73,40,993386,2,0,0,0,0,0
20150105.230616,2807.73,14,993400,2,0,0,0,0,0
20150105.230617,2807.73,40,993440,28,0,0,0,0,0
20150105.230618,2807.73,32,993472,2,0,0,0,0,0
20150105.230619,2807.73,4,993476,4,0,0,0,0,0
20150105.23062,2807.11,76,993552,0,0,0,0,0,0
20150105.230621,2807.11,28,993580,-8,0,0,0,0,0
20150105.230622,2807.11,120,993700,-106,0,0,0,0,0
20150105.230623,2807.11,10,993710,0,0,0,0,0,0
20150105.230624,2807.73,212,993922,-8,0,0,0,0,0
20150105.230625,2807.11,4,993926,2,0,0,0,0,0
20150105.230626,2807.73,2,993928,0,0,0,0,0,0
20150105.230627,2807.11,2,993930,2,0,0,0,0,0
20150105.230628,2807.11,6,993936,-2,0,0,0,0,0
20150105.230629,2807.73,52,993988,40,0,0,0,0,0
20150105.23063,2807.11,2,993990,0,0,0,0,0,0
20150105.230631,2807.73,6,993996,0,0,0,0,0,0
20150105.230632,2807.73,216,994212,8,0,0,0,0,0
20150105.230633,2807.73,2,994214,2,0,0,0,0,0
20150105.230634,2807.73,42,994256,42,0,0,0,0,0
20150105.230635,2807.11,402,994658,234,0,0,0,0,0
20150105.230636,2807.73,60,994718,34,0,0,0,0,0
20150105.230637,2808.35,4,994722,4,0,0,0,0,0
20150105.230638,2807.73,12,994734,12,0,0,0,0,0
20150105.230639,2807.73,24,994758,24,0,0,0,0,0
20150105.23064,2807.73,246,995004,-172,0,0,0,0,0
20150105.230641,2807.73,26,995030,2,0,0,0,0,0
20150105.230642,2807.73,64,995094,28,0,0,0,0,0
20150105.230643,2807.73,20,995114,0,0,0,0,0,0
20150105.230644,2807.73,2,995116,2,0,0,0,0,0
20150105.230645,2807.73,2,995118,0,0,0,0,0,0
20150105.230646,2807.73,28,995146,20,0,0,0,0,0
20150105.230647,2807.73,124,995270,48,0,0,0,0,0
20150105.230648,2807.73,4,995274,0,0,0,0,0,0
20150105.230649,2807.73,42,995316,-8,0,0,0,0,0
20150105.23065,2807.73,2,995318,-2,0,0,0,0,0
20150105.230651,2807.11,46,995364,20,0,0,0,0,0
20150105.230652,2807.73,2,995366,2,0,0,0,0,0
20150105.230653,2807.73,10,995376,6,0,0,0,0,0
20150105.230654,2807.73,4,995380,2,0,0,0,0,0
20150105.230655,2807.11,14,995394,-8,0,0,0,0,0
20150105.230656,2807.11,2,995396,-2,0,0,0,0,0
20150105.230657,2807.73,566,995962,-120,0,0,0,0,0
20150105.230658,2807.73,2,995964,0,0,0,0,0,0
20150105.230659,2807.73,4,995968,0,0,0,0,0,0
20150105.2307,2807.73,2,995970,0,0,0,0,0,0
20150105.230701,2807.73,22,995992,0,0,0,0,0,0
20150105.230702,2807.73,24,996016,0,0,0,0,0,0
20150105.230703,2807.73,4,996020,0,0,0,0,0,0
20150105.230704,2807.73,12,996032,0,0,0,0,0,0
20150105.230705,2807.73,8,996040,-6,0,0,0,0,0
20150105.230706,2807.73,222,996262,-200,0,0,0,0,0
20150105.230707,2807.73,2,996264,-2,0,0,0,0,0
20150105.230708,2807.73,2,996266,0,0,0,0,0,0
20150105.230709,2807.73,108,996374,34,0,0,0,0,0
20150105.23071,2808.35,20,996394,0,0,0,0,0,0
20150105.230711,2808.35,14,996408,8,0,0,0,0,0
20150105.230712,2807.73,8,996416,8,0,0,0,0,0
20150105.230713,2807.73,4,996420,4,0,0,0,0,0
20150105.230714,2807.73,6,996426,6,0,0,0,0,0
20150105.230715,2807.73,4,996430,0,0,0,0,0,0
20150105.230716,2807.73,4,996434,0,0,0,0,0,0
20150105.230717,2808.35,6,996440,-6,0,0,0,0,0
20150105.230718,2808.35,4,996444,0,0,0,0,0,0
20150105.230719,2808.35,2,996446,0,0,0,0,0,0
20150105.23072,2807.73,8,996454,6,0,0,0,0,0
20150105.230721,2807.73,2,996456,2,0,0,0,0,0
20150105.230722,2808.35,2,996458,0,0,0,0,0,0
20150105.230723,2808.35,6,996464,4,0,0,0,0,0
20150105.230724,2807.73,2,996466,2,0,0,0,0,0
20150105.230725,2808.35,60,996526,-8,0,0,0,0,0
20150105.230726,2808.35,56,996582,12,0,0,0,0,0
20150105.230727,2808.35,86,996668,-6,0,0,0,0,0
20150105.230728,2808.35,12,996680,2,0,0,0,0,0
20150105.230729,2808.35,226,996906,-44,0,0,0,0,0
20150105.23073,2808.35,24,996930,-8,0,0,0,0,0
20150105.230731,2807.73,10,996940,10,0,0,0,0,0
20150105.230732,2808.35,4,996944,0,0,0,0,0,0
20150105.230733,2808.35,2,996946,0,0,0,0,0,0
20150105.230734,2808.35,6,996952,0,0,0,0,0,0
20150105.230735,2808.35,24,996976,-22,0,0,0,0,0
20150105.230736,2808.35,6,996982,6,0,0,0,0,0
20150105.230737,2808.35,10,996992,10,0,0,0,0,0
20150105.230738,2808.35,208,997200,-2,0,0,0,0,0
20150105.230739,2808.35,4,997204,0,0,0,0,0,0
20150105.23074,2808.35,2,997206,0,0,0,0,0,0
20150105.230741,2807.73,44,997250,44,0,0,0,0,0
20150105.230742,2808.35,10,997260,0,0,0,0,0,0
20150105.230743,2807.73,4,997264,4,0,0,0,0,0
20150105.230744,2808.35,312,997576,-148,0,0,0,0,0
20150105.230745,2808.35,530,998106,-430,0,0,0,0,0
20150105.230746,2808.35,242,998348,-72,0,0,0,0,0
20150105.230747,2808.35,24,998372,-4,0,0,0,0,0
20150105.230748,2808.35,6,998378,-2,0,0,0,0,0
20150105.230749,2808.35,2,998380,0,0,0,0,0,0
20150105.23075,2808.35,4,998384,0,0,0,0,0,0
20150105.230751,2808.97,36,998420,-36,0,0,0,0,0
20150105.230752,2808.97,6,998426,-2,0,0,0,0,0
20150105.230753,2808.35,10,998436,0,0,0,0,0,0
20150105.230754,2808.35,84,998520,-52,0,0,0,0,0
20150105.230755,2808.35,132,998652,-38,0,0,0,0,0
20150105.230756,2808.35,2,998654,2,0,0,0,0,0
20150105.230757,2807.73,2,998656,0,0,0,0,0,0
20150105.230758,2808.35,30,998686,26,0,0,0,0,0
20150105.230759,2807.73,8,998694,6,0,0,0,0,0
20150105.2308,2808.35,6,998700,6,0,0,0,0,0
20150105.230801,2808.35,2,998702,2,0,0,0,0,0
20150105.230802,2808.35,2,998704,0,0,0,0,0,0
20150105.230803,2808.35,2,998706,0,0,0,0,0,0
20150105.230804,2808.35,6,998712,6,0,0,0,0,0
20150105.230805,2808.35,2,998714,2,0,0,0,0,0
20150105.230806,2807.73,114,998828,-62,0,0,0,0,0
20150105.230807,2808.35,12,998840,0,0,0,0,0,0
20150105.230808,2808.35,70,998910,28,0,0,0,0,0
20150105.230809,2808.35,66,998976,52,0,0,0,0,0
20150105.23081,2808.35,14,998990,14,0,0,0,0,0
20150105.230811,2808.97,16,999006,-10,0,0,0,0,0
20150105.230812,2808.35,2,999008,0,0,0,0,0,0
20150105.230813,2808.35,2,999010,-2,0,0,0,0,0
20150105.230814,2808.35,16,999026,-16,0,0,0,0,0
20150105.230815,2808.35,264,999290,146,0,0,0,0,0
20150105.230816,2807.73,6,999296,6,0,0,0,0,0
20150105.230817,2808.35,4,999300,0,0,0,0,0,0
20150105.230818,2808.35,26,999326,6,0,0,0,0,0
20150105.230819,2807.73,60,999386,60,0,0,0,0,0
20150105.23082,2807.73,2,999388,2,0,0,0,0,0
20150105.230821,2808.35,2,999390,0,0,0,0,0,0
20150105.230822,2808.35,2,999392,2,0,0,0,0,0
20150105.230823,2808.35,2,999394,0,0,0,0,0,0
20150105.230824,2808.35,2,999396,2,0,0,0,0,0
20150105.230825,2808.35,20,999416,0,0,0,0,0,0
20150105.230826,2808.35,12,999428,12,0,0,0,0,0
20150105.230827,2807.73,28,999456,0,0,0,0,0,0
20150105.230828,2807.73,2,999458,2,0,0,0,0,0
20150105.230829,2807.73,2,999460,0,0,0,0,0,0
20150105.23083,2807.73,10,999470,0,0,0,0,0,0
20150105.230831,2808.35,180,999650,180,0,0,0,0,0
20150105.230832,2808.35,14,999664,14,0,0,0,0,0
20150105.230833,2808.35,2,999666,2,0,0,0,0,0
20150105.230834,2808.35,24,999690,2,0,0,0,0,0
20150105.230835,2807.73,40,999730,40,0,0,0,0,0
20150105.230836,2808.35,2,999732,0,0,0,0,0,0
20150105.230837,2808.35,2,999734,2,0,0,0,0,0
20150105.230838,2808.35,2,999736,2,0,0,0,0,0
20150105.230839,2808.35,2,999738,0,0,0,0,0,0
20150105.23084,2808.35,104,999842,32,0,0,0,0,0
20150105.230841,2807.73,4,999846,4,0,0,0,0,0
20150105.230842,2808.35,2,999848,2,0,0,0,0,0
20150105.230843,2808.35,2,999850,2,0,0,0,0,0
20150105.230844,2808.35,2,999852,2,0,0,0,0,0
20150105.230845,2808.35,4,999856,4,0,0,0,0,0
20150105.230846,2808.35,6,999862,0,0,0,0,0,0
20150105.230847,2808.35,2,999864,2,0,0,0,0,0
20150105.230848,2808.35,36,999900,16,0,0,0,0,0
20150105.230849,2807.73,2,999902,2,0,0,0,0,0
20150105.23085,2808.35,10,999912,8,0,0,0,0,0
20150105.230851,2808.35,32,999944,32,0,0,0,0,0
20150105.230852,2808.35,2,999946,2,0,0,0,0,0
20150105.230853,2808.35,34,999980,10,0,0,0,0,0
20150105.230854,2808.35,12,999992,12,0,0,0,0,0
20150105.230855,2807.73,10,1000002,10,0,0,0,0,0
20150105.230856,2807.73,4,1000006,0,0,0,0,0,0
20150105.230857,2807.73,6,1000012,6,0,0,0,0,0
20150105.230858,2808.35,6,1000018,0,0,0,0,0,0
20150105.230859,2808.35,202,1000220,-84,0,0,0,0,0
20150105.2309,2808.35,204,1000424,84,0,0,0,0,0
20150105.230901,2807.73,248,1000672,-102,0,0,0,0,0
20150105.230902,2808.35,124,1000796,-26,0,0,0,0,0
20150105.230903,2808.35,74,1000870,44,0,0,0,0,0
20150105.230904,2807.73,6,1000876,6,0,0,0,0,0
20150105.230905,2807.73,2,1000878,2,0,0,0,0,0
20150105.230906,2807.73,20,1000898,0,0,0,0,0,0
20150105.230907,2808.35,12,1000910,2,0,0,0,0,0
20150105.230908,2807.73,10,1000920,0,0,0,0,0,0
20150105.230909,2808.35,102,1001022,20,0,0,0,0,0
20150105.23091,2808.35,12,1001034,0,0,0,0,0,0
20150105.230911,2808.35,2,1001036,-2,0,0,0,0,0
20150105.230912,2807.73,20,1001056,0,0,0,0,0,0
20150105.230913,2807.73,2,1001058,2,0,0,0,0,0
20150105.230914,2808.35,2,1001060,-2,0,0,0,0,0
20150105.230915,2807.73,2,1001062,2,0,0,0,0,0
20150105.230916,2808.35,2,1001064,0,0,0,0,0,0
20150105.230917,2807.73,34,1001098,32,0,0,0,0,0
20150105.230918,2808.35,4,1001102,0,0,0,0,0,0
20150105.230919,2808.35,2,1001104,0,0,0,0,0,0
20150105.23092,2807.73,8,1001112,8,0,0,0,0,0
20150105.230921,2808.35,4,1001116,-2,0,0,0,0,0
20150105.230922,2808.35,62,1001178,-42,0,0,0,0,0
20150105.230923,2808.35,12,1001190,12,0,0,0,0,0
20150105.230924,2807.73,20,1001210,0,0,0,0,0,0
20150105.230925,2807.73,20,1001230,0,0,0,0,0,0
20150105.230926,2808.35,6,1001236,6,0,0,0,0,0
20150105.230927,2808.35,26,1001262,22,0,0,0,0,0
20150105.230928,2807.73,12,1001274,2,0,0,0,0,0
20150105.230929,2808.35,12,1001286,12,0,0,0,0,0
20150105.23093,2808.35,6,1001292,4,0,0,0,0,0
20150105.230931,2808.35,4,1001296,4,0,0,0,0,0
20150105.230932,2807.73,2,1001298,2,0,0,0,0,0
20150105.230933,2808.35,212,1001510,194,0,0,0,0,0
20150105.230934,2808.35,2,1001512,-2,0,0,0,0,0
20150105.230935,2807.73,10,1001522,0,0,0,0,0,0
20150105.230936,2807.73,2,1001524,2,0,0,0,0,0
20150105.230937,2808.35,24,1001548,-24,0,0,0,0,0
20150105.230938,2807.73,10,1001558,0,0,0,0,0,0
20150105.230939,2808.35,2,1001560,-2,0,0,0,0,0
20150105.23094,2808.35,2,1001562,0,0,0,0,0,0
20150105.230941,2807.73,6,1001568,6,0,0,0,0,0
20150105.230942,2807.73,10,1001578,-4,0,0,0,0,0
20150105.230943,2807.73,4,1001582,2,0,0,0,0,0
20150105.230944,2807.73,144,1001726,2,0,0,0,0,0
20150105.230945,2807.73,2,1001728,2,0,0,0,0,0
20150105.230946,2808.35,2,1001730,0,0,0,0,0,0
20150105.230947,2808.35,2,1001732,0,0,0,0,0,0
20150105.230948,2808.35,6,1001738,0,0,0,0,0,0
20150105.230949,2808.35,4,1001742,0,0,0,0,0,0
20150105.23095,2808.35,2,1001744,0,0,0,0,0,0
20150105.230951,2808.35,44,1001788,8,0,0,0,0,0
20150105.230952,2808.35,4,1001792,0,0,0,0,0,0
20150105.230953,2807.73,12,1001804,6,0,0,0,0,0
20150105.230954,2808.35,2,1001806,-2,0,0,0,0,0
20150105.230955,2807.73,12,1001818,4,0,0,0,0,0
20150105.230956,2807.73,10,1001828,0,0,0,0,0,0
20150105.230957,2807.73,10,1001838,10,0,0,0,0,0
20150105.230958,2807.73,230,1002068,20,0,0,0,0,0
20150105.230959,2807.73,4,1002072,0,0,0,0,0,0
20150105.231,2807.73,178,1002250,98,0,0,0,0,0
20150105.231001,2807.73,104,1002354,100,0,0,0,0,0
20150105.231002,2808.35,28,1002382,24,0,0,0,0,0
20150105.231003,2807.73,32,1002414,14,0,0,0,0,0
20150105.231004,2808.35,6,1002420,0,0,0,0,0,0
20150105.231005,2808.35,4,1002424,-2,0,0,0,0,0
20150105.231006,2808.35,4,1002428,2,0,0,0,0,0
20150105.231007,2808.35,168,1002596,58,0,0,0,0,0
20150105.231008,2808.35,6,1002602,0,0,0,0,0,0
20150105.231009,2807.73,6,1002608,-4,0,0,0,0,0
20150105.23101,2808.35,22,1002630,-2,0,0,0,0,0
20150105.231011,2808.35,6,1002636,0,0,0,0,0,0
20150105.231012,2807.73,20,1002656,2,0,0,0,0,0
20150105.231013,2808.35,20,1002676,-20,0,0,0,0,0
20150105.231014,2807.73,16,1002692,-10,0,0,0,0,0
20150105.231015,2807.73,72,1002764,56,0,0,0,0,0
20150105.231016,2807.73,242,1003006,242,0,0,0,0,0
20150105.231017,2807.73,226,1003232,226,0,0,0,0,0
20150105.231018,2807.73,76,1003308,22,0,0,0,0,0
20150105.231019,2808.35,14,1003322,0,0,0,0,0,0
20150105.23102,2807.73,434,1003756,122,0,0,0,0,0
20150105.231021,2807.73,1648,1005404,1084,0,0,0,0,0
20150105.231022,2807.11,2,1005406,0,0,0,0,0,0
20150105.231023,2807.11,270,1005676,84,0,0,0,0,0
20150105.231024,2807.11,20,1005696,0,0,0,0,0,0
20150105.231025,2807.73,2,1005698,2,0,0,0,0,0
20150105.231026,2807.11,20,1005718,0,0,0,0,0,0
20150105.231027,2807.11,22,1005740,0,0,0,0,0,0
20150105.231028,2807.11,4,1005744,0,0,0,0,0,0
20150105.231029,2807.11,8,1005752,2,0,0,0,0,0
20150105.23103,2807.73,6,1005758,-4,0,0,0,0,0
20150105.231031,2807.11,54,1005812,0,0,0,0,0,0
20150105.231032,2807.11,130,1005942,6,0,0,0,0,0
20150105.231033,2807.11,2,1005944,0,0,0,0,0,0
20150105.231034,2807.11,6,1005950,6,0,0,0,0,0
20150105.231035,2807.11,2,1005952,0,0,0,0,0,0
20150105.231036,2807.11,2,1005954,2,0,0,0,0,0
20150105.231037,2807.73,36,1005990,0,0,0,0,0,0
20150105.231038,2807.73,2,1005992,2,0,0,0,0,0
20150105.231039,2807.73,78,1006070,68,0,0,0,0,0
20150105.23104,2807.11,400,1006470,-260,0,0,0,0,0
20150105.231041,2807.11,464,1006934,380,0,0,0,0,0
20150105.231042,2807.11,12,1006946,12,0,0,0,0,0
20150105.231043,2807.11,8,1006954,0,0,0,0,0,0
20150105.231044,2807.11,40,1006994,2,0,0,0,0,0
20150105.231045,2807.73,4,1006998,4,0,0,0,0,0
20150105.231046,2807.73,88,1007086,84,0,0,0,0,0
20150105.231047,2807.11,20,1007106,10,0,0,0,0,0
20150105.231048,2807.11,40,1007146,2,0,0,0,0,0
20150105.231049,2807.11,32,1007178,24,0,0,0,0,0
20150105.23105,2807.73,212,1007390,12,0,0,0,0,0
20150105.231051,2807.11,28,1007418,2,0,0,0,0,0
20150105.231052,2807.11,102,1007520,2,0,0,0,0,0
20150105.231053,2807.11,100,1007620,100,0,0,0,0,0
20150105.231054,2807.11,4,1007624,4,0,0,0,0,0
20150105.231055,2807.11,14,1007638,14,0,0,0,0,0
20150105.231056,2807.11,40,1007678,30,0,0,0,0,0
20150105.231057,2807.73,2,1007680,2,0,0,0,0,0
20150105.231058,2807.73,2,1007682,2,0,0,0,0,0
20150105.231059,2807.73,150,1007832,8,0,0,0,0,0
20150105.2311,2807.73,6,1007838,6,0,0,0,0,0
20150105.231101,2807.73,70,1007908,70,0,0,0,0,0
20150105.231102,2807.73,2,1007910,2,0,0,0,0,0
20150105.231103,2807.11,202,1008112,202,0,0,0,0,0
20150105.231104,2807.11,8,1008120,8,0,0,0,0,0
20150105.231105,2807.11,204,1008324,168,0,0,0,0,0
20150105.231106,2807.11,50,1008374,50,0,0,0,0,0
20150105.231107,2807.11,10,1008384,10,0,0,0,0,0
20150105.231108,2807.11,24,1008408,24,0,0,0,0,0
20150105.231109,2807.11,204,1008612,202,0,0,0,0,0
20150105.23111,2807.11,2,1008614,0,0,0,0,0,0
20150105.231111,2807.11,90,1008704,84,0,0,0,0,0
20150105.231112,2807.11,4,1008708,0,0,0,0,0,0
20150105.231113,2807.11,84,1008792,82,0,0,0,0,0
20150105.231114,2807.11,2,1008794,0,0,0,0,0,0
20150105.231115,2807.11,4,1008798,2,0,0,0,0,0
20150105.231116,2807.73,6,1008804,2,0,0,0,0,0
20150105.231117,2807.73,2,1008806,2,0,0,0,0,0
20150105.231118,2807.73,124,1008930,2,0,0,0,0,0
20150105.231119,2807.11,146,1009076,102,0,0,0,0,0
20150105.23112,2807.73,2,1009078,2,0,0,0,0,0
20150105.231121,2807.11,4,1009082,4,0,0,0,0,0
20150105.231122,2807.11,6,1009088,4,0,0,0,0,0
20150105.231123,2807.11,6,1009094,2,0,0,0,0,0
20150105.231124,2807.73,10,1009104,10,0,0,0,0,0
20150105.231125,2807.73,40,1009144,40,0,0,0,0,0
20150105.231126,2807.11,36,1009180,16,0,0,0,0,0
20150105.231127,2807.11,108,1009288,104,0,0,0,0,0
20150105.231128,2807.11,20,1009308,20,0,0,0,0,0
20150105.231129,2807.11,160,1009468,120,0,0,0,0,0
20150105.23113,2807.11,10,1009478,10,0,0,0,0,0
20150105.231131,2807.11,2,1009480,0,0,0,0,0,0
20150105.231132,2807.11,4,1009484,2,0,0,0,0,0
20150105.231133,2807.11,2,1009486,2,0,0,0,0,0
20150105.231134,2807.11,44,1009530,4,0,0,0,0,0
20150105.231135,2807.11,6,1009536,6,0,0,0,0,0
20150105.231136,2807.73,40,1009576,40,0,0,0,0,0
20150105.231137,2807.73,2,1009578,2,0,0,0,0,0
20150105.231138,2807.11,2,1009580,2,0,0,0,0,0
20150105.231139,2807.11,6,1009586,6,0,0,0,0,0
20150105.23114,2807.11,28,1009614,26,0,0,0,0,0
20150105.231141,2807.11,12,1009626,12,0,0,0,0,0
20150105.231142,2807.73,4,1009630,0,0,0,0,0,0
20150105.231143,2807.73,20,1009650,0,0,0,0,0,0
20150105.231144,2807.11,2,1009652,2,0,0,0,0,0
20150105.231145,2807.11,12,1009664,0,0,0,0,0,0
20150105.231146,2807.11,4,1009668,4,0,0,0,0,0
20150105.231147,2807.11,6,1009674,4,0,0,0,0,0
20150105.231148,2807.11,4,1009678,4,0,0,0,0,0
20150105.231149,2807.11,2,1009680,2,0,0,0,0,0
20150105.23115,2807.73,20,1009700,0,0,0,0,0,0
20150105.231151,2807.11,4,1009704,4,0,0,0,0,0
20150105.231152,2807.11,2,1009706,0,0,0,0,0,0
20150105.231153,2807.11,8,1009714,0,0,0,0,0,0
20150105.231154,2807.11,30,1009744,30,0,0,0,0,0
20150105.231155,2807.11,24,1009768,4,0,0,0,0,0
20150105.231156,2807.73,258,1010026,-2,0,0,0,0,0
20150105.231157,2807.11,4,1010030,2,0,0,0,0,0
20150105.231158,2807.11,6,1010036,2,0,0,0,0,0
20150105.231159,2807.11,214,1010250,-36,0,0,0,0,0
20150105.2312,2807.73,2,1010252,2,0,0,0,0,0
20150105.231201,2807.11,2,1010254,0,0,0,0,0,0
20150105.231202,2807.11,2,1010256,0,0,0,0,0,0
20150105.231203,2807.11,2,1010258,2,0,0,0,0,0
20150105.231204,2807.11,4,1010262,4,0,0,0,0,0
20150105.231205,2807.11,2,1010264,2,0,0,0,0,0
20150105.231206,2807.11,14,1010278,2,0,0,0,0,0
20150105.231207,2807.11,12,1010290,12,0,0,0,0,0
20150105.231208,2807.11,6,1010296,6,0,0,0,0,0
20150105.231209,2807.11,2,1010298,2,0,0,0,0,0
20150105.23121,2807.11,10,1010308,10,0,0,0,0,0
20150105.231211,2807.11,26,1010334,0,0,0,0,0,0
20150105.231212,2807.11,6,1010340,6,0,0,0,0,0
20150105.231213,2807.11,22,1010362,0,0,0,0,0,0
20150105.231214,2807.73,102,1010464,82,0,0,0,0,0
20150105.231215,2807.11,6,1010470,-4,0,0,0,0,0
20150105.231216,2807.73,2,1010472,0,0,0,0,0,0
20150105.231217,2807.11,22,1010494,2,0,0,0,0,0
20150105.231218,2807.11,80,1010574,0,0,0,0,0,0
20150105.231219,2807.11,100,1010674,-76,0,0,0,0,0
20150105.23122,2807.11,4,1010678,0,0,0,0,0,0
20150105.231221,2807.11,112,1010790,52,0,0,0,0,0
20150105.231222,2807.73,2,1010792,2,0,0,0,0,0
20150105.231223,2807.11,2,1010794,2,0,0,0,0,0
20150105.231224,2807.11,2,1010796,2,0,0,0,0,0
20150105.231225,2807.11,2,1010798,2,0,0,0,0,0
20150105.231226,2807.11,42,1010840,-4,0,0,0,0,0
20150105.231227,2807.11,4,1010844,0,0,0,0,0,0
20150105.231228,2807.11,8,1010852,-8,0,0,0,0,0
20150105.231229,2807.11,2,1010854,0,0,0,0,0,0
20150105.23123,2807.11,12,1010866,-10,0,0,0,0,0
20150105.231231,2807.73,4,1010870,4,0,0,0,0,0
20150105.231232,2807.73,2,1010872,2,0,0,0,0,0
20150105.231233,2807.73,2,1010874,2,0,0,0,0,0
20150105.231234,2807.11,216,1011090,26,0,0,0,0,0
20150105.231235,2807.73,4,1011094,4,0,0,0,0,0
20150105.231236,2807.11,4,1011098,-4,0,0,0,0,0
20150105.231237,2807.11,2,1011100,0,0,0,0,0,0
20150105.231238,2807.73,8,1011108,0,0,0,0,0,0
20150105.231239,2807.73,4,1011112,2,0,0,0,0,0
20150105.23124,2807.73,20,1011132,18,0,0,0,0,0
20150105.231241,2807.73,4,1011136,4,0,0,0,0,0
20150105.231242,2807.73,2,1011138,0,0,0,0,0,0
20150105.231243,2807.73,2,1011140,0,0,0,0,0,0
20150105.231244,2807.73,82,1011222,82,0,0,0,0,0
20150105.231245,2807.73,2,1011224,0,0,0,0,0,0
20150105.231246,2807.73,14,1011238,10,0,0,0,0,0
20150105.231247,2807.73,80,1011318,0,0,0,0,0,0
20150105.231248,2807.11,102,1011420,96,0,0,0,0,0
20150105.231249,2807.73,34,1011454,0,0,0,0,0,0
20150105.23125,2807.73,2,1011456,2,0,0,0,0,0
20150105.231251,2807.11,4,1011460,2,0,0,0,0,0
20150105.231252,2807.11,2,1011462,2,0,0,0,0,0
20150105.231253,2807.73,16,1011478,0,0,0,0,0,0
20150105.231254,2807.11,2,1011480,0,0,0,0,0,0
20150105.231255,2807.73,2,1011482,2,0,0,0,0,0
20150105.231256,2807.73,2,1011484,2,0,0,0,0,0
20150105.231257,2807.73,2,1011486,2,0,0,0,0,0
20150105.231258,2807.73,4,1011490,2,0,0,0,0,0
20150105.231259,2807.73,2,1011492,2,0,0,0,0,0
20150105.2313,2807.73,4,1011496,4,0,0,0,0,0
20150105.231301,2807.73,6,1011502,6,0,0,0,0,0
20150105.231302,2807.73,2,1011504,2,0,0,0,0,0
20150105.231303,2807.73,2,1011506,2,0,0,0,0,0
20150105.231304,2807.73,2,1011508,0,0,0,0,0,0
20150105.231305,2807.73,6,1011514,-6,0,0,0,0,0
20150105.231306,2807.73,10,1011524,2,0,0,0,0,0
20150105.231307,2807.73,2,1011526,0,0,0,0,0,0
20150105.231308,2807.73,2,1011528,-2,0,0,0,0,0
20150105.231309,2807.11,26,1011554,26,0,0,0,0,0
20150105.23131,2807.11,102,1011656,98,0,0,0,0,0
20150105.231311,2807.73,2,1011658,-2,0,0,0,0,0
20150105.231312,2807.73,18,1011676,-6,0,0,0,0,0
20150105.231313,2807.73,200,1011876,-54,0,0,0,0,0
20150105.231314,2807.11,2,1011878,0,0,0,0,0,0
20150105.231315,2807.73,40,1011918,0,0,0,0,0,0
20150105.231316,2807.11,4,1011922,0,0,0,0,0,0
20150105.231317,2807.11,4,1011926,4,0,0,0,0,0
20150105.231318,2807.73,4,1011930,0,0,0,0,0,0
20150105.231319,2807.73,10,1011940,0,0,0,0,0,0
20150105.23132,2807.11,204,1012144,200,0,0,0,0,0
20150105.231321,2807.11,2,1012146,0,0,0,0,0,0
20150105.231322,2807.74,20,1012166,0,0,0,0,0,0
20150105.231323,2807.73,2,1012168,-2,0,0,0,0,0
20150105.231324,2807.74,2,1012170,-2,0,0,0,0,0
20150105.231325,2807.74,6,1012176,-4,0,0,0,0,0
20150105.231326,2807.11,2,1012178,2,0,0,0,0,0
20150105.231327,2807.74,404,1012582,-18,0,0,0,0,0
20150105.231328,2807.73,20,1012602,-2,0,0,0,0,0
20150105.231329,2807.73,30,1012632,-16,0,0,0,0,0
20150105.23133,2807.73,242,1012874,-70,0,0,0,0,0
20150105.231331,2807.73,4,1012878,0,0,0,0,0,0
20150105.231332,2807.73,6,1012884,2,0,0,0,0,0
20150105.231333,2807.11,222,1013106,0,0,0,0,0,0
20150105.231334,2807.11,10,1013116,10,0,0,0,0,0
20150105.231335,2807.73,6,1013122,4,0,0,0,0,0
20150105.231336,2807.73,2,1013124,0,0,0,0,0,0
20150105.231337,2807.73,2,1013126,2,0,0,0,0,0
20150105.231338,2807.73,1002,1014128,-118,0,0,0,0,0
20150105.231339,2807.73,416,1014544,164,0,0,0,0,0
20150105.23134,2808.36,44,1014588,0,0,0,0,0,0
20150105.231341,2807.73,22,1014610,0,0,0,0,0,0
20150105.231342,2807.74,40,1014650,40,0,0,0,0,0
20150105.231343,2807.74,816,1015466,468,0,0,0,0,0
20150105.231344,2807.74,2,1015468,0,0,0,0,0,0
20150105.231345,2807.74,214,1015682,206,0,0,0,0,0
20150105.231346,2807.74,174,1015856,-170,0,0,0,0,0
20150105.231347,2807.74,8,1015864,-8,0,0,0,0,0
20150105.231348,2807.74,30,1015894,-30,0,0,0,0,0
20150105.231349,2807.74,10,1015904,-10,0,0,0,0,0
20150105.23135,2808.36,2,1015906,0,0,0,0,0,0
20150105.231351,2807.74,4,1015910,0,0,0,0,0,0
20150105.231352,2807.74,2,1015912,-2,0,0,0,0,0
20150105.231353,2808.36,16,1015928,-16,0,0,0,0,0
20150105.231354,2808.36,2,1015930,-2,0,0,0,0,0
20150105.231355,2807.74,10,1015940,0,0,0,0,0,0
20150105.231356,2807.74,20,1015960,0,0,0,0,0,0
20150105.231357,2808.36,2,1015962,0,0,0,0,0,0
20150105.231358,2807.74,8,1015970,-8,0,0,0,0,0
20150105.231359,2807.74,4,1015974,-4,0,0,0,0,0
20150105.2314,2808.36,4,1015978,-2,0,0,0,0,0
20150105.231401,2808.36,2,1015980,0,0,0,0,0,0
20150105.231402,2807.74,42,1016022,-40,0,0,0,0,0
20150105.231403,2808.36,240,1016262,-208,0,0,0,0,0
20150105.231404,2808.36,14,1016276,0,0,0,0,0,0
20150105.231405,2808.36,62,1016338,42,0,0,0,0,0
20150105.231406,2808.36,2,1016340,-2,0,0,0,0,0
20150105.231407,2808.36,2,1016342,-2,0,0,0,0,0
20150105.231408,2807.74,8,1016350,-8,0,0,0,0,0
20150105.231409,2808.36,2,1016352,-2,0,0,0,0,0
20150105.23141,2808.36,6,1016358,-2,0,0,0,0,0
20150105.231411,2807.74,8,1016366,-2,0,0,0,0,0
20150105.231412,2808.36,4,1016370,-4,0,0,0,0,0
20150105.231413,2808.36,6,1016376,-2,0,0,0,0,0
20150105.231414,2808.36,6,1016382,-6,0,0,0,0,0
20150105.231415,2808.36,22,1016404,-14,0,0,0,0,0
20150105.231416,2807.74,4,1016408,-2,0,0,0,0,0
20150105.231417,2808.36,10,1016418,8,0,0,0,0,0
20150105.231418,2808.36,2,1016420,0,0,0,0,0,0
20150105.231419,2808.36,2,1016422,2,0,0,0,0,0
20150105.23142,2808.36,6,1016428,-2,0,0,0,0,0
20150105.231421,2808.36,2,1016430,0,0,0,0,0,0
20150105.231422,2808.36,10,1016440,2,0,0,0,0,0
20150105.231423,2808.36,304,1016744,-96,0,0,0,0,0
20150105.231424,2808.36,8,1016752,6,0,0,0,0,0
20150105.231425,2808.36,6,1016758,-2,0,0,0,0,0
20150105.231426,2808.36,2,1016760,2,0,0,0,0,0
20150105.231427,2808.36,438,1017198,348,0,0,0,0,0
20150105.231428,2808.36,12,1017210,0,0,0,0,0,0
20150105.231429,2808.36,4,1017214,2,0,0,0,0,0
20150105.23143,2807.74,20,1017234,-20,0,0,0,0,0
20150105.231431,2808.36,2,1017236,2,0,0,0,0,0
20150105.231432,2807.74,4,1017240,-4,0,0,0,0,0
20150105.231433,2808.36,2,1017242,2,0,0,0,0,0
20150105.231434,2808.36,10,1017252,10,0,0,0,0,0
20150105.231435,2807.74,30,1017282,-30,0,0,0,0,0
20150105.231436,2807.74,20,1017302,-20,0,0,0,0,0
20150105.231437,2808.36,2,1017304,2,0,0,0,0,0
20150105.231438,2808.36,4,1017308,4,0,0,0,0,0
20150105.231439,2807.74,2,1017310,-2,0,0,0,0,0
20150105.23144,2808.36,14,1017324,14,0,0,0,0,0
20150105.231441,2807.74,2,1017326,0,0,0,0,0,0
20150105.231442,2807.74,8,1017334,-8,0,0,0,0,0
20150105.231443,2807.74,2,1017336,0,0,0,0,0,0
20150105.231444,2808.36,4,1017340,4,0,0,0,0,0
20150105.231445,2808.36,2,1017342,2,0,0,0,0,0
20150105.231446,2807.74,2,1017344,0,0,0,0,0,0
20150105.231447,2807.74,86,1017430,-84,0,0,0,0,0
20150105.231448,2808.36,2,1017432,2,0,0,0,0,0
20150105.231449,2807.74,4,1017436,0,0,0,0,0,0
20150105.23145,2808.36,20,1017456,0,0,0,0,0,0
20150105.231451,2808.36,2,1017458,2,0,0,0,0,0
20150105.231452,2807.74,4,1017462,-4,0,0,0,0,0
20150105.231453,2808.36,26,1017488,0,0,0,0,0,0
20150105.231454,2808.36,2,1017490,2,0,0,0,0,0
20150105.231455,2808.36,20,1017510,0,0,0,0,0,0
20150105.231456,2807.74,4,1017514,-2,0,0,0,0,0
20150105.231457,2808.36,4,1017518,0,0,0,0,0,0
20150105.231458,2807.74,18,1017536,-16,0,0,0,0,0
20150105.231459,2807.74,10,1017546,-10,0,0,0,0,0
20150105.2315,2807.74,4,1017550,0,0,0,0,0,0
20150105.231501,2807.74,2,1017552,0,0,0,0,0,0
20150105.231502,2808.36,20,1017572,20,0,0,0,0,0
20150105.231503,2808.36,40,1017612,0,0,0,0,0,0
20150105.231504,2808.36,2,1017614,0,0,0,0,0,0
20150105.231505,2807.73,1006,1018620,-490,0,0,0,0,0
20150105.231506,2807.74,1474,1020094,822,0,0,0,0,0
20150105.231507,2807.11,4,1020098,2,0,0,0,0,0
20150105.231508,2807.74,6,1020104,6,0,0,0,0,0
20150105.231509,2807.74,2,1020106,2,0,0,0,0,0
20150105.23151,2807.11,4,1020110,0,0,0,0,0,0
20150105.231511,2807.11,4,1020114,4,0,0,0,0,0
20150105.231512,2807.11,8,1020122,6,0,0,0,0,0
20150105.231513,2807.74,620,1020742,-4,0,0,0,0,0
20150105.231514,2808.36,6,1020748,-6,0,0,0,0,0
20150105.231515,2807.74,2,1020750,0,0,0,0,0,0
20150105.231516,2807.74,10,1020760,2,0,0,0,0,0
20150105.231517,2807.74,20,1020780,-20,0,0,0,0,0
20150105.231518,2807.74,4,1020784,0,0,0,0,0,0
20150105.231519,2807.74,264,1021048,212,0,0,0,0,0
20150105.23152,2807.74,2,1021050,2,0,0,0,0,0
20150105.231521,2807.11,2,1021052,2,0,0,0,0,0
20150105.231522,2807.11,2,1021054,2,0,0,0,0,0
20150105.231523,2807.11,40,1021094,40,0,0,0,0,0
20150105.231524,2807.12,1000,1022094,1000,0,0,0,0,0
20150105.231525,2807.12,2,1022096,2,0,0,0,0,0
20150105.231526,2807.74,4,1022100,4,0,0,0,0,0
20150105.231527,2807.74,24,1022124,24,0,0,0,0,0
20150105.231528,2807.12,1010,1023134,710,0,0,0,0,0
20150105.231529,2807.12,112,1023246,102,0,0,0,0,0
20150105.23153,2807.12,4,1023250,2,0,0,0,0,0
20150105.231531,2807.12,1358,1024608,742,0,0,0,0,0
20150105.231532,2807.12,210,1024818,-96,0,0,0,0,0
20150105.231533,2807.12,130,1024948,28,0,0,0,0,0
20150105.231534,2807.12,108,1025056,2,0,0,0,0,0
20150105.231535,2806.5,242,1025298,14,0,0,0,0,0
20150105.231536,2806.5,764,1026062,586,0,0,0,0,0
20150105.231537,2807.12,32,1026094,0,0,0,0,0,0
20150105.231538,2807.12,1008,1027102,620,0,0,0,0,0
20150105.231539,2807.12,22,1027124,0,0,0,0,0,0
20150105.23154,2807.12,8,1027132,-6,0,0,0,0,0
20150105.231541,2806.5,18,1027150,0,0,0,0,0,0
20150105.231542,2807.12,2,1027152,0,0,0,0,0,0
20150105.231543,2807.12,226,1027378,-112,0,0,0,0,0
20150105.231544,2807.12,2,1027380,0,0,0,0,0,0
20150105.231545,2807.12,624,1028004,140,0,0,0,0,0
20150105.231546,2806.5,4,1028008,4,0,0,0,0,0
20150105.231547,2806.5,2,1028010,0,0,0,0,0,0
20150105.231548,2806.5,32,1028042,26,0,0,0,0,0
20150105.231549,2806.5,84,1028126,0,0,0,0,0,0
20150105.23155,2807.12,2,1028128,0,0,0,0,0,0
20150105.231551,2807.12,20,1028148,0,0,0,0,0,0
20150105.231552,2807.12,6,1028154,-2,0,0,0,0,0
20150105.231553,2806.5,20,1028174,0,0,0,0,0,0
20150105.231554,2807.12,12,1028186,-10,0,0,0,0,0
20150105.231555,2807.12,1344,1029530,-336,0,0,0,0,0
20150105.231556,2807.12,32,1029562,16,0,0,0,0,0
20150105.231557,2807.12,214,1029776,2,0,0,0,0,0
20150105.231558,2807.74,2,1029778,0,0,0,0,0,0
20150105.231559,2807.12,28,1029806,16,0,0,0,0,0
20150105.2316,2807.12,234,1030040,6,0,0,0,0,0
20150105.231601,2807.12,454,1030494,-138,0,0,0,0,0
20150105.231602,2807.12,32,1030526,-30,0,0,0,0,0
20150105.231603,2807.74,2,1030528,-2,0,0,0,0,0
20150105.231604,2807.12,2,1030530,0,0,0,0,0,0
20150105.231605,2807.12,6,1030536,-6,0,0,0,0,0
20150105.231606,2807.12,100,1030636,42,0,0,0,0,0
20150105.231607,2807.74,100,1030736,52,0,0,0,0,0
20150105.231608,2807.12,6,1030742,6,0,0,0,0,0
20150105.231609,2807.12,12,1030754,2,0,0,0,0,0
20150105.23161,2807.12,4,1030758,-4,0,0,0,0,0
20150105.231611,2807.12,8,1030766,-6,0,0,0,0,0
20150105.231612,2807.12,100,1030866,-100,0,0,0,0,0
20150105.231613,2807.12,80,1030946,0,0,0,0,0,0
20150105.231614,2807.12,6,1030952,-6,0,0,0,0,0
20150105.231615,2807.12,28,1030980,0,0,0,0,0,0
20150105.231616,2807.12,2,1030982,0,0,0,0,0,0
20150105.231617,2807.12,10,1030992,0,0,0,0,0,0
20150105.231618,2807.12,6,1030998,-2,0,0,0,0,0
20150105.231619,2807.74,2,1031000,0,0,0,0,0,0
20150105.23162,2807.12,2,1031002,0,0,0,0,0,0
20150105.231621,2807.74,2,1031004,0,0,0,0,0,0
20150105.231622,2807.74,4,1031008,0,0,0,0,0,0
20150105.231623,2807.12,4,1031012,-4,0,0,0,0,0
20150105.231624,2807.12,4,1031016,0,0,0,0,0,0
20150105.231625,2807.74,10,1031026,-10,0,0,0,0,0
20150105.231626,2807.74,120,1031146,-70,0,0,0,0,0
20150105.231627,2807.74,4,1031150,0,0,0,0,0,0
20150105.231628,2807.74,230,1031380,102,0,0,0,0,0
20150105.231629,2807.74,2,1031382,0,0,0,0,0,0
20150105.23163,2807.74,2,1031384,0,0,0,0,0,0
20150105.231631,2807.74,106,1031490,0,0,0,0,0,0
20150105.231632,2807.74,2,1031492,0,0,0,0,0,0
20150105.231633,2807.74,4,1031496,-2,0,0,0,0,0
20150105.231634,2807.74,76,1031572,0,0,0,0,0,0
20150105.231635,2807.74,6,1031578,-2,0,0,0,0,0
20150105.231636,2807.74,2,1031580,-2,0,0,0,0,0
20150105.231637,2807.12,2,1031582,-2,0,0,0,0,0
20150105.231638,2807.74,2,1031584,-2,0,0,0,0,0
20150105.231639,2807.12,2,1031586,-2,0,0,0,0,0
20150105.23164,2807.74,40,1031626,22,0,0,0,0,0
20150105.231641,2807.12,6,1031632,-6,0,0,0,0,0
20150105.231642,2807.12,2,1031634,-2,0,0,0,0,0
20150105.231643,2807.74,4,1031638,4,0,0,0,0,0
20150105.231644,2807.74,4,1031642,4,0,0,0,0,0
20150105.231645,2807.74,22,1031664,2,0,0,0,0,0
20150105.231646,2807.74,202,1031866,2,0,0,0,0,0
20150105.231647,2807.74,2,1031868,2,0,0,0,0,0
20150105.231648,2807.74,100,1031968,100,0,0,0,0,0
20150105.231649,2807.12,2,1031970,0,0,0,0,0,0
20150105.23165,2807.74,2,1031972,0,0,0,0,0,0
20150105.231651,2807.12,20,1031992,0,0,0,0,0,0
20150105.231652,2807.74,2,1031994,2,0,0,0,0,0
20150105.231653,2807.74,4,1031998,2,0,0,0,0,0
20150105.231654,2807.12,8,1032006,-8,0,0,0,0,0
20150105.231655,2807.74,2,1032008,0,0,0,0,0,0
20150105.231656,2807.12,6,1032014,-4,0,0,0,0,0
20150105.231657,2807.12,2,1032016,0,0,0,0,0,0
20150105.231658,2807.74,8,1032024,6,0,0,0,0,0
20150105.231659,2807.74,4,1032028,0,0,0,0,0,0
20150105.2317,2807.74,50,1032078,42,0,0,0,0,0
20150105.231701,2807.74,2,1032080,2,0,0,0,0,0
20150105.231702,2807.12,2,1032082,-2,0,0,0,0,0
20150105.231703,2807.74,102,1032184,94,0,0,0,0,0
20150105.231704,2807.74,16,1032200,16,0,0,0,0,0
20150105.231705,2807.74,4,1032204,2,0,0,0,0,0
20150105.231706,2807.74,2,1032206,2,0,0,0,0,0
20150105.231707,2807.12,4,1032210,-4,0,0,0,0,0
20150105.231708,2807.74,2,1032212,2,0,0,0,0,0
20150105.231709,2807.74,164,1032376,90,0,0,0,0,0
20150105.23171,2808.36,2,1032378,0,0,0,0,0,0
20150105.231711,2807.74,2,1032380,0,0,0,0,0,0
20150105.231712,2807.74,48,1032428,-20,0,0,0,0,0
20150105.231713,2807.74,4,1032432,-4,0,0,0,0,0
20150105.231714,2807.74,16,1032448,-10,0,0,0,0,0
20150105.231715,2807.74,266,1032714,-88,0,0,0,0,0
20150105.231716,2807.74,10,1032724,-4,0,0,0,0,0
20150105.231717,2807.74,4,1032728,-2,0,0,0,0,0
20150105.231718,2808.36,8,1032736,-8,0,0,0,0,0
20150105.231719,2808.36,6,1032742,-4,0,0,0,0,0
20150105.23172,2807.74,66,1032808,2,0,0,0,0,0
20150105.231721,2807.74,8,1032816,0,0,0,0,0,0
20150105.231722,2808.36,2,1032818,0,0,0,0,0,0
20150105.231723,2808.36,6,1032824,-4,0,0,0,0,0
20150105.231724,2807.74,2,1032826,2,0,0,0,0,0
20150105.231725,2808.36,2,1032828,0,0,0,0,0,0
20150105.231726,2807.74,86,1032914,46,0,0,0,0,0
20150105.231727,2808.36,2,1032916,2,0,0,0,0,0
20150105.231728,2808.36,4,1032920,0,0,0,0,0,0
20150105.231729,2807.74,202,1033122,-118,0,0,0,0,0
20150105.23173,2807.74,104,1033226,-58,0,0,0,0,0
20150105.231731,2807.74,8,1033234,-2,0,0,0,0,0
20150105.231732,2808.36,268,1033502,-10,0,0,0,0,0
20150105.231733,2807.74,2,1033504,-2,0,0,0,0,0
20150105.231734,2807.74,160,1033664,38,0,0,0,0,0
20150105.231735,2808.36,14,1033678,14,0,0,0,0,0
20150105.231736,2808.36,2,1033680,0,0,0,0,0,0
20150105.231737,2807.74,2,1033682,-2,0,0,0,0,0
20150105.231738,2807.74,2,1033684,-2,0,0,0,0,0
20150105.231739,2807.74,2,1033686,-2,0,0,0,0,0
20150105.23174,2808.36,2,1033688,2,0,0,0,0,0
20150105.231741,2807.74,254,1033942,-26,0,0,0,0,0
20150105.231742,2807.74,196,1034138,-186,0,0,0,0,0
20150105.231743,2807.74,24,1034162,-6,0,0,0,0,0
20150105.231744,2807.74,6,1034168,6,0,0,0,0,0
20150105.231745,2807.74,8,1034176,2,0,0,0,0,0
20150105.231746,2807.74,2,1034178,2,0,0,0,0,0
20150105.231747,2807.74,4,1034182,0,0,0,0,0,0
20150105.231748,2807.74,4,1034186,0,0,0,0,0,0
20150105.231749,2807.74,4,1034190,4,0,0,0,0,0
20150105.23175,2807.74,2,1034192,2,0,0,0,0,0
20150105.231751,2807.74,4,1034196,0,0,0,0,0,0
20150105.231752,2807.74,2,1034198,2,0,0,0,0,0
20150105.231753,2807.74,2,1034200,2,0,0,0,0,0
20150105.231754,2807.74,2,1034202,2,0,0,0,0,0
20150105.231755,2807.12,10,1034212,0,0,0,0,0,0
20150105.231756,2807.74,4,1034216,4,0,0,0,0,0
20150105.231757,2807.12,180,1034396,0,0,0,0,0,0
20150105.231758,2807.74,18,1034414,6,0,0,0,0,0
20150105.231759,2807.74,38,1034452,4,0,0,0,0,0
20150105.2318,2807.74,2,1034454,2,0,0,0,0,0
20150105.231801,2807.74,6,1034460,-4,0,0,0,0,0
20150105.231802,2807.74,2,1034462,0,0,0,0,0,0
20150105.231803,2807.74,2,1034464,0,0,0,0,0,0
20150105.231804,2807.12,6,1034470,0,0,0,0,0,0
20150105.231805,2807.74,2,1034472,-2,0,0,0,0,0
20150105.231806,2807.12,4,1034476,0,0,0,0,0,0
20150105.231807,2807.74,2,1034478,0,0,0,0,0,0
20150105.231808,2807.74,2,1034480,0,0,0,0,0,0
20150105.231809,2807.74,6,1034486,-6,0,0,0,0,0
20150105.23181,2807.74,4,1034490,-4,0,0,0,0,0
20150105.231811,2807.12,4,1034494,0,0,0,0,0,0
20150105.231812,2807.12,4,1034498,0,0,0,0,0,0
20150105.231813,2807.74,10,1034508,0,0,0,0,0,0
20150105.231814,2807.74,2,1034510,0,0,0,0,0,0
20150105.231815,2807.74,10,1034520,-10,0,0,0,0,0
20150105.231816,2807.74,2,1034522,-2,0,0,0,0,0
20150105.231817,2807.74,2,1034524,0,0,0,0,0,0
20150105.231818,2807.12,4,1034528,-4,0,0,0,0,0
20150105.231819,2807.74,6,1034534,4,0,0,0,0,0
20150105.23182,2807.74,16,1034550,14,0,0,0,0,0
20150105.231821,2807.74,48,1034598,0,0,0,0,0,0
20150105.231822,2807.12,20,1034618,0,0,0,0,0,0
20150105.231823,2807.12,40,1034658,-40,0,0,0,0,0
20150105.231824,2807.74,2,1034660,0,0,0,0,0,0
20150105.231825,2807.12,40,1034700,-32,0,0,0,0,0
20150105.231826,2807.74,120,1034820,118,0,0,0,0,0
20150105.231827,2807.74,2,1034822,0,0,0,0,0,0
20150105.231828,2807.74,2,1034824,2,0,0,0,0,0
20150105.231829,2807.74,258,1035082,-36,0,0,0,0,0
20150105.23183,2807.74,10,1035092,4,0,0,0,0,0
20150105.231831,2807.74,2,1035094,-2,0,0,0,0,0
20150105.231832,2807.74,302,1035396,130,0,0,0,0,0
20150105.231833,2807.74,218,1035614,-202,0,0,0,0,0
20150105.231834,2807.74,2,1035616,-2,0,0,0,0,0
20150105.231835,2807.74,10,1035626,6,0,0,0,0,0
20150105.231836,2807.74,60,1035686,40,0,0,0,0,0
20150105.231837,2807.74,2,1035688,0,0,0,0,0,0
20150105.231838,2807.74,162,1035850,-122,0,0,0,0,0
20150105.231839,2807.74,6,1035856,0,0,0,0,0,0
20150105.23184,2807.74,20,1035876,0,0,0,0,0,0
20150105.231841,2807.74,2,1035878,2,0,0,0,0,0
20150105.231842,2807.74,38,1035916,26,0,0,0,0,0
20150105.231843,2807.74,32,1035948,-26,0,0,0,0,0
20150105.231844,2807.74,4,1035952,-2,0,0,0,0,0
20150105.231845,2807.12,2,1035954,-2,0,0,0,0,0
20150105.231846,2807.74,4,1035958,-4,0,0,0,0,0
20150105.231847,2807.74,2,1035960,0,0,0,0,0,0
20150105.231848,2807.12,2,1035962,0,0,0,0,0,0
20150105.231849,2807.74,4,1035966,0,0,0,0,0,0
20150105.23185,2807.74,2,1035968,-2,0,0,0,0,0
20150105.231851,2807.74,40,1036008,-34,0,0,0,0,0
20150105.231852,2807.74,60,1036068,60,0,0,0,0,0
20150105.231853,2807.74,44,1036112,0,0,0,0,0,0
20150105.231854,2807.74,34,1036146,20,0,0,0,0,0
20150105.231855,2807.74,58,1036204,6,0,0,0,0,0
20150105.231856,2807.74,46,1036250,4,0,0,0,0,0
20150105.231857,2807.74,4,1036254,0,0,0,0,0,0
20150105.231858,2807.74,2,1036256,0,0,0,0,0,0
20150105.231859,2807.74,20,1036276,0,0,0,0,0,0
20150105.2319,2808.36,10,1036286,0,0,0,0,0,0
20150105.231901,2807.74,2,1036288,0,0,0,0,0,0
20150105.231902,2808.36,2,1036290,0,0,0,0,0,0
20150105.231903,2807.74,32,1036322,0,0,0,0,0,0
20150105.231904,2808.36,86,1036408,-80,0,0,0,0,0
20150105.231905,2807.74,2,1036410,2,0,0,0,0,0
20150105.231906,2808.36,10,1036420,-10,0,0,0,0,0
20150105.231907,2808.36,2,1036422,0,0,0,0,0,0
20150105.231908,2808.36,2,1036424,0,0,0,0,0,0
20150105.231909,2807.74,2,1036426,-2,0,0,0,0,0
20150105.23191,2808.36,8,1036434,-8,0,0,0,0,0
20150105.231911,2807.74,200,1036634,2,0,0,0,0,0
20150105.231912,2808.36,8,1036642,-6,0,0,0,0,0
20150105.231913,2808.36,14,1036656,-14,0,0,0,0,0
20150105.231914,2808.36,18,1036674,-12,0,0,0,0,0
20150105.231915,2808.36,6,1036680,6,0,0,0,0,0
20150105.231916,2807.74,32,1036712,-30,0,0,0,0,0
20150105.231917,2808.36,2,1036714,0,0,0,0,0,0
20150105.231918,2808.36,2,1036716,0,0,0,0,0,0
20150105.231919,2807.74,12,1036728,0,0,0,0,0,0
20150105.23192,2808.36,8,1036736,-2,0,0,0,0,0
20150105.231921,2808.36,2,1036738,0,0,0,0,0,0
20150105.231922,2807.74,4,1036742,0,0,0,0,0,0
20150105.231923,2808.36,4,1036746,0,0,0,0,0,0
20150105.231924,2807.74,80,1036826,-6,0,0,0,0,0
20150105.231925,2808.36,600,1037426,-200,0,0,0,0,0
20150105.231926,2808.36,4,1037430,-2,0,0,0,0,0
20150105.231927,2808.36,28,1037458,-10,0,0,0,0,0
20150105.231928,2808.36,20,1037478,12,0,0,0,0,0
20150105.231929,2808.36,40,1037518,-38,0,0,0,0,0
20150105.23193,2808.36,16,1037534,-16,0,0,0,0,0
20150105.231931,2808.36,58,1037592,48,0,0,0,0,0
20150105.231932,2808.36,4,1037596,0,0,0,0,0,0
20150105.231933,2808.36,4,1037600,2,0,0,0,0,0
20150105.231934,2808.98,2,1037602,0,0,0,0,0,0
20150105.231935,2808.98,16,1037618,0,0,0,0,0,0
20150105.231936,2808.36,182,1037800,14,0,0,0,0,0
20150105.231937,2808.36,20,1037820,-2,0,0,0,0,0
20150105.231938,2808.36,2,1037822,-2,0,0,0,0,0
20150105.231939,2808.36,2,1037824,-2,0,0,0,0,0
20150105.23194,2808.98,2,1037826,2,0,0,0,0,0
20150105.231941,2808.36,74,1037900,-68,0,0,0,0,0
20150105.231942,2808.36,10,1037910,-10,0,0,0,0,0
20150105.231943,2808.98,2,1037912,2,0,0,0,0,0
20150105.231944,2808.36,6,1037918,-6,0,0,0,0,0
20150105.231945,2808.98,26,1037944,0,0,0,0,0,0
20150105.231946,2808.98,2,1037946,0,0,0,0,0,0
20150105.231947,2808.98,18,1037964,8,0,0,0,0,0
20150105.231948,2808.36,2,1037966,-2,0,0,0,0,0
20150105.231949,2808.98,20,1037986,-10,0,0,0,0,0
20150105.23195,2808.36,2,1037988,-2,0,0,0,0,0
20150105.231951,2808.98,2,1037990,2,0,0,0,0,0
20150105.231952,2808.98,14,1038004,-2,0,0,0,0,0
20150105.231953,2808.98,8,1038012,0,0,0,0,0,0
20150105.231954,2808.98,2,1038014,2,0,0,0,0,0
20150105.231955,2808.98,4,1038018,0,0,0,0,0,0
20150105.231956,2808.98,16,1038034,0,0,0,0,0,0
20150105.231957,2808.98,18,1038052,2,0,0,0,0,0
20150105.231958,2808.98,2,1038054,2,0,0,0,0,0
20150105.231959,2808.98,4,1038058,0,0,0,0,0,0
20150105.232,2808.98,12,1038070,0,0,0,0,0,0
20150105.232001,2808.98,4,1038074,0,0,0,0,0,0
20150105.232002,2808.98,2,1038076,0,0,0,0,0,0
20150105.232003,2808.36,2,1038078,-2,0,0,0,0,0
20150105.232004,2808.98,6,1038084,6,0,0,0,0,0
20150105.232005,2808.98,4,1038088,0,0,0,0,0,0
20150105.232006,2808.98,20,1038108,10,0,0,0,0,0
20150105.232007,2808.36,76,1038184,24,0,0,0,0,0
20150105.232008,2808.98,10,1038194,10,0,0,0,0,0
20150105.232009,2808.98,10,1038204,0,0,0,0,0,0
20150105.23201,2808.36,2,1038206,0,0,0,0,0,0
20150105.232011,2808.98,400,1038606,-68,0,0,0,0,0
20150105.232012,2808.98,44,1038650,40,0,0,0,0,0
20150105.232013,2808.98,136,1038786,0,0,0,0,0,0
20150105.232014,2808.98,10,1038796,2,0,0,0,0,0
20150105.232015,2808.98,400,1039196,0,0,0,0,0,0
20150105.232016,2808.98,2,1039198,2,0,0,0,0,0
20150105.232017,2808.98,20,1039218,-12,0,0,0,0,0
20150105.232018,2808.98,24,1039242,12,0,0,0,0,0
20150105.232019,2808.98,70,1039312,-14,0,0,0,0,0
20150105.23202,2808.98,10,1039322,4,0,0,0,0,0
20150105.232021,2808.36,60,1039382,-42,0,0,0,0,0
20150105.232022,2808.36,12,1039394,0,0,0,0,0,0
20150105.232023,2808.98,2,1039396,0,0,0,0,0,0
20150105.232024,2808.36,2,1039398,0,0,0,0,0,0
20150105.232025,2808.98,2,1039400,2,0,0,0,0,0
20150105.232026,2808.98,4,1039404,4,0,0,0,0,0
20150105.232027,2808.98,420,1039824,-230,0,0,0,0,0
20150105.232028,2808.36,2,1039826,0,0,0,0,0,0
20150105.232029,2808.98,6,1039832,0,0,0,0,0,0
20150105.23203,2808.98,6,1039838,-4,0,0,0,0,0
20150105.232031,2808.98,6,1039844,0,0,0,0,0,0
20150105.232032,2808.98,12,1039856,4,0,0,0,0,0
20150105.232033,2808.98,2,1039858,0,0,0,0,0,0
20150105.232034,2808.36,2,1039860,2,0,0,0,0,0
20150105.232035,2808.98,2,1039862,0,0,0,0,0,0
20150105.232036,2808.98,2,1039864,0,0,0,0,0,0
20150105.232037,2808.36,400,1040264,-164,0,0,0,0,0
20150105.232038,2808.36,2,1040266,-2,0,0,0,0,0
20150105.232039,2808.98,12,1040278,-4,0,0,0,0,0
20150105.23204,2808.98,404,1040682,-264,0,0,0,0,0
20150105.232041,2808.98,8,1040690,4,0,0,0,0,0
20150105.232042,2808.98,2,1040692,-2,0,0,0,0,0
20150105.232043,2808.98,6,1040698,0,0,0,0,0,0
20150105.232044,2808.98,32,1040730,20,0,0,0,0,0
20150105.232045,2808.98,406,1041136,-66,0,0,0,0,0
20150105.232046,2808.98,8,1041144,-4,0,0,0,0,0
20150105.232047,2808.98,6,1041150,-4,0,0,0,0,0
20150105.232048,2808.98,6,1041156,0,0,0,0,0,0
20150105.232049,2808.98,6,1041162,-6,0,0,0,0,0
20150105.23205,2808.98,2,1041164,2,0,0,0,0,0
20150105.232051,2808.98,4,1041168,0,0,0,0,0,0
20150105.232052,2808.98,30,1041198,14,0,0,0,0,0
20150105.232053,2808.98,2,1041200,-2,0,0,0,0,0
20150105.232054,2808.98,6,1041206,0,0,0,0,0,0
20150105.232055,2808.98,4,1041210,0,0,0,0,0,0
20150105.232056,2808.98,94,1041304,-84,0,0,0,0,0
20150105.232057,2808.98,104,1041408,-104,0,0,0,0,0
20150105.232058,2808.98,300,1041708,-174,0,0,0,0,0
20150105.232059,2808.98,2,1041710,0,0,0,0,0,0
20150105.2321,2808.98,4,1041714,-2,0,0,0,0,0
20150105.232101,2808.98,2,1041716,0,0,0,0,0,0
20150105.232102,2808.98,4,1041720,0,0,0,0,0,0
20150105.232103,2808.98,2,1041722,-2,0,0,0,0,0
20150105.232104,2808.98,22,1041744,8,0,0,0,0,0
20150105.232105,2808.98,20,1041764,0,0,0,0,0,0
20150105.232106,2808.98,20,1041784,0,0,0,0,0,0
20150105.232107,2808.98,2,1041786,0,0,0,0,0,0
20150105.232108,2808.98,10,1041796,10,0,0,0,0,0
20150105.232109,2808.36,4,1041800,2,0,0,0,0,0
20150105.23211,2808.36,4,1041804,-4,0,0,0,0,0
20150105.232111,2808.98,404,1042208,-64,0,0,0,0,0
20150105.232112,2808.98,12,1042220,-10,0,0,0,0,0
20150105.232113,2808.98,100,1042320,-10,0,0,0,0,0
20150105.232114,2808.98,2,1042322,0,0,0,0,0,0
20150105.232115,2808.98,20,1042342,10,0,0,0,0,0
20150105.232116,2808.36,84,1042426,-46,0,0,0,0,0
20150105.232117,2808.36,4,1042430,4,0,0,0,0,0
20150105.232118,2808.98,2,1042432,2,0,0,0,0,0
20150105.232119,2808.98,2,1042434,0,0,0,0,0,0
20150105.23212,2808.98,404,1042838,-58,0,0,0,0,0
20150105.232121,2808.98,2,1042840,0,0,0,0,0,0
20150105.232122,2808.36,2,1042842,2,0,0,0,0,0
20150105.232123,2808.36,2,1042844,2,0,0,0,0,0
20150105.232124,2808.98,316,1043160,-10,0,0,0,0,0
20150105.232125,2808.36,4,1043164,0,0,0,0,0,0
20150105.232126,2808.36,94,1043258,-46,0,0,0,0,0
20150105.232127,2808.98,22,1043280,14,0,0,0,0,0
20150105.232128,2808.98,2,1043282,2,0,0,0,0,0
20150105.232129,2808.36,22,1043304,-2,0,0,0,0,0
20150105.23213,2808.98,2,1043306,2,0,0,0,0,0
20150105.232131,2808.98,6,1043312,6,0,0,0,0,0
20150105.232132,2808.36,2,1043314,0,0,0,0,0,0
20150105.232133,2808.98,2,1043316,0,0,0,0,0,0
20150105.232134,2808.36,64,1043380,0,0,0,0,0,0
20150105.232135,2808.98,2,1043382,0,0,0,0,0,0
20150105.232136,2808.36,2,1043384,-2,0,0,0,0,0
20150105.232137,2808.36,2,1043386,-2,0,0,0,0,0
20150105.232138,2808.36,20,1043406,6,0,0,0,0,0
20150105.232139,2808.98,6,1043412,2,0,0,0,0,0
20150105.23214,2808.36,22,1043434,6,0,0,0,0,0
20150105.232141,2808.36,216,1043650,-144,0,0,0,0,0
20150105.232142,2808.98,12,1043662,-12,0,0,0,0,0
20150105.232143,2808.98,2,1043664,-2,0,0,0,0,0
20150105.232144,2808.36,18,1043682,0,0,0,0,0,0
20150105.232145,2808.98,300,1043982,-128,0,0,0,0,0
20150105.232146,2808.98,2,1043984,0,0,0,0,0,0
20150105.232147,2808.98,2,1043986,0,0,0,0,0,0
20150105.232148,2808.98,20,1044006,2,0,0,0,0,0
20150105.232149,2808.98,372,1044378,-346,0,0,0,0,0
20150105.23215,2808.36,100,1044478,-100,0,0,0,0,0
20150105.232151,2808.98,44,1044522,4,0,0,0,0,0
20150105.232152,2808.98,8,1044530,-2,0,0,0,0,0
20150105.232153,2808.98,40,1044570,0,0,0,0,0,0
20150105.232154,2809.6,20,1044590,6,0,0,0,0,0
20150105.232155,2809.6,150,1044740,-16,0,0,0,0,0
20150105.232156,2808.98,58,1044798,-26,0,0,0,0,0
20150105.232157,2808.98,4,1044802,-4,0,0,0,0,0
20150105.232158,2808.98,16,1044818,-10,0,0,0,0,0
20150105.232159,2808.98,12,1044830,-8,0,0,0,0,0
20150105.2322,2808.98,12,1044842,-8,0,0,0,0,0
20150105.232201,2809.6,2,1044844,-2,0,0,0,0,0
20150105.232202,2809.6,2,1044846,0,0,0,0,0,0
20150105.232203,2808.98,130,1044976,-44,0,0,0,0,0
20150105.232204,2808.98,2,1044978,0,0,0,0,0,0
20150105.232205,2808.98,2,1044980,0,0,0,0,0,0
20150105.232206,2808.98,2,1044982,-2,0,0,0,0,0
20150105.232207,2808.98,10,1044992,-6,0,0,0,0,0
20150105.232208,2809.6,4,1044996,-4,0,0,0,0,0
20150105.232209,2809.6,2,1044998,-2,0,0,0,0,0
20150105.23221,2809.6,406,1045404,-192,0,0,0,0,0
20150105.232211,2809.6,4,1045408,0,0,0,0,0,0
20150105.232212,2809.6,4,1045412,-2,0,0,0,0,0
20150105.232213,2809.6,2,1045414,0,0,0,0,0,0
20150105.232214,2809.6,4,1045418,0,0,0,0,0,0
20150105.232215,2808.98,40,1045458,-40,0,0,0,0,0
20150105.232216,2809.6,2,1045460,-2,0,0,0,0,0
20150105.232217,2808.98,4,1045464,-2,0,0,0,0,0
20150105.232218,2809.6,10,1045474,0,0,0,0,0,0
20150105.232219,2809.6,2,1045476,-2,0,0,0,0,0
20150105.23222,2809.6,2,1045478,0,0,0,0,0,0
20150105.232221,2809.6,6,1045484,0,0,0,0,0,0
20150105.232222,2809.6,4,1045488,0,0,0,0,0,0
20150105.232223,2809.6,2,1045490,0,0,0,0,0,0
20150105.232224,2808.98,2,1045492,-2,0,0,0,0,0
20150105.232225,2808.98,2,1045494,0,0,0,0,0,0
20150105.232226,2809.6,400,1045894,-52,0,0,0,0,0
20150105.232227,2809.6,4,1045898,4,0,0,0,0,0
20150105.232228,2809.6,2,1045900,2,0,0,0,0,0
20150105.232229,2809.6,76,1045976,4,0,0,0,0,0
20150105.23223,2808.98,2,1045978,-2,0,0,0,0,0
20150105.232231,2809.6,296,1046274,-66,0,0,0,0,0
20150105.232232,2809.6,18,1046292,0,0,0,0,0,0
20150105.232233,2809.6,2,1046294,0,0,0,0,0,0
20150105.232234,2809.6,2,1046296,2,0,0,0,0,0
20150105.232235,2808.98,12,1046308,0,0,0,0,0,0
20150105.232236,2809.6,100,1046408,100,0,0,0,0,0
20150105.232237,2809.6,400,1046808,-188,0,0,0,0,0
20150105.232238,2810.22,264,1047072,-54,0,0,0,0,0
20150105.232239,2810.22,22,1047094,-22,0,0,0,0,0
20150105.23224,2810.22,8,1047102,0,0,0,0,0,0
20150105.232241,2809.6,4,1047106,0,0,0,0,0,0
20150105.232242,2809.6,76,1047182,44,0,0,0,0,0
20150105.232243,2809.6,6,1047188,2,0,0,0,0,0
20150105.232244,2809.6,4,1047192,2,0,0,0,0,0
20150105.232245,2809.6,8,1047200,0,0,0,0,0,0
20150105.232246,2809.6,2,1047202,0,0,0,0,0,0
20150105.232247,2809.6,6,1047208,0,0,0,0,0,0
20150105.232248,2809.6,4,1047212,0,0,0,0,0,0
20150105.232249,2809.6,60,1047272,-2,0,0,0,0,0
20150105.23225,2809.6,212,1047484,4,0,0,0,0,0
20150105.232251,2809.6,60,1047544,-30,0,0,0,0,0
20150105.232252,2808.98,2,1047546,0,0,0,0,0,0
20150105.232253,2809.6,2,1047548,-2,0,0,0,0,0
20150105.232254,2809.6,24,1047572,-24,0,0,0,0,0
20150105.232255,2809.6,124,1047696,-26,0,0,0,0,0
20150105.232256,2809.6,2,1047698,0,0,0,0,0,0
20150105.232257,2809.6,400,1048098,0,0,0,0,0,0
20150105.232258,2809.6,2,1048100,2,0,0,0,0,0
20150105.232259,2808.98,16,1048116,16,0,0,0,0,0
20150105.2323,2809.6,2,1048118,2,0,0,0,0,0
20150105.232301,2808.98,60,1048178,0,0,0,0,0,0
20150105.232302,2809.6,8,1048186,-6,0,0,0,0,0
20150105.232303,2808.98,22,1048208,12,0,0,0,0,0
20150105.232304,2809.6,2,1048210,0,0,0,0,0,0
20150105.232305,2809.6,8,1048218,-4,0,0,0,0,0
20150105.232306,2809.6,2,1048220,2,0,0,0,0,0
20150105.232307,2809.6,6,1048226,0,0,0,0,0,0
20150105.232308,2808.98,148,1048374,148,0,0,0,0,0
20150105.232309,2809.6,2,1048376,0,0,0,0,0,0
20150105.23231,2808.98,2,1048378,2,0,0,0,0,0
20150105.232311,2808.98,14,1048392,0,0,0,0,0,0
20150105.232312,2809.6,10,1048402,6,0,0,0,0,0
20150105.232313,2809.6,2,1048404,2,0,0,0,0,0
20150105.232314,2809.6,12,1048416,10,0,0,0,0,0
20150105.232315,2809.6,4,1048420,0,0,0,0,0,0
20150105.232316,2808.98,458,1048878,270,0,0,0,0,0
20150105.232317,2808.98,6,1048884,0,0,0,0,0,0
20150105.232318,2809.6,2,1048886,2,0,0,0,0,0
20150105.232319,2809.6,2,1048888,0,0,0,0,0,0
20150105.23232,2808.98,40,1048928,28,0,0,0,0,0
20150105.232321,2809.6,2,1048930,0,0,0,0,0,0
20150105.232322,2809.6,2,1048932,2,0,0,0,0,0
20150105.232323,2808.98,14,1048946,-12,0,0,0,0,0
20150105.232324,2808.98,40,1048986,0,0,0,0,0,0
20150105.232325,2808.98,4,1048990,-4,0,0,0,0,0
20150105.232326,2808.98,40,1049030,0,0,0,0,0,0
20150105.232327,2808.98,2,1049032,0,0,0,0,0,0
20150105.232328,2808.98,2,1049034,0,0,0,0,0,0
20150105.232329,2809.6,2,1049036,2,0,0,0,0,0
20150105.23233,2809.6,6,1049042,6,0,0,0,0,0
20150105.232331,2808.98,88,1049130,-88,0,0,0,0,0
20150105.232332,2809.6,2,1049132,2,0,0,0,0,0
20150105.232333,2808.98,56,1049188,0,0,0,0,0,0
20150105.232334,2809.6,24,1049212,0,0,0,0,0,0
20150105.232335,2808.98,2,1049214,-2,0,0,0,0,0
20150105.232336,2808.98,2,1049216,0,0,0,0,0,0
20150105.232337,2808.98,88,1049304,-60,0,0,0,0,0
20150105.232338,2808.98,4,1049308,-4,0,0,0,0,0
20150105.232339,2808.98,4,1049312,0,0,0,0,0,0
20150105.23234,2808.98,40,1049352,0,0,0,0,0,0
20150105.232341,2809.6,2,1049354,0,0,0,0,0,0
20150105.232342,2808.98,12,1049366,0,0,0,0,0,0
20150105.232343,2808.98,450,1049816,128,0,0,0,0,0
20150105.232344,2808.98,14,1049830,-14,0,0,0,0,0
20150105.232345,2808.98,16,1049846,-16,0,0,0,0,0
20150105.232346,2808.98,2,1049848,-2,0,0,0,0,0
20150105.232347,2808.98,2,1049850,-2,0,0,0,0,0
20150105.232348,2808.98,2,1049852,0,0,0,0,0,0
20150105.232349,2808.98,6,1049858,-6,0,0,0,0,0
20150105.23235,2809.6,4,1049862,-2,0,0,0,0,0
20150105.232351,2809.6,64,1049926,64,0,0,0,0,0
20150105.232352,2808.98,2,1049928,-2,0,0,0,0,0
20150105.232353,2808.98,18,1049946,-18,0,0,0,0,0
20150105.232354,2809.6,2,1049948,0,0,0,0,0,0
20150105.232355,2808.98,2,1049950,-2,0,0,0,0,0
20150105.232356,2808.98,40,1049990,6,0,0,0,0,0
20150105.232357,2808.98,6,1049996,2,0,0,0,0,0
20150105.232358,2809.6,110,1050106,8,0,0,0,0,0
20150105.232359,2809.6,10,1050116,0,0,0,0,0,0
20150105.2324,2808.98,20,1050136,4,0,0,0,0,0
20150105.232401,2808.98,4,1050140,-4,0,0,0,0,0
20150105.232402,2808.98,82,1050222,-30,0,0,0,0,0
20150105.232403,2808.98,4,1050226,-4,0,0,0,0,0
20150105.232404,2809.6,160,1050386,-66,0,0,0,0,0
20150105.232405,2809.6,270,1050656,-22,0,0,0,0,0
20150105.232406,2809.6,2,1050658,0,0,0,0,0,0
20150105.232407,2808.98,76,1050734,-62,0,0,0,0,0
20150105.232408,2808.98,6,1050740,0,0,0,0,0,0
20150105.232409,2808.98,4,1050744,0,0,0,0,0,0
20150105.23241,2809.6,64,1050808,54,0,0,0,0,0
20150105.232411,2808.98,102,1050910,-66,0,0,0,0,0
20150105.232412,2808.98,50,1050960,-2,0,0,0,0,0
20150105.232413,2808.98,2,1050962,-2,0,0,0,0,0
20150105.232414,2808.98,22,1050984,-12,0,0,0,0,0
20150105.232415,2808.98,16,1051000,10,0,0,0,0,0
20150105.232416,2808.98,4,1051004,0,0,0,0,0,0
20150105.232417,2808.98,12,1051016,-8,0,0,0,0,0
20150105.232418,2808.98,2,1051018,-2,0,0,0,0,0
20150105.232419,2808.98,4,1051022,-4,0,0,0,0,0
20150105.23242,2808.98,2,1051024,0,0,0,0,0,0
20150105.232421,2808.98,2,1051026,-2,0,0,0,0,0
20150105.232422,2808.98,274,1051300,10,0,0,0,0,0
20150105.232423,2808.98,12,1051312,0,0,0,0,0,0
20150105.232424,2808.98,40,1051352,2,0,0,0,0,0
20150105.232425,2808.98,80,1051432,-2,0,0,0,0,0
20150105.232426,2808.98,20,1051452,0,0,0,0,0,0
20150105.232427,2808.98,2,1051454,-2,0,0,0,0,0
20150105.232428,2808.98,12,1051466,0,0,0,0,0,0
20150105.232429,2808.98,2,1051468,-2,0,0,0,0,0
20150105.23243,2808.98,4,1051472,0,0,0,0,0,0
20150105.232431,2808.98,8,1051480,0,0,0,0,0,0
20150105.232432,2808.98,2,1051482,-2,0,0,0,0,0
20150105.232433,2808.98,4,1051486,0,0,0,0,0,0
20150105.232434,2808.98,4,1051490,-4,0,0,0,0,0
20150105.232435,2808.98,6,1051496,-2,0,0,0,0,0
20150105.232436,2808.98,2,1051498,0,0,0,0,0,0
20150105.232437,2808.36,6,1051504,0,0,0,0,0,0
20150105.232438,2808.36,2,1051506,0,0,0,0,0,0
20150105.232439,2808.98,10,1051516,-2,0,0,0,0,0
20150105.23244,2808.98,6,1051522,-6,0,0,0,0,0
20150105.232441,2808.98,12,1051534,-10,0,0,0,0,0
20150105.232442,2808.98,130,1051664,36,0,0,0,0,0
20150105.232443,2808.98,216,1051880,214,0,0,0,0,0
20150105.232444,2808.98,28,1051908,-4,0,0,0,0,0
20150105.232445,2808.98,16,1051924,4,0,0,0,0,0
20150105.232446,2809.6,434,1052358,-388,0,0,0,0,0
20150105.232447,2809.6,106,1052464,16,0,0,0,0,0
20150105.232448,2809.6,22,1052486,18,0,0,0,0,0
20150105.232449,2810.22,212,1052698,-212,0,0,0,0,0
20150105.23245,2809.6,94,1052792,-50,0,0,0,0,0
20150105.232451,2809.6,108,1052900,6,0,0,0,0,0
20150105.232452,2809.6,112,1053012,42,0,0,0,0,0
20150105.232453,2809.6,6,1053018,4,0,0,0,0,0
20150105.232454,2810.22,208,1053226,80,0,0,0,0,0
20150105.232455,2809.6,22,1053248,4,0,0,0,0,0
20150105.232456,2810.22,8,1053256,6,0,0,0,0,0
20150105.232457,2810.22,14,1053270,12,0,0,0,0,0
20150105.232458,2810.22,56,1053326,16,0,0,0,0,0
20150105.232459,2809.6,20,1053346,-20,0,0,0,0,0
20150105.2325,2810.22,28,1053374,-20,0,0,0,0,0
20150105.232501,2810.22,2,1053376,2,0,0,0,0,0
20150105.232502,2809.6,2,1053378,-2,0,0,0,0,0
20150105.232503,2809.6,4,1053382,0,0,0,0,0,0
20150105.232504,2810.22,26,1053408,26,0,0,0,0,0
20150105.232505,2810.22,200,1053608,200,0,0,0,0,0
20150105.232506,2810.22,22,1053630,-20,0,0,0,0,0
20150105.232507,2809.6,22,1053652,10,0,0,0,0,0
20150105.232508,2809.6,4,1053656,0,0,0,0,0,0
20150105.232509,2810.22,2,1053658,2,0,0,0,0,0
20150105.23251,2810.22,48,1053706,-2,0,0,0,0,0
20150105.232511,2809.6,90,1053796,-32,0,0,0,0,0
20150105.232512,2810.22,2,1053798,2,0,0,0,0,0
20150105.232513,2809.6,120,1053918,24,0,0,0,0,0
20150105.232514,2809.6,32,1053950,0,0,0,0,0,0
20150105.232515,2810.22,254,1054204,174,0,0,0,0,0
20150105.232516,2809.6,12,1054216,-6,0,0,0,0,0
20150105.232517,2809.6,18,1054234,-2,0,0,0,0,0
20150105.232518,2809.6,26,1054260,-6,0,0,0,0,0
20150105.232519,2809.6,10,1054270,0,0,0,0,0,0
20150105.23252,2809.6,2,1054272,-2,0,0,0,0,0
20150105.232521,2809.6,10,1054282,0,0,0,0,0,0
20150105.232522,2809.6,6,1054288,0,0,0,0,0,0
20150105.232523,2809.6,4,1054292,0,0,0,0,0,0
20150105.232524,2809.6,2,1054294,0,0,0,0,0,0
20150105.232525,2809.6,10,1054304,-10,0,0,0,0,0
20150105.232526,2809.6,46,1054350,20,0,0,0,0,0
20150105.232527,2810.22,6,1054356,0,0,0,0,0,0
20150105.232528,2809.6,2,1054358,0,0,0,0,0,0
20150105.232529,2809.6,12,1054370,-12,0,0,0,0,0
20150105.23253,2810.22,50,1054420,36,0,0,0,0,0
20150105.232531,2810.22,532,1054952,180,0,0,0,0,0
20150105.232532,2810.22,62,1055014,0,0,0,0,0,0
20150105.232533,2810.85,118,1055132,2,0,0,0,0,0
20150105.232534,2810.85,20,1055152,4,0,0,0,0,0
20150105.232535,2810.84,216,1055368,-44,0,0,0,0,0
20150105.232536,2810.22,88,1055456,2,0,0,0,0,0
20150105.232537,2810.22,218,1055674,216,0,0,0,0,0
20150105.232538,2810.22,2,1055676,0,0,0,0,0,0
20150105.232539,2810.22,6,1055682,6,0,0,0,0,0
20150105.23254,2810.22,70,1055752,52,0,0,0,0,0
20150105.232541,2810.22,6,1055758,-2,0,0,0,0,0
20150105.232542,2810.22,4,1055762,0,0,0,0,0,0
20150105.232543,2809.6,86,1055848,60,0,0,0,0,0
20150105.232544,2810.22,30,1055878,2,0,0,0,0,0
20150105.232545,2809.6,6,1055884,0,0,0,0,0,0
20150105.232546,2810.22,2,1055886,2,0,0,0,0,0
20150105.232547,2810.22,2,1055888,2,0,0,0,0,0
20150105.232548,2810.22,8,1055896,4,0,0,0,0,0
20150105.232549,2810.22,2,1055898,2,0,0,0,0,0
20150105.23255,2810.22,20,1055918,20,0,0,0,0,0
20150105.232551,2810.22,100,1056018,100,0,0,0,0,0
20150105.232552,2810.22,2,1056020,2,0,0,0,0,0
20150105.232553,2809.6,2,1056022,2,0,0,0,0,0
20150105.232554,2810.22,2,1056024,2,0,0,0,0,0
20150105.232555,2810.22,18,1056042,12,0,0,0,0,0
20150105.232556,2810.22,6,1056048,6,0,0,0,0,0
20150105.232557,2809.6,60,1056108,-50,0,0,0,0,0
20150105.232558,2809.6,6,1056114,0,0,0,0,0,0
20150105.232559,2809.6,2,1056116,0,0,0,0,0,0
20150105.2326,2810.22,6,1056122,0,0,0,0,0,0
20150105.232601,2810.22,2,1056124,2,0,0,0,0,0
20150105.232602,2809.6,2,1056126,0,0,0,0,0,0
20150105.232603,2810.22,2,1056128,2,0,0,0,0,0
20150105.232604,2810.22,8,1056136,8,0,0,0,0,0
20150105.232605,2809.6,50,1056186,-26,0,0,0,0,0
20150105.232606,2809.6,4,1056190,0,0,0,0,0,0
20150105.232607,2809.6,18,1056208,-12,0,0,0,0,0
20150105.232608,2809.6,6,1056214,6,0,0,0,0,0
20150105.232609,2810.22,20,1056234,0,0,0,0,0,0
20150105.23261,2810.22,4,1056238,4,0,0,0,0,0
20150105.232611,2810.22,8,1056246,2,0,0,0,0,0
20150105.232612,2810.22,22,1056268,0,0,0,0,0,0
20150105.232613,2810.22,12,1056280,2,0,0,0,0,0
20150105.232614,2810.22,2,1056282,2,0,0,0,0,0
20150105.232615,2810.22,2,1056284,2,0,0,0,0,0
20150105.232616,2809.6,4,1056288,0,0,0,0,0,0
20150105.232617,2809.6,2,1056290,2,0,0,0,0,0
20150105.232618,2809.6,4,1056294,4,0,0,0,0,0
20150105.232619,2810.22,20,1056314,20,0,0,0,0,0
20150105.23262,2810.22,20,1056334,0,0,0,0,0,0
20150105.232621,2810.22,10,1056344,0,0,0,0,0,0
20150105.232622,2810.22,6,1056350,6,0,0,0,0,0
20150105.232623,2809.6,36,1056386,36,0,0,0,0,0
20150105.232624,2809.6,4,1056390,4,0,0,0,0,0
20150105.232625,2809.6,30,1056420,30,0,0,0,0,0
20150105.232626,2810.22,4,1056424,0,0,0,0,0,0
20150105.232627,2809.6,2,1056426,2,0,0,0,0,0
20150105.232628,2809.6,2,1056428,2,0,0,0,0,0
20150105.232629,2810.22,28,1056456,0,0,0,0,0,0
20150105.23263,2810.22,6,1056462,2,0,0,0,0,0
20150105.232631,2809.6,2,1056464,2,0,0,0,0,0
20150105.232632,2809.6,46,1056510,46,0,0,0,0,0
20150105.232633,2810.22,2,1056512,2,0,0,0,0,0
20150105.232634,2810.22,2,1056514,0,0,0,0,0,0
20150105.232635,2810.22,2,1056516,2,0,0,0,0,0
20150105.232636,2810.22,10,1056526,0,0,0,0,0,0
20150105.232637,2810.22,2,1056528,0,0,0,0,0,0
20150105.232638,2810.22,20,1056548,20,0,0,0,0,0
20150105.232639,2810.22,8,1056556,8,0,0,0,0,0
20150105.23264,2810.22,712,1057268,44,0,0,0,0,0
20150105.232641,2810.85,114,1057382,-26,0,0,0,0,0
20150105.232642,2810.22,108,1057490,4,0,0,0,0,0
20150105.232643,2810.22,4,1057494,4,0,0,0,0,0
20150105.232644,2810.22,8,1057502,4,0,0,0,0,0
20150105.232645,2810.22,10,1057512,10,0,0,0,0,0
20150105.232646,2810.22,2,1057514,2,0,0,0,0,0
20150105.232647,2810.22,4,1057518,4,0,0,0,0,0
20150105.232648,2810.22,2,1057520,2,0,0,0,0,0
20150105.232649,2809.6,16,1057536,16,0,0,0,0,0
20150105.23265,2810.23,100,1057636,100,0,0,0,0,0
20150105.232651,2810.23,8,1057644,4,0,0,0,0,0
20150105.232652,2810.23,8,1057652,8,0,0,0,0,0
20150105.232653,2810.23,100,1057752,100,0,0,0,0,0
20150105.232654,2810.23,30,1057782,10,0,0,0,0,0
20150105.232655,2810.23,296,1058078,-30,0,0,0,0,0
20150105.232656,2810.23,4,1058082,-4,0,0,0,0,0
20150105.232657,2810.23,10,1058092,0,0,0,0,0,0
20150105.232658,2810.23,2,1058094,-2,0,0,0,0,0
20150105.232659,2810.85,2,1058096,2,0,0,0,0,0
20150105.2327,2810.85,10,1058106,0,0,0,0,0,0
20150105.232701,2810.85,4,1058110,4,0,0,0,0,0
20150105.232702,2810.85,10,1058120,10,0,0,0,0,0
20150105.232703,2810.23,16,1058136,0,0,0,0,0,0
20150105.232704,2810.85,2,1058138,2,0,0,0,0,0
20150105.232705,2810.85,2,1058140,0,0,0,0,0,0
20150105.232706,2810.85,200,1058340,200,0,0,0,0,0
20150105.232707,2810.85,100,1058440,100,0,0,0,0,0
20150105.232708,2810.85,42,1058482,12,0,0,0,0,0
20150105.232709,2810.85,122,1058604,86,0,0,0,0,0
20150105.23271,2810.85,12,1058616,4,0,0,0,0,0
20150105.232711,2810.85,20,1058636,2,0,0,0,0,0
20150105.232712,2810.85,2,1058638,2,0,0,0,0,0
20150105.232713,2810.85,4,1058642,2,0,0,0,0,0
20150105.232714,2810.85,60,1058702,0,0,0,0,0,0
20150105.232715,2810.85,2,1058704,0,0,0,0,0,0
20150105.232716,2810.85,6,1058710,4,0,0,0,0,0
20150105.232717,2810.23,64,1058774,-54,0,0,0,0,0
20150105.232718,2810.85,2,1058776,-2,0,0,0,0,0
20150105.232719,2810.85,12,1058788,2,0,0,0,0,0
20150105.23272,2810.85,102,1058890,58,0,0,0,0,0
20150105.232721,2810.85,14,1058904,14,0,0,0,0,0
20150105.232722,2810.85,8,1058912,8,0,0,0,0,0
20150105.232723,2810.85,2,1058914,0,0,0,0,0,0
20150105.232724,2810.23,12,1058926,10,0,0,0,0,0
20150105.232725,2810.85,12,1058938,12,0,0,0,0,0
20150105.232726,2810.85,2,1058940,2,0,0,0,0,0
20150105.232727,2810.85,4,1058944,4,0,0,0,0,0
20150105.232728,2810.23,2,1058946,0,0,0,0,0,0
20150105.232729,2810.23,32,1058978,8,0,0,0,0,0
20150105.23273,2810.23,2,1058980,-2,0,0,0,0,0
20150105.232731,2810.85,20,1059000,0,0,0,0,0,0
20150105.232732,2810.23,140,1059140,-100,0,0,0,0,0
20150105.232733,2810.23,2,1059142,0,0,0,0,0,0
20150105.232734,2810.23,2,1059144,0,0,0,0,0,0
20150105.232735,2810.85,4,1059148,0,0,0,0,0,0
20150105.232736,2810.85,2,1059150,2,0,0,0,0,0
20150105.232737,2810.85,2,1059152,2,0,0,0,0,0
20150105.232738,2810.85,20,1059172,20,0,0,0,0,0
20150105.232739,2810.23,2,1059174,-2,0,0,0,0,0
20150105.23274,2810.85,2,1059176,2,0,0,0,0,0
20150105.232741,2810.85,8,1059184,-4,0,0,0,0,0
20150105.232742,2810.23,14,1059198,8,0,0,0,0,0
20150105.232743,2810.23,18,1059216,-18,0,0,0,0,0
20150105.232744,2810.85,24,1059240,-10,0,0,0,0,0
20150105.232745,2810.85,160,1059400,88,0,0,0,0,0
20150105.232746,2810.85,4,1059404,0,0,0,0,0,0
20150105.232747,2810.23,4,1059408,0,0,0,0,0,0
20150105.232748,2810.85,20,1059428,20,0,0,0,0,0
20150105.232749,2810.85,2,1059430,0,0,0,0,0,0
20150105.23275,2810.85,102,1059532,20,0,0,0,0,0
20150105.232751,2810.23,200,1059732,0,0,0,0,0,0
20150105.232752,2810.85,18,1059750,0,0,0,0,0,0
20150105.232753,2810.85,786,1060536,664,0,0,0,0,0
20150105.232754,2811.47,136,1060672,8,0,0,0,0,0
20150105.232755,2811.47,32,1060704,8,0,0,0,0,0
20150105.232756,2811.47,8,1060712,-8,0,0,0,0,0
20150105.232757,2810.85,2,1060714,0,0,0,0,0,0
20150105.232758,2811.47,2,1060716,0,0,0,0,0,0
20150105.232759,2811.47,4,1060720,-4,0,0,0,0,0
20150105.2328,2811.47,4,1060724,0,0,0,0,0,0
20150105.232801,2811.47,14,1060738,0,0,0,0,0,0
20150105.232802,2811.47,278,1061016,-168,0,0,0,0,0
20150105.232803,2811.47,1062,1062078,256,0,0,0,0,0
20150105.232804,2811.47,66,1062144,-64,0,0,0,0,0
20150105.232805,2811.47,2,1062146,0,0,0,0,0,0
20150105.232806,2811.47,66,1062212,44,0,0,0,0,0
20150105.232807,2811.47,14,1062226,0,0,0,0,0,0
20150105.232808,2811.47,2,1062228,0,0,0,0,0,0
20150105.232809,2811.47,12,1062240,-10,0,0,0,0,0
20150105.23281,2811.47,4,1062244,-2,0,0,0,0,0
20150105.232811,2810.85,2,1062246,0,0,0,0,0,0
20150105.232812,2811.47,2,1062248,0,0,0,0,0,0
20150105.232813,2811.47,2,1062250,-2,0,0,0,0,0
20150105.232814,2811.47,2,1062252,0,0,0,0,0,0
20150105.232815,2811.47,2,1062254,0,0,0,0,0,0
20150105.232816,2811.47,20,1062274,0,0,0,0,0,0
20150105.232817,2811.47,4,1062278,0,0,0,0,0,0
20150105.232818,2811.47,2,1062280,0,0,0,0,0,0
20150105.232819,2810.85,20,1062300,0,0,0,0,0,0
20150105.23282,2811.47,24,1062324,-10,0,0,0,0,0
20150105.232821,2811.47,8,1062332,0,0,0,0,0,0
20150105.232822,2810.85,406,1062738,-184,0,0,0,0,0
20150105.232823,2811.47,702,1063440,-2,0,0,0,0,0
20150105.232824,2811.47,402,1063842,210,0,0,0,0,0
20150105.232825,2811.47,66,1063908,48,0,0,0,0,0
20150105.232826,2811.47,4,1063912,0,0,0,0,0,0
20150105.232827,2811.47,12,1063924,0,0,0,0,0,0
20150105.232828,2811.47,120,1064044,-14,0,0,0,0,0
20150105.232829,2811.47,2,1064046,0,0,0,0,0,0
20150105.23283,2811.47,20,1064066,-20,0,0,0,0,0
20150105.232831,2811.47,10,1064076,-10,0,0,0,0,0
20150105.232832,2810.85,92,1064168,-92,0,0,0,0,0
20150105.232833,2811.47,18,1064186,-6,0,0,0,0,0
20150105.232834,2810.85,10,1064196,-8,0,0,0,0,0
20150105.232835,2811.47,10,1064206,0,0,0,0,0,0
20150105.232836,2810.85,8,1064214,0,0,0,0,0,0
20150105.232837,2811.47,126,1064340,-72,0,0,0,0,0
20150105.232838,2811.47,30,1064370,-18,0,0,0,0,0
20150105.232839,2811.47,26,1064396,26,0,0,0,0,0
20150105.23284,2811.47,20,1064416,-2,0,0,0,0,0
20150105.232841,2811.47,14,1064430,-4,0,0,0,0,0
20150105.232842,2811.47,6,1064436,-2,0,0,0,0,0
20150105.232843,2810.85,8,1064444,-4,0,0,0,0,0
20150105.232844,2811.47,12,1064456,2,0,0,0,0,0
20150105.232845,2811.47,120,1064576,0,0,0,0,0,0
20150105.232846,2811.47,186,1064762,-184,0,0,0,0,0
20150105.232847,2811.47,30,1064792,0,0,0,0,0,0
20150105.232848,2811.47,58,1064850,-34,0,0,0,0,0
20150105.232849,2811.47,202,1065052,130,0,0,0,0,0
20150105.23285,2811.47,4,1065056,2,0,0,0,0,0
20150105.232851,2811.47,130,1065186,66,0,0,0,0,0
20150105.232852,2811.47,178,1065364,134,0,0,0,0,0
20150105.232853,2811.47,26,1065390,-2,0,0,0,0,0
20150105.232854,2811.47,24,1065414,-18,0,0,0,0,0
20150105.232855,2811.47,6,1065420,0,0,0,0,0,0
20150105.232856,2811.47,4,1065424,-2,0,0,0,0,0
20150105.232857,2811.47,2,1065426,0,0,0,0,0,0
20150105.232858,2811.47,276,1065702,178,0,0,0,0,0
20150105.232859,2811.47,8,1065710,2,0,0,0,0,0
20150105.2329,2811.47,6,1065716,0,0,0,0,0,0
20150105.232901,2811.47,16,1065732,0,0,0,0,0,0
20150105.232902,2812.09,52,1065784,0,0,0,0,0,0
20150105.232903,2811.47,16,1065800,2,0,0,0,0,0
20150105.232904,2811.47,24,1065824,2,0,0,0,0,0
20150105.232905,2811.47,14,1065838,14,0,0,0,0,0
20150105.232906,2811.47,2,1065840,2,0,0,0,0,0
20150105.232907,2811.47,2,1065842,2,0,0,0,0,0
20150105.232908,2812.09,16,1065858,14,0,0,0,0,0
20150105.232909,2812.09,2,1065860,0,0,0,0,0,0
20150105.23291,2812.09,42,1065902,2,0,0,0,0,0
20150105.232911,2811.47,6,1065908,2,0,0,0,0,0
20150105.232912,2811.47,74,1065982,4,0,0,0,0,0
20150105.232913,2812.09,46,1066028,42,0,0,0,0,0
20150105.232914,2811.47,40,1066068,16,0,0,0,0,0
20150105.232915,2812.09,2,1066070,0,0,0,0,0,0
20150105.232916,2812.09,2,1066072,0,0,0,0,0,0
20150105.232917,2811.47,24,1066096,20,0,0,0,0,0
20150105.232918,2812.09,10,1066106,4,0,0,0,0,0
20150105.232919,2812.09,4,1066110,2,0,0,0,0,0
20150105.23292,2812.09,200,1066310,200,0,0,0,0,0
20150105.232921,2811.47,202,1066512,84,0,0,0,0,0
20150105.232922,2811.47,2,1066514,0,0,0,0,0,0
20150105.232923,2812.09,4,1066518,2,0,0,0,0,0
20150105.232924,2812.09,2,1066520,2,0,0,0,0,0
20150105.232925,2812.09,22,1066542,2,0,0,0,0,0
20150105.232926,2812.09,12,1066554,12,0,0,0,0,0
20150105.232927,2812.09,2,1066556,0,0,0,0,0,0
20150105.232928,2812.09,12,1066568,10,0,0,0,0,0
20150105.232929,2812.09,4,1066572,0,0,0,0,0,0
20150105.23293,2812.09,200,1066772,148,0,0,0,0,0
20150105.232931,2811.47,2,1066774,2,0,0,0,0,0
20150105.232932,2812.09,8,1066782,6,0,0,0,0,0
20150105.232933,2812.09,6,1066788,2,0,0,0,0,0
20150105.232934,2811.47,2,1066790,0,0,0,0,0,0
20150105.232935,2812.1,270,1067060,270,0,0,0,0,0
20150105.232936,2811.47,8,1067068,6,0,0,0,0,0
20150105.232937,2812.1,10,1067078,10,0,0,0,0,0
20150105.232938,2812.1,10,1067088,0,0,0,0,0,0
20150105.232939,2812.1,10,1067098,10,0,0,0,0,0
20150105.23294,2812.1,88,1067186,18,0,0,0,0,0
20150105.232941,2812.1,4,1067190,4,0,0,0,0,0
20150105.232942,2812.1,2,1067192,2,0,0,0,0,0
20150105.232943,2812.1,16,1067208,14,0,0,0,0,0
20150105.232944,2811.47,86,1067294,0,0,0,0,0,0
20150105.232945,2811.47,252,1067546,170,0,0,0,0,0
20150105.232946,2811.47,574,1068120,66,0,0,0,0,0
20150105.232947,2810.85,20,1068140,-20,0,0,0,0,0
20150105.232948,2811.47,72,1068212,46,0,0,0,0,0
20150105.232949,2811.47,44,1068256,42,0,0,0,0,0
20150105.23295,2811.47,30,1068286,-30,0,0,0,0,0
20150105.232951,2811.47,32,1068318,-2,0,0,0,0,0
20150105.232952,2810.85,4,1068322,0,0,0,0,0,0
20150105.232953,2811.47,6,1068328,0,0,0,0,0,0
20150105.232954,2811.47,8,1068336,-8,0,0,0,0,0
20150105.232955,2810.85,2,1068338,0,0,0,0,0,0
20150105.232956,2811.47,2,1068340,0,0,0,0,0,0
20150105.232957,2811.47,8,1068348,0,0,0,0,0,0
20150105.232958,2811.47,2,1068350,0,0,0,0,0,0
20150105.232959,2811.47,10,1068360,-6,0,0,0,0,0
20150105.09,2811.47,0,1068360,0,0,0,0,0,0
20150105.090001,2811.47,0,1068360,0,0,0,0,0,0
20150105.090002,2811.47,0,1068360,0,0,0,0,0,0
20150105.090003,2811.47,0,1068360,0,0,0,0,0,0
20150105.090004,2811.47,0,1068360,0,0,0,0,0,0
20150105.090005,2811.47,0,1068360,0,0,0,0,0,0
20150105.090006,2811.47,0,1068360,0,0,0,0,0,0
20150105.090007,2811.47,0,1068360,0,0,0,0,0,0
20150105.090008,2811.47,0,1068360,0,0,0,0,0,0
20150105.090009,2811.47,0,1068360,0,0,0,0,0,0
20150105.09001,2811.47,0,1068360,0,0,0,0,0,0
20150105.090011,2811.47,0,1068360,0,0,0,0,0,0
20150105.090012,2811.47,0,1068360,0,0,0,0,0,0
20150105.090013,2811.47,0,1068360,0,0,0,0,0,0
20150105.090014,2811.47,0,1068360,0,0,0,0,0,0
20150105.090015,2811.47,0,1068360,0,0,0,0,0,0
20150105.090016,2811.47,0,1068360,0,0,0,0,0,0
20150105.090017,2811.47,0,1068360,0,0,0,0,0,0
20150105.090018,2811.47,0,1068360,0,0,0,0,0,0
20150105.090019,2811.47,0,1068360,0,0,0,0,0,0
20150105.09002,2811.47,0,1068360,0,0,0,0,0,0
20150105.090021,2811.47,0,1068360,0,0,0,0,0,0
20150105.090022,2811.47,0,1068360,0,0,0,0,0,0
20150105.090023,2811.47,0,1068360,0,0,0,0,0,0
20150105.090024,2811.47,0,1068360,0,0,0,0,0,0
20150105.090025,2811.47,0,1068360,0,0,0,0,0,0
20150105.090026,2811.47,0,1068360,0,0,0,0,0,0
20150105.090027,2811.47,0,1068360,0,0,0,0,0,0
20150105.090028,2811.47,0,1068360,0,0,0,0,0,0
20150105.090029,2811.47,0,1068360,0,0,0,0,0,0
20150105.09003,2811.47,0,1068360,0,0,0,0,0,0
20150105.090031,2811.47,0,1068360,0,0,0,0,0,0
20150105.090032,2811.47,0,1068360,0,0,0,0,0,0
20150105.090033,2811.47,0,1068360,0,0,0,0,0,0
20150105.090034,2811.47,0,1068360,0,0,0,0,0,0
20150105.090035,2811.47,0,1068360,0,0,0,0,0,0
20150105.090036,2811.47,0,1068360,0,0,0,0,0,0
20150105.090037,2811.47,0,1068360,0,0,0,0,0,0
20150105.090038,2811.47,0,1068360,0,0,0,0,0,0
20150105.090039,2811.47,0,1068360,0,0,0,0,0,0
20150105.09004,2811.47,0,1068360,0,0,0,0,0,0
20150105.090041,2811.47,0,1068360,0,0,0,0,0,0
20150105.090042,2811.47,0,1068360,0,0,0,0,0,0
20150105.090043,2811.47,0,1068360,0,0,0,0,0,0
20150105.090044,2811.47,0,1068360,0,0,0,0,0,0
20150105.090045,2811.47,0,1068360,0,0,0,0,0,0
20150105.090046,2811.47,0,1068360,0,0,0,0,0,0
20150105.090047,2811.47,0,1068360,0,0,0,0,0,0
20150105.090048,2811.47,0,1068360,0,0,0,0,0,0
20150105.090049,2811.47,0,1068360,0,0,0,0,0,0
20150105.09005,2811.47,0,1068360,0,0,0,0,0,0
20150105.090051,2811.47,0,1068360,0,0,0,0,0,0
20150105.090052,2811.47,0,1068360,0,0,0,0,0,0
20150105.090053,2811.47,0,1068360,0,0,0,0,0,0
20150105.090054,2811.47,0,1068360,0,0,0,0,0,0
20150105.090055,2811.47,0,1068360,0,0,0,0,0,0
20150105.090056,2811.47,0,1068360,0,0,0,0,0,0
20150105.090057,2811.47,0,1068360,0,0,0,0,0,0
20150105.090058,2811.47,0,1068360,0,0,0,0,0,0
20150105.090059,2811.47,0,1068360,0,0,0,0,0,0
20150105.0901,2811.47,0,1068360,0,0,0,0,0,0
20150105.090101,2811.47,0,1068360,0,0,0,0,0,0
20150105.090102,2811.47,0,1068360,0,0,0,0,0,0
20150105.090103,2811.47,0,1068360,0,0,0,0,0,0
20150105.090104,2811.47,0,1068360,0,0,0,0,0,0
20150105.090105,2811.47,0,1068360,0,0,0,0,0,0
20150105.090106,2811.47,0,1068360,0,0,0,0,0,0
20150105.090107,2811.47,0,1068360,0,0,0,0,0,0
20150105.090108,2811.47,0,1068360,0,0,0,0,0,0
20150105.090109,2811.47,0,1068360,0,0,0,0,0,0
20150105.09011,2811.47,0,1068360,0,0,0,0,0,0
20150105.090111,2811.47,0,1068360,0,0,0,0,0,0
20150105.090112,2811.47,0,1068360,0,0,0,0,0,0
20150105.090113,2811.47,0,1068360,0,0,0,0,0,0
20150105.090114,2811.47,0,1068360,0,0,0,0,0,0
20150105.090115,2811.47,0,1068360,0,0,0,0,0,0
20150105.090116,2811.47,0,1068360,0,0,0,0,0,0
20150105.090117,2811.47,0,1068360,0,0,0,0,0,0
20150105.090118,2811.47,0,1068360,0,0,0,0,0,0
20150105.090119,2811.47,0,1068360,0,0,0,0,0,0
20150105.09012,2811.47,0,1068360,0,0,0,0,0,0
20150105.090121,2811.47,0,1068360,0,0,0,0,0,0
20150105.090122,2811.47,0,1068360,0,0,0,0,0,0
20150105.090123,2811.47,0,1068360,0,0,0,0,0,0
20150105.090124,2811.47,0,1068360,0,0,0,0,0,0
20150105.090125,2811.47,0,1068360,0,0,0,0,0,0
20150105.090126,2811.47,0,1068360,0,0,0,0,0,0
20150105.090127,2811.47,0,1068360,0,0,0,0,0,0
20150105.090128,2811.47,0,1068360,0,0,0,0,0,0
20150105.090129,2811.47,0,1068360,0,0,0,0,0,0
20150105.09013,2811.47,0,1068360,0,0,0,0,0,0
20150105.090131,2811.47,0,1068360,0,0,0,0,0,0
20150105.090132,2811.47,0,1068360,0,0,0,0,0,0
20150105.090133,2811.47,0,1068360,0,0,0,0,0,0
20150105.090134,2811.47,0,1068360,0,0,0,0,0,0
20150105.090135,2811.47,0,1068360,0,0,0,0,0,0
20150105.090136,2811.47,0,1068360,0,0,0,0,0,0
20150105.090137,2811.47,0,1068360,0,0,0,0,0,0
20150105.090138,2811.47,0,1068360,0,0,0,0,0,0
20150105.090139,2811.47,0,1068360,0,0,0,0,0,0
20150105.09014,2811.47,0,1068360,0,0,0,0,0,0
20150105.090141,2811.47,0,1068360,0,0,0,0,0,0
20150105.090142,2811.47,0,1068360,0,0,0,0,0,0
20150105.090143,2811.47,0,1068360,0,0,0,0,0,0
20150105.090144,2811.47,0,1068360,0,0,0,0,0,0
20150105.090145,2811.47,0,1068360,0,0,0,0,0,0
20150105.090146,2811.47,0,1068360,0,0,0,0,0,0
20150105.090147,2811.47,0,1068360,0,0,0,0,0,0
20150105.090148,2811.47,0,1068360,0,0,0,0,0,0
20150105.090149,2811.47,0,1068360,0,0,0,0,0,0
20150105.09015,2811.47,0,1068360,0,0,0,0,0,0
20150105.090151,2811.47,0,1068360,0,0,0,0,0,0
20150105.090152,2811.47,0,1068360,0,0,0,0,0,0
20150105.090153,2811.47,0,1068360,0,0,0,0,0,0
20150105.090154,2811.47,0,1068360,0,0,0,0,0,0
20150105.090155,2811.47,0,1068360,0,0,0,0,0,0
20150105.090156,2811.47,0,1068360,0,0,0,0,0,0
20150105.090157,2811.47,0,1068360,0,0,0,0,0,0
20150105.090158,2811.47,0,1068360,0,0,0,0,0,0
20150105.090159,2811.47,0,1068360,0,0,0,0,0,0
20150105.0902,2811.47,0,1068360,0,0,0,0,0,0
20150105.090201,2811.47,0,1068360,0,0,0,0,0,0
20150105.090202,2811.47,0,1068360,0,0,0,0,0,0
20150105.090203,2811.47,0,1068360,0,0,0,0,0,0
20150105.090204,2811.47,0,1068360,0,0,0,0,0,0
20150105.090205,2811.47,0,1068360,0,0,0,0,0,0
20150105.090206,2811.47,0,1068360,0,0,0,0,0,0
20150105.090207,2811.47,0,1068360,0,0,0,0,0,0
20150105.090208,2811.47,0,1068360,0,0,0,0,0,0
20150105.090209,2811.47,0,1068360,0,0,0,0,0,0
20150105.09021,2811.47,0,1068360,0,0,0,0,0,0
20150105.090211,2811.47,0,1068360,0,0,0,0,0,0
20150105.090212,2811.47,0,1068360,0,0,0,0,0,0
20150105.090213,2811.47,0,1068360,0,0,0,0,0,0
20150105.090214,2811.47,0,1068360,0,0,0,0,0,0
20150105.090215,2811.47,0,1068360,0,0,0,0,0,0
20150105.090216,2811.47,0,1068360,0,0,0,0,0,0
20150105.090217,2811.47,0,1068360,0,0,0,0,0,0
20150105.090218,2811.47,0,1068360,0,0,0,0,0,0
20150105.090219,2811.47,0,1068360,0,0,0,0,0,0
20150105.09022,2811.47,0,1068360,0,0,0,0,0,0
20150105.090221,2811.47,0,1068360,0,0,0,0,0,0
20150105.090222,2811.47,0,1068360,0,0,0,0,0,0
20150105.090223,2811.47,0,1068360,0,0,0,0,0,0
20150105.090224,2811.47,0,1068360,0,0,0,0,0,0
20150105.090225,2811.47,0,1068360,0,0,0,0,0,0
20150105.090226,2811.47,0,1068360,0,0,0,0,0,0
20150105.090227,2811.47,0,1068360,0,0,0,0,0,0
20150105.090228,2811.47,0,1068360,0,0,0,0,0,0
20150105.090229,2811.47,0,1068360,0,0,0,0,0,0
20150105.09023,2811.47,0,1068360,0,0,0,0,0,0
20150105.090231,2811.47,0,1068360,0,0,0,0,0,0
20150105.090232,2811.47,0,1068360,0,0,0,0,0,0
20150105.090233,2811.47,0,1068360,0,0,0,0,0,0
20150105.090234,2811.47,0,1068360,0,0,0,0,0,0
20150105.090235,2811.47,0,1068360,0,0,0,0,0,0
20150105.090236,2811.47,0,1068360,0,0,0,0,0,0
20150105.090237,2811.47,0,1068360,0,0,0,0,0,0
20150105.090238,2811.47,0,1068360,0,0,0,0,0,0
20150105.090239,2811.47,0,1068360,0,0,0,0,0,0
20150105.09024,2811.47,0,1068360,0,0,0,0,0,0
20150105.090241,2811.47,0,1068360,0,0,0,0,0,0
20150105.090242,2811.47,0,1068360,0,0,0,0,0,0
20150105.090243,2811.47,0,1068360,0,0,0,0,0,0
20150105.090244,2811.47,0,1068360,0,0,0,0,0,0
20150105.090245,2811.47,0,1068360,0,0,0,0,0,0
20150105.090246,2811.47,0,1068360,0,0,0,0,0,0
20150105.090247,2811.47,0,1068360,0,0,0,0,0,0
20150105.090248,2811.47,0,1068360,0,0,0,0,0,0
20150105.090249,2811.47,0,1068360,0,0,0,0,0,0
20150105.09025,2811.47,0,1068360,0,0,0,0,0,0
20150105.090251,2811.47,0,1068360,0,0,0,0,0,0
20150105.090252,2811.47,0,1068360,0,0,0,0,0,0
20150105.090253,2811.47,0,1068360,0,0,0,0,0,0
20150105.090254,2811.47,0,1068360,0,0,0,0,0,0
20150105.090255,2811.47,0,1068360,0,0,0,0,0,0
20150105.090256,2811.47,0,1068360,0,0,0,0,0,0
20150105.090257,2811.47,0,1068360,0,0,0,0,0,0
20150105.090258,2811.47,0,1068360,0,0,0,0,0,0
20150105.090259,2811.47,0,1068360,0,0,0,0,0,0
20150105.0903,2811.47,0,1068360,0,0,0,0,0,0
20150105.090301,2811.47,0,1068360,0,0,0,0,0,0
20150105.090302,2811.47,0,1068360,0,0,0,0,0,0
20150105.090303,2811.47,0,1068360,0,0,0,0,0,0
20150105.090304,2811.47,0,1068360,0,0,0,0,0,0
20150105.090305,2811.47,0,1068360,0,0,0,0,0,0
20150105.090306,2811.47,0,1068360,0,0,0,0,0,0
20150105.090307,2811.47,0,1068360,0,0,0,0,0,0
20150105.090308,2811.47,0,1068360,0,0,0,0,0,0
20150105.090309,2811.47,0,1068360,0,0,0,0,0,0
20150105.09031,2811.47,0,1068360,0,0,0,0,0,0
20150105.090311,2811.47,0,1068360,0,0,0,0,0,0
20150105.090312,2811.47,0,1068360,0,0,0,0,0,0
20150105.090313,2811.47,0,1068360,0,0,0,0,0,0
20150105.090314,2811.47,0,1068360,0,0,0,0,0,0
20150105.090315,2811.47,0,1068360,0,0,0,0,0,0
20150105.090316,2811.47,0,1068360,0,0,0,0,0,0
20150105.090317,2811.47,0,1068360,0,0,0,0,0,0
20150105.090318,2811.47,0,1068360,0,0,0,0,0,0
20150105.090319,2811.47,0,1068360,0,0,0,0,0,0
20150105.09032,2811.47,0,1068360,0,0,0,0,0,0
20150105.090321,2811.47,0,1068360,0,0,0,0,0,0
20150105.090322,2811.47,0,1068360,0,0,0,0,0,0
20150105.090323,2811.47,0,1068360,0,0,0,0,0,0
20150105.090324,2811.47,0,1068360,0,0,0,0,0,0
20150105.090325,2811.47,0,1068360,0,0,0,0,0,0
20150105.090326,2811.47,0,1068360,0,0,0,0,0,0
20150105.090327,2811.47,0,1068360,0,0,0,0,0,0
20150105.090328,2811.47,0,1068360,0,0,0,0,0,0
20150105.090329,2811.47,0,1068360,0,0,0,0,0,0
20150105.09033,2811.47,0,1068360,0,0,0,0,0,0
20150105.090331,2811.47,0,1068360,0,0,0,0,0,0
20150105.090332,2811.47,0,1068360,0,0,0,0,0,0
20150105.090333,2811.47,0,1068360,0,0,0,0,0,0
20150105.090334,2811.47,0,1068360,0,0,0,0,0,0
20150105.090335,2811.47,0,1068360,0,0,0,0,0,0
20150105.090336,2811.47,0,1068360,0,0,0,0,0,0
20150105.090337,2811.47,0,1068360,0,0,0,0,0,0
20150105.090338,2811.47,0,1068360,0,0,0,0,0,0
20150105.090339,2811.47,0,1068360,0,0,0,0,0,0
20150105.09034,2811.47,0,1068360,0,0,0,0,0,0
20150105.090341,2811.47,0,1068360,0,0,0,0,0,0
20150105.090342,2811.47,0,1068360,0,0,0,0,0,0
20150105.090343,2811.47,0,1068360,0,0,0,0,0,0
20150105.090344,2811.47,0,1068360,0,0,0,0,0,0
20150105.090345,2811.47,0,1068360,0,0,0,0,0,0
20150105.090346,2811.47,0,1068360,0,0,0,0,0,0
20150105.090347,2811.47,0,1068360,0,0,0,0,0,0
20150105.090348,2811.47,0,1068360,0,0,0,0,0,0
20150105.090349,2811.47,0,1068360,0,0,0,0,0,0
20150105.09035,2811.47,0,1068360,0,0,0,0,0,0
20150105.090351,2811.47,0,1068360,0,0,0,0,0,0
20150105.090352,2811.47,0,1068360,0,0,0,0,0,0
20150105.090353,2811.47,0,1068360,0,0,0,0,0,0
20150105.090354,2811.47,0,1068360,0,0,0,0,0,0
20150105.090355,2811.47,0,1068360,0,0,0,0,0,0
20150105.090356,2811.47,0,1068360,0,0,0,0,0,0
20150105.090357,2811.47,0,1068360,0,0,0,0,0,0
20150105.090358,2811.47,0,1068360,0,0,0,0,0,0
20150105.090359,2811.47,0,1068360,0,0,0,0,0,0
20150105.0904,2811.47,0,1068360,0,0,0,0,0,0
20150105.090401,2811.47,0,1068360,0,0,0,0,0,0
20150105.090402,2811.47,0,1068360,0,0,0,0,0,0
20150105.090403,2811.47,0,1068360,0,0,0,0,0,0
20150105.090404,2811.47,0,1068360,0,0,0,0,0,0
20150105.090405,2811.47,0,1068360,0,0,0,0,0,0
20150105.090406,2811.47,0,1068360,0,0,0,0,0,0
20150105.090407,2811.47,0,1068360,0,0,0,0,0,0
20150105.090408,2811.47,0,1068360,0,0,0,0,0,0
20150105.090409,2811.47,0,1068360,0,0,0,0,0,0
20150105.09041,2811.47,0,1068360,0,0,0,0,0,0
20150105.090411,2811.47,0,1068360,0,0,0,0,0,0
20150105.090412,2811.47,0,1068360,0,0,0,0,0,0
20150105.090413,2811.47,0,1068360,0,0,0,0,0,0
20150105.090414,2811.47,0,1068360,0,0,0,0,0,0
20150105.090415,2811.47,0,1068360,0,0,0,0,0,0
20150105.090416,2811.47,0,1068360,0,0,0,0,0,0
20150105.090417,2811.47,0,1068360,0,0,0,0,0,0
20150105.090418,2811.47,0,1068360,0,0,0,0,0,0
20150105.090419,2811.47,0,1068360,0,0,0,0,0,0
20150105.09042,2811.47,0,1068360,0,0,0,0,0,0
20150105.090421,2811.47,0,1068360,0,0,0,0,0,0
20150105.090422,2811.47,0,1068360,0,0,0,0,0,0
20150105.090423,2811.47,0,1068360,0,0,0,0,0,0
20150105.090424,2811.47,0,1068360,0,0,0,0,0,0
20150105.090425,2811.47,0,1068360,0,0,0,0,0,0
20150105.090426,2811.47,0,1068360,0,0,0,0,0,0
20150105.090427,2811.47,0,1068360,0,0,0,0,0,0
20150105.090428,2811.47,0,1068360,0,0,0,0,0,0
20150105.090429,2811.47,0,1068360,0,0,0,0,0,0
20150105.09043,2811.47,0,1068360,0,0,0,0,0,0
20150105.090431,2811.47,0,1068360,0,0,0,0,0,0
20150105.090432,2811.47,0,1068360,0,0,0,0,0,0
20150105.090433,2811.47,0,1068360,0,0,0,0,0,0
20150105.090434,2811.47,0,1068360,0,0,0,0,0,0
20150105.090435,2811.47,0,1068360,0,0,0,0,0,0
20150105.090436,2811.47,0,1068360,0,0,0,0,0,0
20150105.090437,2811.47,0,1068360,0,0,0,0,0,0
20150105.090438,2811.47,0,1068360,0,0,0,0,0,0
20150105.090439,2811.47,0,1068360,0,0,0,0,0,0
20150105.09044,2811.47,0,1068360,0,0,0,0,0,0
20150105.090441,2811.47,0,1068360,0,0,0,0,0,0
20150105.090442,2811.47,0,1068360,0,0,0,0,0,0
20150105.090443,2811.47,0,1068360,0,0,0,0,0,0
20150105.090444,2811.47,0,1068360,0,0,0,0,0,0
20150105.090445,2811.47,0,1068360,0,0,0,0,0,0
20150105.090446,2811.47,0,1068360,0,0,0,0,0,0
20150105.090447,2811.47,0,1068360,0,0,0,0,0,0
20150105.090448,2811.47,0,1068360,0,0,0,0,0,0
20150105.090449,2811.47,0,1068360,0,0,0,0,0,0
20150105.09045,2811.47,0,1068360,0,0,0,0,0,0
20150105.090451,2811.47,0,1068360,0,0,0,0,0,0
20150105.090452,2811.47,0,1068360,0,0,0,0,0,0
20150105.090453,2811.47,0,1068360,0,0,0,0,0,0
20150105.090454,2811.47,0,1068360,0,0,0,0,0,0
20150105.090455,2811.47,0,1068360,0,0,0,0,0,0
20150105.090456,2811.47,0,1068360,0,0,0,0,0,0
20150105.090457,2811.47,0,1068360,0,0,0,0,0,0
20150105.090458,2811.47,0,1068360,0,0,0,0,0,0
20150105.090459,2811.47,0,1068360,0,0,0,0,0,0
20150105.0905,2811.47,0,1068360,0,0,0,0,0,0
20150105.090501,2811.47,0,1068360,0,0,0,0,0,0
20150105.090502,2811.47,0,1068360,0,0,0,0,0,0
20150105.090503,2811.47,0,1068360,0,0,0,0,0,0
20150105.090504,2811.47,0,1068360,0,0,0,0,0,0
20150105.090505,2811.47,0,1068360,0,0,0,0,0,0
20150105.090506,2811.47,0,1068360,0,0,0,0,0,0
20150105.090507,2811.47,0,1068360,0,0,0,0,0,0
20150105.090508,2811.47,0,1068360,0,0,0,0,0,0
20150105.090509,2811.47,0,1068360,0,0,0,0,0,0
20150105.09051,2811.47,0,1068360,0,0,0,0,0,0
20150105.090511,2811.47,0,1068360,0,0,0,0,0,0
20150105.090512,2811.47,0,1068360,0,0,0,0,0,0
20150105.090513,2811.47,0,1068360,0,0,0,0,0,0
20150105.090514,2811.47,0,1068360,0,0,0,0,0,0
20150105.090515,2811.47,0,1068360,0,0,0,0,0,0
20150105.090516,2811.47,0,1068360,0,0,0,0,0,0
20150105.090517,2811.47,0,1068360,0,0,0,0,0,0
20150105.090518,2811.47,0,1068360,0,0,0,0,0,0
20150105.090519,2811.47,0,1068360,0,0,0,0,0,0
20150105.09052,2811.47,0,1068360,0,0,0,0,0,0
20150105.090521,2811.47,0,1068360,0,0,0,0,0,0
20150105.090522,2811.47,0,1068360,0,0,0,0,0,0
20150105.090523,2811.47,0,1068360,0,0,0,0,0,0
20150105.090524,2811.47,0,1068360,0,0,0,0,0,0
20150105.090525,2811.47,0,1068360,0,0,0,0,0,0
20150105.090526,2811.47,0,1068360,0,0,0,0,0,0
20150105.090527,2811.47,0,1068360,0,0,0,0,0,0
20150105.090528,2811.47,0,1068360,0,0,0,0,0,0
20150105.090529,2811.47,0,1068360,0,0,0,0,0,0
20150105.09053,2811.47,0,1068360,0,0,0,0,0,0
20150105.090531,2811.47,0,1068360,0,0,0,0,0,0
20150105.090532,2811.47,0,1068360,0,0,0,0,0,0
20150105.090533,2811.47,0,1068360,0,0,0,0,0,0
20150105.090534,2811.47,0,1068360,0,0,0,0,0,0
20150105.090535,2811.47,0,1068360,0,0,0,0,0,0
20150105.090536,2811.47,0,1068360,0,0,0,0,0,0
20150105.090537,2811.47,0,1068360,0,0,0,0,0,0
20150105.090538,2811.47,0,1068360,0,0,0,0,0,0
20150105.090539,2811.47,0,1068360,0,0,0,0,0,0
20150105.09054,2811.47,0,1068360,0,0,0,0,0,0
20150105.090541,2811.47,0,1068360,0,0,0,0,0,0
20150105.090542,2811.47,0,1068360,0,0,0,0,0,0
20150105.090543,2811.47,0,1068360,0,0,0,0,0,0
20150105.090544,2811.47,0,1068360,0,0,0,0,0,0
20150105.090545,2811.47,0,1068360,0,0,0,0,0,0
20150105.090546,2811.47,0,1068360,0,0,0,0,0,0
20150105.090547,2811.47,0,1068360,0,0,0,0,0,0
20150105.090548,2811.47,0,1068360,0,0,0,0,0,0
20150105.090549,2811.47,0,1068360,0,0,0,0,0,0
20150105.09055,2811.47,0,1068360,0,0,0,0,0,0
20150105.090551,2811.47,0,1068360,0,0,0,0,0,0
20150105.090552,2811.47,0,1068360,0,0,0,0,0,0
20150105.090553,2811.47,0,1068360,0,0,0,0,0,0
20150105.090554,2811.47,0,1068360,0,0,0,0,0,0
20150105.090555,2811.47,0,1068360,0,0,0,0,0,0
20150105.090556,2811.47,0,1068360,0,0,0,0,0,0
20150105.090557,2811.47,0,1068360,0,0,0,0,0,0
20150105.090558,2811.47,0,1068360,0,0,0,0,0,0
20150105.090559,2811.47,0,1068360,0,0,0,0,0,0
20150105.0906,2811.47,0,1068360,0,0,0,0,0,0
20150105.090601,2811.47,0,1068360,0,0,0,0,0,0
20150105.090602,2811.47,0,1068360,0,0,0,0,0,0
20150105.090603,2811.47,0,1068360,0,0,0,0,0,0
20150105.090604,2811.47,0,1068360,0,0,0,0,0,0
20150105.090605,2811.47,0,1068360,0,0,0,0,0,0
20150105.090606,2811.47,0,1068360,0,0,0,0,0,0
20150105.090607,2811.47,0,1068360,0,0,0,0,0,0
20150105.090608,2811.47,0,1068360,0,0,0,0,0,0
20150105.090609,2811.47,0,1068360,0,0,0,0,0,0
20150105.09061,2811.47,0,1068360,0,0,0,0,0,0
20150105.090611,2811.47,0,1068360,0,0,0,0,0,0
20150105.090612,2811.47,0,1068360,0,0,0,0,0,0
20150105.090613,2811.47,0,1068360,0,0,0,0,0,0
20150105.090614,2811.47,0,1068360,0,0,0,0,0,0
20150105.090615,2811.47,0,1068360,0,0,0,0,0,0
20150105.090616,2811.47,0,1068360,0,0,0,0,0,0
20150105.090617,2811.47,0,1068360,0,0,0,0,0,0
20150105.090618,2811.47,0,1068360,0,0,0,0,0,0
20150105.090619,2811.47,0,1068360,0,0,0,0,0,0
20150105.09062,2811.47,0,1068360,0,0,0,0,0,0
20150105.090621,2811.47,0,1068360,0,0,0,0,0,0
20150105.090622,2811.47,0,1068360,0,0,0,0,0,0
20150105.090623,2811.47,0,1068360,0,0,0,0,0,0
20150105.090624,2811.47,0,1068360,0,0,0,0,0,0
20150105.090625,2811.47,0,1068360,0,0,0,0,0,0
20150105.090626,2811.47,0,1068360,0,0,0,0,0,0
20150105.090627,2811.47,0,1068360,0,0,0,0,0,0
20150105.090628,2811.47,0,1068360,0,0,0,0,0,0
20150105.090629,2811.47,0,1068360,0,0,0,0,0,0
20150105.09063,2811.47,0,1068360,0,0,0,0,0,0
20150105.090631,2811.47,0,1068360,0,0,0,0,0,0
20150105.090632,2811.47,0,1068360,0,0,0,0,0,0
20150105.090633,2811.47,0,1068360,0,0,0,0,0,0
20150105.090634,2811.47,0,1068360,0,0,0,0,0,0
20150105.090635,2811.47,0,1068360,0,0,0,0,0,0
20150105.090636,2811.47,0,1068360,0,0,0,0,0,0
20150105.090637,2811.47,0,1068360,0,0,0,0,0,0
20150105.090638,2811.47,0,1068360,0,0,0,0,0,0
20150105.090639,2811.47,0,1068360,0,0,0,0,0,0
20150105.09064,2811.47,0,1068360,0,0,0,0,0,0
20150105.090641,2811.47,0,1068360,0,0,0,0,0,0
20150105.090642,2811.47,0,1068360,0,0,0,0,0,0
20150105.090643,2811.47,0,1068360,0,0,0,0,0,0
20150105.090644,2811.47,0,1068360,0,0,0,0,0,0
20150105.090645,2811.47,0,1068360,0,0,0,0,0,0
20150105.090646,2811.47,0,1068360,0,0,0,0,0,0
20150105.090647,2811.47,0,1068360,0,0,0,0,0,0
20150105.090648,2811.47,0,1068360,0,0,0,0,0,0
20150105.090649,2811.47,0,1068360,0,0,0,0,0,0
20150105.09065,2811.47,0,1068360,0,0,0,0,0,0
20150105.090651,2811.47,0,1068360,0,0,0,0,0,0
20150105.090652,2811.47,0,1068360,0,0,0,0,0,0
20150105.090653,2811.47,0,1068360,0,0,0,0,0,0
20150105.090654,2811.47,0,1068360,0,0,0,0,0,0
20150105.090655,2811.47,0,1068360,0,0,0,0,0,0
20150105.090656,2811.47,0,1068360,0,0,0,0,0,0
20150105.090657,2811.47,0,1068360,0,0,0,0,0,0
20150105.090658,2811.47,0,1068360,0,0,0,0,0,0
20150105.090659,2811.47,0,1068360,0,0,0,0,0,0
20150105.0907,2811.47,0,1068360,0,0,0,0,0,0
20150105.090701,2811.47,0,1068360,0,0,0,0,0,0
20150105.090702,2811.47,0,1068360,0,0,0,0,0,0
20150105.090703,2811.47,0,1068360,0,0,0,0,0,0
20150105.090704,2811.47,0,1068360,0,0,0,0,0,0
20150105.090705,2811.47,0,1068360,0,0,0,0,0,0
20150105.090706,2811.47,0,1068360,0,0,0,0,0,0
20150105.090707,2811.47,0,1068360,0,0,0,0,0,0
20150105.090708,2811.47,0,1068360,0,0,0,0,0,0
20150105.090709,2811.47,0,1068360,0,0,0,0,0,0
20150105.09071,2811.47,0,1068360,0,0,0,0,0,0
20150105.090711,2811.47,0,1068360,0,0,0,0,0,0
20150105.090712,2811.47,0,1068360,0,0,0,0,0,0
20150105.090713,2811.47,0,1068360,0,0,0,0,0,0
20150105.090714,2811.47,0,1068360,0,0,0,0,0,0
20150105.090715,2811.47,0,1068360,0,0,0,0,0,0
20150105.090716,2811.47,0,1068360,0,0,0,0,0,0
20150105.090717,2811.47,0,1068360,0,0,0,0,0,0
20150105.090718,2811.47,0,1068360,0,0,0,0,0,0
20150105.090719,2811.47,0,1068360,0,0,0,0,0,0
20150105.09072,2811.47,0,1068360,0,0,0,0,0,0
20150105.090721,2811.47,0,1068360,0,0,0,0,0,0
20150105.090722,2811.47,0,1068360,0,0,0,0,0,0
20150105.090723,2811.47,0,1068360,0,0,0,0,0,0
20150105.090724,2811.47,0,1068360,0,0,0,0,0,0
20150105.090725,2811.47,0,1068360,0,0,0,0,0,0
20150105.090726,2811.47,0,1068360,0,0,0,0,0,0
20150105.090727,2811.47,0,1068360,0,0,0,0,0,0
20150105.090728,2811.47,0,1068360,0,0,0,0,0,0
20150105.090729,2811.47,0,1068360,0,0,0,0,0,0
20150105.09073,2811.47,0,1068360,0,0,0,0,0,0
20150105.090731,2811.47,0,1068360,0,0,0,0,0,0
20150105.090732,2811.47,0,1068360,0,0,0,0,0,0
20150105.090733,2811.47,0,1068360,0,0,0,0,0,0
20150105.090734,2811.47,0,1068360,0,0,0,0,0,0
20150105.090735,2811.47,0,1068360,0,0,0,0,0,0
20150105.090736,2811.47,0,1068360,0,0,0,0,0,0
20150105.090737,2811.47,0,1068360,0,0,0,0,0,0
20150105.090738,2811.47,0,1068360,0,0,0,0,0,0
20150105.090739,2811.47,0,1068360,0,0,0,0,0,0
20150105.09074,2811.47,0,1068360,0,0,0,0,0,0
20150105.090741,2811.47,0,1068360,0,0,0,0,0,0
20150105.090742,2811.47,0,1068360,0,0,0,0,0,0
20150105.090743,2811.47,0,1068360,0,0,0,0,0,0
20150105.090744,2811.47,0,1068360,0,0,0,0,0,0
20150105.090745,2811.47,0,1068360,0,0,0,0,0,0
20150105.090746,2811.47,0,1068360,0,0,0,0,0,0
20150105.090747,2811.47,0,1068360,0,0,0,0,0,0
20150105.090748,2811.47,0,1068360,0,0,0,0,0,0
20150105.090749,2811.47,0,1068360,0,0,0,0,0,0
20150105.09075,2811.47,0,1068360,0,0,0,0,0,0
20150105.090751,2811.47,0,1068360,0,0,0,0,0,0
20150105.090752,2811.47,0,1068360,0,0,0,0,0,0
20150105.090753,2811.47,0,1068360,0,0,0,0,0,0
20150105.090754,2811.47,0,1068360,0,0,0,0,0,0
20150105.090755,2811.47,0,1068360,0,0,0,0,0,0
20150105.090756,2811.47,0,1068360,0,0,0,0,0,0
20150105.090757,2811.47,0,1068360,0,0,0,0,0,0
20150105.090758,2811.47,0,1068360,0,0,0,0,0,0
20150105.090759,2811.47,0,1068360,0,0,0,0,0,0
20150105.0908,2811.47,0,1068360,0,0,0,0,0,0
20150105.090801,2811.47,0,1068360,0,0,0,0,0,0
20150105.090802,2811.47,0,1068360,0,0,0,0,0,0
20150105.090803,2811.47,0,1068360,0,0,0,0,0,0
20150105.090804,2811.47,0,1068360,0,0,0,0,0,0
20150105.090805,2811.47,0,1068360,0,0,0,0,0,0
20150105.090806,2811.47,0,1068360,0,0,0,0,0,0
20150105.090807,2811.47,0,1068360,0,0,0,0,0,0
20150105.090808,2811.47,0,1068360,0,0,0,0,0,0
20150105.090809,2811.47,0,1068360,0,0,0,0,0,0
20150105.09081,2811.47,0,1068360,0,0,0,0,0,0
20150105.090811,2811.47,0,1068360,0,0,0,0,0,0
20150105.090812,2811.47,0,1068360,0,0,0,0,0,0
20150105.090813,2811.47,0,1068360,0,0,0,0,0,0
20150105.090814,2811.47,0,1068360,0,0,0,0,0,0
20150105.090815,2811.47,0,1068360,0,0,0,0,0,0
20150105.090816,2811.47,0,1068360,0,0,0,0,0,0
20150105.090817,2811.47,0,1068360,0,0,0,0,0,0
20150105.090818,2811.47,0,1068360,0,0,0,0,0,0
20150105.090819,2811.47,0,1068360,0,0,0,0,0,0
20150105.09082,2811.47,0,1068360,0,0,0,0,0,0
20150105.090821,2811.47,0,1068360,0,0,0,0,0,0
20150105.090822,2811.47,0,1068360,0,0,0,0,0,0
20150105.090823,2811.47,0,1068360,0,0,0,0,0,0
20150105.090824,2811.47,0,1068360,0,0,0,0,0,0
20150105.090825,2811.47,0,1068360,0,0,0,0,0,0
20150105.090826,2811.47,0,1068360,0,0,0,0,0,0
20150105.090827,2811.47,0,1068360,0,0,0,0,0,0
20150105.090828,2811.47,0,1068360,0,0,0,0,0,0
20150105.090829,2811.47,0,1068360,0,0,0,0,0,0
20150105.09083,2811.47,0,1068360,0,0,0,0,0,0
20150105.090831,2811.47,0,1068360,0,0,0,0,0,0
20150105.090832,2811.47,0,1068360,0,0,0,0,0,0
20150105.090833,2811.47,0,1068360,0,0,0,0,0,0
20150105.090834,2811.47,0,1068360,0,0,0,0,0,0
20150105.090835,2811.47,0,1068360,0,0,0,0,0,0
20150105.090836,2811.47,0,1068360,0,0,0,0,0,0
20150105.090837,2811.47,0,1068360,0,0,0,0,0,0
20150105.090838,2811.47,0,1068360,0,0,0,0,0,0
20150105.090839,2811.47,0,1068360,0,0,0,0,0,0
20150105.09084,2811.47,0,1068360,0,0,0,0,0,0
20150105.090841,2811.47,0,1068360,0,0,0,0,0,0
20150105.090842,2811.47,0,1068360,0,0,0,0,0,0
20150105.090843,2811.47,0,1068360,0,0,0,0,0,0
20150105.090844,2811.47,0,1068360,0,0,0,0,0,0
20150105.090845,2811.47,0,1068360,0,0,0,0,0,0
20150105.090846,2811.47,0,1068360,0,0,0,0,0,0
20150105.090847,2811.47,0,1068360,0,0,0,0,0,0
20150105.090848,2811.47,0,1068360,0,0,0,0,0,0
20150105.090849,2811.47,0,1068360,0,0,0,0,0,0
20150105.09085,2811.47,0,1068360,0,0,0,0,0,0
20150105.090851,2811.47,0,1068360,0,0,0,0,0,0
20150105.090852,2811.47,0,1068360,0,0,0,0,0,0
20150105.090853,2811.47,0,1068360,0,0,0,0,0,0
20150105.090854,2811.47,0,1068360,0,0,0,0,0,0
20150105.090855,2811.47,0,1068360,0,0,0,0,0,0
20150105.090856,2811.47,0,1068360,0,0,0,0,0,0
20150105.090857,2811.47,0,1068360,0,0,0,0,0,0
20150105.090858,2811.47,0,1068360,0,0,0,0,0,0
20150105.090859,2811.47,0,1068360,0,0,0,0,0,0
20150105.0909,2811.47,0,1068360,0,0,0,0,0,0
20150105.090901,2811.47,0,1068360,0,0,0,0,0,0
20150105.090902,2811.47,0,1068360,0,0,0,0,0,0
20150105.090903,2811.47,0,1068360,0,0,0,0,0,0
20150105.090904,2811.47,0,1068360,0,0,0,0,0,0
20150105.090905,2811.47,0,1068360,0,0,0,0,0,0
20150105.090906,2811.47,0,1068360,0,0,0,0,0,0
20150105.090907,2811.47,0,1068360,0,0,0,0,0,0
20150105.090908,2811.47,0,1068360,0,0,0,0,0,0
20150105.090909,2811.47,0,1068360,0,0,0,0,0,0
20150105.09091,2811.47,0,1068360,0,0,0,0,0,0
20150105.090911,2811.47,0,1068360,0,0,0,0,0,0
20150105.090912,2811.47,0,1068360,0,0,0,0,0,0
20150105.090913,2811.47,0,1068360,0,0,0,0,0,0
20150105.090914,2811.47,0,1068360,0,0,0,0,0,0
20150105.090915,2811.47,0,1068360,0,0,0,0,0,0
20150105.090916,2811.47,0,1068360,0,0,0,0,0,0
20150105.090917,2811.47,0,1068360,0,0,0,0,0,0
20150105.090918,2811.47,0,1068360,0,0,0,0,0,0
20150105.090919,2811.47,0,1068360,0,0,0,0,0,0
20150105.09092,2811.47,0,1068360,0,0,0,0,0,0
20150105.090921,2811.47,0,1068360,0,0,0,0,0,0
20150105.090922,2811.47,0,1068360,0,0,0,0,0,0
20150105.090923,2811.47,0,1068360,0,0,0,0,0,0
20150105.090924,2811.47,0,1068360,0,0,0,0,0,0
20150105.090925,2811.47,0,1068360,0,0,0,0,0,0
20150105.090926,2811.47,0,1068360,0,0,0,0,0,0
20150105.090927,2811.47,0,1068360,0,0,0,0,0,0
20150105.090928,2811.47,0,1068360,0,0,0,0,0,0
20150105.090929,2811.47,0,1068360,0,0,0,0,0,0
20150105.09093,2811.47,0,1068360,0,0,0,0,0,0
20150105.090931,2811.47,0,1068360,0,0,0,0,0,0
20150105.090932,2811.47,0,1068360,0,0,0,0,0,0
20150105.090933,2811.47,0,1068360,0,0,0,0,0,0
20150105.090934,2811.47,0,1068360,0,0,0,0,0,0
20150105.090935,2811.47,0,1068360,0,0,0,0,0,0
20150105.090936,2811.47,0,1068360,0,0,0,0,0,0
20150105.090937,2811.47,0,1068360,0,0,0,0,0,0
20150105.090938,2811.47,0,1068360,0,0,0,0,0,0
20150105.090939,2811.47,0,1068360,0,0,0,0,0,0
20150105.09094,2811.47,0,1068360,0,0,0,0,0,0
20150105.090941,2811.47,0,1068360,0,0,0,0,0,0
20150105.090942,2811.47,0,1068360,0,0,0,0,0,0
20150105.090943,2811.47,0,1068360,0,0,0,0,0,0
20150105.090944,2811.47,0,1068360,0,0,0,0,0,0
20150105.090945,2811.47,0,1068360,0,0,0,0,0,0
20150105.090946,2811.47,0,1068360,0,0,0,0,0,0
20150105.090947,2811.47,0,1068360,0,0,0,0,0,0
20150105.090948,2811.47,0,1068360,0,0,0,0,0,0
20150105.090949,2811.47,0,1068360,0,0,0,0,0,0
20150105.09095,2811.47,0,1068360,0,0,0,0,0,0
20150105.090951,2811.47,0,1068360,0,0,0,0,0,0
20150105.090952,2811.47,0,1068360,0,0,0,0,0,0
20150105.090953,2811.47,0,1068360,0,0,0,0,0,0
20150105.090954,2811.47,0,1068360,0,0,0,0,0,0
20150105.090955,2811.47,0,1068360,0,0,0,0,0,0
20150105.090956,2811.47,0,1068360,0,0,0,0,0,0
20150105.090957,2811.47,0,1068360,0,0,0,0,0,0
20150105.090958,2811.47,0,1068360,0,0,0,0,0,0
20150105.090959,2811.47,0,1068360,0,0,0,0,0,0
20150105.091,2811.47,0,1068360,0,0,0,0,0,0
20150105.091001,2811.47,0,1068360,0,0,0,0,0,0
20150105.091002,2811.47,0,1068360,0,0,0,0,0,0
20150105.091003,2811.47,0,1068360,0,0,0,0,0,0
20150105.091004,2811.47,0,1068360,0,0,0,0,0,0
20150105.091005,2811.47,0,1068360,0,0,0,0,0,0
20150105.091006,2811.47,0,1068360,0,0,0,0,0,0
20150105.091007,2811.47,0,1068360,0,0,0,0,0,0
20150105.091008,2811.47,0,1068360,0,0,0,0,0,0
20150105.091009,2811.47,0,1068360,0,0,0,0,0,0
20150105.09101,2811.47,0,1068360,0,0,0,0,0,0
20150105.091011,2811.47,0,1068360,0,0,0,0,0,0
20150105.091012,2811.47,0,1068360,0,0,0,0,0,0
20150105.091013,2811.47,0,1068360,0,0,0,0,0,0
20150105.091014,2811.47,0,1068360,0,0,0,0,0,0
20150105.091015,2811.47,0,1068360,0,0,0,0,0,0
20150105.091016,2811.47,0,1068360,0,0,0,0,0,0
20150105.091017,2811.47,0,1068360,0,0,0,0,0,0
20150105.091018,2811.47,0,1068360,0,0,0,0,0,0
20150105.091019,2811.47,0,1068360,0,0,0,0,0,0
20150105.09102,2811.47,0,1068360,0,0,0,0,0,0
20150105.091021,2811.47,0,1068360,0,0,0,0,0,0
20150105.091022,2811.47,0,1068360,0,0,0,0,0,0
20150105.091023,2811.47,0,1068360,0,0,0,0,0,0
20150105.091024,2811.47,0,1068360,0,0,0,0,0,0
20150105.091025,2811.47,0,1068360,0,0,0,0,0,0
20150105.091026,2811.47,0,1068360,0,0,0,0,0,0
20150105.091027,2811.47,0,1068360,0,0,0,0,0,0
20150105.091028,2811.47,0,1068360,0,0,0,0,0,0
20150105.091029,2811.47,0,1068360,0,0,0,0,0,0
20150105.09103,2811.47,0,1068360,0,0,0,0,0,0
20150105.091031,2811.47,0,1068360,0,0,0,0,0,0
20150105.091032,2811.47,0,1068360,0,0,0,0,0,0
20150105.091033,2811.47,0,1068360,0,0,0,0,0,0
20150105.091034,2811.47,0,1068360,0,0,0,0,0,0
20150105.091035,2811.47,0,1068360,0,0,0,0,0,0
20150105.091036,2811.47,0,1068360,0,0,0,0,0,0
20150105.091037,2811.47,0,1068360,0,0,0,0,0,0
20150105.091038,2811.47,0,1068360,0,0,0,0,0,0
20150105.091039,2811.47,0,1068360,0,0,0,0,0,0
20150105.09104,2811.47,0,1068360,0,0,0,0,0,0
20150105.091041,2811.47,0,1068360,0,0,0,0,0,0
20150105.091042,2811.47,0,1068360,0,0,0,0,0,0
20150105.091043,2811.47,0,1068360,0,0,0,0,0,0
20150105.091044,2811.47,0,1068360,0,0,0,0,0,0
20150105.091045,2811.47,0,1068360,0,0,0,0,0,0
20150105.091046,2811.47,0,1068360,0,0,0,0,0,0
20150105.091047,2811.47,0,1068360,0,0,0,0,0,0
20150105.091048,2811.47,0,1068360,0,0,0,0,0,0
20150105.091049,2811.47,0,1068360,0,0,0,0,0,0
20150105.09105,2811.47,0,1068360,0,0,0,0,0,0
20150105.091051,2811.47,0,1068360,0,0,0,0,0,0
20150105.091052,2811.47,0,1068360,0,0,0,0,0,0
20150105.091053,2811.47,0,1068360,0,0,0,0,0,0
20150105.091054,2811.47,0,1068360,0,0,0,0,0,0
20150105.091055,2811.47,0,1068360,0,0,0,0,0,0
20150105.091056,2811.47,0,1068360,0,0,0,0,0,0
20150105.091057,2811.47,0,1068360,0,0,0,0,0,0
20150105.091058,2811.47,0,1068360,0,0,0,0,0,0
20150105.091059,2811.47,0,1068360,0,0,0,0,0,0
20150105.0911,2811.47,0,1068360,0,0,0,0,0,0
20150105.091101,2811.47,0,1068360,0,0,0,0,0,0
20150105.091102,2811.47,0,1068360,0,0,0,0,0,0
20150105.091103,2811.47,0,1068360,0,0,0,0,0,0
20150105.091104,2811.47,0,1068360,0,0,0,0,0,0
20150105.091105,2811.47,0,1068360,0,0,0,0,0,0
20150105.091106,2811.47,0,1068360,0,0,0,0,0,0
20150105.091107,2811.47,0,1068360,0,0,0,0,0,0
20150105.091108,2811.47,0,1068360,0,0,0,0,0,0
20150105.091109,2811.47,0,1068360,0,0,0,0,0,0
20150105.09111,2811.47,0,1068360,0,0,0,0,0,0
20150105.091111,2811.47,0,1068360,0,0,0,0,0,0
20150105.091112,2811.47,0,1068360,0,0,0,0,0,0
20150105.091113,2811.47,0,1068360,0,0,0,0,0,0
20150105.091114,2811.47,0,1068360,0,0,0,0,0,0
20150105.091115,2811.47,0,1068360,0,0,0,0,0,0
20150105.091116,2811.47,0,1068360,0,0,0,0,0,0
20150105.091117,2811.47,0,1068360,0,0,0,0,0,0
20150105.091118,2811.47,0,1068360,0,0,0,0,0,0
20150105.091119,2811.47,0,1068360,0,0,0,0,0,0
20150105.09112,2811.47,0,1068360,0,0,0,0,0,0
20150105.091121,2811.47,0,1068360,0,0,0,0,0,0
20150105.091122,2811.47,0,1068360,0,0,0,0,0,0
20150105.091123,2811.47,0,1068360,0,0,0,0,0,0
20150105.091124,2811.47,0,1068360,0,0,0,0,0,0
20150105.091125,2811.47,0,1068360,0,0,0,0,0,0
20150105.091126,2811.47,0,1068360,0,0,0,0,0,0
20150105.091127,2811.47,0,1068360,0,0,0,0,0,0
20150105.091128,2811.47,0,1068360,0,0,0,0,0,0
20150105.091129,2811.47,0,1068360,0,0,0,0,0,0
20150105.09113,2811.47,0,1068360,0,0,0,0,0,0
20150105.091131,2811.47,0,1068360,0,0,0,0,0,0
20150105.091132,2811.47,0,1068360,0,0,0,0,0,0
20150105.091133,2811.47,0,1068360,0,0,0,0,0,0
20150105.091134,2811.47,0,1068360,0,0,0,0,0,0
20150105.091135,2811.47,0,1068360,0,0,0,0,0,0
20150105.091136,2811.47,0,1068360,0,0,0,0,0,0
20150105.091137,2811.47,0,1068360,0,0,0,0,0,0
20150105.091138,2811.47,0,1068360,0,0,0,0,0,0
20150105.091139,2811.47,0,1068360,0,0,0,0,0,0
20150105.09114,2811.47,0,1068360,0,0,0,0,0,0
20150105.091141,2811.47,0,1068360,0,0,0,0,0,0
20150105.091142,2811.47,0,1068360,0,0,0,0,0,0
20150105.091143,2811.47,0,1068360,0,0,0,0,0,0
20150105.091144,2811.47,0,1068360,0,0,0,0,0,0
20150105.091145,2811.47,0,1068360,0,0,0,0,0,0
20150105.091146,2811.47,0,1068360,0,0,0,0,0,0
20150105.091147,2811.47,0,1068360,0,0,0,0,0,0
20150105.091148,2811.47,0,1068360,0,0,0,0,0,0
20150105.091149,2811.47,0,1068360,0,0,0,0,0,0
20150105.09115,2811.47,0,1068360,0,0,0,0,0,0
20150105.091151,2811.47,0,1068360,0,0,0,0,0,0
20150105.091152,2811.47,0,1068360,0,0,0,0,0,0
20150105.091153,2811.47,0,1068360,0,0,0,0,0,0
20150105.091154,2811.47,0,1068360,0,0,0,0,0,0
20150105.091155,2811.47,0,1068360,0,0,0,0,0,0
20150105.091156,2811.47,0,1068360,0,0,0,0,0,0
20150105.091157,2811.47,0,1068360,0,0,0,0,0,0
20150105.091158,2811.47,0,1068360,0,0,0,0,0,0
20150105.091159,2811.47,0,1068360,0,0,0,0,0,0
20150105.0912,2811.47,0,1068360,0,0,0,0,0,0
20150105.091201,2811.47,0,1068360,0,0,0,0,0,0
20150105.091202,2811.47,0,1068360,0,0,0,0,0,0
20150105.091203,2811.47,0,1068360,0,0,0,0,0,0
20150105.091204,2811.47,0,1068360,0,0,0,0,0,0
20150105.091205,2811.47,0,1068360,0,0,0,0,0,0
20150105.091206,2811.47,0,1068360,0,0,0,0,0,0
20150105.091207,2811.47,0,1068360,0,0,0,0,0,0
20150105.091208,2811.47,0,1068360,0,0,0,0,0,0
20150105.091209,2811.47,0,1068360,0,0,0,0,0,0
20150105.09121,2811.47,0,1068360,0,0,0,0,0,0
20150105.091211,2811.47,0,1068360,0,0,0,0,0,0
20150105.091212,2811.47,0,1068360,0,0,0,0,0,0
20150105.091213,2811.47,0,1068360,0,0,0,0,0,0
20150105.091214,2811.47,0,1068360,0,0,0,0,0,0
20150105.091215,2811.47,0,1068360,0,0,0,0,0,0
20150105.091216,2811.47,0,1068360,0,0,0,0,0,0
20150105.091217,2811.47,0,1068360,0,0,0,0,0,0
20150105.091218,2811.47,0,1068360,0,0,0,0,0,0
20150105.091219,2811.47,0,1068360,0,0,0,0,0,0
20150105.09122,2811.47,0,1068360,0,0,0,0,0,0
20150105.091221,2811.47,0,1068360,0,0,0,0,0,0
20150105.091222,2811.47,0,1068360,0,0,0,0,0,0
20150105.091223,2811.47,0,1068360,0,0,0,0,0,0
20150105.091224,2811.47,0,1068360,0,0,0,0,0,0
20150105.091225,2811.47,0,1068360,0,0,0,0,0,0
20150105.091226,2811.47,0,1068360,0,0,0,0,0,0
20150105.091227,2811.47,0,1068360,0,0,0,0,0,0
20150105.091228,2811.47,0,1068360,0,0,0,0,0,0
20150105.091229,2811.47,0,1068360,0,0,0,0,0,0
20150105.09123,2811.47,0,1068360,0,0,0,0,0,0
20150105.091231,2811.47,0,1068360,0,0,0,0,0,0
20150105.091232,2811.47,0,1068360,0,0,0,0,0,0
20150105.091233,2811.47,0,1068360,0,0,0,0,0,0
20150105.091234,2811.47,0,1068360,0,0,0,0,0,0
20150105.091235,2811.47,0,1068360,0,0,0,0,0,0
20150105.091236,2811.47,0,1068360,0,0,0,0,0,0
20150105.091237,2811.47,0,1068360,0,0,0,0,0,0
20150105.091238,2811.47,0,1068360,0,0,0,0,0,0
20150105.091239,2811.47,0,1068360,0,0,0,0,0,0
20150105.09124,2811.47,0,1068360,0,0,0,0,0,0
20150105.091241,2811.47,0,1068360,0,0,0,0,0,0
20150105.091242,2811.47,0,1068360,0,0,0,0,0,0
20150105.091243,2811.47,0,1068360,0,0,0,0,0,0
20150105.091244,2811.47,0,1068360,0,0,0,0,0,0
20150105.091245,2811.47,0,1068360,0,0,0,0,0,0
20150105.091246,2811.47,0,1068360,0,0,0,0,0,0
20150105.091247,2811.47,0,1068360,0,0,0,0,0,0
20150105.091248,2811.47,0,1068360,0,0,0,0,0,0
20150105.091249,2811.47,0,1068360,0,0,0,0,0,0
20150105.09125,2811.47,0,1068360,0,0,0,0,0,0
20150105.091251,2811.47,0,1068360,0,0,0,0,0,0
20150105.091252,2811.47,0,1068360,0,0,0,0,0,0
20150105.091253,2811.47,0,1068360,0,0,0,0,0,0
20150105.091254,2811.47,0,1068360,0,0,0,0,0,0
20150105.091255,2811.47,0,1068360,0,0,0,0,0,0
20150105.091256,2811.47,0,1068360,0,0,0,0,0,0
20150105.091257,2811.47,0,1068360,0,0,0,0,0,0
20150105.091258,2811.47,0,1068360,0,0,0,0,0,0
20150105.091259,2811.47,0,1068360,0,0,0,0,0,0
20150105.0913,2811.47,0,1068360,0,0,0,0,0,0
20150105.091301,2811.47,0,1068360,0,0,0,0,0,0
20150105.091302,2811.47,0,1068360,0,0,0,0,0,0
20150105.091303,2811.47,0,1068360,0,0,0,0,0,0
20150105.091304,2811.47,0,1068360,0,0,0,0,0,0
20150105.091305,2811.47,0,1068360,0,0,0,0,0,0
20150105.091306,2811.47,0,1068360,0,0,0,0,0,0
20150105.091307,2811.47,0,1068360,0,0,0,0,0,0
20150105.091308,2811.47,0,1068360,0,0,0,0,0,0
20150105.091309,2811.47,0,1068360,0,0,0,0,0,0
20150105.09131,2811.47,0,1068360,0,0,0,0,0,0
20150105.091311,2811.47,0,1068360,0,0,0,0,0,0
20150105.091312,2811.47,0,1068360,0,0,0,0,0,0
20150105.091313,2811.47,0,1068360,0,0,0,0,0,0
20150105.091314,2811.47,0,1068360,0,0,0,0,0,0
20150105.091315,2811.47,0,1068360,0,0,0,0,0,0
20150105.091316,2811.47,0,1068360,0,0,0,0,0,0
20150105.091317,2811.47,0,1068360,0,0,0,0,0,0
20150105.091318,2811.47,0,1068360,0,0,0,0,0,0
20150105.091319,2811.47,0,1068360,0,0,0,0,0,0
20150105.09132,2811.47,0,1068360,0,0,0,0,0,0
20150105.091321,2811.47,0,1068360,0,0,0,0,0,0
20150105.091322,2811.47,0,1068360,0,0,0,0,0,0
20150105.091323,2811.47,0,1068360,0,0,0,0,0,0
20150105.091324,2811.47,0,1068360,0,0,0,0,0,0
20150105.091325,2811.47,0,1068360,0,0,0,0,0,0
20150105.091326,2811.47,0,1068360,0,0,0,0,0,0
20150105.091327,2811.47,0,1068360,0,0,0,0,0,0
20150105.091328,2811.47,0,1068360,0,0,0,0,0,0
20150105.091329,2811.47,0,1068360,0,0,0,0,0,0
20150105.09133,2811.47,0,1068360,0,0,0,0,0,0
20150105.091331,2811.47,0,1068360,0,0,0,0,0,0
20150105.091332,2811.47,0,1068360,0,0,0,0,0,0
20150105.091333,2811.47,0,1068360,0,0,0,0,0,0
20150105.091334,2811.47,0,1068360,0,0,0,0,0,0
20150105.091335,2811.47,0,1068360,0,0,0,0,0,0
20150105.091336,2811.47,0,1068360,0,0,0,0,0,0
20150105.091337,2811.47,0,1068360,0,0,0,0,0,0
20150105.091338,2811.47,0,1068360,0,0,0,0,0,0
20150105.091339,2811.47,0,1068360,0,0,0,0,0,0
20150105.09134,2811.47,0,1068360,0,0,0,0,0,0
20150105.091341,2811.47,0,1068360,0,0,0,0,0,0
20150105.091342,2811.47,0,1068360,0,0,0,0,0,0
20150105.091343,2811.47,0,1068360,0,0,0,0,0,0
20150105.091344,2811.47,0,1068360,0,0,0,0,0,0
20150105.091345,2811.47,0,1068360,0,0,0,0,0,0
20150105.091346,2811.47,0,1068360,0,0,0,0,0,0
20150105.091347,2811.47,0,1068360,0,0,0,0,0,0
20150105.091348,2811.47,0,1068360,0,0,0,0,0,0
20150105.091349,2811.47,0,1068360,0,0,0,0,0,0
20150105.09135,2811.47,0,1068360,0,0,0,0,0,0
20150105.091351,2811.47,0,1068360,0,0,0,0,0,0
20150105.091352,2811.47,0,1068360,0,0,0,0,0,0
20150105.091353,2811.47,0,1068360,0,0,0,0,0,0
20150105.091354,2811.47,0,1068360,0,0,0,0,0,0
20150105.091355,2811.47,0,1068360,0,0,0,0,0,0
20150105.091356,2811.47,0,1068360,0,0,0,0,0,0
20150105.091357,2811.47,0,1068360,0,0,0,0,0,0
20150105.091358,2811.47,0,1068360,0,0,0,0,0,0
20150105.091359,2811.47,0,1068360,0,0,0,0,0,0
20150105.0914,2811.47,0,1068360,0,0,0,0,0,0
20150105.091401,2811.47,0,1068360,0,0,0,0,0,0
20150105.091402,2811.47,0,1068360,0,0,0,0,0,0
20150105.091403,2811.47,0,1068360,0,0,0,0,0,0
20150105.091404,2811.47,0,1068360,0,0,0,0,0,0
20150105.091405,2811.47,0,1068360,0,0,0,0,0,0
20150105.091406,2811.47,0,1068360,0,0,0,0,0,0
20150105.091407,2811.47,0,1068360,0,0,0,0,0,0
20150105.091408,2811.47,0,1068360,0,0,0,0,0,0
20150105.091409,2811.47,0,1068360,0,0,0,0,0,0
20150105.09141,2811.47,0,1068360,0,0,0,0,0,0
20150105.091411,2811.47,0,1068360,0,0,0,0,0,0
20150105.091412,2811.47,0,1068360,0,0,0,0,0,0
20150105.091413,2811.47,0,1068360,0,0,0,0,0,0
20150105.091414,2811.47,0,1068360,0,0,0,0,0,0
20150105.091415,2811.47,0,1068360,0,0,0,0,0,0
20150105.091416,2811.47,0,1068360,0,0,0,0,0,0
20150105.091417,2811.47,0,1068360,0,0,0,0,0,0
20150105.091418,2811.47,0,1068360,0,0,0,0,0,0
20150105.091419,2811.47,0,1068360,0,0,0,0,0,0
20150105.09142,2811.47,0,1068360,0,0,0,0,0,0
20150105.091421,2811.47,0,1068360,0,0,0,0,0,0
20150105.091422,2811.47,0,1068360,0,0,0,0,0,0
20150105.091423,2811.47,0,1068360,0,0,0,0,0,0
20150105.091424,2811.47,0,1068360,0,0,0,0,0,0
20150105.091425,2811.47,0,1068360,0,0,0,0,0,0
20150105.091426,2811.47,0,1068360,0,0,0,0,0,0
20150105.091427,2811.47,0,1068360,0,0,0,0,0,0
20150105.091428,2811.47,0,1068360,0,0,0,0,0,0
20150105.091429,2811.47,0,1068360,0,0,0,0,0,0
20150105.09143,2811.47,0,1068360,0,0,0,0,0,0
20150105.091431,2811.47,0,1068360,0,0,0,0,0,0
20150105.091432,2811.47,0,1068360,0,0,0,0,0,0
20150105.091433,2811.47,0,1068360,0,0,0,0,0,0
20150105.091434,2811.47,0,1068360,0,0,0,0,0,0
20150105.091435,2811.47,0,1068360,0,0,0,0,0,0
20150105.091436,2811.47,0,1068360,0,0,0,0,0,0
20150105.091437,2811.47,0,1068360,0,0,0,0,0,0
20150105.091438,2811.47,0,1068360,0,0,0,0,0,0
20150105.091439,2811.47,0,1068360,0,0,0,0,0,0
20150105.09144,2811.47,0,1068360,0,0,0,0,0,0
20150105.091441,2811.47,0,1068360,0,0,0,0,0,0
20150105.091442,2811.47,0,1068360,0,0,0,0,0,0
20150105.091443,2811.47,0,1068360,0,0,0,0,0,0
20150105.091444,2811.47,0,1068360,0,0,0,0,0,0
20150105.091445,2811.47,0,1068360,0,0,0,0,0,0
20150105.091446,2811.47,0,1068360,0,0,0,0,0,0
20150105.091447,2811.47,0,1068360,0,0,0,0,0,0
20150105.091448,2811.47,0,1068360,0,0,0,0,0,0
20150105.091449,2811.47,0,1068360,0,0,0,0,0,0
20150105.09145,2811.47,0,1068360,0,0,0,0,0,0
20150105.091451,2811.47,0,1068360,0,0,0,0,0,0
20150105.091452,2811.47,0,1068360,0,0,0,0,0,0
20150105.091453,2811.47,0,1068360,0,0,0,0,0,0
20150105.091454,2811.47,0,1068360,0,0,0,0,0,0
20150105.091455,2811.47,0,1068360,0,0,0,0,0,0
20150105.091456,2811.47,0,1068360,0,0,0,0,0,0
20150105.091457,2811.47,0,1068360,0,0,0,0,0,0
20150105.091458,2811.47,0,1068360,0,0,0,0,0,0
20150105.091459,2811.47,0,1068360,0,0,0,0,0,0
20150105.0915,2811.47,0,1068360,0,0,0,0,0,0
20150105.091501,2811.47,0,1068360,0,0,0,0,0,0
20150105.091502,2811.47,0,1068360,0,0,0,0,0,0
20150105.091503,2811.47,0,1068360,0,0,0,0,0,0
20150105.091504,2811.47,0,1068360,0,0,0,0,0,0
20150105.091505,2811.47,0,1068360,0,0,0,0,0,0
20150105.091506,2811.47,0,1068360,0,0,0,0,0,0
20150105.091507,2811.47,0,1068360,0,0,0,0,0,0
20150105.091508,2811.47,0,1068360,0,0,0,0,0,0
20150105.091509,2811.47,0,1068360,0,0,0,0,0,0
20150105.09151,2811.47,0,1068360,0,0,0,0,0,0
20150105.091511,2811.47,0,1068360,0,0,0,0,0,0
20150105.091512,2811.47,0,1068360,0,0,0,0,0,0
20150105.091513,2811.47,0,1068360,0,0,0,0,0,0
20150105.091514,2811.47,0,1068360,0,0,0,0,0,0
20150105.091515,2811.47,0,1068360,0,0,0,0,0,0
20150105.091516,2811.47,0,1068360,0,0,0,0,0,0
20150105.091517,2811.47,0,1068360,0,0,0,0,0,0
20150105.091518,2811.47,0,1068360,0,0,0,0,0,0
20150105.091519,2811.47,0,1068360,0,0,0,0,0,0
20150105.09152,2811.47,0,1068360,0,0,0,0,0,0
20150105.091521,2811.47,0,1068360,0,0,0,0,0,0
20150105.091522,2811.47,0,1068360,0,0,0,0,0,0
20150105.091523,2811.47,0,1068360,0,0,0,0,0,0
20150105.091524,2811.47,0,1068360,0,0,0,0,0,0
20150105.091525,2811.47,0,1068360,0,0,0,0,0,0
20150105.091526,2811.47,0,1068360,0,0,0,0,0,0
20150105.091527,2811.47,0,1068360,0,0,0,0,0,0
20150105.091528,2811.47,0,1068360,0,0,0,0,0,0
20150105.091529,2811.47,0,1068360,0,0,0,0,0,0
20150105.09153,2811.47,0,1068360,0,0,0,0,0,0
20150105.091531,2811.47,0,1068360,0,0,0,0,0,0
20150105.091532,2811.47,0,1068360,0,0,0,0,0,0
20150105.091533,2811.47,0,1068360,0,0,0,0,0,0
20150105.091534,2811.47,0,1068360,0,0,0,0,0,0
20150105.091535,2811.47,0,1068360,0,0,0,0,0,0
20150105.091536,2811.47,0,1068360,0,0,0,0,0,0
20150105.091537,2811.47,0,1068360,0,0,0,0,0,0
20150105.091538,2811.47,0,1068360,0,0,0,0,0,0
20150105.091539,2811.47,0,1068360,0,0,0,0,0,0
20150105.09154,2811.47,0,1068360,0,0,0,0,0,0
20150105.091541,2811.47,0,1068360,0,0,0,0,0,0
20150105.091542,2811.47,0,1068360,0,0,0,0,0,0
20150105.091543,2811.47,0,1068360,0,0,0,0,0,0
20150105.091544,2811.47,0,1068360,0,0,0,0,0,0
20150105.091545,2811.47,0,1068360,0,0,0,0,0,0
20150105.091546,2811.47,0,1068360,0,0,0,0,0,0
20150105.091547,2811.47,0,1068360,0,0,0,0,0,0
20150105.091548,2811.47,0,1068360,0,0,0,0,0,0
20150105.091549,2811.47,0,1068360,0,0,0,0,0,0
20150105.09155,2811.47,0,1068360,0,0,0,0,0,0
20150105.091551,2811.47,0,1068360,0,0,0,0,0,0
20150105.091552,2811.47,0,1068360,0,0,0,0,0,0
20150105.091553,2811.47,0,1068360,0,0,0,0,0,0
20150105.091554,2811.47,0,1068360,0,0,0,0,0,0
20150105.091555,2811.47,0,1068360,0,0,0,0,0,0
20150105.091556,2811.47,0,1068360,0,0,0,0,0,0
20150105.091557,2811.47,0,1068360,0,0,0,0,0,0
20150105.091558,2811.47,0,1068360,0,0,0,0,0,0
20150105.091559,2811.47,0,1068360,0,0,0,0,0,0
20150105.0916,2811.47,0,1068360,0,0,0,0,0,0
20150105.091601,2811.47,0,1068360,0,0,0,0,0,0
20150105.091602,2811.47,0,1068360,0,0,0,0,0,0
20150105.091603,2811.47,0,1068360,0,0,0,0,0,0
20150105.091604,2811.47,0,1068360,0,0,0,0,0,0
20150105.091605,2811.47,0,1068360,0,0,0,0,0,0
20150105.091606,2811.47,0,1068360,0,0,0,0,0,0
20150105.091607,2811.47,0,1068360,0,0,0,0,0,0
20150105.091608,2811.47,0,1068360,0,0,0,0,0,0
20150105.091609,2811.47,0,1068360,0,0,0,0,0,0
20150105.09161,2811.47,0,1068360,0,0,0,0,0,0
20150105.091611,2811.47,0,1068360,0,0,0,0,0,0
20150105.091612,2811.47,0,1068360,0,0,0,0,0,0
20150105.091613,2811.47,0,1068360,0,0,0,0,0,0
20150105.091614,2811.47,0,1068360,0,0,0,0,0,0
20150105.091615,2811.47,0,1068360,0,0,0,0,0,0
20150105.091616,2811.47,0,1068360,0,0,0,0,0,0
20150105.091617,2811.47,0,1068360,0,0,0,0,0,0
20150105.091618,2811.47,0,1068360,0,0,0,0,0,0
20150105.091619,2811.47,0,1068360,0,0,0,0,0,0
20150105.09162,2811.47,0,1068360,0,0,0,0,0,0
20150105.091621,2811.47,0,1068360,0,0,0,0,0,0
20150105.091622,2811.47,0,1068360,0,0,0,0,0,0
20150105.091623,2811.47,0,1068360,0,0,0,0,0,0
20150105.091624,2811.47,0,1068360,0,0,0,0,0,0
20150105.091625,2811.47,0,1068360,0,0,0,0,0,0
20150105.091626,2811.47,0,1068360,0,0,0,0,0,0
20150105.091627,2811.47,0,1068360,0,0,0,0,0,0
20150105.091628,2811.47,0,1068360,0,0,0,0,0,0
20150105.091629,2811.47,0,1068360,0,0,0,0,0,0
20150105.09163,2811.47,0,1068360,0,0,0,0,0,0
20150105.091631,2811.47,0,1068360,0,0,0,0,0,0
20150105.091632,2811.47,0,1068360,0,0,0,0,0,0
20150105.091633,2811.47,0,1068360,0,0,0,0,0,0
20150105.091634,2811.47,0,1068360,0,0,0,0,0,0
20150105.091635,2811.47,0,1068360,0,0,0,0,0,0
20150105.091636,2811.47,0,1068360,0,0,0,0,0,0
20150105.091637,2811.47,0,1068360,0,0,0,0,0,0
20150105.091638,2811.47,0,1068360,0,0,0,0,0,0
20150105.091639,2811.47,0,1068360,0,0,0,0,0,0
20150105.09164,2811.47,0,1068360,0,0,0,0,0,0
20150105.091641,2811.47,0,1068360,0,0,0,0,0,0
20150105.091642,2811.47,0,1068360,0,0,0,0,0,0
20150105.091643,2811.47,0,1068360,0,0,0,0,0,0
20150105.091644,2811.47,0,1068360,0,0,0,0,0,0
20150105.091645,2811.47,0,1068360,0,0,0,0,0,0
20150105.091646,2811.47,0,1068360,0,0,0,0,0,0
20150105.091647,2811.47,0,1068360,0,0,0,0,0,0
20150105.091648,2811.47,0,1068360,0,0,0,0,0,0
20150105.091649,2811.47,0,1068360,0,0,0,0,0,0
20150105.09165,2811.47,0,1068360,0,0,0,0,0,0
20150105.091651,2811.47,0,1068360,0,0,0,0,0,0
20150105.091652,2811.47,0,1068360,0,0,0,0,0,0
20150105.091653,2811.47,0,1068360,0,0,0,0,0,0
20150105.091654,2811.47,0,1068360,0,0,0,0,0,0
20150105.091655,2811.47,0,1068360,0,0,0,0,0,0
20150105.091656,2811.47,0,1068360,0,0,0,0,0,0
20150105.091657,2811.47,0,1068360,0,0,0,0,0,0
20150105.091658,2811.47,0,1068360,0,0,0,0,0,0
20150105.091659,2811.47,0,1068360,0,0,0,0,0,0
20150105.0917,2811.47,0,1068360,0,0,0,0,0,0
20150105.091701,2811.47,0,1068360,0,0,0,0,0,0
20150105.091702,2811.47,0,1068360,0,0,0,0,0,0
20150105.091703,2811.47,0,1068360,0,0,0,0,0,0
20150105.091704,2811.47,0,1068360,0,0,0,0,0,0
20150105.091705,2811.47,0,1068360,0,0,0,0,0,0
20150105.091706,2811.47,0,1068360,0,0,0,0,0,0
20150105.091707,2811.47,0,1068360,0,0,0,0,0,0
20150105.091708,2811.47,0,1068360,0,0,0,0,0,0
20150105.091709,2811.47,0,1068360,0,0,0,0,0,0
20150105.09171,2811.47,0,1068360,0,0,0,0,0,0
20150105.091711,2811.47,0,1068360,0,0,0,0,0,0
20150105.091712,2811.47,0,1068360,0,0,0,0,0,0
20150105.091713,2811.47,0,1068360,0,0,0,0,0,0
20150105.091714,2811.47,0,1068360,0,0,0,0,0,0
20150105.091715,2811.47,0,1068360,0,0,0,0,0,0
20150105.091716,2811.47,0,1068360,0,0,0,0,0,0
20150105.091717,2811.47,0,1068360,0,0,0,0,0,0
20150105.091718,2811.47,0,1068360,0,0,0,0,0,0
20150105.091719,2811.47,0,1068360,0,0,0,0,0,0
20150105.09172,2811.47,0,1068360,0,0,0,0,0,0
20150105.091721,2811.47,0,1068360,0,0,0,0,0,0
20150105.091722,2811.47,0,1068360,0,0,0,0,0,0
20150105.091723,2811.47,0,1068360,0,0,0,0,0,0
20150105.091724,2811.47,0,1068360,0,0,0,0,0,0
20150105.091725,2811.47,0,1068360,0,0,0,0,0,0
20150105.091726,2811.47,0,1068360,0,0,0,0,0,0
20150105.091727,2811.47,0,1068360,0,0,0,0,0,0
20150105.091728,2811.47,0,1068360,0,0,0,0,0,0
20150105.091729,2811.47,0,1068360,0,0,0,0,0,0
20150105.09173,2811.47,0,1068360,0,0,0,0,0,0
20150105.091731,2811.47,0,1068360,0,0,0,0,0,0
20150105.091732,2811.47,0,1068360,0,0,0,0,0,0
20150105.091733,2811.47,0,1068360,0,0,0,0,0,0
20150105.091734,2811.47,0,1068360,0,0,0,0,0,0
20150105.091735,2811.47,0,1068360,0,0,0,0,0,0
20150105.091736,2811.47,0,1068360,0,0,0,0,0,0
20150105.091737,2811.47,0,1068360,0,0,0,0,0,0
20150105.091738,2811.47,0,1068360,0,0,0,0,0,0
20150105.091739,2811.47,0,1068360,0,0,0,0,0,0
20150105.09174,2811.47,0,1068360,0,0,0,0,0,0
20150105.091741,2811.47,0,1068360,0,0,0,0,0,0
20150105.091742,2811.47,0,1068360,0,0,0,0,0,0
20150105.091743,2811.47,0,1068360,0,0,0,0,0,0
20150105.091744,2811.47,0,1068360,0,0,0,0,0,0
20150105.091745,2811.47,0,1068360,0,0,0,0,0,0
20150105.091746,2811.47,0,1068360,0,0,0,0,0,0
20150105.091747,2811.47,0,1068360,0,0,0,0,0,0
20150105.091748,2811.47,0,1068360,0,0,0,0,0,0
20150105.091749,2811.47,0,1068360,0,0,0,0,0,0
20150105.09175,2811.47,0,1068360,0,0,0,0,0,0
20150105.091751,2811.47,0,1068360,0,0,0,0,0,0
20150105.091752,2811.47,0,1068360,0,0,0,0,0,0
20150105.091753,2811.47,0,1068360,0,0,0,0,0,0
20150105.091754,2811.47,0,1068360,0,0,0,0,0,0
20150105.091755,2811.47,0,1068360,0,0,0,0,0,0
20150105.091756,2811.47,0,1068360,0,0,0,0,0,0
20150105.091757,2811.47,0,1068360,0,0,0,0,0,0
20150105.091758,2811.47,0,1068360,0,0,0,0,0,0
20150105.091759,2811.47,0,1068360,0,0,0,0,0,0
20150105.0918,2811.47,0,1068360,0,0,0,0,0,0
20150105.091801,2811.47,0,1068360,0,0,0,0,0,0
20150105.091802,2811.47,0,1068360,0,0,0,0,0,0
20150105.091803,2811.47,0,1068360,0,0,0,0,0,0
20150105.091804,2811.47,0,1068360,0,0,0,0,0,0
20150105.091805,2811.47,0,1068360,0,0,0,0,0,0
20150105.091806,2811.47,0,1068360,0,0,0,0,0,0
20150105.091807,2811.47,0,1068360,0,0,0,0,0,0
20150105.091808,2811.47,0,1068360,0,0,0,0,0,0
20150105.091809,2811.47,0,1068360,0,0,0,0,0,0
20150105.09181,2811.47,0,1068360,0,0,0,0,0,0
20150105.091811,2811.47,0,1068360,0,0,0,0,0,0
20150105.091812,2811.47,0,1068360,0,0,0,0,0,0
20150105.091813,2811.47,0,1068360,0,0,0,0,0,0
20150105.091814,2811.47,0,1068360,0,0,0,0,0,0
20150105.091815,2811.47,0,1068360,0,0,0,0,0,0
20150105.091816,2811.47,0,1068360,0,0,0,0,0,0
20150105.091817,2811.47,0,1068360,0,0,0,0,0,0
20150105.091818,2811.47,0,1068360,0,0,0,0,0,0
20150105.091819,2811.47,0,1068360,0,0,0,0,0,0
20150105.09182,2811.47,0,1068360,0,0,0,0,0,0
20150105.091821,2811.47,0,1068360,0,0,0,0,0,0
20150105.091822,2811.47,0,1068360,0,0,0,0,0,0
20150105.091823,2811.47,0,1068360,0,0,0,0,0,0
20150105.091824,2811.47,0,1068360,0,0,0,0,0,0
20150105.091825,2811.47,0,1068360,0,0,0,0,0,0
20150105.091826,2811.47,0,1068360,0,0,0,0,0,0
20150105.091827,2811.47,0,1068360,0,0,0,0,0,0
20150105.091828,2811.47,0,1068360,0,0,0,0,0,0
20150105.091829,2811.47,0,1068360,0,0,0,0,0,0
20150105.09183,2811.47,0,1068360,0,0,0,0,0,0
20150105.091831,2811.47,0,1068360,0,0,0,0,0,0
20150105.091832,2811.47,0,1068360,0,0,0,0,0,0
20150105.091833,2811.47,0,1068360,0,0,0,0,0,0
20150105.091834,2811.47,0,1068360,0,0,0,0,0,0
20150105.091835,2811.47,0,1068360,0,0,0,0,0,0
20150105.091836,2811.47,0,1068360,0,0,0,0,0,0
20150105.091837,2811.47,0,1068360,0,0,0,0,0,0
20150105.091838,2811.47,0,1068360,0,0,0,0,0,0
20150105.091839,2811.47,0,1068360,0,0,0,0,0,0
20150105.09184,2811.47,0,1068360,0,0,0,0,0,0
20150105.091841,2811.47,0,1068360,0,0,0,0,0,0
20150105.091842,2811.47,0,1068360,0,0,0,0,0,0
20150105.091843,2811.47,0,1068360,0,0,0,0,0,0
20150105.091844,2811.47,0,1068360,0,0,0,0,0,0
20150105.091845,2811.47,0,1068360,0,0,0,0,0,0
20150105.091846,2811.47,0,1068360,0,0,0,0,0,0
20150105.091847,2811.47,0,1068360,0,0,0,0,0,0
20150105.091848,2811.47,0,1068360,0,0,0,0,0,0
20150105.091849,2811.47,0,1068360,0,0,0,0,0,0
20150105.09185,2811.47,0,1068360,0,0,0,0,0,0
20150105.091851,2811.47,0,1068360,0,0,0,0,0,0
20150105.091852,2811.47,0,1068360,0,0,0,0,0,0
20150105.091853,2811.47,0,1068360,0,0,0,0,0,0
20150105.091854,2811.47,0,1068360,0,0,0,0,0,0
20150105.091855,2811.47,0,1068360,0,0,0,0,0,0
20150105.091856,2811.47,0,1068360,0,0,0,0,0,0
20150105.091857,2811.47,0,1068360,0,0,0,0,0,0
20150105.091858,2811.47,0,1068360,0,0,0,0,0,0
20150105.091859,2811.47,0,1068360,0,0,0,0,0,0
20150105.0919,2811.47,0,1068360,0,0,0,0,0,0
20150105.091901,2811.47,0,1068360,0,0,0,0,0,0
20150105.091902,2811.47,0,1068360,0,0,0,0,0,0
20150105.091903,2811.47,0,1068360,0,0,0,0,0,0
20150105.091904,2811.47,0,1068360,0,0,0,0,0,0
20150105.091905,2811.47,0,1068360,0,0,0,0,0,0
20150105.091906,2811.47,0,1068360,0,0,0,0,0,0
20150105.091907,2811.47,0,1068360,0,0,0,0,0,0
20150105.091908,2811.47,0,1068360,0,0,0,0,0,0
20150105.091909,2811.47,0,1068360,0,0,0,0,0,0
20150105.09191,2811.47,0,1068360,0,0,0,0,0,0
20150105.091911,2811.47,0,1068360,0,0,0,0,0,0
20150105.091912,2811.47,0,1068360,0,0,0,0,0,0
20150105.091913,2811.47,0,1068360,0,0,0,0,0,0
20150105.091914,2811.47,0,1068360,0,0,0,0,0,0
20150105.091915,2811.47,0,1068360,0,0,0,0,0,0
20150105.091916,2811.47,0,1068360,0,0,0,0,0,0
20150105.091917,2811.47,0,1068360,0,0,0,0,0,0
20150105.091918,2811.47,0,1068360,0,0,0,0,0,0
20150105.091919,2811.47,0,1068360,0,0,0,0,0,0
20150105.09192,2811.47,0,1068360,0,0,0,0,0,0
20150105.091921,2811.47,0,1068360,0,0,0,0,0,0
20150105.091922,2811.47,0,1068360,0,0,0,0,0,0
20150105.091923,2811.47,0,1068360,0,0,0,0,0,0
20150105.091924,2811.47,0,1068360,0,0,0,0,0,0
20150105.091925,2811.47,0,1068360,0,0,0,0,0,0
20150105.091926,2811.47,0,1068360,0,0,0,0,0,0
20150105.091927,2811.47,0,1068360,0,0,0,0,0,0
20150105.091928,2811.47,0,1068360,0,0,0,0,0,0
20150105.091929,2811.47,0,1068360,0,0,0,0,0,0
20150105.09193,2811.47,0,1068360,0,0,0,0,0,0
20150105.091931,2811.47,0,1068360,0,0,0,0,0,0
20150105.091932,2811.47,0,1068360,0,0,0,0,0,0
20150105.091933,2811.47,0,1068360,0,0,0,0,0,0
20150105.091934,2811.47,0,1068360,0,0,0,0,0,0
20150105.091935,2811.47,0,1068360,0,0,0,0,0,0
20150105.091936,2811.47,0,1068360,0,0,0,0,0,0
20150105.091937,2811.47,0,1068360,0,0,0,0,0,0
20150105.091938,2811.47,0,1068360,0,0,0,0,0,0
20150105.091939,2811.47,0,1068360,0,0,0,0,0,0
20150105.09194,2811.47,0,1068360,0,0,0,0,0,0
20150105.091941,2811.47,0,1068360,0,0,0,0,0,0
20150105.091942,2811.47,0,1068360,0,0,0,0,0,0
20150105.091943,2811.47,0,1068360,0,0,0,0,0,0
20150105.091944,2811.47,0,1068360,0,0,0,0,0,0
20150105.091945,2811.47,0,1068360,0,0,0,0,0,0
20150105.091946,2811.47,0,1068360,0,0,0,0,0,0
20150105.091947,2811.47,0,1068360,0,0,0,0,0,0
20150105.091948,2811.47,0,1068360,0,0,0,0,0,0
20150105.091949,2811.47,0,1068360,0,0,0,0,0,0
20150105.09195,2811.47,0,1068360,0,0,0,0,0,0
20150105.091951,2811.47,0,1068360,0,0,0,0,0,0
20150105.091952,2811.47,0,1068360,0,0,0,0,0,0
20150105.091953,2811.47,0,1068360,0,0,0,0,0,0
20150105.091954,2811.47,0,1068360,0,0,0,0,0,0
20150105.091955,2811.47,0,1068360,0,0,0,0,0,0
20150105.091956,2811.47,0,1068360,0,0,0,0,0,0
20150105.091957,2811.47,0,1068360,0,0,0,0,0,0
20150105.091958,2811.47,0,1068360,0,0,0,0,0,0
20150105.091959,2811.47,0,1068360,0,0,0,0,0,0
20150105.092,2811.47,0,1068360,0,0,0,0,0,0
20150105.092001,2811.47,0,1068360,0,0,0,0,0,0
20150105.092002,2811.47,0,1068360,0,0,0,0,0,0
20150105.092003,2811.47,0,1068360,0,0,0,0,0,0
20150105.092004,2811.47,0,1068360,0,0,0,0,0,0
20150105.092005,2811.47,0,1068360,0,0,0,0,0,0
20150105.092006,2811.47,0,1068360,0,0,0,0,0,0
20150105.092007,2811.47,0,1068360,0,0,0,0,0,0
20150105.092008,2811.47,0,1068360,0,0,0,0,0,0
20150105.092009,2811.47,0,1068360,0,0,0,0,0,0
20150105.09201,2811.47,0,1068360,0,0,0,0,0,0
20150105.092011,2811.47,0,1068360,0,0,0,0,0,0
20150105.092012,2811.47,0,1068360,0,0,0,0,0,0
20150105.092013,2811.47,0,1068360,0,0,0,0,0,0
20150105.092014,2811.47,0,1068360,0,0,0,0,0,0
20150105.092015,2811.47,0,1068360,0,0,0,0,0,0
20150105.092016,2811.47,0,1068360,0,0,0,0,0,0
20150105.092017,2811.47,0,1068360,0,0,0,0,0,0
20150105.092018,2811.47,0,1068360,0,0,0,0,0,0
20150105.092019,2811.47,0,1068360,0,0,0,0,0,0
20150105.09202,2811.47,0,1068360,0,0,0,0,0,0
20150105.092021,2811.47,0,1068360,0,0,0,0,0,0
20150105.092022,2811.47,0,1068360,0,0,0,0,0,0
20150105.092023,2811.47,0,1068360,0,0,0,0,0,0
20150105.092024,2811.47,0,1068360,0,0,0,0,0,0
20150105.092025,2811.47,0,1068360,0,0,0,0,0,0
20150105.092026,2811.47,0,1068360,0,0,0,0,0,0
20150105.092027,2811.47,0,1068360,0,0,0,0,0,0
20150105.092028,2811.47,0,1068360,0,0,0,0,0,0
20150105.092029,2811.47,0,1068360,0,0,0,0,0,0
20150105.09203,2811.47,0,1068360,0,0,0,0,0,0
20150105.092031,2811.47,0,1068360,0,0,0,0,0,0
20150105.092032,2811.47,0,1068360,0,0,0,0,0,0
20150105.092033,2811.47,0,1068360,0,0,0,0,0,0
20150105.092034,2811.47,0,1068360,0,0,0,0,0,0
20150105.092035,2811.47,0,1068360,0,0,0,0,0,0
20150105.092036,2811.47,0,1068360,0,0,0,0,0,0
20150105.092037,2811.47,0,1068360,0,0,0,0,0,0
20150105.092038,2811.47,0,1068360,0,0,0,0,0,0
20150105.092039,2811.47,0,1068360,0,0,0,0,0,0
20150105.09204,2811.47,0,1068360,0,0,0,0,0,0
20150105.092041,2811.47,0,1068360,0,0,0,0,0,0
20150105.092042,2811.47,0,1068360,0,0,0,0,0,0
20150105.092043,2811.47,0,1068360,0,0,0,0,0,0
20150105.092044,2811.47,0,1068360,0,0,0,0,0,0
20150105.092045,2811.47,0,1068360,0,0,0,0,0,0
20150105.092046,2811.47,0,1068360,0,0,0,0,0,0
20150105.092047,2811.47,0,1068360,0,0,0,0,0,0
20150105.092048,2811.47,0,1068360,0,0,0,0,0,0
20150105.092049,2811.47,0,1068360,0,0,0,0,0,0
20150105.09205,2811.47,0,1068360,0,0,0,0,0,0
20150105.092051,2811.47,0,1068360,0,0,0,0,0,0
20150105.092052,2811.47,0,1068360,0,0,0,0,0,0
20150105.092053,2811.47,0,1068360,0,0,0,0,0,0
20150105.092054,2811.47,0,1068360,0,0,0,0,0,0
20150105.092055,2811.47,0,1068360,0,0,0,0,0,0
20150105.092056,2811.47,0,1068360,0,0,0,0,0,0
20150105.092057,2811.47,0,1068360,0,0,0,0,0,0
20150105.092058,2811.47,0,1068360,0,0,0,0,0,0
20150105.092059,2811.47,0,1068360,0,0,0,0,0,0
20150105.0921,2811.47,0,1068360,0,0,0,0,0,0
20150105.092101,2811.47,0,1068360,0,0,0,0,0,0
20150105.092102,2811.47,0,1068360,0,0,0,0,0,0
20150105.092103,2811.47,0,1068360,0,0,0,0,0,0
20150105.092104,2811.47,0,1068360,0,0,0,0,0,0
20150105.092105,2811.47,0,1068360,0,0,0,0,0,0
20150105.092106,2811.47,0,1068360,0,0,0,0,0,0
20150105.092107,2811.47,0,1068360,0,0,0,0,0,0
20150105.092108,2811.47,0,1068360,0,0,0,0,0,0
20150105.092109,2811.47,0,1068360,0,0,0,0,0,0
20150105.09211,2811.47,0,1068360,0,0,0,0,0,0
20150105.092111,2811.47,0,1068360,0,0,0,0,0,0
20150105.092112,2811.47,0,1068360,0,0,0,0,0,0
20150105.092113,2811.47,0,1068360,0,0,0,0,0,0
20150105.092114,2811.47,0,1068360,0,0,0,0,0,0
20150105.092115,2811.47,0,1068360,0,0,0,0,0,0
20150105.092116,2811.47,0,1068360,0,0,0,0,0,0
20150105.092117,2811.47,0,1068360,0,0,0,0,0,0
20150105.092118,2811.47,0,1068360,0,0,0,0,0,0
20150105.092119,2811.47,0,1068360,0,0,0,0,0,0
20150105.09212,2811.47,0,1068360,0,0,0,0,0,0
20150105.092121,2811.47,0,1068360,0,0,0,0,0,0
20150105.092122,2811.47,0,1068360,0,0,0,0,0,0
20150105.092123,2811.47,0,1068360,0,0,0,0,0,0
20150105.092124,2811.47,0,1068360,0,0,0,0,0,0
20150105.092125,2811.47,0,1068360,0,0,0,0,0,0
20150105.092126,2811.47,0,1068360,0,0,0,0,0,0
20150105.092127,2811.47,0,1068360,0,0,0,0,0,0
20150105.092128,2811.47,0,1068360,0,0,0,0,0,0
20150105.092129,2811.47,0,1068360,0,0,0,0,0,0
20150105.09213,2811.47,0,1068360,0,0,0,0,0,0
20150105.092131,2811.47,0,1068360,0,0,0,0,0,0
20150105.092132,2811.47,0,1068360,0,0,0,0,0,0
20150105.092133,2811.47,0,1068360,0,0,0,0,0,0
20150105.092134,2811.47,0,1068360,0,0,0,0,0,0
20150105.092135,2811.47,0,1068360,0,0,0,0,0,0
20150105.092136,2811.47,0,1068360,0,0,0,0,0,0
20150105.092137,2811.47,0,1068360,0,0,0,0,0,0
20150105.092138,2811.47,0,1068360,0,0,0,0,0,0
20150105.092139,2811.47,0,1068360,0,0,0,0,0,0
20150105.09214,2811.47,0,1068360,0,0,0,0,0,0
20150105.092141,2811.47,0,1068360,0,0,0,0,0,0
20150105.092142,2811.47,0,1068360,0,0,0,0,0,0
20150105.092143,2811.47,0,1068360,0,0,0,0,0,0
20150105.092144,2811.47,0,1068360,0,0,0,0,0,0
20150105.092145,2811.47,0,1068360,0,0,0,0,0,0
20150105.092146,2811.47,0,1068360,0,0,0,0,0,0
20150105.092147,2811.47,0,1068360,0,0,0,0,0,0
20150105.092148,2811.47,0,1068360,0,0,0,0,0,0
20150105.092149,2811.47,0,1068360,0,0,0,0,0,0
20150105.09215,2811.47,0,1068360,0,0,0,0,0,0
20150105.092151,2811.47,0,1068360,0,0,0,0,0,0
20150105.092152,2811.47,0,1068360,0,0,0,0,0,0
20150105.092153,2811.47,0,1068360,0,0,0,0,0,0
20150105.092154,2811.47,0,1068360,0,0,0,0,0,0
20150105.092155,2811.47,0,1068360,0,0,0,0,0,0
20150105.092156,2811.47,0,1068360,0,0,0,0,0,0
20150105.092157,2811.47,0,1068360,0,0,0,0,0,0
20150105.092158,2811.47,0,1068360,0,0,0,0,0,0
20150105.092159,2811.47,0,1068360,0,0,0,0,0,0
20150105.0922,2811.47,0,1068360,0,0,0,0,0,0
20150105.092201,2811.47,0,1068360,0,0,0,0,0,0
20150105.092202,2811.47,0,1068360,0,0,0,0,0,0
20150105.092203,2811.47,0,1068360,0,0,0,0,0,0
20150105.092204,2811.47,0,1068360,0,0,0,0,0,0
20150105.092205,2811.47,0,1068360,0,0,0,0,0,0
20150105.092206,2811.47,0,1068360,0,0,0,0,0,0
20150105.092207,2811.47,0,1068360,0,0,0,0,0,0
20150105.092208,2811.47,0,1068360,0,0,0,0,0,0
20150105.092209,2811.47,0,1068360,0,0,0,0,0,0
20150105.09221,2811.47,0,1068360,0,0,0,0,0,0
20150105.092211,2811.47,0,1068360,0,0,0,0,0,0
20150105.092212,2811.47,0,1068360,0,0,0,0,0,0
20150105.092213,2811.47,0,1068360,0,0,0,0,0,0
20150105.092214,2811.47,0,1068360,0,0,0,0,0,0
20150105.092215,2811.47,0,1068360,0,0,0,0,0,0
20150105.092216,2811.47,0,1068360,0,0,0,0,0,0
20150105.092217,2811.47,0,1068360,0,0,0,0,0,0
20150105.092218,2811.47,0,1068360,0,0,0,0,0,0
20150105.092219,2811.47,0,1068360,0,0,0,0,0,0
20150105.09222,2811.47,0,1068360,0,0,0,0,0,0
20150105.092221,2811.47,0,1068360,0,0,0,0,0,0
20150105.092222,2811.47,0,1068360,0,0,0,0,0,0
20150105.092223,2811.47,0,1068360,0,0,0,0,0,0
20150105.092224,2811.47,0,1068360,0,0,0,0,0,0
20150105.092225,2811.47,0,1068360,0,0,0,0,0,0
20150105.092226,2811.47,0,1068360,0,0,0,0,0,0
20150105.092227,2811.47,0,1068360,0,0,0,0,0,0
20150105.092228,2811.47,0,1068360,0,0,0,0,0,0
20150105.092229,2811.47,0,1068360,0,0,0,0,0,0
20150105.09223,2811.47,0,1068360,0,0,0,0,0,0
20150105.092231,2811.47,0,1068360,0,0,0,0,0,0
20150105.092232,2811.47,0,1068360,0,0,0,0,0,0
20150105.092233,2811.47,0,1068360,0,0,0,0,0,0
20150105.092234,2811.47,0,1068360,0,0,0,0,0,0
20150105.092235,2811.47,0,1068360,0,0,0,0,0,0
20150105.092236,2811.47,0,1068360,0,0,0,0,0,0
20150105.092237,2811.47,0,1068360,0,0,0,0,0,0
20150105.092238,2811.47,0,1068360,0,0,0,0,0,0
20150105.092239,2811.47,0,1068360,0,0,0,0,0,0
20150105.09224,2811.47,0,1068360,0,0,0,0,0,0
20150105.092241,2811.47,0,1068360,0,0,0,0,0,0
20150105.092242,2811.47,0,1068360,0,0,0,0,0,0
20150105.092243,2811.47,0,1068360,0,0,0,0,0,0
20150105.092244,2811.47,0,1068360,0,0,0,0,0,0
20150105.092245,2811.47,0,1068360,0,0,0,0,0,0
20150105.092246,2811.47,0,1068360,0,0,0,0,0,0
20150105.092247,2811.47,0,1068360,0,0,0,0,0,0
20150105.092248,2811.47,0,1068360,0,0,0,0,0,0
20150105.092249,2811.47,0,1068360,0,0,0,0,0,0
20150105.09225,2811.47,0,1068360,0,0,0,0,0,0
20150105.092251,2811.47,0,1068360,0,0,0,0,0,0
20150105.092252,2811.47,0,1068360,0,0,0,0,0,0
20150105.092253,2811.47,0,1068360,0,0,0,0,0,0
20150105.092254,2811.47,0,1068360,0,0,0,0,0,0
20150105.092255,2811.47,0,1068360,0,0,0,0,0,0
20150105.092256,2811.47,0,1068360,0,0,0,0,0,0
20150105.092257,2811.47,0,1068360,0,0,0,0,0,0
20150105.092258,2811.47,0,1068360,0,0,0,0,0,0
20150105.092259,2811.47,0,1068360,0,0,0,0,0,0
20150105.0923,2811.47,0,1068360,0,0,0,0,0,0
20150105.092301,2811.47,0,1068360,0,0,0,0,0,0
20150105.092302,2811.47,0,1068360,0,0,0,0,0,0
20150105.092303,2811.47,0,1068360,0,0,0,0,0,0
20150105.092304,2811.47,0,1068360,0,0,0,0,0,0
20150105.092305,2811.47,0,1068360,0,0,0,0,0,0
20150105.092306,2811.47,0,1068360,0,0,0,0,0,0
20150105.092307,2811.47,0,1068360,0,0,0,0,0,0
20150105.092308,2811.47,0,1068360,0,0,0,0,0,0
20150105.092309,2811.47,0,1068360,0,0,0,0,0,0
20150105.09231,2811.47,0,1068360,0,0,0,0,0,0
20150105.092311,2811.47,0,1068360,0,0,0,0,0,0
20150105.092312,2811.47,0,1068360,0,0,0,0,0,0
20150105.092313,2811.47,0,1068360,0,0,0,0,0,0
20150105.092314,2811.47,0,1068360,0,0,0,0,0,0
20150105.092315,2811.47,0,1068360,0,0,0,0,0,0
20150105.092316,2811.47,0,1068360,0,0,0,0,0,0
20150105.092317,2811.47,0,1068360,0,0,0,0,0,0
20150105.092318,2811.47,0,1068360,0,0,0,0,0,0
20150105.092319,2811.47,0,1068360,0,0,0,0,0,0
20150105.09232,2811.47,0,1068360,0,0,0,0,0,0
20150105.092321,2811.47,0,1068360,0,0,0,0,0,0
20150105.092322,2811.47,0,1068360,0,0,0,0,0,0
20150105.092323,2811.47,0,1068360,0,0,0,0,0,0
20150105.092324,2811.47,0,1068360,0,0,0,0,0,0
20150105.092325,2811.47,0,1068360,0,0,0,0,0,0
20150105.092326,2811.47,0,1068360,0,0,0,0,0,0
20150105.092327,2811.47,0,1068360,0,0,0,0,0,0
20150105.092328,2811.47,0,1068360,0,0,0,0,0,0
20150105.092329,2811.47,0,1068360,0,0,0,0,0,0
20150105.09233,2811.47,0,1068360,0,0,0,0,0,0
20150105.092331,2811.47,0,1068360,0,0,0,0,0,0
20150105.092332,2811.47,0,1068360,0,0,0,0,0,0
20150105.092333,2811.47,0,1068360,0,0,0,0,0,0
20150105.092334,2811.47,0,1068360,0,0,0,0,0,0
20150105.092335,2811.47,0,1068360,0,0,0,0,0,0
20150105.092336,2811.47,0,1068360,0,0,0,0,0,0
20150105.092337,2811.47,0,1068360,0,0,0,0,0,0
20150105.092338,2811.47,0,1068360,0,0,0,0,0,0
20150105.092339,2811.47,0,1068360,0,0,0,0,0,0
20150105.09234,2811.47,0,1068360,0,0,0,0,0,0
20150105.092341,2811.47,0,1068360,0,0,0,0,0,0
20150105.092342,2811.47,0,1068360,0,0,0,0,0,0
20150105.092343,2811.47,0,1068360,0,0,0,0,0,0
20150105.092344,2811.47,0,1068360,0,0,0,0,0,0
20150105.092345,2811.47,0,1068360,0,0,0,0,0,0
20150105.092346,2811.47,0,1068360,0,0,0,0,0,0
20150105.092347,2811.47,0,1068360,0,0,0,0,0,0
20150105.092348,2811.47,0,1068360,0,0,0,0,0,0
20150105.092349,2811.47,0,1068360,0,0,0,0,0,0
20150105.09235,2811.47,0,1068360,0,0,0,0,0,0
20150105.092351,2811.47,0,1068360,0,0,0,0,0,0
20150105.092352,2811.47,0,1068360,0,0,0,0,0,0
20150105.092353,2811.47,0,1068360,0,0,0,0,0,0
20150105.092354,2811.47,0,1068360,0,0,0,0,0,0
20150105.092355,2811.47,0,1068360,0,0,0,0,0,0
20150105.092356,2811.47,0,1068360,0,0,0,0,0,0
20150105.092357,2811.47,0,1068360,0,0,0,0,0,0
20150105.092358,2811.47,0,1068360,0,0,0,0,0,0
20150105.092359,2811.47,0,1068360,0,0,0,0,0,0
20150105.0924,2811.47,0,1068360,0,0,0,0,0,0
20150105.092401,2811.47,0,1068360,0,0,0,0,0,0
20150105.092402,2811.47,0,1068360,0,0,0,0,0,0
20150105.092403,2811.47,0,1068360,0,0,0,0,0,0
20150105.092404,2811.47,0,1068360,0,0,0,0,0,0
20150105.092405,2811.47,0,1068360,0,0,0,0,0,0
20150105.092406,2811.47,0,1068360,0,0,0,0,0,0
20150105.092407,2811.47,0,1068360,0,0,0,0,0,0
20150105.092408,2811.47,0,1068360,0,0,0,0,0,0
20150105.092409,2811.47,0,1068360,0,0,0,0,0,0
20150105.09241,2811.47,0,1068360,0,0,0,0,0,0
20150105.092411,2811.47,0,1068360,0,0,0,0,0,0
20150105.092412,2811.47,0,1068360,0,0,0,0,0,0
20150105.092413,2811.47,0,1068360,0,0,0,0,0,0
20150105.092414,2811.47,0,1068360,0,0,0,0,0,0
20150105.092415,2811.47,0,1068360,0,0,0,0,0,0
20150105.092416,2811.47,0,1068360,0,0,0,0,0,0
20150105.092417,2811.47,0,1068360,0,0,0,0,0,0
20150105.092418,2811.47,0,1068360,0,0,0,0,0,0
20150105.092419,2811.47,0,1068360,0,0,0,0,0,0
20150105.09242,2811.47,0,1068360,0,0,0,0,0,0
20150105.092421,2811.47,0,1068360,0,0,0,0,0,0
20150105.092422,2811.47,0,1068360,0,0,0,0,0,0
20150105.092423,2811.47,0,1068360,0,0,0,0,0,0
20150105.092424,2811.47,0,1068360,0,0,0,0,0,0
20150105.092425,2811.47,0,1068360,0,0,0,0,0,0
20150105.092426,2811.47,0,1068360,0,0,0,0,0,0
20150105.092427,2811.47,0,1068360,0,0,0,0,0,0
20150105.092428,2811.47,0,1068360,0,0,0,0,0,0
20150105.092429,2811.47,0,1068360,0,0,0,0,0,0
20150105.09243,2811.47,0,1068360,0,0,0,0,0,0
20150105.092431,2811.47,0,1068360,0,0,0,0,0,0
20150105.092432,2811.47,0,1068360,0,0,0,0,0,0
20150105.092433,2811.47,0,1068360,0,0,0,0,0,0
20150105.092434,2811.47,0,1068360,0,0,0,0,0,0
20150105.092435,2811.47,0,1068360,0,0,0,0,0,0
20150105.092436,2811.47,0,1068360,0,0,0,0,0,0
20150105.092437,2811.47,0,1068360,0,0,0,0,0,0
20150105.092438,2811.47,0,1068360,0,0,0,0,0,0
20150105.092439,2811.47,0,1068360,0,0,0,0,0,0
20150105.09244,2811.47,0,1068360,0,0,0,0,0,0
20150105.092441,2811.47,0,1068360,0,0,0,0,0,0
20150105.092442,2811.47,0,1068360,0,0,0,0,0,0
20150105.092443,2811.47,0,1068360,0,0,0,0,0,0
20150105.092444,2811.47,0,1068360,0,0,0,0,0,0
20150105.092445,2811.47,0,1068360,0,0,0,0,0,0
20150105.092446,2811.47,0,1068360,0,0,0,0,0,0
20150105.092447,2811.47,0,1068360,0,0,0,0,0,0
20150105.092448,2811.47,0,1068360,0,0,0,0,0,0
20150105.092449,2811.47,0,1068360,0,0,0,0,0,0
20150105.09245,2811.47,0,1068360,0,0,0,0,0,0
20150105.092451,2811.47,0,1068360,0,0,0,0,0,0
20150105.092452,2811.47,0,1068360,0,0,0,0,0,0
20150105.092453,2811.47,0,1068360,0,0,0,0,0,0
20150105.092454,2811.47,0,1068360,0,0,0,0,0,0
20150105.092455,2811.47,0,1068360,0,0,0,0,0,0
20150105.092456,2811.47,0,1068360,0,0,0,0,0,0
20150105.092457,2811.47,0,1068360,0,0,0,0,0,0
20150105.092458,2811.47,0,1068360,0,0,0,0,0,0
20150105.092459,2811.47,0,1068360,0,0,0,0,0,0
20150105.0925,2811.47,0,1068360,0,0,0,0,0,0
20150105.092501,2811.47,0,1068360,0,0,0,0,0,0
20150105.092502,2811.47,0,1068360,0,0,0,0,0,0
20150105.092503,2811.47,0,1068360,0,0,0,0,0,0
20150105.092504,2811.47,0,1068360,0,0,0,0,0,0
20150105.092505,2811.47,0,1068360,0,0,0,0,0,0
20150105.092506,2811.47,0,1068360,0,0,0,0,0,0
20150105.092507,2811.47,0,1068360,0,0,0,0,0,0
20150105.092508,2811.47,0,1068360,0,0,0,0,0,0
20150105.092509,2811.47,0,1068360,0,0,0,0,0,0
20150105.09251,2811.47,0,1068360,0,0,0,0,0,0
20150105.092511,2811.47,0,1068360,0,0,0,0,0,0
20150105.092512,2811.47,0,1068360,0,0,0,0,0,0
20150105.092513,2811.47,0,1068360,0,0,0,0,0,0
20150105.092514,2811.47,0,1068360,0,0,0,0,0,0
20150105.092515,2811.47,0,1068360,0,0,0,0,0,0
20150105.092516,2811.47,0,1068360,0,0,0,0,0,0
20150105.092517,2811.47,0,1068360,0,0,0,0,0,0
20150105.092518,2811.47,0,1068360,0,0,0,0,0,0
20150105.092519,2811.47,0,1068360,0,0,0,0,0,0
20150105.09252,2811.47,0,1068360,0,0,0,0,0,0
20150105.092521,2811.47,0,1068360,0,0,0,0,0,0
20150105.092522,2811.47,0,1068360,0,0,0,0,0,0
20150105.092523,2811.47,0,1068360,0,0,0,0,0,0
20150105.092524,2811.47,0,1068360,0,0,0,0,0,0
20150105.092525,2811.47,0,1068360,0,0,0,0,0,0
20150105.092526,2811.47,0,1068360,0,0,0,0,0,0
20150105.092527,2811.47,0,1068360,0,0,0,0,0,0
20150105.092528,2811.47,0,1068360,0,0,0,0,0,0
20150105.092529,2811.47,0,1068360,0,0,0,0,0,0
20150105.09253,2811.47,0,1068360,0,0,0,0,0,0
20150105.092531,2811.47,0,1068360,0,0,0,0,0,0
20150105.092532,2811.47,0,1068360,0,0,0,0,0,0
20150105.092533,2811.47,0,1068360,0,0,0,0,0,0
20150105.092534,2811.47,0,1068360,0,0,0,0,0,0
20150105.092535,2811.47,0,1068360,0,0,0,0,0,0
20150105.092536,2811.47,0,1068360,0,0,0,0,0,0
20150105.092537,2811.47,0,1068360,0,0,0,0,0,0
20150105.092538,2811.47,0,1068360,0,0,0,0,0,0
20150105.092539,2811.47,0,1068360,0,0,0,0,0,0
20150105.09254,2811.47,0,1068360,0,0,0,0,0,0
20150105.092541,2811.47,0,1068360,0,0,0,0,0,0
20150105.092542,2811.47,0,1068360,0,0,0,0,0,0
20150105.092543,2811.47,0,1068360,0,0,0,0,0,0
20150105.092544,2811.47,0,1068360,0,0,0,0,0,0
20150105.092545,2811.47,0,1068360,0,0,0,0,0,0
20150105.092546,2811.47,0,1068360,0,0,0,0,0,0
20150105.092547,2811.47,0,1068360,0,0,0,0,0,0
20150105.092548,2811.47,0,1068360,0,0,0,0,0,0
20150105.092549,2811.47,0,1068360,0,0,0,0,0,0
20150105.09255,2811.47,0,1068360,0,0,0,0,0,0
20150105.092551,2811.47,0,1068360,0,0,0,0,0,0
20150105.092552,2811.47,0,1068360,0,0,0,0,0,0
20150105.092553,2811.47,0,1068360,0,0,0,0,0,0
20150105.092554,2811.47,0,1068360,0,0,0,0,0,0
20150105.092555,2811.47,0,1068360,0,0,0,0,0,0
20150105.092556,2811.47,0,1068360,0,0,0,0,0,0
20150105.092557,2811.47,0,1068360,0,0,0,0,0,0
20150105.092558,2811.47,0,1068360,0,0,0,0,0,0
20150105.092559,2811.47,0,1068360,0,0,0,0,0,0
20150105.0926,2811.47,0,1068360,0,0,0,0,0,0
20150105.092601,2811.47,0,1068360,0,0,0,0,0,0
20150105.092602,2811.47,0,1068360,0,0,0,0,0,0
20150105.092603,2811.47,0,1068360,0,0,0,0,0,0
20150105.092604,2811.47,0,1068360,0,0,0,0,0,0
20150105.092605,2811.47,0,1068360,0,0,0,0,0,0
20150105.092606,2811.47,0,1068360,0,0,0,0,0,0
20150105.092607,2811.47,0,1068360,0,0,0,0,0,0
20150105.092608,2811.47,0,1068360,0,0,0,0,0,0
20150105.092609,2811.47,0,1068360,0,0,0,0,0,0
20150105.09261,2811.47,0,1068360,0,0,0,0,0,0
20150105.092611,2811.47,0,1068360,0,0,0,0,0,0
20150105.092612,2811.47,0,1068360,0,0,0,0,0,0
20150105.092613,2811.47,0,1068360,0,0,0,0,0,0
20150105.092614,2811.47,0,1068360,0,0,0,0,0,0
20150105.092615,2811.47,0,1068360,0,0,0,0,0,0
20150105.092616,2811.47,0,1068360,0,0,0,0,0,0
20150105.092617,2811.47,0,1068360,0,0,0,0,0,0
20150105.092618,2811.47,0,1068360,0,0,0,0,0,0
20150105.092619,2811.47,0,1068360,0,0,0,0,0,0
20150105.09262,2811.47,0,1068360,0,0,0,0,0,0
20150105.092621,2811.47,0,1068360,0,0,0,0,0,0
20150105.092622,2811.47,0,1068360,0,0,0,0,0,0
20150105.092623,2811.47,0,1068360,0,0,0,0,0,0
20150105.092624,2811.47,0,1068360,0,0,0,0,0,0
20150105.092625,2811.47,0,1068360,0,0,0,0,0,0
20150105.092626,2811.47,0,1068360,0,0,0,0,0,0
20150105.092627,2811.47,0,1068360,0,0,0,0,0,0
20150105.092628,2811.47,0,1068360,0,0,0,0,0,0
20150105.092629,2811.47,0,1068360,0,0,0,0,0,0
20150105.09263,2811.47,0,1068360,0,0,0,0,0,0
20150105.092631,2811.47,0,1068360,0,0,0,0,0,0
20150105.092632,2811.47,0,1068360,0,0,0,0,0,0
20150105.092633,2811.47,0,1068360,0,0,0,0,0,0
20150105.092634,2811.47,0,1068360,0,0,0,0,0,0
20150105.092635,2811.47,0,1068360,0,0,0,0,0,0
20150105.092636,2811.47,0,1068360,0,0,0,0,0,0
20150105.092637,2811.47,0,1068360,0,0,0,0,0,0
20150105.092638,2811.47,0,1068360,0,0,0,0,0,0
20150105.092639,2811.47,0,1068360,0,0,0,0,0,0
20150105.09264,2811.47,0,1068360,0,0,0,0,0,0
20150105.092641,2811.47,0,1068360,0,0,0,0,0,0
20150105.092642,2811.47,0,1068360,0,0,0,0,0,0
20150105.092643,2811.47,0,1068360,0,0,0,0,0,0
20150105.092644,2811.47,0,1068360,0,0,0,0,0,0
20150105.092645,2811.47,0,1068360,0,0,0,0,0,0
20150105.092646,2811.47,0,1068360,0,0,0,0,0,0
20150105.092647,2811.47,0,1068360,0,0,0,0,0,0
20150105.092648,2811.47,0,1068360,0,0,0,0,0,0
20150105.092649,2811.47,0,1068360,0,0,0,0,0,0
20150105.09265,2811.47,0,1068360,0,0,0,0,0,0
20150105.092651,2811.47,0,1068360,0,0,0,0,0,0
20150105.092652,2811.47,0,1068360,0,0,0,0,0,0
20150105.092653,2811.47,0,1068360,0,0,0,0,0,0
20150105.092654,2811.47,0,1068360,0,0,0,0,0,0
20150105.092655,2811.47,0,1068360,0,0,0,0,0,0
20150105.092656,2811.47,0,1068360,0,0,0,0,0,0
20150105.092657,2811.47,0,1068360,0,0,0,0,0,0
20150105.092658,2811.47,0,1068360,0,0,0,0,0,0
20150105.092659,2811.47,0,1068360,0,0,0,0,0,0
20150105.0927,2811.47,0,1068360,0,0,0,0,0,0
20150105.092701,2811.47,0,1068360,0,0,0,0,0,0
20150105.092702,2811.47,0,1068360,0,0,0,0,0,0
20150105.092703,2811.47,0,1068360,0,0,0,0,0,0
20150105.092704,2811.47,0,1068360,0,0,0,0,0,0
20150105.092705,2811.47,0,1068360,0,0,0,0,0,0
20150105.092706,2811.47,0,1068360,0,0,0,0,0,0
20150105.092707,2811.47,0,1068360,0,0,0,0,0,0
20150105.092708,2811.47,0,1068360,0,0,0,0,0,0
20150105.092709,2811.47,0,1068360,0,0,0,0,0,0
20150105.09271,2811.47,0,1068360,0,0,0,0,0,0
20150105.092711,2811.47,0,1068360,0,0,0,0,0,0
20150105.092712,2811.47,0,1068360,0,0,0,0,0,0
20150105.092713,2811.47,0,1068360,0,0,0,0,0,0
20150105.092714,2811.47,0,1068360,0,0,0,0,0,0
20150105.092715,2811.47,0,1068360,0,0,0,0,0,0
20150105.092716,2811.47,0,1068360,0,0,0,0,0,0
20150105.092717,2811.47,0,1068360,0,0,0,0,0,0
20150105.092718,2811.47,0,1068360,0,0,0,0,0,0
20150105.092719,2811.47,0,1068360,0,0,0,0,0,0
20150105.09272,2811.47,0,1068360,0,0,0,0,0,0
20150105.092721,2811.47,0,1068360,0,0,0,0,0,0
20150105.092722,2811.47,0,1068360,0,0,0,0,0,0
20150105.092723,2811.47,0,1068360,0,0,0,0,0,0
20150105.092724,2811.47,0,1068360,0,0,0,0,0,0
20150105.092725,2811.47,0,1068360,0,0,0,0,0,0
20150105.092726,2811.47,0,1068360,0,0,0,0,0,0
20150105.092727,2811.47,0,1068360,0,0,0,0,0,0
20150105.092728,2811.47,0,1068360,0,0,0,0,0,0
20150105.092729,2811.47,0,1068360,0,0,0,0,0,0
20150105.09273,2811.47,0,1068360,0,0,0,0,0,0
20150105.092731,2811.47,0,1068360,0,0,0,0,0,0
20150105.092732,2811.47,0,1068360,0,0,0,0,0,0
20150105.092733,2811.47,0,1068360,0,0,0,0,0,0
20150105.092734,2811.47,0,1068360,0,0,0,0,0,0
20150105.092735,2811.47,0,1068360,0,0,0,0,0,0
20150105.092736,2811.47,0,1068360,0,0,0,0,0,0
20150105.092737,2811.47,0,1068360,0,0,0,0,0,0
20150105.092738,2811.47,0,1068360,0,0,0,0,0,0
20150105.092739,2811.47,0,1068360,0,0,0,0,0,0
20150105.09274,2811.47,0,1068360,0,0,0,0,0,0
20150105.092741,2811.47,0,1068360,0,0,0,0,0,0
20150105.092742,2811.47,0,1068360,0,0,0,0,0,0
20150105.092743,2811.47,0,1068360,0,0,0,0,0,0
20150105.092744,2811.47,0,1068360,0,0,0,0,0,0
20150105.092745,2811.47,0,1068360,0,0,0,0,0,0
20150105.092746,2811.47,0,1068360,0,0,0,0,0,0
20150105.092747,2811.47,0,1068360,0,0,0,0,0,0
20150105.092748,2811.47,0,1068360,0,0,0,0,0,0
20150105.092749,2811.47,0,1068360,0,0,0,0,0,0
20150105.09275,2811.47,0,1068360,0,0,0,0,0,0
20150105.092751,2811.47,0,1068360,0,0,0,0,0,0
20150105.092752,2811.47,0,1068360,0,0,0,0,0,0
20150105.092753,2811.47,0,1068360,0,0,0,0,0,0
20150105.092754,2811.47,0,1068360,0,0,0,0,0,0
20150105.092755,2811.47,0,1068360,0,0,0,0,0,0
20150105.092756,2811.47,0,1068360,0,0,0,0,0,0
20150105.092757,2811.47,0,1068360,0,0,0,0,0,0
20150105.092758,2811.47,0,1068360,0,0,0,0,0,0
20150105.092759,2811.47,0,1068360,0,0,0,0,0,0
20150105.0928,2811.47,0,1068360,0,0,0,0,0,0
20150105.092801,2811.47,0,1068360,0,0,0,0,0,0
20150105.092802,2811.47,0,1068360,0,0,0,0,0,0
20150105.092803,2811.47,0,1068360,0,0,0,0,0,0
20150105.092804,2811.47,0,1068360,0,0,0,0,0,0
20150105.092805,2811.47,0,1068360,0,0,0,0,0,0
20150105.092806,2811.47,0,1068360,0,0,0,0,0,0
20150105.092807,2811.47,0,1068360,0,0,0,0,0,0
20150105.092808,2811.47,0,1068360,0,0,0,0,0,0
20150105.092809,2811.47,0,1068360,0,0,0,0,0,0
20150105.09281,2811.47,0,1068360,0,0,0,0,0,0
20150105.092811,2811.47,0,1068360,0,0,0,0,0,0
20150105.092812,2811.47,0,1068360,0,0,0,0,0,0
20150105.092813,2811.47,0,1068360,0,0,0,0,0,0
20150105.092814,2811.47,0,1068360,0,0,0,0,0,0
20150105.092815,2811.47,0,1068360,0,0,0,0,0,0
20150105.092816,2811.47,0,1068360,0,0,0,0,0,0
20150105.092817,2811.47,0,1068360,0,0,0,0,0,0
20150105.092818,2811.47,0,1068360,0,0,0,0,0,0
20150105.092819,2811.47,0,1068360,0,0,0,0,0,0
20150105.09282,2811.47,0,1068360,0,0,0,0,0,0
20150105.092821,2811.47,0,1068360,0,0,0,0,0,0
20150105.092822,2811.47,0,1068360,0,0,0,0,0,0
20150105.092823,2811.47,0,1068360,0,0,0,0,0,0
20150105.092824,2811.47,0,1068360,0,0,0,0,0,0
20150105.092825,2811.47,0,1068360,0,0,0,0,0,0
20150105.092826,2811.47,0,1068360,0,0,0,0,0,0
20150105.092827,2811.47,0,1068360,0,0,0,0,0,0
20150105.092828,2811.47,0,1068360,0,0,0,0,0,0
20150105.092829,2811.47,0,1068360,0,0,0,0,0,0
20150105.09283,2811.47,0,1068360,0,0,0,0,0,0
20150105.092831,2811.47,0,1068360,0,0,0,0,0,0
20150105.092832,2811.47,0,1068360,0,0,0,0,0,0
20150105.092833,2811.47,0,1068360,0,0,0,0,0,0
20150105.092834,2811.47,0,1068360,0,0,0,0,0,0
20150105.092835,2811.47,0,1068360,0,0,0,0,0,0
20150105.092836,2811.47,0,1068360,0,0,0,0,0,0
20150105.092837,2811.47,0,1068360,0,0,0,0,0,0
20150105.092838,2811.47,0,1068360,0,0,0,0,0,0
20150105.092839,2811.47,0,1068360,0,0,0,0,0,0
20150105.09284,2811.47,0,1068360,0,0,0,0,0,0
20150105.092841,2811.47,0,1068360,0,0,0,0,0,0
20150105.092842,2811.47,0,1068360,0,0,0,0,0,0
20150105.092843,2811.47,0,1068360,0,0,0,0,0,0
20150105.092844,2811.47,0,1068360,0,0,0,0,0,0
20150105.092845,2811.47,0,1068360,0,0,0,0,0,0
20150105.092846,2811.47,0,1068360,0,0,0,0,0,0
20150105.092847,2811.47,0,1068360,0,0,0,0,0,0
20150105.092848,2811.47,0,1068360,0,0,0,0,0,0
20150105.092849,2811.47,0,1068360,0,0,0,0,0,0
20150105.09285,2811.47,0,1068360,0,0,0,0,0,0
20150105.092851,2811.47,0,1068360,0,0,0,0,0,0
20150105.092852,2811.47,0,1068360,0,0,0,0,0,0
20150105.092853,2811.47,0,1068360,0,0,0,0,0,0
20150105.092854,2811.47,0,1068360,0,0,0,0,0,0
20150105.092855,2811.47,0,1068360,0,0,0,0,0,0
20150105.092856,2811.47,0,1068360,0,0,0,0,0,0
20150105.092857,2811.47,0,1068360,0,0,0,0,0,0
20150105.092858,2811.47,0,1068360,0,0,0,0,0,0
20150105.092859,2811.47,0,1068360,0,0,0,0,0,0
20150105.0929,2811.47,0,1068360,0,0,0,0,0,0
20150105.092901,2811.47,0,1068360,0,0,0,0,0,0
20150105.092902,2811.47,0,1068360,0,0,0,0,0,0
20150105.092903,2811.47,0,1068360,0,0,0,0,0,0
20150105.092904,2811.47,0,1068360,0,0,0,0,0,0
20150105.092905,2811.47,0,1068360,0,0,0,0,0,0
20150105.092906,2811.47,0,1068360,0,0,0,0,0,0
20150105.092907,2811.47,0,1068360,0,0,0,0,0,0
20150105.092908,2811.47,0,1068360,0,0,0,0,0,0
20150105.092909,2811.47,0,1068360,0,0,0,0,0,0
20150105.09291,2811.47,0,1068360,0,0,0,0,0,0
20150105.092911,2811.47,0,1068360,0,0,0,0,0,0
20150105.092912,2811.47,0,1068360,0,0,0,0,0,0
20150105.092913,2811.47,0,1068360,0,0,0,0,0,0
20150105.092914,2811.47,0,1068360,0,0,0,0,0,0
20150105.092915,2811.47,0,1068360,0,0,0,0,0,0
20150105.092916,2811.47,0,1068360,0,0,0,0,0,0
20150105.092917,2811.47,0,1068360,0,0,0,0,0,0
20150105.092918,2811.47,0,1068360,0,0,0,0,0,0
20150105.092919,2811.47,0,1068360,0,0,0,0,0,0
20150105.09292,2811.47,0,1068360,0,0,0,0,0,0
20150105.092921,2811.47,0,1068360,0,0,0,0,0,0
20150105.092922,2811.47,0,1068360,0,0,0,0,0,0
20150105.092923,2811.47,0,1068360,0,0,0,0,0,0
20150105.092924,2811.47,0,1068360,0,0,0,0,0,0
20150105.092925,2811.47,0,1068360,0,0,0,0,0,0
20150105.092926,2811.47,0,1068360,0,0,0,0,0,0
20150105.092927,2811.47,0,1068360,0,0,0,0,0,0
20150105.092928,2811.47,0,1068360,0,0,0,0,0,0
20150105.092929,2811.47,0,1068360,0,0,0,0,0,0
20150105.09293,2811.47,0,1068360,0,0,0,0,0,0
20150105.092931,2811.47,0,1068360,0,0,0,0,0,0
20150105.092932,2811.47,0,1068360,0,0,0,0,0,0
20150105.092933,2811.47,0,1068360,0,0,0,0,0,0
20150105.092934,2811.47,0,1068360,0,0,0,0,0,0
20150105.092935,2811.47,0,1068360,0,0,0,0,0,0
20150105.092936,2811.47,0,1068360,0,0,0,0,0,0
20150105.092937,2811.47,0,1068360,0,0,0,0,0,0
20150105.092938,2811.47,0,1068360,0,0,0,0,0,0
20150105.092939,2811.47,0,1068360,0,0,0,0,0,0
20150105.09294,2811.47,0,1068360,0,0,0,0,0,0
20150105.092941,2811.47,0,1068360,0,0,0,0,0,0
20150105.092942,2811.47,0,1068360,0,0,0,0,0,0
20150105.092943,2811.47,0,1068360,0,0,0,0,0,0
20150105.092944,2811.47,0,1068360,0,0,0,0,0,0
20150105.092945,2811.47,0,1068360,0,0,0,0,0,0
20150105.092946,2811.47,0,1068360,0,0,0,0,0,0
20150105.092947,2811.47,0,1068360,0,0,0,0,0,0
20150105.092948,2811.47,0,1068360,0,0,0,0,0,0
20150105.092949,2811.47,0,1068360,0,0,0,0,0,0
20150105.09295,2811.47,0,1068360,0,0,0,0,0,0
20150105.092951,2811.47,0,1068360,0,0,0,0,0,0
20150105.092952,2811.47,0,1068360,0,0,0,0,0,0
20150105.092953,2811.47,0,1068360,0,0,0,0,0,0
20150105.092954,2811.47,0,1068360,0,0,0,0,0,0
20150105.092955,2811.47,0,1068360,0,0,0,0,0,0
20150105.092956,2811.47,0,1068360,0,0,0,0,0,0
20150105.092957,2811.47,0,1068360,0,0,0,0,0,0
20150105.092958,2811.47,0,1068360,0,0,0,0,0,0
20150105.092959,2811.47,0,1068360,0,0,0,0,0,0
20150105.093,2811.47,0,1068360,0,0,0,0,0,0
20150105.093001,2811.47,0,1068360,0,0,0,0,0,0
20150105.093002,2811.47,0,1068360,0,0,0,0,0,0
20150105.093003,2811.47,0,1068360,0,0,0,0,0,0
20150105.093004,2811.47,0,1068360,0,0,0,0,0,0
20150105.093005,2811.47,0,1068360,0,0,0,0,0,0
20150105.093006,2811.47,0,1068360,0,0,0,0,0,0
20150105.093007,2811.47,0,1068360,0,0,0,0,0,0
20150105.093008,2811.47,0,1068360,0,0,0,0,0,0
20150105.093009,2811.47,0,1068360,0,0,0,0,0,0
20150105.09301,2811.47,0,1068360,0,0,0,0,0,0
20150105.093011,2811.47,0,1068360,0,0,0,0,0,0
20150105.093012,2811.47,0,1068360,0,0,0,0,0,0
20150105.093013,2811.47,0,1068360,0,0,0,0,0,0
20150105.093014,2811.47,0,1068360,0,0,0,0,0,0
20150105.093015,2811.47,0,1068360,0,0,0,0,0,0
20150105.093016,2811.47,0,1068360,0,0,0,0,0,0
20150105.093017,2811.47,0,1068360,0,0,0,0,0,0
20150105.093018,2811.47,0,1068360,0,0,0,0,0,0
20150105.093019,2811.47,0,1068360,0,0,0,0,0,0
20150105.09302,2811.47,0,1068360,0,0,0,0,0,0
20150105.093021,2811.47,0,1068360,0,0,0,0,0,0
20150105.093022,2811.47,0,1068360,0,0,0,0,0,0
20150105.093023,2811.47,0,1068360,0,0,0,0,0,0
20150105.093024,2811.47,0,1068360,0,0,0,0,0,0
20150105.093025,2811.47,0,1068360,0,0,0,0,0,0
20150105.093026,2811.47,0,1068360,0,0,0,0,0,0
20150105.093027,2811.47,0,1068360,0,0,0,0,0,0
20150105.093028,2811.47,0,1068360,0,0,0,0,0,0
20150105.093029,2811.47,0,1068360,0,0,0,0,0,0
20150105.09303,2811.47,0,1068360,0,0,0,0,0,0
20150105.093031,2811.47,0,1068360,0,0,0,0,0,0
20150105.093032,2811.47,0,1068360,0,0,0,0,0,0
20150105.093033,2811.47,0,1068360,0,0,0,0,0,0
20150105.093034,2811.47,0,1068360,0,0,0,0,0,0
20150105.093035,2811.47,0,1068360,0,0,0,0,0,0
20150105.093036,2811.47,0,1068360,0,0,0,0,0,0
20150105.093037,2811.47,0,1068360,0,0,0,0,0,0
20150105.093038,2811.47,0,1068360,0,0,0,0,0,0
20150105.093039,2811.47,0,1068360,0,0,0,0,0,0
20150105.09304,2811.47,0,1068360,0,0,0,0,0,0
20150105.093041,2811.47,0,1068360,0,0,0,0,0,0
20150105.093042,2811.47,0,1068360,0,0,0,0,0,0
20150105.093043,2811.47,0,1068360,0,0,0,0,0,0
20150105.093044,2811.47,0,1068360,0,0,0,0,0,0
20150105.093045,2811.47,0,1068360,0,0,0,0,0,0
20150105.093046,2811.47,0,1068360,0,0,0,0,0,0
20150105.093047,2811.47,0,1068360,0,0,0,0,0,0
20150105.093048,2811.47,0,1068360,0,0,0,0,0,0
20150105.093049,2811.47,0,1068360,0,0,0,0,0,0
20150105.09305,2811.47,0,1068360,0,0,0,0,0,0
20150105.093051,2811.47,0,1068360,0,0,0,0,0,0
20150105.093052,2811.47,0,1068360,0,0,0,0,0,0
20150105.093053,2811.47,0,1068360,0,0,0,0,0,0
20150105.093054,2811.47,0,1068360,0,0,0,0,0,0
20150105.093055,2811.47,0,1068360,0,0,0,0,0,0
20150105.093056,2811.47,0,1068360,0,0,0,0,0,0
20150105.093057,2811.47,0,1068360,0,0,0,0,0,0
20150105.093058,2811.47,0,1068360,0,0,0,0,0,0
20150105.093059,2811.47,0,1068360,0,0,0,0,0,0
20150105.0931,2811.47,0,1068360,0,0,0,0,0,0
20150105.093101,2811.47,0,1068360,0,0,0,0,0,0
20150105.093102,2811.47,0,1068360,0,0,0,0,0,0
20150105.093103,2811.47,0,1068360,0,0,0,0,0,0
20150105.093104,2811.47,0,1068360,0,0,0,0,0,0
20150105.093105,2811.47,0,1068360,0,0,0,0,0,0
20150105.093106,2811.47,0,1068360,0,0,0,0,0,0
20150105.093107,2811.47,0,1068360,0,0,0,0,0,0
20150105.093108,2811.47,0,1068360,0,0,0,0,0,0
20150105.093109,2811.47,0,1068360,0,0,0,0,0,0
20150105.09311,2811.47,0,1068360,0,0,0,0,0,0
20150105.093111,2811.47,0,1068360,0,0,0,0,0,0
20150105.093112,2811.47,0,1068360,0,0,0,0,0,0
20150105.093113,2811.47,0,1068360,0,0,0,0,0,0
20150105.093114,2811.47,0,1068360,0,0,0,0,0,0
20150105.093115,2811.47,0,1068360,0,0,0,0,0,0
20150105.093116,2811.47,0,1068360,0,0,0,0,0,0
20150105.093117,2811.47,0,1068360,0,0,0,0,0,0
20150105.093118,2811.47,0,1068360,0,0,0,0,0,0
20150105.093119,2811.47,0,1068360,0,0,0,0,0,0
20150105.09312,2811.47,0,1068360,0,0,0,0,0,0
20150105.093121,2811.47,0,1068360,0,0,0,0,0,0
20150105.093122,2811.47,0,1068360,0,0,0,0,0,0
20150105.093123,2811.47,0,1068360,0,0,0,0,0,0
20150105.093124,2811.47,0,1068360,0,0,0,0,0,0
20150105.093125,2811.47,0,1068360,0,0,0,0,0,0
20150105.093126,2811.47,0,1068360,0,0,0,0,0,0
20150105.093127,2811.47,0,1068360,0,0,0,0,0,0
20150105.093128,2811.47,0,1068360,0,0,0,0,0,0
20150105.093129,2811.47,0,1068360,0,0,0,0,0,0
20150105.09313,2811.47,0,1068360,0,0,0,0,0,0
20150105.093131,2811.47,0,1068360,0,0,0,0,0,0
20150105.093132,2811.47,0,1068360,0,0,0,0,0,0
20150105.093133,2811.47,0,1068360,0,0,0,0,0,0
20150105.093134,2811.47,0,1068360,0,0,0,0,0,0
20150105.093135,2811.47,0,1068360,0,0,0,0,0,0
20150105.093136,2811.47,0,1068360,0,0,0,0,0,0
20150105.093137,2811.47,0,1068360,0,0,0,0,0,0
20150105.093138,2811.47,0,1068360,0,0,0,0,0,0
20150105.093139,2811.47,0,1068360,0,0,0,0,0,0
20150105.09314,2811.47,0,1068360,0,0,0,0,0,0
20150105.093141,2811.47,0,1068360,0,0,0,0,0,0
20150105.093142,2811.47,0,1068360,0,0,0,0,0,0
20150105.093143,2811.47,0,1068360,0,0,0,0,0,0
20150105.093144,2811.47,0,1068360,0,0,0,0,0,0
20150105.093145,2811.47,0,1068360,0,0,0,0,0,0
20150105.093146,2811.47,0,1068360,0,0,0,0,0,0
20150105.093147,2811.47,0,1068360,0,0,0,0,0,0
20150105.093148,2811.47,0,1068360,0,0,0,0,0,0
20150105.093149,2811.47,0,1068360,0,0,0,0,0,0
20150105.09315,2811.47,0,1068360,0,0,0,0,0,0
20150105.093151,2811.47,0,1068360,0,0,0,0,0,0
20150105.093152,2811.47,0,1068360,0,0,0,0,0,0
20150105.093153,2811.47,0,1068360,0,0,0,0,0,0
20150105.093154,2811.47,0,1068360,0,0,0,0,0,0
20150105.093155,2811.47,0,1068360,0,0,0,0,0,0
20150105.093156,2811.47,0,1068360,0,0,0,0,0,0
20150105.093157,2811.47,0,1068360,0,0,0,0,0,0
20150105.093158,2811.47,0,1068360,0,0,0,0,0,0
20150105.093159,2811.47,0,1068360,0,0,0,0,0,0
20150105.0932,2811.47,0,1068360,0,0,0,0,0,0
20150105.093201,2811.47,0,1068360,0,0,0,0,0,0
20150105.093202,2811.47,0,1068360,0,0,0,0,0,0
20150105.093203,2811.47,0,1068360,0,0,0,0,0,0
20150105.093204,2811.47,0,1068360,0,0,0,0,0,0
20150105.093205,2811.47,0,1068360,0,0,0,0,0,0
20150105.093206,2811.47,0,1068360,0,0,0,0,0,0
20150105.093207,2811.47,0,1068360,0,0,0,0,0,0
20150105.093208,2811.47,0,1068360,0,0,0,0,0,0
20150105.093209,2811.47,0,1068360,0,0,0,0,0,0
20150105.09321,2811.47,0,1068360,0,0,0,0,0,0
20150105.093211,2811.47,0,1068360,0,0,0,0,0,0
20150105.093212,2811.47,0,1068360,0,0,0,0,0,0
20150105.093213,2811.47,0,1068360,0,0,0,0,0,0
20150105.093214,2811.47,0,1068360,0,0,0,0,0,0
20150105.093215,2811.47,0,1068360,0,0,0,0,0,0
20150105.093216,2811.47,0,1068360,0,0,0,0,0,0
20150105.093217,2811.47,0,1068360,0,0,0,0,0,0
20150105.093218,2811.47,0,1068360,0,0,0,0,0,0
20150105.093219,2811.47,0,1068360,0,0,0,0,0,0
20150105.09322,2811.47,0,1068360,0,0,0,0,0,0
20150105.093221,2811.47,0,1068360,0,0,0,0,0,0
20150105.093222,2811.47,0,1068360,0,0,0,0,0,0
20150105.093223,2811.47,0,1068360,0,0,0,0,0,0
20150105.093224,2811.47,0,1068360,0,0,0,0,0,0
20150105.093225,2811.47,0,1068360,0,0,0,0,0,0
20150105.093226,2811.47,0,1068360,0,0,0,0,0,0
20150105.093227,2811.47,0,1068360,0,0,0,0,0,0
20150105.093228,2811.47,0,1068360,0,0,0,0,0,0
20150105.093229,2811.47,0,1068360,0,0,0,0,0,0
20150105.09323,2811.47,0,1068360,0,0,0,0,0,0
20150105.093231,2811.47,0,1068360,0,0,0,0,0,0
20150105.093232,2811.47,0,1068360,0,0,0,0,0,0
20150105.093233,2811.47,0,1068360,0,0,0,0,0,0
20150105.093234,2811.47,0,1068360,0,0,0,0,0,0
20150105.093235,2811.47,0,1068360,0,0,0,0,0,0
20150105.093236,2811.47,0,1068360,0,0,0,0,0,0
20150105.093237,2811.47,0,1068360,0,0,0,0,0,0
20150105.093238,2811.47,0,1068360,0,0,0,0,0,0
20150105.093239,2811.47,0,1068360,0,0,0,0,0,0
20150105.09324,2811.47,0,1068360,0,0,0,0,0,0
20150105.093241,2811.47,0,1068360,0,0,0,0,0,0
20150105.093242,2811.47,0,1068360,0,0,0,0,0,0
20150105.093243,2811.47,0,1068360,0,0,0,0,0,0
20150105.093244,2811.47,0,1068360,0,0,0,0,0,0
20150105.093245,2811.47,0,1068360,0,0,0,0,0,0
20150105.093246,2811.47,0,1068360,0,0,0,0,0,0
20150105.093247,2811.47,0,1068360,0,0,0,0,0,0
20150105.093248,2811.47,0,1068360,0,0,0,0,0,0
20150105.093249,2811.47,0,1068360,0,0,0,0,0,0
20150105.09325,2811.47,0,1068360,0,0,0,0,0,0
20150105.093251,2811.47,0,1068360,0,0,0,0,0,0
20150105.093252,2811.47,0,1068360,0,0,0,0,0,0
20150105.093253,2811.47,0,1068360,0,0,0,0,0,0
20150105.093254,2811.47,0,1068360,0,0,0,0,0,0
20150105.093255,2811.47,0,1068360,0,0,0,0,0,0
20150105.093256,2811.47,0,1068360,0,0,0,0,0,0
20150105.093257,2811.47,0,1068360,0,0,0,0,0,0
20150105.093258,2811.47,0,1068360,0,0,0,0,0,0
20150105.093259,2811.47,0,1068360,0,0,0,0,0,0
20150105.0933,2811.47,0,1068360,0,0,0,0,0,0
20150105.093301,2811.47,0,1068360,0,0,0,0,0,0
20150105.093302,2811.47,0,1068360,0,0,0,0,0,0
20150105.093303,2811.47,0,1068360,0,0,0,0,0,0
20150105.093304,2811.47,0,1068360,0,0,0,0,0,0
20150105.093305,2811.47,0,1068360,0,0,0,0,0,0
20150105.093306,2811.47,0,1068360,0,0,0,0,0,0
20150105.093307,2811.47,0,1068360,0,0,0,0,0,0
20150105.093308,2811.47,0,1068360,0,0,0,0,0,0
20150105.093309,2811.47,0,1068360,0,0,0,0,0,0
20150105.09331,2811.47,0,1068360,0,0,0,0,0,0
20150105.093311,2811.47,0,1068360,0,0,0,0,0,0
20150105.093312,2811.47,0,1068360,0,0,0,0,0,0
20150105.093313,2811.47,0,1068360,0,0,0,0,0,0
20150105.093314,2811.47,0,1068360,0,0,0,0,0,0
20150105.093315,2811.47,0,1068360,0,0,0,0,0,0
20150105.093316,2811.47,0,1068360,0,0,0,0,0,0
20150105.093317,2811.47,0,1068360,0,0,0,0,0,0
20150105.093318,2811.47,0,1068360,0,0,0,0,0,0
20150105.093319,2811.47,0,1068360,0,0,0,0,0,0
20150105.09332,2811.47,0,1068360,0,0,0,0,0,0
20150105.093321,2811.47,0,1068360,0,0,0,0,0,0
20150105.093322,2811.47,0,1068360,0,0,0,0,0,0
20150105.093323,2811.47,0,1068360,0,0,0,0,0,0
20150105.093324,2811.47,0,1068360,0,0,0,0,0,0
20150105.093325,2811.47,0,1068360,0,0,0,0,0,0
20150105.093326,2811.47,0,1068360,0,0,0,0,0,0
20150105.093327,2811.47,0,1068360,0,0,0,0,0,0
20150105.093328,2811.47,0,1068360,0,0,0,0,0,0
20150105.093329,2811.47,0,1068360,0,0,0,0,0,0
20150105.09333,2811.47,0,1068360,0,0,0,0,0,0
20150105.093331,2811.47,0,1068360,0,0,0,0,0,0
20150105.093332,2811.47,0,1068360,0,0,0,0,0,0
20150105.093333,2811.47,0,1068360,0,0,0,0,0,0
20150105.093334,2811.47,0,1068360,0,0,0,0,0,0
20150105.093335,2811.47,0,1068360,0,0,0,0,0,0
20150105.093336,2811.47,0,1068360,0,0,0,0,0,0
20150105.093337,2811.47,0,1068360,0,0,0,0,0,0
20150105.093338,2811.47,0,1068360,0,0,0,0,0,0
20150105.093339,2811.47,0,1068360,0,0,0,0,0,0
20150105.09334,2811.47,0,1068360,0,0,0,0,0,0
20150105.093341,2811.47,0,1068360,0,0,0,0,0,0
20150105.093342,2811.47,0,1068360,0,0,0,0,0,0
20150105.093343,2811.47,0,1068360,0,0,0,0,0,0
20150105.093344,2811.47,0,1068360,0,0,0,0,0,0
20150105.093345,2811.47,0,1068360,0,0,0,0,0,0
20150105.093346,2811.47,0,1068360,0,0,0,0,0,0
20150105.093347,2811.47,0,1068360,0,0,0,0,0,0
20150105.093348,2811.47,0,1068360,0,0,0,0,0,0
20150105.093349,2811.47,0,1068360,0,0,0,0,0,0
20150105.09335,2811.47,0,1068360,0,0,0,0,0,0
20150105.093351,2811.47,0,1068360,0,0,0,0,0,0
20150105.093352,2811.47,0,1068360,0,0,0,0,0,0
20150105.093353,2811.47,0,1068360,0,0,0,0,0,0
20150105.093354,2811.47,0,1068360,0,0,0,0,0,0
20150105.093355,2811.47,0,1068360,0,0,0,0,0,0
20150105.093356,2811.47,0,1068360,0,0,0,0,0,0
20150105.093357,2811.47,0,1068360,0,0,0,0,0,0
20150105.093358,2811.47,0,1068360,0,0,0,0,0,0
20150105.093359,2811.47,0,1068360,0,0,0,0,0,0
20150105.0934,2811.47,0,1068360,0,0,0,0,0,0
20150105.093401,2811.47,0,1068360,0,0,0,0,0,0
20150105.093402,2811.47,0,1068360,0,0,0,0,0,0
20150105.093403,2811.47,0,1068360,0,0,0,0,0,0
20150105.093404,2811.47,0,1068360,0,0,0,0,0,0
20150105.093405,2811.47,0,1068360,0,0,0,0,0,0
20150105.093406,2811.47,0,1068360,0,0,0,0,0,0
20150105.093407,2811.47,0,1068360,0,0,0,0,0,0
20150105.093408,2811.47,0,1068360,0,0,0,0,0,0
20150105.093409,2811.47,0,1068360,0,0,0,0,0,0
20150105.09341,2811.47,0,1068360,0,0,0,0,0,0
20150105.093411,2811.47,0,1068360,0,0,0,0,0,0
20150105.093412,2811.47,0,1068360,0,0,0,0,0,0
20150105.093413,2811.47,0,1068360,0,0,0,0,0,0
20150105.093414,2811.47,0,1068360,0,0,0,0,0,0
20150105.093415,2811.47,0,1068360,0,0,0,0,0,0
20150105.093416,2811.47,0,1068360,0,0,0,0,0,0
20150105.093417,2811.47,0,1068360,0,0,0,0,0,0
20150105.093418,2811.47,0,1068360,0,0,0,0,0,0
20150105.093419,2811.47,0,1068360,0,0,0,0,0,0
20150105.09342,2811.47,0,1068360,0,0,0,0,0,0
20150105.093421,2811.47,0,1068360,0,0,0,0,0,0
20150105.093422,2811.47,0,1068360,0,0,0,0,0,0
20150105.093423,2811.47,0,1068360,0,0,0,0,0,0
20150105.093424,2811.47,0,1068360,0,0,0,0,0,0
20150105.093425,2811.47,0,1068360,0,0,0,0,0,0
20150105.093426,2811.47,0,1068360,0,0,0,0,0,0
20150105.093427,2811.47,0,1068360,0,0,0,0,0,0
20150105.093428,2811.47,0,1068360,0,0,0,0,0,0
20150105.093429,2811.47,0,1068360,0,0,0,0,0,0
20150105.09343,2811.47,0,1068360,0,0,0,0,0,0
20150105.093431,2811.47,0,1068360,0,0,0,0,0,0
20150105.093432,2811.47,0,1068360,0,0,0,0,0,0
20150105.093433,2811.47,0,1068360,0,0,0,0,0,0
20150105.093434,2811.47,0,1068360,0,0,0,0,0,0
20150105.093435,2811.47,0,1068360,0,0,0,0,0,0
20150105.093436,2811.47,0,1068360,0,0,0,0,0,0
20150105.093437,2811.47,0,1068360,0,0,0,0,0,0
20150105.093438,2811.47,0,1068360,0,0,0,0,0,0
20150105.093439,2811.47,0,1068360,0,0,0,0,0,0
20150105.09344,2811.47,0,1068360,0,0,0,0,0,0
20150105.093441,2811.47,0,1068360,0,0,0,0,0,0
20150105.093442,2811.47,0,1068360,0,0,0,0,0,0
20150105.093443,2811.47,0,1068360,0,0,0,0,0,0
20150105.093444,2811.47,0,1068360,0,0,0,0,0,0
20150105.093445,2811.47,0,1068360,0,0,0,0,0,0
20150105.093446,2811.47,0,1068360,0,0,0,0,0,0
20150105.093447,2811.47,0,1068360,0,0,0,0,0,0
20150105.093448,2811.47,0,1068360,0,0,0,0,0,0
20150105.093449,2811.47,0,1068360,0,0,0,0,0,0
20150105.09345,2811.47,0,1068360,0,0,0,0,0,0
20150105.093451,2811.47,0,1068360,0,0,0,0,0,0
20150105.093452,2811.47,0,1068360,0,0,0,0,0,0
20150105.093453,2811.47,0,1068360,0,0,0,0,0,0
20150105.093454,2811.47,0,1068360,0,0,0,0,0,0
20150105.093455,2811.47,0,1068360,0,0,0,0,0,0
20150105.093456,2811.47,0,1068360,0,0,0,0,0,0
20150105.093457,2811.47,0,1068360,0,0,0,0,0,0
20150105.093458,2811.47,0,1068360,0,0,0,0,0,0
20150105.093459,2811.47,0,1068360,0,0,0,0,0,0
20150105.0935,2811.47,0,1068360,0,0,0,0,0,0
20150105.093501,2811.47,0,1068360,0,0,0,0,0,0
20150105.093502,2811.47,0,1068360,0,0,0,0,0,0
20150105.093503,2811.47,0,1068360,0,0,0,0,0,0
20150105.093504,2811.47,0,1068360,0,0,0,0,0,0
20150105.093505,2811.47,0,1068360,0,0,0,0,0,0
20150105.093506,2811.47,0,1068360,0,0,0,0,0,0
20150105.093507,2811.47,0,1068360,0,0,0,0,0,0
20150105.093508,2811.47,0,1068360,0,0,0,0,0,0
20150105.093509,2811.47,0,1068360,0,0,0,0,0,0
20150105.09351,2811.47,0,1068360,0,0,0,0,0,0
20150105.093511,2811.47,0,1068360,0,0,0,0,0,0
20150105.093512,2811.47,0,1068360,0,0,0,0,0,0
20150105.093513,2811.47,0,1068360,0,0,0,0,0,0
20150105.093514,2811.47,0,1068360,0,0,0,0,0,0
20150105.093515,2811.47,0,1068360,0,0,0,0,0,0
20150105.093516,2811.47,0,1068360,0,0,0,0,0,0
20150105.093517,2811.47,0,1068360,0,0,0,0,0,0
20150105.093518,2811.47,0,1068360,0,0,0,0,0,0
20150105.093519,2811.47,0,1068360,0,0,0,0,0,0
20150105.09352,2811.47,0,1068360,0,0,0,0,0,0
20150105.093521,2811.47,0,1068360,0,0,0,0,0,0
20150105.093522,2811.47,0,1068360,0,0,0,0,0,0
20150105.093523,2811.47,0,1068360,0,0,0,0,0,0
20150105.093524,2811.47,0,1068360,0,0,0,0,0,0
20150105.093525,2811.47,0,1068360,0,0,0,0,0,0
20150105.093526,2811.47,0,1068360,0,0,0,0,0,0
20150105.093527,2811.47,0,1068360,0,0,0,0,0,0
20150105.093528,2811.47,0,1068360,0,0,0,0,0,0
20150105.093529,2811.47,0,1068360,0,0,0,0,0,0
20150105.09353,2811.47,0,1068360,0,0,0,0,0,0
20150105.093531,2811.47,0,1068360,0,0,0,0,0,0
20150105.093532,2811.47,0,1068360,0,0,0,0,0,0
20150105.093533,2811.47,0,1068360,0,0,0,0,0,0
20150105.093534,2811.47,0,1068360,0,0,0,0,0,0
20150105.093535,2811.47,0,1068360,0,0,0,0,0,0
20150105.093536,2811.47,0,1068360,0,0,0,0,0,0
20150105.093537,2811.47,0,1068360,0,0,0,0,0,0
20150105.093538,2811.47,0,1068360,0,0,0,0,0,0
20150105.093539,2811.47,0,1068360,0,0,0,0,0,0
20150105.09354,2811.47,0,1068360,0,0,0,0,0,0
20150105.093541,2811.47,0,1068360,0,0,0,0,0,0
20150105.093542,2811.47,0,1068360,0,0,0,0,0,0
20150105.093543,2811.47,0,1068360,0,0,0,0,0,0
20150105.093544,2811.47,0,1068360,0,0,0,0,0,0
20150105.093545,2811.47,0,1068360,0,0,0,0,0,0
20150105.093546,2811.47,0,1068360,0,0,0,0,0,0
20150105.093547,2811.47,0,1068360,0,0,0,0,0,0
20150105.093548,2811.47,0,1068360,0,0,0,0,0,0
20150105.093549,2811.47,0,1068360,0,0,0,0,0,0
20150105.09355,2811.47,0,1068360,0,0,0,0,0,0
20150105.093551,2811.47,0,1068360,0,0,0,0,0,0
20150105.093552,2811.47,0,1068360,0,0,0,0,0,0
20150105.093553,2811.47,0,1068360,0,0,0,0,0,0
20150105.093554,2811.47,0,1068360,0,0,0,0,0,0
20150105.093555,2811.47,0,1068360,0,0,0,0,0,0
20150105.093556,2811.47,0,1068360,0,0,0,0,0,0
20150105.093557,2811.47,0,1068360,0,0,0,0,0,0
20150105.093558,2811.47,0,1068360,0,0,0,0,0,0
20150105.093559,2811.47,0,1068360,0,0,0,0,0,0
20150105.0936,2811.47,0,1068360,0,0,0,0,0,0
20150105.093601,2811.47,0,1068360,0,0,0,0,0,0
20150105.093602,2811.47,0,1068360,0,0,0,0,0,0
20150105.093603,2811.47,0,1068360,0,0,0,0,0,0
20150105.093604,2811.47,0,1068360,0,0,0,0,0,0
20150105.093605,2811.47,0,1068360,0,0,0,0,0,0
20150105.093606,2811.47,0,1068360,0,0,0,0,0,0
20150105.093607,2811.47,0,1068360,0,0,0,0,0,0
20150105.093608,2811.47,0,1068360,0,0,0,0,0,0
20150105.093609,2811.47,0,1068360,0,0,0,0,0,0
20150105.09361,2811.47,0,1068360,0,0,0,0,0,0
20150105.093611,2811.47,0,1068360,0,0,0,0,0,0
20150105.093612,2811.47,0,1068360,0,0,0,0,0,0
20150105.093613,2811.47,0,1068360,0,0,0,0,0,0
20150105.093614,2811.47,0,1068360,0,0,0,0,0,0
20150105.093615,2811.47,0,1068360,0,0,0,0,0,0
20150105.093616,2811.47,0,1068360,0,0,0,0,0,0
20150105.093617,2811.47,0,1068360,0,0,0,0,0,0
20150105.093618,2811.47,0,1068360,0,0,0,0,0,0
20150105.093619,2811.47,0,1068360,0,0,0,0,0,0
20150105.09362,2811.47,0,1068360,0,0,0,0,0,0
20150105.093621,2811.47,0,1068360,0,0,0,0,0,0
20150105.093622,2811.47,0,1068360,0,0,0,0,0,0
20150105.093623,2811.47,0,1068360,0,0,0,0,0,0
20150105.093624,2811.47,0,1068360,0,0,0,0,0,0
20150105.093625,2811.47,0,1068360,0,0,0,0,0,0
20150105.093626,2811.47,0,1068360,0,0,0,0,0,0
20150105.093627,2811.47,0,1068360,0,0,0,0,0,0
20150105.093628,2811.47,0,1068360,0,0,0,0,0,0
20150105.093629,2811.47,0,1068360,0,0,0,0,0,0
20150105.09363,2811.47,0,1068360,0,0,0,0,0,0
20150105.093631,2811.47,0,1068360,0,0,0,0,0,0
20150105.093632,2811.47,0,1068360,0,0,0,0,0,0
20150105.093633,2811.47,0,1068360,0,0,0,0,0,0
20150105.093634,2811.47,0,1068360,0,0,0,0,0,0
20150105.093635,2811.47,0,1068360,0,0,0,0,0,0
20150105.093636,2811.47,0,1068360,0,0,0,0,0,0
20150105.093637,2811.47,0,1068360,0,0,0,0,0,0
20150105.093638,2811.47,0,1068360,0,0,0,0,0,0
20150105.093639,2811.47,0,1068360,0,0,0,0,0,0
20150105.09364,2811.47,0,1068360,0,0,0,0,0,0
20150105.093641,2811.47,0,1068360,0,0,0,0,0,0
20150105.093642,2811.47,0,1068360,0,0,0,0,0,0
20150105.093643,2811.47,0,1068360,0,0,0,0,0,0
20150105.093644,2811.47,0,1068360,0,0,0,0,0,0
20150105.093645,2811.47,0,1068360,0,0,0,0,0,0
20150105.093646,2811.47,0,1068360,0,0,0,0,0,0
20150105.093647,2811.47,0,1068360,0,0,0,0,0,0
20150105.093648,2811.47,0,1068360,0,0,0,0,0,0
20150105.093649,2811.47,0,1068360,0,0,0,0,0,0
20150105.09365,2811.47,0,1068360,0,0,0,0,0,0
20150105.093651,2811.47,0,1068360,0,0,0,0,0,0
20150105.093652,2811.47,0,1068360,0,0,0,0,0,0
20150105.093653,2811.47,0,1068360,0,0,0,0,0,0
20150105.093654,2811.47,0,1068360,0,0,0,0,0,0
20150105.093655,2811.47,0,1068360,0,0,0,0,0,0
20150105.093656,2811.47,0,1068360,0,0,0,0,0,0
20150105.093657,2811.47,0,1068360,0,0,0,0,0,0
20150105.093658,2811.47,0,1068360,0,0,0,0,0,0
20150105.093659,2811.47,0,1068360,0,0,0,0,0,0
20150105.0937,2811.47,0,1068360,0,0,0,0,0,0
20150105.093701,2811.47,0,1068360,0,0,0,0,0,0
20150105.093702,2811.47,0,1068360,0,0,0,0,0,0
20150105.093703,2811.47,0,1068360,0,0,0,0,0,0
20150105.093704,2811.47,0,1068360,0,0,0,0,0,0
20150105.093705,2811.47,0,1068360,0,0,0,0,0,0
20150105.093706,2811.47,0,1068360,0,0,0,0,0,0
20150105.093707,2811.47,0,1068360,0,0,0,0,0,0
20150105.093708,2811.47,0,1068360,0,0,0,0,0,0
20150105.093709,2811.47,0,1068360,0,0,0,0,0,0
20150105.09371,2811.47,0,1068360,0,0,0,0,0,0
20150105.093711,2811.47,0,1068360,0,0,0,0,0,0
20150105.093712,2811.47,0,1068360,0,0,0,0,0,0
20150105.093713,2811.47,0,1068360,0,0,0,0,0,0
20150105.093714,2811.47,0,1068360,0,0,0,0,0,0
20150105.093715,2811.47,0,1068360,0,0,0,0,0,0
20150105.093716,2811.47,0,1068360,0,0,0,0,0,0
20150105.093717,2811.47,0,1068360,0,0,0,0,0,0
20150105.093718,2811.47,0,1068360,0,0,0,0,0,0
20150105.093719,2811.47,0,1068360,0,0,0,0,0,0
20150105.09372,2811.47,0,1068360,0,0,0,0,0,0
20150105.093721,2811.47,0,1068360,0,0,0,0,0,0
20150105.093722,2811.47,0,1068360,0,0,0,0,0,0
20150105.093723,2811.47,0,1068360,0,0,0,0,0,0
20150105.093724,2811.47,0,1068360,0,0,0,0,0,0
20150105.093725,2811.47,0,1068360,0,0,0,0,0,0
20150105.093726,2811.47,0,1068360,0,0,0,0,0,0
20150105.093727,2811.47,0,1068360,0,0,0,0,0,0
20150105.093728,2811.47,0,1068360,0,0,0,0,0,0
20150105.093729,2811.47,0,1068360,0,0,0,0,0,0
20150105.09373,2811.47,0,1068360,0,0,0,0,0,0
20150105.093731,2811.47,0,1068360,0,0,0,0,0,0
20150105.093732,2811.47,0,1068360,0,0,0,0,0,0
20150105.093733,2811.47,0,1068360,0,0,0,0,0,0
20150105.093734,2811.47,0,1068360,0,0,0,0,0,0
20150105.093735,2811.47,0,1068360,0,0,0,0,0,0
20150105.093736,2811.47,0,1068360,0,0,0,0,0,0
20150105.093737,2811.47,0,1068360,0,0,0,0,0,0
20150105.093738,2811.47,0,1068360,0,0,0,0,0,0
20150105.093739,2811.47,0,1068360,0,0,0,0,0,0
20150105.09374,2811.47,0,1068360,0,0,0,0,0,0
20150105.093741,2811.47,0,1068360,0,0,0,0,0,0
20150105.093742,2811.47,0,1068360,0,0,0,0,0,0
20150105.093743,2811.47,0,1068360,0,0,0,0,0,0
20150105.093744,2811.47,0,1068360,0,0,0,0,0,0
20150105.093745,2811.47,0,1068360,0,0,0,0,0,0
20150105.093746,2811.47,0,1068360,0,0,0,0,0,0
20150105.093747,2811.47,0,1068360,0,0,0,0,0,0
20150105.093748,2811.47,0,1068360,0,0,0,0,0,0
20150105.093749,2811.47,0,1068360,0,0,0,0,0,0
20150105.09375,2811.47,0,1068360,0,0,0,0,0,0
20150105.093751,2811.47,0,1068360,0,0,0,0,0,0
20150105.093752,2811.47,0,1068360,0,0,0,0,0,0
20150105.093753,2811.47,0,1068360,0,0,0,0,0,0
20150105.093754,2811.47,0,1068360,0,0,0,0,0,0
20150105.093755,2811.47,0,1068360,0,0,0,0,0,0
20150105.093756,2811.47,0,1068360,0,0,0,0,0,0
20150105.093757,2811.47,0,1068360,0,0,0,0,0,0
20150105.093758,2811.47,0,1068360,0,0,0,0,0,0
20150105.093759,2811.47,0,1068360,0,0,0,0,0,0
20150105.0938,2811.47,0,1068360,0,0,0,0,0,0
20150105.093801,2811.47,0,1068360,0,0,0,0,0,0
20150105.093802,2811.47,0,1068360,0,0,0,0,0,0
20150105.093803,2811.47,0,1068360,0,0,0,0,0,0
20150105.093804,2811.47,0,1068360,0,0,0,0,0,0
20150105.093805,2811.47,0,1068360,0,0,0,0,0,0
20150105.093806,2811.47,0,1068360,0,0,0,0,0,0
20150105.093807,2811.47,0,1068360,0,0,0,0,0,0
20150105.093808,2811.47,0,1068360,0,0,0,0,0,0
20150105.093809,2811.47,0,1068360,0,0,0,0,0,0
20150105.09381,2811.47,0,1068360,0,0,0,0,0,0
20150105.093811,2811.47,0,1068360,0,0,0,0,0,0
20150105.093812,2811.47,0,1068360,0,0,0,0,0,0
20150105.093813,2811.47,0,1068360,0,0,0,0,0,0
20150105.093814,2811.47,0,1068360,0,0,0,0,0,0
20150105.093815,2811.47,0,1068360,0,0,0,0,0,0
20150105.093816,2811.47,0,1068360,0,0,0,0,0,0
20150105.093817,2811.47,0,1068360,0,0,0,0,0,0
20150105.093818,2811.47,0,1068360,0,0,0,0,0,0
20150105.093819,2811.47,0,1068360,0,0,0,0,0,0
20150105.09382,2811.47,0,1068360,0,0,0,0,0,0
20150105.093821,2811.47,0,1068360,0,0,0,0,0,0
20150105.093822,2811.47,0,1068360,0,0,0,0,0,0
20150105.093823,2811.47,0,1068360,0,0,0,0,0,0
20150105.093824,2811.47,0,1068360,0,0,0,0,0,0
20150105.093825,2811.47,0,1068360,0,0,0,0,0,0
20150105.093826,2811.47,0,1068360,0,0,0,0,0,0
20150105.093827,2811.47,0,1068360,0,0,0,0,0,0
20150105.093828,2811.47,0,1068360,0,0,0,0,0,0
20150105.093829,2811.47,0,1068360,0,0,0,0,0,0
20150105.09383,2811.47,0,1068360,0,0,0,0,0,0
20150105.093831,2811.47,0,1068360,0,0,0,0,0,0
20150105.093832,2811.47,0,1068360,0,0,0,0,0,0
20150105.093833,2811.47,0,1068360,0,0,0,0,0,0
20150105.093834,2811.47,0,1068360,0,0,0,0,0,0
20150105.093835,2811.47,0,1068360,0,0,0,0,0,0
20150105.093836,2811.47,0,1068360,0,0,0,0,0,0
20150105.093837,2811.47,0,1068360,0,0,0,0,0,0
20150105.093838,2811.47,0,1068360,0,0,0,0,0,0
20150105.093839,2811.47,0,1068360,0,0,0,0,0,0
20150105.09384,2811.47,0,1068360,0,0,0,0,0,0
20150105.093841,2811.47,0,1068360,0,0,0,0,0,0
20150105.093842,2811.47,0,1068360,0,0,0,0,0,0
20150105.093843,2811.47,0,1068360,0,0,0,0,0,0
20150105.093844,2811.47,0,1068360,0,0,0,0,0,0
20150105.093845,2811.47,0,1068360,0,0,0,0,0,0
20150105.093846,2811.47,0,1068360,0,0,0,0,0,0
20150105.093847,2811.47,0,1068360,0,0,0,0,0,0
20150105.093848,2811.47,0,1068360,0,0,0,0,0,0
20150105.093849,2811.47,0,1068360,0,0,0,0,0,0
20150105.09385,2811.47,0,1068360,0,0,0,0,0,0
20150105.093851,2811.47,0,1068360,0,0,0,0,0,0
20150105.093852,2811.47,0,1068360,0,0,0,0,0,0
20150105.093853,2811.47,0,1068360,0,0,0,0,0,0
20150105.093854,2811.47,0,1068360,0,0,0,0,0,0
20150105.093855,2811.47,0,1068360,0,0,0,0,0,0
20150105.093856,2811.47,0,1068360,0,0,0,0,0,0
20150105.093857,2811.47,0,1068360,0,0,0,0,0,0
20150105.093858,2811.47,0,1068360,0,0,0,0,0,0
20150105.093859,2811.47,0,1068360,0,0,0,0,0,0
20150105.0939,2811.47,0,1068360,0,0,0,0,0,0
20150105.093901,2811.47,0,1068360,0,0,0,0,0,0
20150105.093902,2811.47,0,1068360,0,0,0,0,0,0
20150105.093903,2811.47,0,1068360,0,0,0,0,0,0
20150105.093904,2811.47,0,1068360,0,0,0,0,0,0
20150105.093905,2811.47,0,1068360,0,0,0,0,0,0
20150105.093906,2811.47,0,1068360,0,0,0,0,0,0
20150105.093907,2811.47,0,1068360,0,0,0,0,0,0
20150105.093908,2811.47,0,1068360,0,0,0,0,0,0
20150105.093909,2811.47,0,1068360,0,0,0,0,0,0
20150105.09391,2811.47,0,1068360,0,0,0,0,0,0
20150105.093911,2811.47,0,1068360,0,0,0,0,0,0
20150105.093912,2811.47,0,1068360,0,0,0,0,0,0
20150105.093913,2811.47,0,1068360,0,0,0,0,0,0
20150105.093914,2811.47,0,1068360,0,0,0,0,0,0
20150105.093915,2811.47,0,1068360,0,0,0,0,0,0
20150105.093916,2811.47,0,1068360,0,0,0,0,0,0
20150105.093917,2811.47,0,1068360,0,0,0,0,0,0
20150105.093918,2811.47,0,1068360,0,0,0,0,0,0
20150105.093919,2811.47,0,1068360,0,0,0,0,0,0
20150105.09392,2811.47,0,1068360,0,0,0,0,0,0
20150105.093921,2811.47,0,1068360,0,0,0,0,0,0
20150105.093922,2811.47,0,1068360,0,0,0,0,0,0
20150105.093923,2811.47,0,1068360,0,0,0,0,0,0
20150105.093924,2811.47,0,1068360,0,0,0,0,0,0
20150105.093925,2811.47,0,1068360,0,0,0,0,0,0
20150105.093926,2811.47,0,1068360,0,0,0,0,0,0
20150105.093927,2811.47,0,1068360,0,0,0,0,0,0
20150105.093928,2811.47,0,1068360,0,0,0,0,0,0
20150105.093929,2811.47,0,1068360,0,0,0,0,0,0
20150105.09393,2811.47,0,1068360,0,0,0,0,0,0
20150105.093931,2811.47,0,1068360,0,0,0,0,0,0
20150105.093932,2811.47,0,1068360,0,0,0,0,0,0
20150105.093933,2811.47,0,1068360,0,0,0,0,0,0
20150105.093934,2811.47,0,1068360,0,0,0,0,0,0
20150105.093935,2811.47,0,1068360,0,0,0,0,0,0
20150105.093936,2811.47,0,1068360,0,0,0,0,0,0
20150105.093937,2811.47,0,1068360,0,0,0,0,0,0
20150105.093938,2811.47,0,1068360,0,0,0,0,0,0
20150105.093939,2811.47,0,1068360,0,0,0,0,0,0
20150105.09394,2811.47,0,1068360,0,0,0,0,0,0
20150105.093941,2811.47,0,1068360,0,0,0,0,0,0
20150105.093942,2811.47,0,1068360,0,0,0,0,0,0
20150105.093943,2811.47,0,1068360,0,0,0,0,0,0
20150105.093944,2811.47,0,1068360,0,0,0,0,0,0
20150105.093945,2811.47,0,1068360,0,0,0,0,0,0
20150105.093946,2811.47,0,1068360,0,0,0,0,0,0
20150105.093947,2811.47,0,1068360,0,0,0,0,0,0
20150105.093948,2811.47,0,1068360,0,0,0,0,0,0
20150105.093949,2811.47,0,1068360,0,0,0,0,0,0
20150105.09395,2811.47,0,1068360,0,0,0,0,0,0
20150105.093951,2811.47,0,1068360,0,0,0,0,0,0
20150105.093952,2811.47,0,1068360,0,0,0,0,0,0
20150105.093953,2811.47,0,1068360,0,0,0,0,0,0
20150105.093954,2811.47,0,1068360,0,0,0,0,0,0
20150105.093955,2811.47,0,1068360,0,0,0,0,0,0
20150105.093956,2811.47,0,1068360,0,0,0,0,0,0
20150105.093957,2811.47,0,1068360,0,0,0,0,0,0
20150105.093958,2811.47,0,1068360,0,0,0,0,0,0
20150105.093959,2811.47,0,1068360,0,0,0,0,0,0
20150105.094,2811.47,0,1068360,0,0,0,0,0,0
20150105.094001,2811.47,0,1068360,0,0,0,0,0,0
20150105.094002,2811.47,0,1068360,0,0,0,0,0,0
20150105.094003,2811.47,0,1068360,0,0,0,0,0,0
20150105.094004,2811.47,0,1068360,0,0,0,0,0,0
20150105.094005,2811.47,0,1068360,0,0,0,0,0,0
20150105.094006,2811.47,0,1068360,0,0,0,0,0,0
20150105.094007,2811.47,0,1068360,0,0,0,0,0,0
20150105.094008,2811.47,0,1068360,0,0,0,0,0,0
20150105.094009,2811.47,0,1068360,0,0,0,0,0,0
20150105.09401,2811.47,0,1068360,0,0,0,0,0,0
20150105.094011,2811.47,0,1068360,0,0,0,0,0,0
20150105.094012,2811.47,0,1068360,0,0,0,0,0,0
20150105.094013,2811.47,0,1068360,0,0,0,0,0,0
20150105.094014,2811.47,0,1068360,0,0,0,0,0,0
20150105.094015,2811.47,0,1068360,0,0,0,0,0,0
20150105.094016,2811.47,0,1068360,0,0,0,0,0,0
20150105.094017,2811.47,0,1068360,0,0,0,0,0,0
20150105.094018,2811.47,0,1068360,0,0,0,0,0,0
20150105.094019,2811.47,0,1068360,0,0,0,0,0,0
20150105.09402,2811.47,0,1068360,0,0,0,0,0,0
20150105.094021,2811.47,0,1068360,0,0,0,0,0,0
20150105.094022,2811.47,0,1068360,0,0,0,0,0,0
20150105.094023,2811.47,0,1068360,0,0,0,0,0,0
20150105.094024,2811.47,0,1068360,0,0,0,0,0,0
20150105.094025,2811.47,0,1068360,0,0,0,0,0,0
20150105.094026,2811.47,0,1068360,0,0,0,0,0,0
20150105.094027,2811.47,0,1068360,0,0,0,0,0,0
20150105.094028,2811.47,0,1068360,0,0,0,0,0,0
20150105.094029,2811.47,0,1068360,0,0,0,0,0,0
20150105.09403,2811.47,0,1068360,0,0,0,0,0,0
20150105.094031,2811.47,0,1068360,0,0,0,0,0,0
20150105.094032,2811.47,0,1068360,0,0,0,0,0,0
20150105.094033,2811.47,0,1068360,0,0,0,0,0,0
20150105.094034,2811.47,0,1068360,0,0,0,0,0,0
20150105.094035,2811.47,0,1068360,0,0,0,0,0,0
20150105.094036,2811.47,0,1068360,0,0,0,0,0,0
20150105.094037,2811.47,0,1068360,0,0,0,0,0,0
20150105.094038,2811.47,0,1068360,0,0,0,0,0,0
20150105.094039,2811.47,0,1068360,0,0,0,0,0,0
20150105.09404,2811.47,0,1068360,0,0,0,0,0,0
20150105.094041,2811.47,0,1068360,0,0,0,0,0,0
20150105.094042,2811.47,0,1068360,0,0,0,0,0,0
20150105.094043,2811.47,0,1068360,0,0,0,0,0,0
20150105.094044,2811.47,0,1068360,0,0,0,0,0,0
20150105.094045,2811.47,0,1068360,0,0,0,0,0,0
20150105.094046,2811.47,0,1068360,0,0,0,0,0,0
20150105.094047,2811.47,0,1068360,0,0,0,0,0,0
20150105.094048,2811.47,0,1068360,0,0,0,0,0,0
20150105.094049,2811.47,0,1068360,0,0,0,0,0,0
20150105.09405,2811.47,0,1068360,0,0,0,0,0,0
20150105.094051,2811.47,0,1068360,0,0,0,0,0,0
20150105.094052,2811.47,0,1068360,0,0,0,0,0,0
20150105.094053,2811.47,0,1068360,0,0,0,0,0,0
20150105.094054,2811.47,0,1068360,0,0,0,0,0,0
20150105.094055,2811.47,0,1068360,0,0,0,0,0,0
20150105.094056,2811.47,0,1068360,0,0,0,0,0,0
20150105.094057,2811.47,0,1068360,0,0,0,0,0,0
20150105.094058,2811.47,0,1068360,0,0,0,0,0,0
20150105.094059,2811.47,0,1068360,0,0,0,0,0,0
20150105.0941,2811.47,0,1068360,0,0,0,0,0,0
20150105.094101,2811.47,0,1068360,0,0,0,0,0,0
20150105.094102,2811.47,0,1068360,0,0,0,0,0,0
20150105.094103,2811.47,0,1068360,0,0,0,0,0,0
20150105.094104,2811.47,0,1068360,0,0,0,0,0,0
20150105.094105,2811.47,0,1068360,0,0,0,0,0,0
20150105.094106,2811.47,0,1068360,0,0,0,0,0,0
20150105.094107,2811.47,0,1068360,0,0,0,0,0,0
20150105.094108,2811.47,0,1068360,0,0,0,0,0,0
20150105.094109,2811.47,0,1068360,0,0,0,0,0,0
20150105.09411,2811.47,0,1068360,0,0,0,0,0,0
20150105.094111,2811.47,0,1068360,0,0,0,0,0,0
20150105.094112,2811.47,0,1068360,0,0,0,0,0,0
20150105.094113,2811.47,0,1068360,0,0,0,0,0,0
20150105.094114,2811.47,0,1068360,0,0,0,0,0,0
20150105.094115,2811.47,0,1068360,0,0,0,0,0,0
20150105.094116,2811.47,0,1068360,0,0,0,0,0,0
20150105.094117,2811.47,0,1068360,0,0,0,0,0,0
20150105.094118,2811.47,0,1068360,0,0,0,0,0,0
20150105.094119,2811.47,0,1068360,0,0,0,0,0,0
20150105.09412,2811.47,0,1068360,0,0,0,0,0,0
20150105.094121,2811.47,0,1068360,0,0,0,0,0,0
20150105.094122,2811.47,0,1068360,0,0,0,0,0,0
20150105.094123,2811.47,0,1068360,0,0,0,0,0,0
20150105.094124,2811.47,0,1068360,0,0,0,0,0,0
20150105.094125,2811.47,0,1068360,0,0,0,0,0,0
20150105.094126,2811.47,0,1068360,0,0,0,0,0,0
20150105.094127,2811.47,0,1068360,0,0,0,0,0,0
20150105.094128,2811.47,0,1068360,0,0,0,0,0,0
20150105.094129,2811.47,0,1068360,0,0,0,0,0,0
20150105.09413,2811.47,0,1068360,0,0,0,0,0,0
20150105.094131,2811.47,0,1068360,0,0,0,0,0,0
20150105.094132,2811.47,0,1068360,0,0,0,0,0,0
20150105.094133,2811.47,0,1068360,0,0,0,0,0,0
20150105.094134,2811.47,0,1068360,0,0,0,0,0,0
20150105.094135,2811.47,0,1068360,0,0,0,0,0,0
20150105.094136,2811.47,0,1068360,0,0,0,0,0,0
20150105.094137,2811.47,0,1068360,0,0,0,0,0,0
20150105.094138,2811.47,0,1068360,0,0,0,0,0,0
20150105.094139,2811.47,0,1068360,0,0,0,0,0,0
20150105.09414,2811.47,0,1068360,0,0,0,0,0,0
20150105.094141,2811.47,0,1068360,0,0,0,0,0,0
20150105.094142,2811.47,0,1068360,0,0,0,0,0,0
20150105.094143,2811.47,0,1068360,0,0,0,0,0,0
20150105.094144,2811.47,0,1068360,0,0,0,0,0,0
20150105.094145,2811.47,0,1068360,0,0,0,0,0,0
20150105.094146,2811.47,0,1068360,0,0,0,0,0,0
20150105.094147,2811.47,0,1068360,0,0,0,0,0,0
20150105.094148,2811.47,0,1068360,0,0,0,0,0,0
20150105.094149,2811.47,0,1068360,0,0,0,0,0,0
20150105.09415,2811.47,0,1068360,0,0,0,0,0,0
20150105.094151,2811.47,0,1068360,0,0,0,0,0,0
20150105.094152,2811.47,0,1068360,0,0,0,0,0,0
20150105.094153,2811.47,0,1068360,0,0,0,0,0,0
20150105.094154,2811.47,0,1068360,0,0,0,0,0,0
20150105.094155,2811.47,0,1068360,0,0,0,0,0,0
20150105.094156,2811.47,0,1068360,0,0,0,0,0,0
20150105.094157,2811.47,0,1068360,0,0,0,0,0,0
20150105.094158,2811.47,0,1068360,0,0,0,0,0,0
20150105.094159,2811.47,0,1068360,0,0,0,0,0,0
20150105.0942,2811.47,0,1068360,0,0,0,0,0,0
20150105.094201,2811.47,0,1068360,0,0,0,0,0,0
20150105.094202,2811.47,0,1068360,0,0,0,0,0,0
20150105.094203,2811.47,0,1068360,0,0,0,0,0,0
20150105.094204,2811.47,0,1068360,0,0,0,0,0,0
20150105.094205,2811.47,0,1068360,0,0,0,0,0,0
20150105.094206,2811.47,0,1068360,0,0,0,0,0,0
20150105.094207,2811.47,0,1068360,0,0,0,0,0,0
20150105.094208,2811.47,0,1068360,0,0,0,0,0,0
20150105.094209,2811.47,0,1068360,0,0,0,0,0,0
20150105.09421,2811.47,0,1068360,0,0,0,0,0,0
20150105.094211,2811.47,0,1068360,0,0,0,0,0,0
20150105.094212,2811.47,0,1068360,0,0,0,0,0,0
20150105.094213,2811.47,0,1068360,0,0,0,0,0,0
20150105.094214,2811.47,0,1068360,0,0,0,0,0,0
20150105.094215,2811.47,0,1068360,0,0,0,0,0,0
20150105.094216,2811.47,0,1068360,0,0,0,0,0,0
20150105.094217,2811.47,0,1068360,0,0,0,0,0,0
20150105.094218,2811.47,0,1068360,0,0,0,0,0,0
20150105.094219,2811.47,0,1068360,0,0,0,0,0,0
20150105.09422,2811.47,0,1068360,0,0,0,0,0,0
20150105.094221,2811.47,0,1068360,0,0,0,0,0,0
20150105.094222,2811.47,0,1068360,0,0,0,0,0,0
20150105.094223,2811.47,0,1068360,0,0,0,0,0,0
20150105.094224,2811.47,0,1068360,0,0,0,0,0,0
20150105.094225,2811.47,0,1068360,0,0,0,0,0,0
20150105.094226,2811.47,0,1068360,0,0,0,0,0,0
20150105.094227,2811.47,0,1068360,0,0,0,0,0,0
20150105.094228,2811.47,0,1068360,0,0,0,0,0,0
20150105.094229,2811.47,0,1068360,0,0,0,0,0,0
20150105.09423,2811.47,0,1068360,0,0,0,0,0,0
20150105.094231,2811.47,0,1068360,0,0,0,0,0,0
20150105.094232,2811.47,0,1068360,0,0,0,0,0,0
20150105.094233,2811.47,0,1068360,0,0,0,0,0,0
20150105.094234,2811.47,0,1068360,0,0,0,0,0,0
20150105.094235,2811.47,0,1068360,0,0,0,0,0,0
20150105.094236,2811.47,0,1068360,0,0,0,0,0,0
20150105.094237,2811.47,0,1068360,0,0,0,0,0,0
20150105.094238,2811.47,0,1068360,0,0,0,0,0,0
20150105.094239,2811.47,0,1068360,0,0,0,0,0,0
20150105.09424,2811.47,0,1068360,0,0,0,0,0,0
20150105.094241,2811.47,0,1068360,0,0,0,0,0,0
20150105.094242,2811.47,0,1068360,0,0,0,0,0,0
20150105.094243,2811.47,0,1068360,0,0,0,0,0,0
20150105.094244,2811.47,0,1068360,0,0,0,0,0,0
20150105.094245,2811.47,0,1068360,0,0,0,0,0,0
20150105.094246,2811.47,0,1068360,0,0,0,0,0,0
20150105.094247,2811.47,0,1068360,0,0,0,0,0,0
20150105.094248,2811.47,0,1068360,0,0,0,0,0,0
20150105.094249,2811.47,0,1068360,0,0,0,0,0,0
20150105.09425,2811.47,0,1068360,0,0,0,0,0,0
20150105.094251,2811.47,0,1068360,0,0,0,0,0,0
20150105.094252,2811.47,0,1068360,0,0,0,0,0,0
20150105.094253,2811.47,0,1068360,0,0,0,0,0,0
20150105.094254,2811.47,0,1068360,0,0,0,0,0,0
20150105.094255,2811.47,0,1068360,0,0,0,0,0,0
20150105.094256,2811.47,0,1068360,0,0,0,0,0,0
20150105.094257,2811.47,0,1068360,0,0,0,0,0,0
20150105.094258,2811.47,0,1068360,0,0,0,0,0,0
20150105.094259,2811.47,0,1068360,0,0,0,0,0,0
20150105.0943,2811.47,0,1068360,0,0,0,0,0,0
20150105.094301,2811.47,0,1068360,0,0,0,0,0,0
20150105.094302,2811.47,0,1068360,0,0,0,0,0,0
20150105.094303,2811.47,0,1068360,0,0,0,0,0,0
20150105.094304,2811.47,0,1068360,0,0,0,0,0,0
20150105.094305,2811.47,0,1068360,0,0,0,0,0,0
20150105.094306,2811.47,0,1068360,0,0,0,0,0,0
20150105.094307,2811.47,0,1068360,0,0,0,0,0,0
20150105.094308,2811.47,0,1068360,0,0,0,0,0,0
20150105.094309,2811.47,0,1068360,0,0,0,0,0,0
20150105.09431,2811.47,0,1068360,0,0,0,0,0,0
20150105.094311,2811.47,0,1068360,0,0,0,0,0,0
20150105.094312,2811.47,0,1068360,0,0,0,0,0,0
20150105.094313,2811.47,0,1068360,0,0,0,0,0,0
20150105.094314,2811.47,0,1068360,0,0,0,0,0,0
20150105.094315,2811.47,0,1068360,0,0,0,0,0,0
20150105.094316,2811.47,0,1068360,0,0,0,0,0,0
20150105.094317,2811.47,0,1068360,0,0,0,0,0,0
20150105.094318,2811.47,0,1068360,0,0,0,0,0,0
20150105.094319,2811.47,0,1068360,0,0,0,0,0,0
20150105.09432,2811.47,0,1068360,0,0,0,0,0,0
20150105.094321,2811.47,0,1068360,0,0,0,0,0,0
20150105.094322,2811.47,0,1068360,0,0,0,0,0,0
20150105.094323,2811.47,0,1068360,0,0,0,0,0,0
20150105.094324,2811.47,0,1068360,0,0,0,0,0,0
20150105.094325,2811.47,0,1068360,0,0,0,0,0,0
20150105.094326,2811.47,0,1068360,0,0,0,0,0,0
20150105.094327,2811.47,0,1068360,0,0,0,0,0,0
20150105.094328,2811.47,0,1068360,0,0,0,0,0,0
20150105.094329,2811.47,0,1068360,0,0,0,0,0,0
20150105.09433,2811.47,0,1068360,0,0,0,0,0,0
20150105.094331,2811.47,0,1068360,0,0,0,0,0,0
20150105.094332,2811.47,0,1068360,0,0,0,0,0,0
20150105.094333,2811.47,0,1068360,0,0,0,0,0,0
20150105.094334,2811.47,0,1068360,0,0,0,0,0,0
20150105.094335,2811.47,0,1068360,0,0,0,0,0,0
20150105.094336,2811.47,0,1068360,0,0,0,0,0,0
20150105.094337,2811.47,0,1068360,0,0,0,0,0,0
20150105.094338,2811.47,0,1068360,0,0,0,0,0,0
20150105.094339,2811.47,0,1068360,0,0,0,0,0,0
20150105.09434,2811.47,0,1068360,0,0,0,0,0,0
20150105.094341,2811.47,0,1068360,0,0,0,0,0,0
20150105.094342,2811.47,0,1068360,0,0,0,0,0,0
20150105.094343,2811.47,0,1068360,0,0,0,0,0,0
20150105.094344,2811.47,0,1068360,0,0,0,0,0,0
20150105.094345,2811.47,0,1068360,0,0,0,0,0,0
20150105.094346,2811.47,0,1068360,0,0,0,0,0,0
20150105.094347,2811.47,0,1068360,0,0,0,0,0,0
20150105.094348,2811.47,0,1068360,0,0,0,0,0,0
20150105.094349,2811.47,0,1068360,0,0,0,0,0,0
20150105.09435,2811.47,0,1068360,0,0,0,0,0,0
20150105.094351,2811.47,0,1068360,0,0,0,0,0,0
20150105.094352,2811.47,0,1068360,0,0,0,0,0,0
20150105.094353,2811.47,0,1068360,0,0,0,0,0,0
20150105.094354,2811.47,0,1068360,0,0,0,0,0,0
20150105.094355,2811.47,0,1068360,0,0,0,0,0,0
20150105.094356,2811.47,0,1068360,0,0,0,0,0,0
20150105.094357,2811.47,0,1068360,0,0,0,0,0,0
20150105.094358,2811.47,0,1068360,0,0,0,0,0,0
20150105.094359,2811.47,0,1068360,0,0,0,0,0,0
20150105.0944,2811.47,0,1068360,0,0,0,0,0,0
20150105.094401,2811.47,0,1068360,0,0,0,0,0,0
20150105.094402,2811.47,0,1068360,0,0,0,0,0,0
20150105.094403,2811.47,0,1068360,0,0,0,0,0,0
20150105.094404,2811.47,0,1068360,0,0,0,0,0,0
20150105.094405,2811.47,0,1068360,0,0,0,0,0,0
20150105.094406,2811.47,0,1068360,0,0,0,0,0,0
20150105.094407,2811.47,0,1068360,0,0,0,0,0,0
20150105.094408,2811.47,0,1068360,0,0,0,0,0,0
20150105.094409,2811.47,0,1068360,0,0,0,0,0,0
20150105.09441,2811.47,0,1068360,0,0,0,0,0,0
20150105.094411,2811.47,0,1068360,0,0,0,0,0,0
20150105.094412,2811.47,0,1068360,0,0,0,0,0,0
20150105.094413,2811.47,0,1068360,0,0,0,0,0,0
20150105.094414,2811.47,0,1068360,0,0,0,0,0,0
20150105.094415,2811.47,0,1068360,0,0,0,0,0,0
20150105.094416,2811.47,0,1068360,0,0,0,0,0,0
20150105.094417,2811.47,0,1068360,0,0,0,0,0,0
20150105.094418,2811.47,0,1068360,0,0,0,0,0,0
20150105.094419,2811.47,0,1068360,0,0,0,0,0,0
20150105.09442,2811.47,0,1068360,0,0,0,0,0,0
20150105.094421,2811.47,0,1068360,0,0,0,0,0,0
20150105.094422,2811.47,0,1068360,0,0,0,0,0,0
20150105.094423,2811.47,0,1068360,0,0,0,0,0,0
20150105.094424,2811.47,0,1068360,0,0,0,0,0,0
20150105.094425,2811.47,0,1068360,0,0,0,0,0,0
20150105.094426,2811.47,0,1068360,0,0,0,0,0,0
20150105.094427,2811.47,0,1068360,0,0,0,0,0,0
20150105.094428,2811.47,0,1068360,0,0,0,0,0,0
20150105.094429,2811.47,0,1068360,0,0,0,0,0,0
20150105.09443,2811.47,0,1068360,0,0,0,0,0,0
20150105.094431,2811.47,0,1068360,0,0,0,0,0,0
20150105.094432,2811.47,0,1068360,0,0,0,0,0,0
20150105.094433,2811.47,0,1068360,0,0,0,0,0,0
20150105.094434,2811.47,0,1068360,0,0,0,0,0,0
20150105.094435,2811.47,0,1068360,0,0,0,0,0,0
20150105.094436,2811.47,0,1068360,0,0,0,0,0,0
20150105.094437,2811.47,0,1068360,0,0,0,0,0,0
20150105.094438,2811.47,0,1068360,0,0,0,0,0,0
20150105.094439,2811.47,0,1068360,0,0,0,0,0,0
20150105.09444,2811.47,0,1068360,0,0,0,0,0,0
20150105.094441,2811.47,0,1068360,0,0,0,0,0,0
20150105.094442,2811.47,0,1068360,0,0,0,0,0,0
20150105.094443,2811.47,0,1068360,0,0,0,0,0,0
20150105.094444,2811.47,0,1068360,0,0,0,0,0,0
20150105.094445,2811.47,0,1068360,0,0,0,0,0,0
20150105.094446,2811.47,0,1068360,0,0,0,0,0,0
20150105.094447,2811.47,0,1068360,0,0,0,0,0,0
20150105.094448,2811.47,0,1068360,0,0,0,0,0,0
20150105.094449,2811.47,0,1068360,0,0,0,0,0,0
20150105.09445,2811.47,0,1068360,0,0,0,0,0,0
20150105.094451,2811.47,0,1068360,0,0,0,0,0,0
20150105.094452,2811.47,0,1068360,0,0,0,0,0,0
20150105.094453,2811.47,0,1068360,0,0,0,0,0,0
20150105.094454,2811.47,0,1068360,0,0,0,0,0,0
20150105.094455,2811.47,0,1068360,0,0,0,0,0,0
20150105.094456,2811.47,0,1068360,0,0,0,0,0,0
20150105.094457,2811.47,0,1068360,0,0,0,0,0,0
20150105.094458,2811.47,0,1068360,0,0,0,0,0,0
20150105.094459,2811.47,0,1068360,0,0,0,0,0,0
20150105.0945,2811.47,0,1068360,0,0,0,0,0,0
20150105.094501,2811.47,0,1068360,0,0,0,0,0,0
20150105.094502,2811.47,0,1068360,0,0,0,0,0,0
20150105.094503,2811.47,0,1068360,0,0,0,0,0,0
20150105.094504,2811.47,0,1068360,0,0,0,0,0,0
20150105.094505,2811.47,0,1068360,0,0,0,0,0,0
20150105.094506,2811.47,0,1068360,0,0,0,0,0,0
20150105.094507,2811.47,0,1068360,0,0,0,0,0,0
20150105.094508,2811.47,0,1068360,0,0,0,0,0,0
20150105.094509,2811.47,0,1068360,0,0,0,0,0,0
20150105.09451,2811.47,0,1068360,0,0,0,0,0,0
20150105.094511,2811.47,0,1068360,0,0,0,0,0,0
20150105.094512,2811.47,0,1068360,0,0,0,0,0,0
20150105.094513,2811.47,0,1068360,0,0,0,0,0,0
20150105.094514,2811.47,0,1068360,0,0,0,0,0,0
20150105.094515,2811.47,0,1068360,0,0,0,0,0,0
20150105.094516,2811.47,0,1068360,0,0,0,0,0,0
20150105.094517,2811.47,0,1068360,0,0,0,0,0,0
20150105.094518,2811.47,0,1068360,0,0,0,0,0,0
20150105.094519,2811.47,0,1068360,0,0,0,0,0,0
20150105.09452,2811.47,0,1068360,0,0,0,0,0,0
20150105.094521,2811.47,0,1068360,0,0,0,0,0,0
20150105.094522,2811.47,0,1068360,0,0,0,0,0,0
20150105.094523,2811.47,0,1068360,0,0,0,0,0,0
20150105.094524,2811.47,0,1068360,0,0,0,0,0,0
20150105.094525,2811.47,0,1068360,0,0,0,0,0,0
20150105.094526,2811.47,0,1068360,0,0,0,0,0,0
20150105.094527,2811.47,0,1068360,0,0,0,0,0,0
20150105.094528,2811.47,0,1068360,0,0,0,0,0,0
20150105.094529,2811.47,0,1068360,0,0,0,0,0,0
20150105.09453,2811.47,0,1068360,0,0,0,0,0,0
20150105.094531,2811.47,0,1068360,0,0,0,0,0,0
20150105.094532,2811.47,0,1068360,0,0,0,0,0,0
20150105.094533,2811.47,0,1068360,0,0,0,0,0,0
20150105.094534,2811.47,0,1068360,0,0,0,0,0,0
20150105.094535,2811.47,0,1068360,0,0,0,0,0,0
20150105.094536,2811.47,0,1068360,0,0,0,0,0,0
20150105.094537,2811.47,0,1068360,0,0,0,0,0,0
20150105.094538,2811.47,0,1068360,0,0,0,0,0,0
20150105.094539,2811.47,0,1068360,0,0,0,0,0,0
20150105.09454,2811.47,0,1068360,0,0,0,0,0,0
20150105.094541,2811.47,0,1068360,0,0,0,0,0,0
20150105.094542,2811.47,0,1068360,0,0,0,0,0,0
20150105.094543,2811.47,0,1068360,0,0,0,0,0,0
20150105.094544,2811.47,0,1068360,0,0,0,0,0,0
20150105.094545,2811.47,0,1068360,0,0,0,0,0,0
20150105.094546,2811.47,0,1068360,0,0,0,0,0,0
20150105.094547,2811.47,0,1068360,0,0,0,0,0,0
20150105.094548,2811.47,0,1068360,0,0,0,0,0,0
20150105.094549,2811.47,0,1068360,0,0,0,0,0,0
20150105.09455,2811.47,0,1068360,0,0,0,0,0,0
20150105.094551,2811.47,0,1068360,0,0,0,0,0,0
20150105.094552,2811.47,0,1068360,0,0,0,0,0,0
20150105.094553,2811.47,0,1068360,0,0,0,0,0,0
20150105.094554,2811.47,0,1068360,0,0,0,0,0,0
20150105.094555,2811.47,0,1068360,0,0,0,0,0,0
20150105.094556,2811.47,0,1068360,0,0,0,0,0,0
20150105.094557,2811.47,0,1068360,0,0,0,0,0,0
20150105.094558,2811.47,0,1068360,0,0,0,0,0,0
20150105.094559,2811.47,0,1068360,0,0,0,0,0,0
20150105.0946,2811.47,0,1068360,0,0,0,0,0,0
20150105.094601,2811.47,0,1068360,0,0,0,0,0,0
20150105.094602,2811.47,0,1068360,0,0,0,0,0,0
20150105.094603,2811.47,0,1068360,0,0,0,0,0,0
20150105.094604,2811.47,0,1068360,0,0,0,0,0,0
20150105.094605,2811.47,0,1068360,0,0,0,0,0,0
20150105.094606,2811.47,0,1068360,0,0,0,0,0,0
20150105.094607,2811.47,0,1068360,0,0,0,0,0,0
20150105.094608,2811.47,0,1068360,0,0,0,0,0,0
20150105.094609,2811.47,0,1068360,0,0,0,0,0,0
20150105.09461,2811.47,0,1068360,0,0,0,0,0,0
20150105.094611,2811.47,0,1068360,0,0,0,0,0,0
20150105.094612,2811.47,0,1068360,0,0,0,0,0,0
20150105.094613,2811.47,0,1068360,0,0,0,0,0,0
20150105.094614,2811.47,0,1068360,0,0,0,0,0,0
20150105.094615,2811.47,0,1068360,0,0,0,0,0,0
20150105.094616,2811.47,0,1068360,0,0,0,0,0,0
20150105.094617,2811.47,0,1068360,0,0,0,0,0,0
20150105.094618,2811.47,0,1068360,0,0,0,0,0,0
20150105.094619,2811.47,0,1068360,0,0,0,0,0,0
20150105.09462,2811.47,0,1068360,0,0,0,0,0,0
20150105.094621,2811.47,0,1068360,0,0,0,0,0,0
20150105.094622,2811.47,0,1068360,0,0,0,0,0,0
20150105.094623,2811.47,0,1068360,0,0,0,0,0,0
20150105.094624,2811.47,0,1068360,0,0,0,0,0,0
20150105.094625,2811.47,0,1068360,0,0,0,0,0,0
20150105.094626,2811.47,0,1068360,0,0,0,0,0,0
20150105.094627,2811.47,0,1068360,0,0,0,0,0,0
20150105.094628,2811.47,0,1068360,0,0,0,0,0,0
20150105.094629,2811.47,0,1068360,0,0,0,0,0,0
20150105.09463,2811.47,0,1068360,0,0,0,0,0,0
20150105.094631,2811.47,0,1068360,0,0,0,0,0,0
20150105.094632,2811.47,0,1068360,0,0,0,0,0,0
20150105.094633,2811.47,0,1068360,0,0,0,0,0,0
20150105.094634,2811.47,0,1068360,0,0,0,0,0,0
20150105.094635,2811.47,0,1068360,0,0,0,0,0,0
20150105.094636,2811.47,0,1068360,0,0,0,0,0,0
20150105.094637,2811.47,0,1068360,0,0,0,0,0,0
20150105.094638,2811.47,0,1068360,0,0,0,0,0,0
20150105.094639,2811.47,0,1068360,0,0,0,0,0,0
20150105.09464,2811.47,0,1068360,0,0,0,0,0,0
20150105.094641,2811.47,0,1068360,0,0,0,0,0,0
20150105.094642,2811.47,0,1068360,0,0,0,0,0,0
20150105.094643,2811.47,0,1068360,0,0,0,0,0,0
20150105.094644,2811.47,0,1068360,0,0,0,0,0,0
20150105.094645,2811.47,0,1068360,0,0,0,0,0,0
20150105.094646,2811.47,0,1068360,0,0,0,0,0,0
20150105.094647,2811.47,0,1068360,0,0,0,0,0,0
20150105.094648,2811.47,0,1068360,0,0,0,0,0,0
20150105.094649,2811.47,0,1068360,0,0,0,0,0,0
20150105.09465,2811.47,0,1068360,0,0,0,0,0,0
20150105.094651,2811.47,0,1068360,0,0,0,0,0,0
20150105.094652,2811.47,0,1068360,0,0,0,0,0,0
20150105.094653,2811.47,0,1068360,0,0,0,0,0,0
20150105.094654,2811.47,0,1068360,0,0,0,0,0,0
20150105.094655,2811.47,0,1068360,0,0,0,0,0,0
20150105.094656,2811.47,0,1068360,0,0,0,0,0,0
20150105.094657,2811.47,0,1068360,0,0,0,0,0,0
20150105.094658,2811.47,0,1068360,0,0,0,0,0,0
20150105.094659,2811.47,0,1068360,0,0,0,0,0,0
20150105.0947,2811.47,0,1068360,0,0,0,0,0,0
20150105.094701,2811.47,0,1068360,0,0,0,0,0,0
20150105.094702,2811.47,0,1068360,0,0,0,0,0,0
20150105.094703,2811.47,0,1068360,0,0,0,0,0,0
20150105.094704,2811.47,0,1068360,0,0,0,0,0,0
20150105.094705,2811.47,0,1068360,0,0,0,0,0,0
20150105.094706,2811.47,0,1068360,0,0,0,0,0,0
20150105.094707,2811.47,0,1068360,0,0,0,0,0,0
20150105.094708,2811.47,0,1068360,0,0,0,0,0,0
20150105.094709,2811.47,0,1068360,0,0,0,0,0,0
20150105.09471,2811.47,0,1068360,0,0,0,0,0,0
20150105.094711,2811.47,0,1068360,0,0,0,0,0,0
20150105.094712,2811.47,0,1068360,0,0,0,0,0,0
20150105.094713,2811.47,0,1068360,0,0,0,0,0,0
20150105.094714,2811.47,0,1068360,0,0,0,0,0,0
20150105.094715,2811.47,0,1068360,0,0,0,0,0,0
20150105.094716,2811.47,0,1068360,0,0,0,0,0,0
20150105.094717,2811.47,0,1068360,0,0,0,0,0,0
20150105.094718,2811.47,0,1068360,0,0,0,0,0,0
20150105.094719,2811.47,0,1068360,0,0,0,0,0,0
20150105.09472,2811.47,0,1068360,0,0,0,0,0,0
20150105.094721,2811.47,0,1068360,0,0,0,0,0,0
20150105.094722,2811.47,0,1068360,0,0,0,0,0,0
20150105.094723,2811.47,0,1068360,0,0,0,0,0,0
20150105.094724,2811.47,0,1068360,0,0,0,0,0,0
20150105.094725,2811.47,0,1068360,0,0,0,0,0,0
20150105.094726,2811.47,0,1068360,0,0,0,0,0,0
20150105.094727,2811.47,0,1068360,0,0,0,0,0,0
20150105.094728,2811.47,0,1068360,0,0,0,0,0,0
20150105.094729,2811.47,0,1068360,0,0,0,0,0,0
20150105.09473,2811.47,0,1068360,0,0,0,0,0,0
20150105.094731,2811.47,0,1068360,0,0,0,0,0,0
20150105.094732,2811.47,0,1068360,0,0,0,0,0,0
20150105.094733,2811.47,0,1068360,0,0,0,0,0,0
20150105.094734,2811.47,0,1068360,0,0,0,0,0,0
20150105.094735,2811.47,0,1068360,0,0,0,0,0,0
20150105.094736,2811.47,0,1068360,0,0,0,0,0,0
20150105.094737,2811.47,0,1068360,0,0,0,0,0,0
20150105.094738,2811.47,0,1068360,0,0,0,0,0,0
20150105.094739,2811.47,0,1068360,0,0,0,0,0,0
20150105.09474,2811.47,0,1068360,0,0,0,0,0,0
20150105.094741,2811.47,0,1068360,0,0,0,0,0,0
20150105.094742,2811.47,0,1068360,0,0,0,0,0,0
20150105.094743,2811.47,0,1068360,0,0,0,0,0,0
20150105.094744,2811.47,0,1068360,0,0,0,0,0,0
20150105.094745,2811.47,0,1068360,0,0,0,0,0,0
20150105.094746,2811.47,0,1068360,0,0,0,0,0,0
20150105.094747,2811.47,0,1068360,0,0,0,0,0,0
20150105.094748,2811.47,0,1068360,0,0,0,0,0,0
20150105.094749,2811.47,0,1068360,0,0,0,0,0,0
20150105.09475,2811.47,0,1068360,0,0,0,0,0,0
20150105.094751,2811.47,0,1068360,0,0,0,0,0,0
20150105.094752,2811.47,0,1068360,0,0,0,0,0,0
20150105.094753,2811.47,0,1068360,0,0,0,0,0,0
20150105.094754,2811.47,0,1068360,0,0,0,0,0,0
20150105.094755,2811.47,0,1068360,0,0,0,0,0,0
20150105.094756,2811.47,0,1068360,0,0,0,0,0,0
20150105.094757,2811.47,0,1068360,0,0,0,0,0,0
20150105.094758,2811.47,0,1068360,0,0,0,0,0,0
20150105.094759,2811.47,0,1068360,0,0,0,0,0,0
20150105.0948,2811.47,0,1068360,0,0,0,0,0,0
20150105.094801,2811.47,0,1068360,0,0,0,0,0,0
20150105.094802,2811.47,0,1068360,0,0,0,0,0,0
20150105.094803,2811.47,0,1068360,0,0,0,0,0,0
20150105.094804,2811.47,0,1068360,0,0,0,0,0,0
20150105.094805,2811.47,0,1068360,0,0,0,0,0,0
20150105.094806,2811.47,0,1068360,0,0,0,0,0,0
20150105.094807,2811.47,0,1068360,0,0,0,0,0,0
20150105.094808,2811.47,0,1068360,0,0,0,0,0,0
20150105.094809,2811.47,0,1068360,0,0,0,0,0,0
20150105.09481,2811.47,0,1068360,0,0,0,0,0,0
20150105.094811,2811.47,0,1068360,0,0,0,0,0,0
20150105.094812,2811.47,0,1068360,0,0,0,0,0,0
20150105.094813,2811.47,0,1068360,0,0,0,0,0,0
20150105.094814,2811.47,0,1068360,0,0,0,0,0,0
20150105.094815,2811.47,0,1068360,0,0,0,0,0,0
20150105.094816,2811.47,0,1068360,0,0,0,0,0,0
20150105.094817,2811.47,0,1068360,0,0,0,0,0,0
20150105.094818,2811.47,0,1068360,0,0,0,0,0,0
20150105.094819,2811.47,0,1068360,0,0,0,0,0,0
20150105.09482,2811.47,0,1068360,0,0,0,0,0,0
20150105.094821,2811.47,0,1068360,0,0,0,0,0,0
20150105.094822,2811.47,0,1068360,0,0,0,0,0,0
20150105.094823,2811.47,0,1068360,0,0,0,0,0,0
20150105.094824,2811.47,0,1068360,0,0,0,0,0,0
20150105.094825,2811.47,0,1068360,0,0,0,0,0,0
20150105.094826,2811.47,0,1068360,0,0,0,0,0,0
20150105.094827,2811.47,0,1068360,0,0,0,0,0,0
20150105.094828,2811.47,0,1068360,0,0,0,0,0,0
20150105.094829,2811.47,0,1068360,0,0,0,0,0,0
20150105.09483,2811.47,0,1068360,0,0,0,0,0,0
20150105.094831,2811.47,0,1068360,0,0,0,0,0,0
20150105.094832,2811.47,0,1068360,0,0,0,0,0,0
20150105.094833,2811.47,0,1068360,0,0,0,0,0,0
20150105.094834,2811.47,0,1068360,0,0,0,0,0,0
20150105.094835,2811.47,0,1068360,0,0,0,0,0,0
20150105.094836,2811.47,0,1068360,0,0,0,0,0,0
20150105.094837,2811.47,0,1068360,0,0,0,0,0,0
20150105.094838,2811.47,0,1068360,0,0,0,0,0,0
20150105.094839,2811.47,0,1068360,0,0,0,0,0,0
20150105.09484,2811.47,0,1068360,0,0,0,0,0,0
20150105.094841,2811.47,0,1068360,0,0,0,0,0,0
20150105.094842,2811.47,0,1068360,0,0,0,0,0,0
20150105.094843,2811.47,0,1068360,0,0,0,0,0,0
20150105.094844,2811.47,0,1068360,0,0,0,0,0,0
20150105.094845,2811.47,0,1068360,0,0,0,0,0,0
20150105.094846,2811.47,0,1068360,0,0,0,0,0,0
20150105.094847,2811.47,0,1068360,0,0,0,0,0,0
20150105.094848,2811.47,0,1068360,0,0,0,0,0,0
20150105.094849,2811.47,0,1068360,0,0,0,0,0,0
20150105.09485,2811.47,0,1068360,0,0,0,0,0,0
20150105.094851,2811.47,0,1068360,0,0,0,0,0,0
20150105.094852,2811.47,0,1068360,0,0,0,0,0,0
20150105.094853,2811.47,0,1068360,0,0,0,0,0,0
20150105.094854,2811.47,0,1068360,0,0,0,0,0,0
20150105.094855,2811.47,0,1068360,0,0,0,0,0,0
20150105.094856,2811.47,0,1068360,0,0,0,0,0,0
20150105.094857,2811.47,0,1068360,0,0,0,0,0,0
20150105.094858,2811.47,0,1068360,0,0,0,0,0,0
20150105.094859,2811.47,0,1068360,0,0,0,0,0,0
20150105.0949,2811.47,0,1068360,0,0,0,0,0,0
20150105.094901,2811.47,0,1068360,0,0,0,0,0,0
20150105.094902,2811.47,0,1068360,0,0,0,0,0,0
20150105.094903,2811.47,0,1068360,0,0,0,0,0,0
20150105.094904,2811.47,0,1068360,0,0,0,0,0,0
20150105.094905,2811.47,0,1068360,0,0,0,0,0,0
20150105.094906,2811.47,0,1068360,0,0,0,0,0,0
20150105.094907,2811.47,0,1068360,0,0,0,0,0,0
20150105.094908,2811.47,0,1068360,0,0,0,0,0,0
20150105.094909,2811.47,0,1068360,0,0,0,0,0,0
20150105.09491,2811.47,0,1068360,0,0,0,0,0,0
20150105.094911,2811.47,0,1068360,0,0,0,0,0,0
20150105.094912,2811.47,0,1068360,0,0,0,0,0,0
20150105.094913,2811.47,0,1068360,0,0,0,0,0,0
20150105.094914,2811.47,0,1068360,0,0,0,0,0,0
20150105.094915,2811.47,0,1068360,0,0,0,0,0,0
20150105.094916,2811.47,0,1068360,0,0,0,0,0,0
20150105.094917,2811.47,0,1068360,0,0,0,0,0,0
20150105.094918,2811.47,0,1068360,0,0,0,0,0,0
20150105.094919,2811.47,0,1068360,0,0,0,0,0,0
20150105.09492,2811.47,0,1068360,0,0,0,0,0,0
20150105.094921,2811.47,0,1068360,0,0,0,0,0,0
20150105.094922,2811.47,0,1068360,0,0,0,0,0,0
20150105.094923,2811.47,0,1068360,0,0,0,0,0,0
20150105.094924,2811.47,0,1068360,0,0,0,0,0,0
20150105.094925,2811.47,0,1068360,0,0,0,0,0,0
20150105.094926,2811.47,0,1068360,0,0,0,0,0,0
20150105.094927,2811.47,0,1068360,0,0,0,0,0,0
20150105.094928,2811.47,0,1068360,0,0,0,0,0,0
20150105.094929,2811.47,0,1068360,0,0,0,0,0,0
20150105.09493,2811.47,0,1068360,0,0,0,0,0,0
20150105.094931,2811.47,0,1068360,0,0,0,0,0,0
20150105.094932,2811.47,0,1068360,0,0,0,0,0,0
20150105.094933,2811.47,0,1068360,0,0,0,0,0,0
20150105.094934,2811.47,0,1068360,0,0,0,0,0,0
20150105.094935,2811.47,0,1068360,0,0,0,0,0,0
20150105.094936,2811.47,0,1068360,0,0,0,0,0,0
20150105.094937,2811.47,0,1068360,0,0,0,0,0,0
20150105.094938,2811.47,0,1068360,0,0,0,0,0,0
20150105.094939,2811.47,0,1068360,0,0,0,0,0,0
20150105.09494,2811.47,0,1068360,0,0,0,0,0,0
20150105.094941,2811.47,0,1068360,0,0,0,0,0,0
20150105.094942,2811.47,0,1068360,0,0,0,0,0,0
20150105.094943,2811.47,0,1068360,0,0,0,0,0,0
20150105.094944,2811.47,0,1068360,0,0,0,0,0,0
20150105.094945,2811.47,0,1068360,0,0,0,0,0,0
20150105.094946,2811.47,0,1068360,0,0,0,0,0,0
20150105.094947,2811.47,0,1068360,0,0,0,0,0,0
20150105.094948,2811.47,0,1068360,0,0,0,0,0,0
20150105.094949,2811.47,0,1068360,0,0,0,0,0,0
20150105.09495,2811.47,0,1068360,0,0,0,0,0,0
20150105.094951,2811.47,0,1068360,0,0,0,0,0,0
20150105.094952,2811.47,0,1068360,0,0,0,0,0,0
20150105.094953,2811.47,0,1068360,0,0,0,0,0,0
20150105.094954,2811.47,0,1068360,0,0,0,0,0,0
20150105.094955,2811.47,0,1068360,0,0,0,0,0,0
20150105.094956,2811.47,0,1068360,0,0,0,0,0,0
20150105.094957,2811.47,0,1068360,0,0,0,0,0,0
20150105.094958,2811.47,0,1068360,0,0,0,0,0,0
20150105.094959,2811.47,0,1068360,0,0,0,0,0,0
20150105.095,2811.47,0,1068360,0,0,0,0,0,0
20150105.095001,2811.47,0,1068360,0,0,0,0,0,0
20150105.095002,2811.47,0,1068360,0,0,0,0,0,0
20150105.095003,2811.47,0,1068360,0,0,0,0,0,0
20150105.095004,2811.47,0,1068360,0,0,0,0,0,0
20150105.095005,2811.47,0,1068360,0,0,0,0,0,0
20150105.095006,2811.47,0,1068360,0,0,0,0,0,0
20150105.095007,2811.47,0,1068360,0,0,0,0,0,0
20150105.095008,2811.47,0,1068360,0,0,0,0,0,0
20150105.095009,2811.47,0,1068360,0,0,0,0,0,0
20150105.09501,2811.47,0,1068360,0,0,0,0,0,0
20150105.095011,2811.47,0,1068360,0,0,0,0,0,0
20150105.095012,2811.47,0,1068360,0,0,0,0,0,0
20150105.095013,2811.47,0,1068360,0,0,0,0,0,0
20150105.095014,2811.47,0,1068360,0,0,0,0,0,0
20150105.095015,2811.47,0,1068360,0,0,0,0,0,0
20150105.095016,2811.47,0,1068360,0,0,0,0,0,0
20150105.095017,2811.47,0,1068360,0,0,0,0,0,0
20150105.095018,2811.47,0,1068360,0,0,0,0,0,0
20150105.095019,2811.47,0,1068360,0,0,0,0,0,0
20150105.09502,2811.47,0,1068360,0,0,0,0,0,0
20150105.095021,2811.47,0,1068360,0,0,0,0,0,0
20150105.095022,2811.47,0,1068360,0,0,0,0,0,0
20150105.095023,2811.47,0,1068360,0,0,0,0,0,0
20150105.095024,2811.47,0,1068360,0,0,0,0,0,0
20150105.095025,2811.47,0,1068360,0,0,0,0,0,0
20150105.095026,2811.47,0,1068360,0,0,0,0,0,0
20150105.095027,2811.47,0,1068360,0,0,0,0,0,0
20150105.095028,2811.47,0,1068360,0,0,0,0,0,0
20150105.095029,2811.47,0,1068360,0,0,0,0,0,0
20150105.09503,2811.47,0,1068360,0,0,0,0,0,0
20150105.095031,2811.47,0,1068360,0,0,0,0,0,0
20150105.095032,2811.47,0,1068360,0,0,0,0,0,0
20150105.095033,2811.47,0,1068360,0,0,0,0,0,0
20150105.095034,2811.47,0,1068360,0,0,0,0,0,0
20150105.095035,2811.47,0,1068360,0,0,0,0,0,0
20150105.095036,2811.47,0,1068360,0,0,0,0,0,0
20150105.095037,2811.47,0,1068360,0,0,0,0,0,0
20150105.095038,2811.47,0,1068360,0,0,0,0,0,0
20150105.095039,2811.47,0,1068360,0,0,0,0,0,0
20150105.09504,2811.47,0,1068360,0,0,0,0,0,0
20150105.095041,2811.47,0,1068360,0,0,0,0,0,0
20150105.095042,2811.47,0,1068360,0,0,0,0,0,0
20150105.095043,2811.47,0,1068360,0,0,0,0,0,0
20150105.095044,2811.47,0,1068360,0,0,0,0,0,0
20150105.095045,2811.47,0,1068360,0,0,0,0,0,0
20150105.095046,2811.47,0,1068360,0,0,0,0,0,0
20150105.095047,2811.47,0,1068360,0,0,0,0,0,0
20150105.095048,2811.47,0,1068360,0,0,0,0,0,0
20150105.095049,2811.47,0,1068360,0,0,0,0,0,0
20150105.09505,2811.47,0,1068360,0,0,0,0,0,0
20150105.095051,2811.47,0,1068360,0,0,0,0,0,0
20150105.095052,2811.47,0,1068360,0,0,0,0,0,0
20150105.095053,2811.47,0,1068360,0,0,0,0,0,0
20150105.095054,2811.47,0,1068360,0,0,0,0,0,0
20150105.095055,2811.47,0,1068360,0,0,0,0,0,0
20150105.095056,2811.47,0,1068360,0,0,0,0,0,0
20150105.095057,2811.47,0,1068360,0,0,0,0,0,0
20150105.095058,2811.47,0,1068360,0,0,0,0,0,0
20150105.095059,2811.47,0,1068360,0,0,0,0,0,0
20150105.0951,2811.47,0,1068360,0,0,0,0,0,0
20150105.095101,2811.47,0,1068360,0,0,0,0,0,0
20150105.095102,2811.47,0,1068360,0,0,0,0,0,0
20150105.095103,2811.47,0,1068360,0,0,0,0,0,0
20150105.095104,2811.47,0,1068360,0,0,0,0,0,0
20150105.095105,2811.47,0,1068360,0,0,0,0,0,0
20150105.095106,2811.47,0,1068360,0,0,0,0,0,0
20150105.095107,2811.47,0,1068360,0,0,0,0,0,0
20150105.095108,2811.47,0,1068360,0,0,0,0,0,0
20150105.095109,2811.47,0,1068360,0,0,0,0,0,0
20150105.09511,2811.47,0,1068360,0,0,0,0,0,0
20150105.095111,2811.47,0,1068360,0,0,0,0,0,0
20150105.095112,2811.47,0,1068360,0,0,0,0,0,0
20150105.095113,2811.47,0,1068360,0,0,0,0,0,0
20150105.095114,2811.47,0,1068360,0,0,0,0,0,0
20150105.095115,2811.47,0,1068360,0,0,0,0,0,0
20150105.095116,2811.47,0,1068360,0,0,0,0,0,0
20150105.095117,2811.47,0,1068360,0,0,0,0,0,0
20150105.095118,2811.47,0,1068360,0,0,0,0,0,0
20150105.095119,2811.47,0,1068360,0,0,0,0,0,0
20150105.09512,2811.47,0,1068360,0,0,0,0,0,0
20150105.095121,2811.47,0,1068360,0,0,0,0,0,0
20150105.095122,2811.47,0,1068360,0,0,0,0,0,0
20150105.095123,2811.47,0,1068360,0,0,0,0,0,0
20150105.095124,2811.47,0,1068360,0,0,0,0,0,0
20150105.095125,2811.47,0,1068360,0,0,0,0,0,0
20150105.095126,2811.47,0,1068360,0,0,0,0,0,0
20150105.095127,2811.47,0,1068360,0,0,0,0,0,0
20150105.095128,2811.47,0,1068360,0,0,0,0,0,0
20150105.095129,2811.47,0,1068360,0,0,0,0,0,0
20150105.09513,2811.47,0,1068360,0,0,0,0,0,0
20150105.095131,2811.47,0,1068360,0,0,0,0,0,0
20150105.095132,2811.47,0,1068360,0,0,0,0,0,0
20150105.095133,2811.47,0,1068360,0,0,0,0,0,0
20150105.095134,2811.47,0,1068360,0,0,0,0,0,0
20150105.095135,2811.47,0,1068360,0,0,0,0,0,0
20150105.095136,2811.47,0,1068360,0,0,0,0,0,0
20150105.095137,2811.47,0,1068360,0,0,0,0,0,0
20150105.095138,2811.47,0,1068360,0,0,0,0,0,0
20150105.095139,2811.47,0,1068360,0,0,0,0,0,0
20150105.09514,2811.47,0,1068360,0,0,0,0,0,0
20150105.095141,2811.47,0,1068360,0,0,0,0,0,0
20150105.095142,2811.47,0,1068360,0,0,0,0,0,0
20150105.095143,2811.47,0,1068360,0,0,0,0,0,0
20150105.095144,2811.47,0,1068360,0,0,0,0,0,0
20150105.095145,2811.47,0,1068360,0,0,0,0,0,0
20150105.095146,2811.47,0,1068360,0,0,0,0,0,0
20150105.095147,2811.47,0,1068360,0,0,0,0,0,0
20150105.095148,2811.47,0,1068360,0,0,0,0,0,0
20150105.095149,2811.47,0,1068360,0,0,0,0,0,0
20150105.09515,2811.47,0,1068360,0,0,0,0,0,0
20150105.095151,2811.47,0,1068360,0,0,0,0,0,0
20150105.095152,2811.47,0,1068360,0,0,0,0,0,0
20150105.095153,2811.47,0,1068360,0,0,0,0,0,0
20150105.095154,2811.47,0,1068360,0,0,0,0,0,0
20150105.095155,2811.47,0,1068360,0,0,0,0,0,0
20150105.095156,2811.47,0,1068360,0,0,0,0,0,0
20150105.095157,2811.47,0,1068360,0,0,0,0,0,0
20150105.095158,2811.47,0,1068360,0,0,0,0,0,0
20150105.095159,2811.47,0,1068360,0,0,0,0,0,0
20150105.0952,2811.47,0,1068360,0,0,0,0,0,0
20150105.095201,2811.47,0,1068360,0,0,0,0,0,0
20150105.095202,2811.47,0,1068360,0,0,0,0,0,0
20150105.095203,2811.47,0,1068360,0,0,0,0,0,0
20150105.095204,2811.47,0,1068360,0,0,0,0,0,0
20150105.095205,2811.47,0,1068360,0,0,0,0,0,0
20150105.095206,2811.47,0,1068360,0,0,0,0,0,0
20150105.095207,2811.47,0,1068360,0,0,0,0,0,0
20150105.095208,2811.47,0,1068360,0,0,0,0,0,0
20150105.095209,2811.47,0,1068360,0,0,0,0,0,0
20150105.09521,2811.47,0,1068360,0,0,0,0,0,0
20150105.095211,2811.47,0,1068360,0,0,0,0,0,0
20150105.095212,2811.47,0,1068360,0,0,0,0,0,0
20150105.095213,2811.47,0,1068360,0,0,0,0,0,0
20150105.095214,2811.47,0,1068360,0,0,0,0,0,0
20150105.095215,2811.47,0,1068360,0,0,0,0,0,0
20150105.095216,2811.47,0,1068360,0,0,0,0,0,0
20150105.095217,2811.47,0,1068360,0,0,0,0,0,0
20150105.095218,2811.47,0,1068360,0,0,0,0,0,0
20150105.095219,2811.47,0,1068360,0,0,0,0,0,0
20150105.09522,2811.47,0,1068360,0,0,0,0,0,0
20150105.095221,2811.47,0,1068360,0,0,0,0,0,0
20150105.095222,2811.47,0,1068360,0,0,0,0,0,0
20150105.095223,2811.47,0,1068360,0,0,0,0,0,0
20150105.095224,2811.47,0,1068360,0,0,0,0,0,0
20150105.095225,2811.47,0,1068360,0,0,0,0,0,0
20150105.095226,2811.47,0,1068360,0,0,0,0,0,0
20150105.095227,2811.47,0,1068360,0,0,0,0,0,0
20150105.095228,2811.47,0,1068360,0,0,0,0,0,0
20150105.095229,2811.47,0,1068360,0,0,0,0,0,0
20150105.09523,2811.47,0,1068360,0,0,0,0,0,0
20150105.095231,2811.47,0,1068360,0,0,0,0,0,0
20150105.095232,2811.47,0,1068360,0,0,0,0,0,0
20150105.095233,2811.47,0,1068360,0,0,0,0,0,0
20150105.095234,2811.47,0,1068360,0,0,0,0,0,0
20150105.095235,2811.47,0,1068360,0,0,0,0,0,0
20150105.095236,2811.47,0,1068360,0,0,0,0,0,0
20150105.095237,2811.47,0,1068360,0,0,0,0,0,0
20150105.095238,2811.47,0,1068360,0,0,0,0,0,0
20150105.095239,2811.47,0,1068360,0,0,0,0,0,0
20150105.09524,2811.47,0,1068360,0,0,0,0,0,0
20150105.095241,2811.47,0,1068360,0,0,0,0,0,0
20150105.095242,2811.47,0,1068360,0,0,0,0,0,0
20150105.095243,2811.47,0,1068360,0,0,0,0,0,0
20150105.095244,2811.47,0,1068360,0,0,0,0,0,0
20150105.095245,2811.47,0,1068360,0,0,0,0,0,0
20150105.095246,2811.47,0,1068360,0,0,0,0,0,0
20150105.095247,2811.47,0,1068360,0,0,0,0,0,0
20150105.095248,2811.47,0,1068360,0,0,0,0,0,0
20150105.095249,2811.47,0,1068360,0,0,0,0,0,0
20150105.09525,2811.47,0,1068360,0,0,0,0,0,0
20150105.095251,2811.47,0,1068360,0,0,0,0,0,0
20150105.095252,2811.47,0,1068360,0,0,0,0,0,0
20150105.095253,2811.47,0,1068360,0,0,0,0,0,0
20150105.095254,2811.47,0,1068360,0,0,0,0,0,0
20150105.095255,2811.47,0,1068360,0,0,0,0,0,0
20150105.095256,2811.47,0,1068360,0,0,0,0,0,0
20150105.095257,2811.47,0,1068360,0,0,0,0,0,0
20150105.095258,2811.47,0,1068360,0,0,0,0,0,0
20150105.095259,2811.47,0,1068360,0,0,0,0,0,0
20150105.0953,2811.47,0,1068360,0,0,0,0,0,0
20150105.095301,2811.47,0,1068360,0,0,0,0,0,0
20150105.095302,2811.47,0,1068360,0,0,0,0,0,0
20150105.095303,2811.47,0,1068360,0,0,0,0,0,0
20150105.095304,2811.47,0,1068360,0,0,0,0,0,0
20150105.095305,2811.47,0,1068360,0,0,0,0,0,0
20150105.095306,2811.47,0,1068360,0,0,0,0,0,0
20150105.095307,2811.47,0,1068360,0,0,0,0,0,0
20150105.095308,2811.47,0,1068360,0,0,0,0,0,0
20150105.095309,2811.47,0,1068360,0,0,0,0,0,0
20150105.09531,2811.47,0,1068360,0,0,0,0,0,0
20150105.095311,2811.47,0,1068360,0,0,0,0,0,0
20150105.095312,2811.47,0,1068360,0,0,0,0,0,0
20150105.095313,2811.47,0,1068360,0,0,0,0,0,0
20150105.095314,2811.47,0,1068360,0,0,0,0,0,0
20150105.095315,2811.47,0,1068360,0,0,0,0,0,0
20150105.095316,2811.47,0,1068360,0,0,0,0,0,0
20150105.095317,2811.47,0,1068360,0,0,0,0,0,0
20150105.095318,2811.47,0,1068360,0,0,0,0,0,0
20150105.095319,2811.47,0,1068360,0,0,0,0,0,0
20150105.09532,2811.47,0,1068360,0,0,0,0,0,0
20150105.095321,2811.47,0,1068360,0,0,0,0,0,0
20150105.095322,2811.47,0,1068360,0,0,0,0,0,0
20150105.095323,2811.47,0,1068360,0,0,0,0,0,0
20150105.095324,2811.47,0,1068360,0,0,0,0,0,0
20150105.095325,2811.47,0,1068360,0,0,0,0,0,0
20150105.095326,2811.47,0,1068360,0,0,0,0,0,0
20150105.095327,2811.47,0,1068360,0,0,0,0,0,0
20150105.095328,2811.47,0,1068360,0,0,0,0,0,0
20150105.095329,2811.47,0,1068360,0,0,0,0,0,0
20150105.09533,2811.47,0,1068360,0,0,0,0,0,0
20150105.095331,2811.47,0,1068360,0,0,0,0,0,0
20150105.095332,2811.47,0,1068360,0,0,0,0,0,0
20150105.095333,2811.47,0,1068360,0,0,0,0,0,0
20150105.095334,2811.47,0,1068360,0,0,0,0,0,0
20150105.095335,2811.47,0,1068360,0,0,0,0,0,0
20150105.095336,2811.47,0,1068360,0,0,0,0,0,0
20150105.095337,2811.47,0,1068360,0,0,0,0,0,0
20150105.095338,2811.47,0,1068360,0,0,0,0,0,0
20150105.095339,2811.47,0,1068360,0,0,0,0,0,0
20150105.09534,2811.47,0,1068360,0,0,0,0,0,0
20150105.095341,2811.47,0,1068360,0,0,0,0,0,0
20150105.095342,2811.47,0,1068360,0,0,0,0,0,0
20150105.095343,2811.47,0,1068360,0,0,0,0,0,0
20150105.095344,2811.47,0,1068360,0,0,0,0,0,0
20150105.095345,2811.47,0,1068360,0,0,0,0,0,0
20150105.095346,2811.47,0,1068360,0,0,0,0,0,0
20150105.095347,2811.47,0,1068360,0,0,0,0,0,0
20150105.095348,2811.47,0,1068360,0,0,0,0,0,0
20150105.095349,2811.47,0,1068360,0,0,0,0,0,0
20150105.09535,2811.47,0,1068360,0,0,0,0,0,0
20150105.095351,2811.47,0,1068360,0,0,0,0,0,0
20150105.095352,2811.47,0,1068360,0,0,0,0,0,0
20150105.095353,2811.47,0,1068360,0,0,0,0,0,0
20150105.095354,2811.47,0,1068360,0,0,0,0,0,0
20150105.095355,2811.47,0,1068360,0,0,0,0,0,0
20150105.095356,2811.47,0,1068360,0,0,0,0,0,0
20150105.095357,2811.47,0,1068360,0,0,0,0,0,0
20150105.095358,2811.47,0,1068360,0,0,0,0,0,0
20150105.095359,2811.47,0,1068360,0,0,0,0,0,0
20150105.0954,2811.47,0,1068360,0,0,0,0,0,0
20150105.095401,2811.47,0,1068360,0,0,0,0,0,0
20150105.095402,2811.47,0,1068360,0,0,0,0,0,0
20150105.095403,2811.47,0,1068360,0,0,0,0,0,0
20150105.095404,2811.47,0,1068360,0,0,0,0,0,0
20150105.095405,2811.47,0,1068360,0,0,0,0,0,0
20150105.095406,2811.47,0,1068360,0,0,0,0,0,0
20150105.095407,2811.47,0,1068360,0,0,0,0,0,0
20150105.095408,2811.47,0,1068360,0,0,0,0,0,0
20150105.095409,2811.47,0,1068360,0,0,0,0,0,0
20150105.09541,2811.47,0,1068360,0,0,0,0,0,0
20150105.095411,2811.47,0,1068360,0,0,0,0,0,0
20150105.095412,2811.47,0,1068360,0,0,0,0,0,0
20150105.095413,2811.47,0,1068360,0,0,0,0,0,0
20150105.095414,2811.47,0,1068360,0,0,0,0,0,0
20150105.095415,2811.47,0,1068360,0,0,0,0,0,0
20150105.095416,2811.47,0,1068360,0,0,0,0,0,0
20150105.095417,2811.47,0,1068360,0,0,0,0,0,0
20150105.095418,2811.47,0,1068360,0,0,0,0,0,0
20150105.095419,2811.47,0,1068360,0,0,0,0,0,0
20150105.09542,2811.47,0,1068360,0,0,0,0,0,0
20150105.095421,2811.47,0,1068360,0,0,0,0,0,0
20150105.095422,2811.47,0,1068360,0,0,0,0,0,0
20150105.095423,2811.47,0,1068360,0,0,0,0,0,0
20150105.095424,2811.47,0,1068360,0,0,0,0,0,0
20150105.095425,2811.47,0,1068360,0,0,0,0,0,0
20150105.095426,2811.47,0,1068360,0,0,0,0,0,0
20150105.095427,2811.47,0,1068360,0,0,0,0,0,0
20150105.095428,2811.47,0,1068360,0,0,0,0,0,0
20150105.095429,2811.47,0,1068360,0,0,0,0,0,0
20150105.09543,2811.47,0,1068360,0,0,0,0,0,0
20150105.095431,2811.47,0,1068360,0,0,0,0,0,0
20150105.095432,2811.47,0,1068360,0,0,0,0,0,0
20150105.095433,2811.47,0,1068360,0,0,0,0,0,0
20150105.095434,2811.47,0,1068360,0,0,0,0,0,0
20150105.095435,2811.47,0,1068360,0,0,0,0,0,0
20150105.095436,2811.47,0,1068360,0,0,0,0,0,0
20150105.095437,2811.47,0,1068360,0,0,0,0,0,0
20150105.095438,2811.47,0,1068360,0,0,0,0,0,0
20150105.095439,2811.47,0,1068360,0,0,0,0,0,0
20150105.09544,2811.47,0,1068360,0,0,0,0,0,0
20150105.095441,2811.47,0,1068360,0,0,0,0,0,0
20150105.095442,2811.47,0,1068360,0,0,0,0,0,0
20150105.095443,2811.47,0,1068360,0,0,0,0,0,0
20150105.095444,2811.47,0,1068360,0,0,0,0,0,0
20150105.095445,2811.47,0,1068360,0,0,0,0,0,0
20150105.095446,2811.47,0,1068360,0,0,0,0,0,0
20150105.095447,2811.47,0,1068360,0,0,0,0,0,0
20150105.095448,2811.47,0,1068360,0,0,0,0,0,0
20150105.095449,2811.47,0,1068360,0,0,0,0,0,0
20150105.09545,2811.47,0,1068360,0,0,0,0,0,0
20150105.095451,2811.47,0,1068360,0,0,0,0,0,0
20150105.095452,2811.47,0,1068360,0,0,0,0,0,0
20150105.095453,2811.47,0,1068360,0,0,0,0,0,0
20150105.095454,2811.47,0,1068360,0,0,0,0,0,0
20150105.095455,2811.47,0,1068360,0,0,0,0,0,0
20150105.095456,2811.47,0,1068360,0,0,0,0,0,0
20150105.095457,2811.47,0,1068360,0,0,0,0,0,0
20150105.095458,2811.47,0,1068360,0,0,0,0,0,0
20150105.095459,2811.47,0,1068360,0,0,0,0,0,0
20150105.0955,2811.47,0,1068360,0,0,0,0,0,0
20150105.095501,2811.47,0,1068360,0,0,0,0,0,0
20150105.095502,2811.47,0,1068360,0,0,0,0,0,0
20150105.095503,2811.47,0,1068360,0,0,0,0,0,0
20150105.095504,2811.47,0,1068360,0,0,0,0,0,0
20150105.095505,2811.47,0,1068360,0,0,0,0,0,0
20150105.095506,2811.47,0,1068360,0,0,0,0,0,0
20150105.095507,2811.47,0,1068360,0,0,0,0,0,0
20150105.095508,2811.47,0,1068360,0,0,0,0,0,0
20150105.095509,2811.47,0,1068360,0,0,0,0,0,0
20150105.09551,2811.47,0,1068360,0,0,0,0,0,0
20150105.095511,2811.47,0,1068360,0,0,0,0,0,0
20150105.095512,2811.47,0,1068360,0,0,0,0,0,0
20150105.095513,2811.47,0,1068360,0,0,0,0,0,0
20150105.095514,2811.47,0,1068360,0,0,0,0,0,0
20150105.095515,2811.47,0,1068360,0,0,0,0,0,0
20150105.095516,2811.47,0,1068360,0,0,0,0,0,0
20150105.095517,2811.47,0,1068360,0,0,0,0,0,0
20150105.095518,2811.47,0,1068360,0,0,0,0,0,0
20150105.095519,2811.47,0,1068360,0,0,0,0,0,0
20150105.09552,2811.47,0,1068360,0,0,0,0,0,0
20150105.095521,2811.47,0,1068360,0,0,0,0,0,0
20150105.095522,2811.47,0,1068360,0,0,0,0,0,0
20150105.095523,2811.47,0,1068360,0,0,0,0,0,0
20150105.095524,2811.47,0,1068360,0,0,0,0,0,0
20150105.095525,2811.47,0,1068360,0,0,0,0,0,0
20150105.095526,2811.47,0,1068360,0,0,0,0,0,0
20150105.095527,2811.47,0,1068360,0,0,0,0,0,0
20150105.095528,2811.47,0,1068360,0,0,0,0,0,0
20150105.095529,2811.47,0,1068360,0,0,0,0,0,0
20150105.09553,2811.47,0,1068360,0,0,0,0,0,0
20150105.095531,2811.47,0,1068360,0,0,0,0,0,0
20150105.095532,2811.47,0,1068360,0,0,0,0,0,0
20150105.095533,2811.47,0,1068360,0,0,0,0,0,0
20150105.095534,2811.47,0,1068360,0,0,0,0,0,0
20150105.095535,2811.47,0,1068360,0,0,0,0,0,0
20150105.095536,2811.47,0,1068360,0,0,0,0,0,0
20150105.095537,2811.47,0,1068360,0,0,0,0,0,0
20150105.095538,2811.47,0,1068360,0,0,0,0,0,0
20150105.095539,2811.47,0,1068360,0,0,0,0,0,0
20150105.09554,2811.47,0,1068360,0,0,0,0,0,0
20150105.095541,2811.47,0,1068360,0,0,0,0,0,0
20150105.095542,2811.47,0,1068360,0,0,0,0,0,0
20150105.095543,2811.47,0,1068360,0,0,0,0,0,0
20150105.095544,2811.47,0,1068360,0,0,0,0,0,0
20150105.095545,2811.47,0,1068360,0,0,0,0,0,0
20150105.095546,2811.47,0,1068360,0,0,0,0,0,0
20150105.095547,2811.47,0,1068360,0,0,0,0,0,0
20150105.095548,2811.47,0,1068360,0,0,0,0,0,0
20150105.095549,2811.47,0,1068360,0,0,0,0,0,0
20150105.09555,2811.47,0,1068360,0,0,0,0,0,0
20150105.095551,2811.47,0,1068360,0,0,0,0,0,0
20150105.095552,2811.47,0,1068360,0,0,0,0,0,0
20150105.095553,2811.47,0,1068360,0,0,0,0,0,0
20150105.095554,2811.47,0,1068360,0,0,0,0,0,0
20150105.095555,2811.47,0,1068360,0,0,0,0,0,0
20150105.095556,2811.47,0,1068360,0,0,0,0,0,0
20150105.095557,2811.47,0,1068360,0,0,0,0,0,0
20150105.095558,2811.47,0,1068360,0,0,0,0,0,0
20150105.095559,2811.47,0,1068360,0,0,0,0,0,0
20150105.0956,2811.47,0,1068360,0,0,0,0,0,0
20150105.095601,2811.47,0,1068360,0,0,0,0,0,0
20150105.095602,2811.47,0,1068360,0,0,0,0,0,0
20150105.095603,2811.47,0,1068360,0,0,0,0,0,0
20150105.095604,2811.47,0,1068360,0,0,0,0,0,0
20150105.095605,2811.47,0,1068360,0,0,0,0,0,0
20150105.095606,2811.47,0,1068360,0,0,0,0,0,0
20150105.095607,2811.47,0,1068360,0,0,0,0,0,0
20150105.095608,2811.47,0,1068360,0,0,0,0,0,0
20150105.095609,2811.47,0,1068360,0,0,0,0,0,0
20150105.09561,2811.47,0,1068360,0,0,0,0,0,0
20150105.095611,2811.47,0,1068360,0,0,0,0,0,0
20150105.095612,2811.47,0,1068360,0,0,0,0,0,0
20150105.095613,2811.47,0,1068360,0,0,0,0,0,0
20150105.095614,2811.47,0,1068360,0,0,0,0,0,0
20150105.095615,2811.47,0,1068360,0,0,0,0,0,0
20150105.095616,2811.47,0,1068360,0,0,0,0,0,0
20150105.095617,2811.47,0,1068360,0,0,0,0,0,0
20150105.095618,2811.47,0,1068360,0,0,0,0,0,0
20150105.095619,2811.47,0,1068360,0,0,0,0,0,0
20150105.09562,2811.47,0,1068360,0,0,0,0,0,0
20150105.095621,2811.47,0,1068360,0,0,0,0,0,0
20150105.095622,2811.47,0,1068360,0,0,0,0,0,0
20150105.095623,2811.47,0,1068360,0,0,0,0,0,0
20150105.095624,2811.47,0,1068360,0,0,0,0,0,0
20150105.095625,2811.47,0,1068360,0,0,0,0,0,0
20150105.095626,2811.47,0,1068360,0,0,0,0,0,0
20150105.095627,2811.47,0,1068360,0,0,0,0,0,0
20150105.095628,2811.47,0,1068360,0,0,0,0,0,0
20150105.095629,2811.47,0,1068360,0,0,0,0,0,0
20150105.09563,2811.47,0,1068360,0,0,0,0,0,0
20150105.095631,2811.47,0,1068360,0,0,0,0,0,0
20150105.095632,2811.47,0,1068360,0,0,0,0,0,0
20150105.095633,2811.47,0,1068360,0,0,0,0,0,0
20150105.095634,2811.47,0,1068360,0,0,0,0,0,0
20150105.095635,2811.47,0,1068360,0,0,0,0,0,0
20150105.095636,2811.47,0,1068360,0,0,0,0,0,0
20150105.095637,2811.47,0,1068360,0,0,0,0,0,0
20150105.095638,2811.47,0,1068360,0,0,0,0,0,0
20150105.095639,2811.47,0,1068360,0,0,0,0,0,0
20150105.09564,2811.47,0,1068360,0,0,0,0,0,0
20150105.095641,2811.47,0,1068360,0,0,0,0,0,0
20150105.095642,2811.47,0,1068360,0,0,0,0,0,0
20150105.095643,2811.47,0,1068360,0,0,0,0,0,0
20150105.095644,2811.47,0,1068360,0,0,0,0,0,0
20150105.095645,2811.47,0,1068360,0,0,0,0,0,0
20150105.095646,2811.47,0,1068360,0,0,0,0,0,0
20150105.095647,2811.47,0,1068360,0,0,0,0,0,0
20150105.095648,2811.47,0,1068360,0,0,0,0,0,0
20150105.095649,2811.47,0,1068360,0,0,0,0,0,0
20150105.09565,2811.47,0,1068360,0,0,0,0,0,0
20150105.095651,2811.47,0,1068360,0,0,0,0,0,0
20150105.095652,2811.47,0,1068360,0,0,0,0,0,0
20150105.095653,2811.47,0,1068360,0,0,0,0,0,0
20150105.095654,2811.47,0,1068360,0,0,0,0,0,0
20150105.095655,2811.47,0,1068360,0,0,0,0,0,0
20150105.095656,2811.47,0,1068360,0,0,0,0,0,0
20150105.095657,2811.47,0,1068360,0,0,0,0,0,0
20150105.095658,2811.47,0,1068360,0,0,0,0,0,0
20150105.095659,2811.47,0,1068360,0,0,0,0,0,0
20150105.0957,2811.47,0,1068360,0,0,0,0,0,0
20150105.095701,2811.47,0,1068360,0,0,0,0,0,0
20150105.095702,2811.47,0,1068360,0,0,0,0,0,0
20150105.095703,2811.47,0,1068360,0,0,0,0,0,0
20150105.095704,2811.47,0,1068360,0,0,0,0,0,0
20150105.095705,2811.47,0,1068360,0,0,0,0,0,0
20150105.095706,2811.47,0,1068360,0,0,0,0,0,0
20150105.095707,2811.47,0,1068360,0,0,0,0,0,0
20150105.095708,2811.47,0,1068360,0,0,0,0,0,0
20150105.095709,2811.47,0,1068360,0,0,0,0,0,0
20150105.09571,2811.47,0,1068360,0,0,0,0,0,0
20150105.095711,2811.47,0,1068360,0,0,0,0,0,0
20150105.095712,2811.47,0,1068360,0,0,0,0,0,0
20150105.095713,2811.47,0,1068360,0,0,0,0,0,0
20150105.095714,2811.47,0,1068360,0,0,0,0,0,0
20150105.095715,2811.47,0,1068360,0,0,0,0,0,0
20150105.095716,2811.47,0,1068360,0,0,0,0,0,0
20150105.095717,2811.47,0,1068360,0,0,0,0,0,0
20150105.095718,2811.47,0,1068360,0,0,0,0,0,0
20150105.095719,2811.47,0,1068360,0,0,0,0,0,0
20150105.09572,2811.47,0,1068360,0,0,0,0,0,0
20150105.095721,2811.47,0,1068360,0,0,0,0,0,0
20150105.095722,2811.47,0,1068360,0,0,0,0,0,0
20150105.095723,2811.47,0,1068360,0,0,0,0,0,0
20150105.095724,2811.47,0,1068360,0,0,0,0,0,0
20150105.095725,2811.47,0,1068360,0,0,0,0,0,0
20150105.095726,2811.47,0,1068360,0,0,0,0,0,0
20150105.095727,2811.47,0,1068360,0,0,0,0,0,0
20150105.095728,2811.47,0,1068360,0,0,0,0,0,0
20150105.095729,2811.47,0,1068360,0,0,0,0,0,0
20150105.09573,2811.47,0,1068360,0,0,0,0,0,0
20150105.095731,2811.47,0,1068360,0,0,0,0,0,0
20150105.095732,2811.47,0,1068360,0,0,0,0,0,0
20150105.095733,2811.47,0,1068360,0,0,0,0,0,0
20150105.095734,2811.47,0,1068360,0,0,0,0,0,0
20150105.095735,2811.47,0,1068360,0,0,0,0,0,0
20150105.095736,2811.47,0,1068360,0,0,0,0,0,0
20150105.095737,2811.47,0,1068360,0,0,0,0,0,0
20150105.095738,2811.47,0,1068360,0,0,0,0,0,0
20150105.095739,2811.47,0,1068360,0,0,0,0,0,0
20150105.09574,2811.47,0,1068360,0,0,0,0,0,0
20150105.095741,2811.47,0,1068360,0,0,0,0,0,0
20150105.095742,2811.47,0,1068360,0,0,0,0,0,0
20150105.095743,2811.47,0,1068360,0,0,0,0,0,0
20150105.095744,2811.47,0,1068360,0,0,0,0,0,0
20150105.095745,2811.47,0,1068360,0,0,0,0,0,0
20150105.095746,2811.47,0,1068360,0,0,0,0,0,0
20150105.095747,2811.47,0,1068360,0,0,0,0,0,0
20150105.095748,2811.47,0,1068360,0,0,0,0,0,0
20150105.095749,2811.47,0,1068360,0,0,0,0,0,0
20150105.09575,2811.47,0,1068360,0,0,0,0,0,0
20150105.095751,2811.47,0,1068360,0,0,0,0,0,0
20150105.095752,2811.47,0,1068360,0,0,0,0,0,0
20150105.095753,2811.47,0,1068360,0,0,0,0,0,0
20150105.095754,2811.47,0,1068360,0,0,0,0,0,0
20150105.095755,2811.47,0,1068360,0,0,0,0,0,0
20150105.095756,2811.47,0,1068360,0,0,0,0,0,0
20150105.095757,2811.47,0,1068360,0,0,0,0,0,0
20150105.095758,2811.47,0,1068360,0,0,0,0,0,0
20150105.095759,2811.47,0,1068360,0,0,0,0,0,0
20150105.0958,2811.47,0,1068360,0,0,0,0,0,0
20150105.095801,2811.47,0,1068360,0,0,0,0,0,0
20150105.095802,2811.47,0,1068360,0,0,0,0,0,0
20150105.095803,2811.47,0,1068360,0,0,0,0,0,0
20150105.095804,2811.47,0,1068360,0,0,0,0,0,0
20150105.095805,2811.47,0,1068360,0,0,0,0,0,0
20150105.095806,2811.47,0,1068360,0,0,0,0,0,0
20150105.095807,2811.47,0,1068360,0,0,0,0,0,0
20150105.095808,2811.47,0,1068360,0,0,0,0,0,0
20150105.095809,2811.47,0,1068360,0,0,0,0,0,0
20150105.09581,2811.47,0,1068360,0,0,0,0,0,0
20150105.095811,2811.47,0,1068360,0,0,0,0,0,0
20150105.095812,2811.47,0,1068360,0,0,0,0,0,0
20150105.095813,2811.47,0,1068360,0,0,0,0,0,0
20150105.095814,2811.47,0,1068360,0,0,0,0,0,0
20150105.095815,2811.47,0,1068360,0,0,0,0,0,0
20150105.095816,2811.47,0,1068360,0,0,0,0,0,0
20150105.095817,2811.47,0,1068360,0,0,0,0,0,0
20150105.095818,2811.47,0,1068360,0,0,0,0,0,0
20150105.095819,2811.47,0,1068360,0,0,0,0,0,0
20150105.09582,2811.47,0,1068360,0,0,0,0,0,0
20150105.095821,2811.47,0,1068360,0,0,0,0,0,0
20150105.095822,2811.47,0,1068360,0,0,0,0,0,0
20150105.095823,2811.47,0,1068360,0,0,0,0,0,0
20150105.095824,2811.47,0,1068360,0,0,0,0,0,0
20150105.095825,2811.47,0,1068360,0,0,0,0,0,0
20150105.095826,2811.47,0,1068360,0,0,0,0,0,0
20150105.095827,2811.47,0,1068360,0,0,0,0,0,0
20150105.095828,2811.47,0,1068360,0,0,0,0,0,0
20150105.095829,2811.47,0,1068360,0,0,0,0,0,0
20150105.09583,2811.47,0,1068360,0,0,0,0,0,0
20150105.095831,2811.47,0,1068360,0,0,0,0,0,0
20150105.095832,2811.47,0,1068360,0,0,0,0,0,0
20150105.095833,2811.47,0,1068360,0,0,0,0,0,0
20150105.095834,2811.47,0,1068360,0,0,0,0,0,0
20150105.095835,2811.47,0,1068360,0,0,0,0,0,0
20150105.095836,2811.47,0,1068360,0,0,0,0,0,0
20150105.095837,2811.47,0,1068360,0,0,0,0,0,0
20150105.095838,2811.47,0,1068360,0,0,0,0,0,0
20150105.095839,2811.47,0,1068360,0,0,0,0,0,0
20150105.09584,2811.47,0,1068360,0,0,0,0,0,0
20150105.095841,2811.47,0,1068360,0,0,0,0,0,0
20150105.095842,2811.47,0,1068360,0,0,0,0,0,0
20150105.095843,2811.47,0,1068360,0,0,0,0,0,0
20150105.095844,2811.47,0,1068360,0,0,0,0,0,0
20150105.095845,2811.47,0,1068360,0,0,0,0,0,0
20150105.095846,2811.47,0,1068360,0,0,0,0,0,0
20150105.095847,2811.47,0,1068360,0,0,0,0,0,0
20150105.095848,2811.47,0,1068360,0,0,0,0,0,0
20150105.095849,2811.47,0,1068360,0,0,0,0,0,0
20150105.09585,2811.47,0,1068360,0,0,0,0,0,0
20150105.095851,2811.47,0,1068360,0,0,0,0,0,0
20150105.095852,2811.47,0,1068360,0,0,0,0,0,0
20150105.095853,2811.47,0,1068360,0,0,0,0,0,0
20150105.095854,2811.47,0,1068360,0,0,0,0,0,0
20150105.095855,2811.47,0,1068360,0,0,0,0,0,0
20150105.095856,2811.47,0,1068360,0,0,0,0,0,0
20150105.095857,2811.47,0,1068360,0,0,0,0,0,0
20150105.095858,2811.47,0,1068360,0,0,0,0,0,0
20150105.095859,2811.47,0,1068360,0,0,0,0,0,0
20150105.0959,2811.47,0,1068360,0,0,0,0,0,0
20150105.095901,2811.47,0,1068360,0,0,0,0,0,0
20150105.095902,2811.47,0,1068360,0,0,0,0,0,0
20150105.095903,2811.47,0,1068360,0,0,0,0,0,0
20150105.095904,2811.47,0,1068360,0,0,0,0,0,0
20150105.095905,2811.47,0,1068360,0,0,0,0,0,0
20150105.095906,2811.47,0,1068360,0,0,0,0,0,0
20150105.095907,2811.47,0,1068360,0,0,0,0,0,0
20150105.095908,2811.47,0,1068360,0,0,0,0,0,0
20150105.095909,2811.47,0,1068360,0,0,0,0,0,0
20150105.09591,2811.47,0,1068360,0,0,0,0,0,0
20150105.095911,2811.47,0,1068360,0,0,0,0,0,0
20150105.095912,2811.47,0,1068360,0,0,0,0,0,0
20150105.095913,2811.47,0,1068360,0,0,0,0,0,0
20150105.095914,2811.47,0,1068360,0,0,0,0,0,0
20150105.095915,2811.47,0,1068360,0,0,0,0,0,0
20150105.095916,2811.47,0,1068360,0,0,0,0,0,0
20150105.095917,2811.47,0,1068360,0,0,0,0,0,0
20150105.095918,2811.47,0,1068360,0,0,0,0,0,0
20150105.095919,2811.47,0,1068360,0,0,0,0,0,0
20150105.09592,2811.47,0,1068360,0,0,0,0,0,0
20150105.095921,2811.47,0,1068360,0,0,0,0,0,0
20150105.095922,2811.47,0,1068360,0,0,0,0,0,0
20150105.095923,2811.47,0,1068360,0,0,0,0,0,0
20150105.095924,2811.47,0,1068360,0,0,0,0,0,0
20150105.095925,2811.47,0,1068360,0,0,0,0,0,0
20150105.095926,2811.47,0,1068360,0,0,0,0,0,0
20150105.095927,2811.47,0,1068360,0,0,0,0,0,0
20150105.095928,2811.47,0,1068360,0,0,0,0,0,0
20150105.095929,2811.47,0,1068360,0,0,0,0,0,0
20150105.09593,2811.47,0,1068360,0,0,0,0,0,0
20150105.095931,2811.47,0,1068360,0,0,0,0,0,0
20150105.095932,2811.47,0,1068360,0,0,0,0,0,0
20150105.095933,2811.47,0,1068360,0,0,0,0,0,0
20150105.095934,2811.47,0,1068360,0,0,0,0,0,0
20150105.095935,2811.47,0,1068360,0,0,0,0,0,0
20150105.095936,2811.47,0,1068360,0,0,0,0,0,0
20150105.095937,2811.47,0,1068360,0,0,0,0,0,0
20150105.095938,2811.47,0,1068360,0,0,0,0,0,0
20150105.095939,2811.47,0,1068360,0,0,0,0,0,0
20150105.09594,2811.47,0,1068360,0,0,0,0,0,0
20150105.095941,2811.47,0,1068360,0,0,0,0,0,0
20150105.095942,2811.47,0,1068360,0,0,0,0,0,0
20150105.095943,2811.47,0,1068360,0,0,0,0,0,0
20150105.095944,2811.47,0,1068360,0,0,0,0,0,0
20150105.095945,2811.47,0,1068360,0,0,0,0,0,0
20150105.095946,2811.47,0,1068360,0,0,0,0,0,0
20150105.095947,2811.47,0,1068360,0,0,0,0,0,0
20150105.095948,2811.47,0,1068360,0,0,0,0,0,0
20150105.095949,2811.47,0,1068360,0,0,0,0,0,0
20150105.09595,2811.47,0,1068360,0,0,0,0,0,0
20150105.095951,2811.47,0,1068360,0,0,0,0,0,0
20150105.095952,2811.47,0,1068360,0,0,0,0,0,0
20150105.095953,2811.47,0,1068360,0,0,0,0,0,0
20150105.095954,2811.47,0,1068360,0,0,0,0,0,0
20150105.095955,2811.47,0,1068360,0,0,0,0,0,0
20150105.095956,2811.47,0,1068360,0,0,0,0,0,0
20150105.095957,2811.47,0,1068360,0,0,0,0,0,0
20150105.095958,2811.47,0,1068360,0,0,0,0,0,0
20150105.095959,2811.47,0,1068360,0,0,0,0,0,0
20150105.1,2811.47,0,1068360,0,0,0,0,0,0
20150105.100001,2811.47,0,1068360,0,0,0,0,0,0
20150105.100002,2811.47,0,1068360,0,0,0,0,0,0
20150105.100003,2811.47,0,1068360,0,0,0,0,0,0
20150105.100004,2811.47,0,1068360,0,0,0,0,0,0
20150105.100005,2811.47,0,1068360,0,0,0,0,0,0
20150105.100006,2811.47,0,1068360,0,0,0,0,0,0
20150105.100007,2811.47,0,1068360,0,0,0,0,0,0
20150105.100008,2811.47,0,1068360,0,0,0,0,0,0
20150105.100009,2811.47,0,1068360,0,0,0,0,0,0
20150105.10001,2811.47,0,1068360,0,0,0,0,0,0
20150105.100011,2811.47,0,1068360,0,0,0,0,0,0
20150105.100012,2811.47,0,1068360,0,0,0,0,0,0
20150105.100013,2811.47,0,1068360,0,0,0,0,0,0
20150105.100014,2811.47,0,1068360,0,0,0,0,0,0
20150105.100015,2811.47,0,1068360,0,0,0,0,0,0
20150105.100016,2811.47,0,1068360,0,0,0,0,0,0
20150105.100017,2811.47,0,1068360,0,0,0,0,0,0
20150105.100018,2811.47,0,1068360,0,0,0,0,0,0
20150105.100019,2811.47,0,1068360,0,0,0,0,0,0
20150105.10002,2811.47,0,1068360,0,0,0,0,0,0
20150105.100021,2811.47,0,1068360,0,0,0,0,0,0
20150105.100022,2811.47,0,1068360,0,0,0,0,0,0
20150105.100023,2811.47,0,1068360,0,0,0,0,0,0
20150105.100024,2811.47,0,1068360,0,0,0,0,0,0
20150105.100025,2811.47,0,1068360,0,0,0,0,0,0
20150105.100026,2811.47,0,1068360,0,0,0,0,0,0
20150105.100027,2811.47,0,1068360,0,0,0,0,0,0
20150105.100028,2811.47,0,1068360,0,0,0,0,0,0
20150105.100029,2811.47,0,1068360,0,0,0,0,0,0
20150105.10003,2811.47,0,1068360,0,0,0,0,0,0
20150105.100031,2811.47,0,1068360,0,0,0,0,0,0
20150105.100032,2811.47,0,1068360,0,0,0,0,0,0
20150105.100033,2811.47,0,1068360,0,0,0,0,0,0
20150105.100034,2811.47,0,1068360,0,0,0,0,0,0
20150105.100035,2811.47,0,1068360,0,0,0,0,0,0
20150105.100036,2811.47,0,1068360,0,0,0,0,0,0
20150105.100037,2811.47,0,1068360,0,0,0,0,0,0
20150105.100038,2811.47,0,1068360,0,0,0,0,0,0
20150105.100039,2811.47,0,1068360,0,0,0,0,0,0
20150105.10004,2811.47,0,1068360,0,0,0,0,0,0
20150105.100041,2811.47,0,1068360,0,0,0,0,0,0
20150105.100042,2811.47,0,1068360,0,0,0,0,0,0
20150105.100043,2811.47,0,1068360,0,0,0,0,0,0
20150105.100044,2811.47,0,1068360,0,0,0,0,0,0
20150105.100045,2811.47,0,1068360,0,0,0,0,0,0
20150105.100046,2811.47,0,1068360,0,0,0,0,0,0
20150105.100047,2811.47,0,1068360,0,0,0,0,0,0
20150105.100048,2811.47,0,1068360,0,0,0,0,0,0
20150105.100049,2811.47,0,1068360,0,0,0,0,0,0
20150105.10005,2811.47,0,1068360,0,0,0,0,0,0
20150105.100051,2811.47,0,1068360,0,0,0,0,0,0
20150105.100052,2811.47,0,1068360,0,0,0,0,0,0
20150105.100053,2811.47,0,1068360,0,0,0,0,0,0
20150105.100054,2811.47,0,1068360,0,0,0,0,0,0
20150105.100055,2811.47,0,1068360,0,0,0,0,0,0
20150105.100056,2811.47,0,1068360,0,0,0,0,0,0
20150105.100057,2811.47,0,1068360,0,0,0,0,0,0
20150105.100058,2811.47,0,1068360,0,0,0,0,0,0
20150105.100059,2811.47,0,1068360,0,0,0,0,0,0
20150105.1001,2811.47,0,1068360,0,0,0,0,0,0
20150105.100101,2811.47,0,1068360,0,0,0,0,0,0
20150105.100102,2811.47,0,1068360,0,0,0,0,0,0
20150105.100103,2811.47,0,1068360,0,0,0,0,0,0
20150105.100104,2811.47,0,1068360,0,0,0,0,0,0
20150105.100105,2811.47,0,1068360,0,0,0,0,0,0
20150105.100106,2811.47,0,1068360,0,0,0,0,0,0
20150105.100107,2811.47,0,1068360,0,0,0,0,0,0
20150105.100108,2811.47,0,1068360,0,0,0,0,0,0
20150105.100109,2811.47,0,1068360,0,0,0,0,0,0
20150105.10011,2811.47,0,1068360,0,0,0,0,0,0
20150105.100111,2811.47,0,1068360,0,0,0,0,0,0
20150105.100112,2811.47,0,1068360,0,0,0,0,0,0
20150105.100113,2811.47,0,1068360,0,0,0,0,0,0
20150105.100114,2811.47,0,1068360,0,0,0,0,0,0
20150105.100115,2811.47,0,1068360,0,0,0,0,0,0
20150105.100116,2811.47,0,1068360,0,0,0,0,0,0
20150105.100117,2811.47,0,1068360,0,0,0,0,0,0
20150105.100118,2811.47,0,1068360,0,0,0,0,0,0
20150105.100119,2811.47,0,1068360,0,0,0,0,0,0
20150105.10012,2811.47,0,1068360,0,0,0,0,0,0
20150105.100121,2811.47,0,1068360,0,0,0,0,0,0
20150105.100122,2811.47,0,1068360,0,0,0,0,0,0
20150105.100123,2811.47,0,1068360,0,0,0,0,0,0
20150105.100124,2811.47,0,1068360,0,0,0,0,0,0
20150105.100125,2811.47,0,1068360,0,0,0,0,0,0
20150105.100126,2811.47,0,1068360,0,0,0,0,0,0
20150105.100127,2811.47,0,1068360,0,0,0,0,0,0
20150105.100128,2811.47,0,1068360,0,0,0,0,0,0
20150105.100129,2811.47,0,1068360,0,0,0,0,0,0
20150105.10013,2811.47,0,1068360,0,0,0,0,0,0
20150105.100131,2811.47,0,1068360,0,0,0,0,0,0
20150105.100132,2811.47,0,1068360,0,0,0,0,0,0
20150105.100133,2811.47,0,1068360,0,0,0,0,0,0
20150105.100134,2811.47,0,1068360,0,0,0,0,0,0
20150105.100135,2811.47,0,1068360,0,0,0,0,0,0
20150105.100136,2811.47,0,1068360,0,0,0,0,0,0
20150105.100137,2811.47,0,1068360,0,0,0,0,0,0
20150105.100138,2811.47,0,1068360,0,0,0,0,0,0
20150105.100139,2811.47,0,1068360,0,0,0,0,0,0
20150105.10014,2811.47,0,1068360,0,0,0,0,0,0
20150105.100141,2811.47,0,1068360,0,0,0,0,0,0
20150105.100142,2811.47,0,1068360,0,0,0,0,0,0
20150105.100143,2811.47,0,1068360,0,0,0,0,0,0
20150105.100144,2811.47,0,1068360,0,0,0,0,0,0
20150105.100145,2811.47,0,1068360,0,0,0,0,0,0
20150105.100146,2811.47,0,1068360,0,0,0,0,0,0
20150105.100147,2811.47,0,1068360,0,0,0,0,0,0
20150105.100148,2811.47,0,1068360,0,0,0,0,0,0
20150105.100149,2811.47,0,1068360,0,0,0,0,0,0
20150105.10015,2811.47,0,1068360,0,0,0,0,0,0
20150105.100151,2811.47,0,1068360,0,0,0,0,0,0
20150105.100152,2811.47,0,1068360,0,0,0,0,0,0
20150105.100153,2811.47,0,1068360,0,0,0,0,0,0
20150105.100154,2811.47,0,1068360,0,0,0,0,0,0
20150105.100155,2811.47,0,1068360,0,0,0,0,0,0
20150105.100156,2811.47,0,1068360,0,0,0,0,0,0
20150105.100157,2811.47,0,1068360,0,0,0,0,0,0
20150105.100158,2811.47,0,1068360,0,0,0,0,0,0
20150105.100159,2811.47,0,1068360,0,0,0,0,0,0
20150105.1002,2811.47,0,1068360,0,0,0,0,0,0
20150105.100201,2811.47,0,1068360,0,0,0,0,0,0
20150105.100202,2811.47,0,1068360,0,0,0,0,0,0
20150105.100203,2811.47,0,1068360,0,0,0,0,0,0
20150105.100204,2811.47,0,1068360,0,0,0,0,0,0
20150105.100205,2811.47,0,1068360,0,0,0,0,0,0
20150105.100206,2811.47,0,1068360,0,0,0,0,0,0
20150105.100207,2811.47,0,1068360,0,0,0,0,0,0
20150105.100208,2811.47,0,1068360,0,0,0,0,0,0
20150105.100209,2811.47,0,1068360,0,0,0,0,0,0
20150105.10021,2811.47,0,1068360,0,0,0,0,0,0
20150105.100211,2811.47,0,1068360,0,0,0,0,0,0
20150105.100212,2811.47,0,1068360,0,0,0,0,0,0
20150105.100213,2811.47,0,1068360,0,0,0,0,0,0
20150105.100214,2811.47,0,1068360,0,0,0,0,0,0
20150105.100215,2811.47,0,1068360,0,0,0,0,0,0
20150105.100216,2811.47,0,1068360,0,0,0,0,0,0
20150105.100217,2811.47,0,1068360,0,0,0,0,0,0
20150105.100218,2811.47,0,1068360,0,0,0,0,0,0
20150105.100219,2811.47,0,1068360,0,0,0,0,0,0
20150105.10022,2811.47,0,1068360,0,0,0,0,0,0
20150105.100221,2811.47,0,1068360,0,0,0,0,0,0
20150105.100222,2811.47,0,1068360,0,0,0,0,0,0
20150105.100223,2811.47,0,1068360,0,0,0,0,0,0
20150105.100224,2811.47,0,1068360,0,0,0,0,0,0
20150105.100225,2811.47,0,1068360,0,0,0,0,0,0
20150105.100226,2811.47,0,1068360,0,0,0,0,0,0
20150105.100227,2811.47,0,1068360,0,0,0,0,0,0
20150105.100228,2811.47,0,1068360,0,0,0,0,0,0
20150105.100229,2811.47,0,1068360,0,0,0,0,0,0
20150105.10023,2811.47,0,1068360,0,0,0,0,0,0
20150105.100231,2811.47,0,1068360,0,0,0,0,0,0
20150105.100232,2811.47,0,1068360,0,0,0,0,0,0
20150105.100233,2811.47,0,1068360,0,0,0,0,0,0
20150105.100234,2811.47,0,1068360,0,0,0,0,0,0
20150105.100235,2811.47,0,1068360,0,0,0,0,0,0
20150105.100236,2811.47,0,1068360,0,0,0,0,0,0
20150105.100237,2811.47,0,1068360,0,0,0,0,0,0
20150105.100238,2811.47,0,1068360,0,0,0,0,0,0
20150105.100239,2811.47,0,1068360,0,0,0,0,0,0
20150105.10024,2811.47,0,1068360,0,0,0,0,0,0
20150105.100241,2811.47,0,1068360,0,0,0,0,0,0
20150105.100242,2811.47,0,1068360,0,0,0,0,0,0
20150105.100243,2811.47,0,1068360,0,0,0,0,0,0
20150105.100244,2811.47,0,1068360,0,0,0,0,0,0
20150105.100245,2811.47,0,1068360,0,0,0,0,0,0
20150105.100246,2811.47,0,1068360,0,0,0,0,0,0
20150105.100247,2811.47,0,1068360,0,0,0,0,0,0
20150105.100248,2811.47,0,1068360,0,0,0,0,0,0
20150105.100249,2811.47,0,1068360,0,0,0,0,0,0
20150105.10025,2811.47,0,1068360,0,0,0,0,0,0
20150105.100251,2811.47,0,1068360,0,0,0,0,0,0
20150105.100252,2811.47,0,1068360,0,0,0,0,0,0
20150105.100253,2811.47,0,1068360,0,0,0,0,0,0
20150105.100254,2811.47,0,1068360,0,0,0,0,0,0
20150105.100255,2811.47,0,1068360,0,0,0,0,0,0
20150105.100256,2811.47,0,1068360,0,0,0,0,0,0
20150105.100257,2811.47,0,1068360,0,0,0,0,0,0
20150105.100258,2811.47,0,1068360,0,0,0,0,0,0
20150105.100259,2811.47,0,1068360,0,0,0,0,0,0
20150105.1003,2811.47,0,1068360,0,0,0,0,0,0
20150105.100301,2811.47,0,1068360,0,0,0,0,0,0
20150105.100302,2811.47,0,1068360,0,0,0,0,0,0
20150105.100303,2811.47,0,1068360,0,0,0,0,0,0
20150105.100304,2811.47,0,1068360,0,0,0,0,0,0
20150105.100305,2811.47,0,1068360,0,0,0,0,0,0
20150105.100306,2811.47,0,1068360,0,0,0,0,0,0
20150105.100307,2811.47,0,1068360,0,0,0,0,0,0
20150105.100308,2811.47,0,1068360,0,0,0,0,0,0
20150105.100309,2811.47,0,1068360,0,0,0,0,0,0
20150105.10031,2811.47,0,1068360,0,0,0,0,0,0
20150105.100311,2811.47,0,1068360,0,0,0,0,0,0
20150105.100312,2811.47,0,1068360,0,0,0,0,0,0
20150105.100313,2811.47,0,1068360,0,0,0,0,0,0
20150105.100314,2811.47,0,1068360,0,0,0,0,0,0
20150105.100315,2811.47,0,1068360,0,0,0,0,0,0
20150105.100316,2811.47,0,1068360,0,0,0,0,0,0
20150105.100317,2811.47,0,1068360,0,0,0,0,0,0
20150105.100318,2811.47,0,1068360,0,0,0,0,0,0
20150105.100319,2811.47,0,1068360,0,0,0,0,0,0
20150105.10032,2811.47,0,1068360,0,0,0,0,0,0
20150105.100321,2811.47,0,1068360,0,0,0,0,0,0
20150105.100322,2811.47,0,1068360,0,0,0,0,0,0
20150105.100323,2811.47,0,1068360,0,0,0,0,0,0
20150105.100324,2811.47,0,1068360,0,0,0,0,0,0
20150105.100325,2811.47,0,1068360,0,0,0,0,0,0
20150105.100326,2811.47,0,1068360,0,0,0,0,0,0
20150105.100327,2811.47,0,1068360,0,0,0,0,0,0
20150105.100328,2811.47,0,1068360,0,0,0,0,0,0
20150105.100329,2811.47,0,1068360,0,0,0,0,0,0
20150105.10033,2811.47,0,1068360,0,0,0,0,0,0
20150105.100331,2811.47,0,1068360,0,0,0,0,0,0
20150105.100332,2811.47,0,1068360,0,0,0,0,0,0
20150105.100333,2811.47,0,1068360,0,0,0,0,0,0
20150105.100334,2811.47,0,1068360,0,0,0,0,0,0
20150105.100335,2811.47,0,1068360,0,0,0,0,0,0
20150105.100336,2811.47,0,1068360,0,0,0,0,0,0
20150105.100337,2811.47,0,1068360,0,0,0,0,0,0
20150105.100338,2811.47,0,1068360,0,0,0,0,0,0
20150105.100339,2811.47,0,1068360,0,0,0,0,0,0
20150105.10034,2811.47,0,1068360,0,0,0,0,0,0
20150105.100341,2811.47,0,1068360,0,0,0,0,0,0
20150105.100342,2811.47,0,1068360,0,0,0,0,0,0
20150105.100343,2811.47,0,1068360,0,0,0,0,0,0
20150105.100344,2811.47,0,1068360,0,0,0,0,0,0
20150105.100345,2811.47,0,1068360,0,0,0,0,0,0
20150105.100346,2811.47,0,1068360,0,0,0,0,0,0
20150105.100347,2811.47,0,1068360,0,0,0,0,0,0
20150105.100348,2811.47,0,1068360,0,0,0,0,0,0
20150105.100349,2811.47,0,1068360,0,0,0,0,0,0
20150105.10035,2811.47,0,1068360,0,0,0,0,0,0
20150105.100351,2811.47,0,1068360,0,0,0,0,0,0
20150105.100352,2811.47,0,1068360,0,0,0,0,0,0
20150105.100353,2811.47,0,1068360,0,0,0,0,0,0
20150105.100354,2811.47,0,1068360,0,0,0,0,0,0
20150105.100355,2811.47,0,1068360,0,0,0,0,0,0
20150105.100356,2811.47,0,1068360,0,0,0,0,0,0
20150105.100357,2811.47,0,1068360,0,0,0,0,0,0
20150105.100358,2811.47,0,1068360,0,0,0,0,0,0
20150105.100359,2811.47,0,1068360,0,0,0,0,0,0
20150105.1004,2811.47,0,1068360,0,0,0,0,0,0
20150105.100401,2811.47,0,1068360,0,0,0,0,0,0
20150105.100402,2811.47,0,1068360,0,0,0,0,0,0
20150105.100403,2811.47,0,1068360,0,0,0,0,0,0
20150105.100404,2811.47,0,1068360,0,0,0,0,0,0
20150105.100405,2811.47,0,1068360,0,0,0,0,0,0
20150105.100406,2811.47,0,1068360,0,0,0,0,0,0
20150105.100407,2811.47,0,1068360,0,0,0,0,0,0
20150105.100408,2811.47,0,1068360,0,0,0,0,0,0
20150105.100409,2811.47,0,1068360,0,0,0,0,0,0
20150105.10041,2811.47,0,1068360,0,0,0,0,0,0
20150105.100411,2811.47,0,1068360,0,0,0,0,0,0
20150105.100412,2811.47,0,1068360,0,0,0,0,0,0
20150105.100413,2811.47,0,1068360,0,0,0,0,0,0
20150105.100414,2811.47,0,1068360,0,0,0,0,0,0
20150105.100415,2811.47,0,1068360,0,0,0,0,0,0
20150105.100416,2811.47,0,1068360,0,0,0,0,0,0
20150105.100417,2811.47,0,1068360,0,0,0,0,0,0
20150105.100418,2811.47,0,1068360,0,0,0,0,0,0
20150105.100419,2811.47,0,1068360,0,0,0,0,0,0
20150105.10042,2811.47,0,1068360,0,0,0,0,0,0
20150105.100421,2811.47,0,1068360,0,0,0,0,0,0
20150105.100422,2811.47,0,1068360,0,0,0,0,0,0
20150105.100423,2811.47,0,1068360,0,0,0,0,0,0
20150105.100424,2811.47,0,1068360,0,0,0,0,0,0
20150105.100425,2811.47,0,1068360,0,0,0,0,0,0
20150105.100426,2811.47,0,1068360,0,0,0,0,0,0
20150105.100427,2811.47,0,1068360,0,0,0,0,0,0
20150105.100428,2811.47,0,1068360,0,0,0,0,0,0
20150105.100429,2811.47,0,1068360,0,0,0,0,0,0
20150105.10043,2811.47,0,1068360,0,0,0,0,0,0
20150105.100431,2811.47,0,1068360,0,0,0,0,0,0
20150105.100432,2811.47,0,1068360,0,0,0,0,0,0
20150105.100433,2811.47,0,1068360,0,0,0,0,0,0
20150105.100434,2811.47,0,1068360,0,0,0,0,0,0
20150105.100435,2811.47,0,1068360,0,0,0,0,0,0
20150105.100436,2811.47,0,1068360,0,0,0,0,0,0
20150105.100437,2811.47,0,1068360,0,0,0,0,0,0
20150105.100438,2811.47,0,1068360,0,0,0,0,0,0
20150105.100439,2811.47,0,1068360,0,0,0,0,0,0
20150105.10044,2811.47,0,1068360,0,0,0,0,0,0
20150105.100441,2811.47,0,1068360,0,0,0,0,0,0
20150105.100442,2811.47,0,1068360,0,0,0,0,0,0
20150105.100443,2811.47,0,1068360,0,0,0,0,0,0
20150105.100444,2811.47,0,1068360,0,0,0,0,0,0
20150105.100445,2811.47,0,1068360,0,0,0,0,0,0
20150105.100446,2811.47,0,1068360,0,0,0,0,0,0
20150105.100447,2811.47,0,1068360,0,0,0,0,0,0
20150105.100448,2811.47,0,1068360,0,0,0,0,0,0
20150105.100449,2811.47,0,1068360,0,0,0,0,0,0
20150105.10045,2811.47,0,1068360,0,0,0,0,0,0
20150105.100451,2811.47,0,1068360,0,0,0,0,0,0
20150105.100452,2811.47,0,1068360,0,0,0,0,0,0
20150105.100453,2811.47,0,1068360,0,0,0,0,0,0
20150105.100454,2811.47,0,1068360,0,0,0,0,0,0
20150105.100455,2811.47,0,1068360,0,0,0,0,0,0
20150105.100456,2811.47,0,1068360,0,0,0,0,0,0
20150105.100457,2811.47,0,1068360,0,0,0,0,0,0
20150105.100458,2811.47,0,1068360,0,0,0,0,0,0
20150105.100459,2811.47,0,1068360,0,0,0,0,0,0
20150105.1005,2811.47,0,1068360,0,0,0,0,0,0
20150105.100501,2811.47,0,1068360,0,0,0,0,0,0
20150105.100502,2811.47,0,1068360,0,0,0,0,0,0
20150105.100503,2811.47,0,1068360,0,0,0,0,0,0
20150105.100504,2811.47,0,1068360,0,0,0,0,0,0
20150105.100505,2811.47,0,1068360,0,0,0,0,0,0
20150105.100506,2811.47,0,1068360,0,0,0,0,0,0
20150105.100507,2811.47,0,1068360,0,0,0,0,0,0
20150105.100508,2811.47,0,1068360,0,0,0,0,0,0
20150105.100509,2811.47,0,1068360,0,0,0,0,0,0
20150105.10051,2811.47,0,1068360,0,0,0,0,0,0
20150105.100511,2811.47,0,1068360,0,0,0,0,0,0
20150105.100512,2811.47,0,1068360,0,0,0,0,0,0
20150105.100513,2811.47,0,1068360,0,0,0,0,0,0
20150105.100514,2811.47,0,1068360,0,0,0,0,0,0
20150105.100515,2811.47,0,1068360,0,0,0,0,0,0
20150105.100516,2811.47,0,1068360,0,0,0,0,0,0
20150105.100517,2811.47,0,1068360,0,0,0,0,0,0
20150105.100518,2811.47,0,1068360,0,0,0,0,0,0
20150105.100519,2811.47,0,1068360,0,0,0,0,0,0
20150105.10052,2811.47,0,1068360,0,0,0,0,0,0
20150105.100521,2811.47,0,1068360,0,0,0,0,0,0
20150105.100522,2811.47,0,1068360,0,0,0,0,0,0
20150105.100523,2811.47,0,1068360,0,0,0,0,0,0
20150105.100524,2811.47,0,1068360,0,0,0,0,0,0
20150105.100525,2811.47,0,1068360,0,0,0,0,0,0
20150105.100526,2811.47,0,1068360,0,0,0,0,0,0
20150105.100527,2811.47,0,1068360,0,0,0,0,0,0
20150105.100528,2811.47,0,1068360,0,0,0,0,0,0
20150105.100529,2811.47,0,1068360,0,0,0,0,0,0
20150105.10053,2811.47,0,1068360,0,0,0,0,0,0
20150105.100531,2811.47,0,1068360,0,0,0,0,0,0
20150105.100532,2811.47,0,1068360,0,0,0,0,0,0
20150105.100533,2811.47,0,1068360,0,0,0,0,0,0
20150105.100534,2811.47,0,1068360,0,0,0,0,0,0
20150105.100535,2811.47,0,1068360,0,0,0,0,0,0
20150105.100536,2811.47,0,1068360,0,0,0,0,0,0
20150105.100537,2811.47,0,1068360,0,0,0,0,0,0
20150105.100538,2811.47,0,1068360,0,0,0,0,0,0
20150105.100539,2811.47,0,1068360,0,0,0,0,0,0
20150105.10054,2811.47,0,1068360,0,0,0,0,0,0
20150105.100541,2811.47,0,1068360,0,0,0,0,0,0
20150105.100542,2811.47,0,1068360,0,0,0,0,0,0
20150105.100543,2811.47,0,1068360,0,0,0,0,0,0
20150105.100544,2811.47,0,1068360,0,0,0,0,0,0
20150105.100545,2811.47,0,1068360,0,0,0,0,0,0
20150105.100546,2811.47,0,1068360,0,0,0,0,0,0
20150105.100547,2811.47,0,1068360,0,0,0,0,0,0
20150105.100548,2811.47,0,1068360,0,0,0,0,0,0
20150105.100549,2811.47,0,1068360,0,0,0,0,0,0
20150105.10055,2811.47,0,1068360,0,0,0,0,0,0
20150105.100551,2811.47,0,1068360,0,0,0,0,0,0
20150105.100552,2811.47,0,1068360,0,0,0,0,0,0
20150105.100553,2811.47,0,1068360,0,0,0,0,0,0
20150105.100554,2811.47,0,1068360,0,0,0,0,0,0
20150105.100555,2811.47,0,1068360,0,0,0,0,0,0
20150105.100556,2811.47,0,1068360,0,0,0,0,0,0
20150105.100557,2811.47,0,1068360,0,0,0,0,0,0
20150105.100558,2811.47,0,1068360,0,0,0,0,0,0
20150105.100559,2811.47,0,1068360,0,0,0,0,0,0
20150105.1006,2811.47,0,1068360,0,0,0,0,0,0
20150105.100601,2811.47,0,1068360,0,0,0,0,0,0
20150105.100602,2811.47,0,1068360,0,0,0,0,0,0
20150105.100603,2811.47,0,1068360,0,0,0,0,0,0
20150105.100604,2811.47,0,1068360,0,0,0,0,0,0
20150105.100605,2811.47,0,1068360,0,0,0,0,0,0
20150105.100606,2811.47,0,1068360,0,0,0,0,0,0
20150105.100607,2811.47,0,1068360,0,0,0,0,0,0
20150105.100608,2811.47,0,1068360,0,0,0,0,0,0
20150105.100609,2811.47,0,1068360,0,0,0,0,0,0
20150105.10061,2811.47,0,1068360,0,0,0,0,0,0
20150105.100611,2811.47,0,1068360,0,0,0,0,0,0
20150105.100612,2811.47,0,1068360,0,0,0,0,0,0
20150105.100613,2811.47,0,1068360,0,0,0,0,0,0
20150105.100614,2811.47,0,1068360,0,0,0,0,0,0
20150105.100615,2811.47,0,1068360,0,0,0,0,0,0
20150105.100616,2811.47,0,1068360,0,0,0,0,0,0
20150105.100617,2811.47,0,1068360,0,0,0,0,0,0
20150105.100618,2811.47,0,1068360,0,0,0,0,0,0
20150105.100619,2811.47,0,1068360,0,0,0,0,0,0
20150105.10062,2811.47,0,1068360,0,0,0,0,0,0
20150105.100621,2811.47,0,1068360,0,0,0,0,0,0
20150105.100622,2811.47,0,1068360,0,0,0,0,0,0
20150105.100623,2811.47,0,1068360,0,0,0,0,0,0
20150105.100624,2811.47,0,1068360,0,0,0,0,0,0
20150105.100625,2811.47,0,1068360,0,0,0,0,0,0
20150105.100626,2811.47,0,1068360,0,0,0,0,0,0
20150105.100627,2811.47,0,1068360,0,0,0,0,0,0
20150105.100628,2811.47,0,1068360,0,0,0,0,0,0
20150105.100629,2811.47,0,1068360,0,0,0,0,0,0
20150105.10063,2811.47,0,1068360,0,0,0,0,0,0
20150105.100631,2811.47,0,1068360,0,0,0,0,0,0
20150105.100632,2811.47,0,1068360,0,0,0,0,0,0
20150105.100633,2811.47,0,1068360,0,0,0,0,0,0
20150105.100634,2811.47,0,1068360,0,0,0,0,0,0
20150105.100635,2811.47,0,1068360,0,0,0,0,0,0
20150105.100636,2811.47,0,1068360,0,0,0,0,0,0
20150105.100637,2811.47,0,1068360,0,0,0,0,0,0
20150105.100638,2811.47,0,1068360,0,0,0,0,0,0
20150105.100639,2811.47,0,1068360,0,0,0,0,0,0
20150105.10064,2811.47,0,1068360,0,0,0,0,0,0
20150105.100641,2811.47,0,1068360,0,0,0,0,0,0
20150105.100642,2811.47,0,1068360,0,0,0,0,0,0
20150105.100643,2811.47,0,1068360,0,0,0,0,0,0
20150105.100644,2811.47,0,1068360,0,0,0,0,0,0
20150105.100645,2811.47,0,1068360,0,0,0,0,0,0
20150105.100646,2811.47,0,1068360,0,0,0,0,0,0
20150105.100647,2811.47,0,1068360,0,0,0,0,0,0
20150105.100648,2811.47,0,1068360,0,0,0,0,0,0
20150105.100649,2811.47,0,1068360,0,0,0,0,0,0
20150105.10065,2811.47,0,1068360,0,0,0,0,0,0
20150105.100651,2811.47,0,1068360,0,0,0,0,0,0
20150105.100652,2811.47,0,1068360,0,0,0,0,0,0
20150105.100653,2811.47,0,1068360,0,0,0,0,0,0
20150105.100654,2811.47,0,1068360,0,0,0,0,0,0
20150105.100655,2811.47,0,1068360,0,0,0,0,0,0
20150105.100656,2811.47,0,1068360,0,0,0,0,0,0
20150105.100657,2811.47,0,1068360,0,0,0,0,0,0
20150105.100658,2811.47,0,1068360,0,0,0,0,0,0
20150105.100659,2811.47,0,1068360,0,0,0,0,0,0
20150105.1007,2811.47,0,1068360,0,0,0,0,0,0
20150105.100701,2811.47,0,1068360,0,0,0,0,0,0
20150105.100702,2811.47,0,1068360,0,0,0,0,0,0
20150105.100703,2811.47,0,1068360,0,0,0,0,0,0
20150105.100704,2811.47,0,1068360,0,0,0,0,0,0
20150105.100705,2811.47,0,1068360,0,0,0,0,0,0
20150105.100706,2811.47,0,1068360,0,0,0,0,0,0
20150105.100707,2811.47,0,1068360,0,0,0,0,0,0
20150105.100708,2811.47,0,1068360,0,0,0,0,0,0
20150105.100709,2811.47,0,1068360,0,0,0,0,0,0
20150105.10071,2811.47,0,1068360,0,0,0,0,0,0
20150105.100711,2811.47,0,1068360,0,0,0,0,0,0
20150105.100712,2811.47,0,1068360,0,0,0,0,0,0
20150105.100713,2811.47,0,1068360,0,0,0,0,0,0
20150105.100714,2811.47,0,1068360,0,0,0,0,0,0
20150105.100715,2811.47,0,1068360,0,0,0,0,0,0
20150105.100716,2811.47,0,1068360,0,0,0,0,0,0
20150105.100717,2811.47,0,1068360,0,0,0,0,0,0
20150105.100718,2811.47,0,1068360,0,0,0,0,0,0
20150105.100719,2811.47,0,1068360,0,0,0,0,0,0
20150105.10072,2811.47,0,1068360,0,0,0,0,0,0
20150105.100721,2811.47,0,1068360,0,0,0,0,0,0
20150105.100722,2811.47,0,1068360,0,0,0,0,0,0
20150105.100723,2811.47,0,1068360,0,0,0,0,0,0
20150105.100724,2811.47,0,1068360,0,0,0,0,0,0
20150105.100725,2811.47,0,1068360,0,0,0,0,0,0
20150105.100726,2811.47,0,1068360,0,0,0,0,0,0
20150105.100727,2811.47,0,1068360,0,0,0,0,0,0
20150105.100728,2811.47,0,1068360,0,0,0,0,0,0
20150105.100729,2811.47,0,1068360,0,0,0,0,0,0
20150105.10073,2811.47,0,1068360,0,0,0,0,0,0
20150105.100731,2811.47,0,1068360,0,0,0,0,0,0
20150105.100732,2811.47,0,1068360,0,0,0,0,0,0
20150105.100733,2811.47,0,1068360,0,0,0,0,0,0
20150105.100734,2811.47,0,1068360,0,0,0,0,0,0
20150105.100735,2811.47,0,1068360,0,0,0,0,0,0
20150105.100736,2811.47,0,1068360,0,0,0,0,0,0
20150105.100737,2811.47,0,1068360,0,0,0,0,0,0
20150105.100738,2811.47,0,1068360,0,0,0,0,0,0
20150105.100739,2811.47,0,1068360,0,0,0,0,0,0
20150105.10074,2811.47,0,1068360,0,0,0,0,0,0
20150105.100741,2811.47,0,1068360,0,0,0,0,0,0
20150105.100742,2811.47,0,1068360,0,0,0,0,0,0
20150105.100743,2811.47,0,1068360,0,0,0,0,0,0
20150105.100744,2811.47,0,1068360,0,0,0,0,0,0
20150105.100745,2811.47,0,1068360,0,0,0,0,0,0
20150105.100746,2811.47,0,1068360,0,0,0,0,0,0
20150105.100747,2811.47,0,1068360,0,0,0,0,0,0
20150105.100748,2811.47,0,1068360,0,0,0,0,0,0
20150105.100749,2811.47,0,1068360,0,0,0,0,0,0
20150105.10075,2811.47,0,1068360,0,0,0,0,0,0
20150105.100751,2811.47,0,1068360,0,0,0,0,0,0
20150105.100752,2811.47,0,1068360,0,0,0,0,0,0
20150105.100753,2811.47,0,1068360,0,0,0,0,0,0
20150105.100754,2811.47,0,1068360,0,0,0,0,0,0
20150105.100755,2811.47,0,1068360,0,0,0,0,0,0
20150105.100756,2811.47,0,1068360,0,0,0,0,0,0
20150105.100757,2811.47,0,1068360,0,0,0,0,0,0
20150105.100758,2811.47,0,1068360,0,0,0,0,0,0
20150105.100759,2811.47,0,1068360,0,0,0,0,0,0
20150105.1008,2811.47,0,1068360,0,0,0,0,0,0
20150105.100801,2811.47,0,1068360,0,0,0,0,0,0
20150105.100802,2811.47,0,1068360,0,0,0,0,0,0
20150105.100803,2811.47,0,1068360,0,0,0,0,0,0
20150105.100804,2811.47,0,1068360,0,0,0,0,0,0
20150105.100805,2811.47,0,1068360,0,0,0,0,0,0
20150105.100806,2811.47,0,1068360,0,0,0,0,0,0
20150105.100807,2811.47,0,1068360,0,0,0,0,0,0
20150105.100808,2811.47,0,1068360,0,0,0,0,0,0
20150105.100809,2811.47,0,1068360,0,0,0,0,0,0
20150105.10081,2811.47,0,1068360,0,0,0,0,0,0
20150105.100811,2811.47,0,1068360,0,0,0,0,0,0
20150105.100812,2811.47,0,1068360,0,0,0,0,0,0
20150105.100813,2811.47,0,1068360,0,0,0,0,0,0
20150105.100814,2811.47,0,1068360,0,0,0,0,0,0
20150105.100815,2811.47,0,1068360,0,0,0,0,0,0
20150105.100816,2811.47,0,1068360,0,0,0,0,0,0
20150105.100817,2811.47,0,1068360,0,0,0,0,0,0
20150105.100818,2811.47,0,1068360,0,0,0,0,0,0
20150105.100819,2811.47,0,1068360,0,0,0,0,0,0
20150105.10082,2811.47,0,1068360,0,0,0,0,0,0
20150105.100821,2811.47,0,1068360,0,0,0,0,0,0
20150105.100822,2811.47,0,1068360,0,0,0,0,0,0
20150105.100823,2811.47,0,1068360,0,0,0,0,0,0
20150105.100824,2811.47,0,1068360,0,0,0,0,0,0
20150105.100825,2811.47,0,1068360,0,0,0,0,0,0
20150105.100826,2811.47,0,1068360,0,0,0,0,0,0
20150105.100827,2811.47,0,1068360,0,0,0,0,0,0
20150105.100828,2811.47,0,1068360,0,0,0,0,0,0
20150105.100829,2811.47,0,1068360,0,0,0,0,0,0
20150105.10083,2811.47,0,1068360,0,0,0,0,0,0
20150105.100831,2811.47,0,1068360,0,0,0,0,0,0
20150105.100832,2811.47,0,1068360,0,0,0,0,0,0
20150105.100833,2811.47,0,1068360,0,0,0,0,0,0
20150105.100834,2811.47,0,1068360,0,0,0,0,0,0
20150105.100835,2811.47,0,1068360,0,0,0,0,0,0
20150105.100836,2811.47,0,1068360,0,0,0,0,0,0
20150105.100837,2811.47,0,1068360,0,0,0,0,0,0
20150105.100838,2811.47,0,1068360,0,0,0,0,0,0
20150105.100839,2811.47,0,1068360,0,0,0,0,0,0
20150105.10084,2811.47,0,1068360,0,0,0,0,0,0
20150105.100841,2811.47,0,1068360,0,0,0,0,0,0
20150105.100842,2811.47,0,1068360,0,0,0,0,0,0
20150105.100843,2811.47,0,1068360,0,0,0,0,0,0
20150105.100844,2811.47,0,1068360,0,0,0,0,0,0
20150105.100845,2811.47,0,1068360,0,0,0,0,0,0
20150105.100846,2811.47,0,1068360,0,0,0,0,0,0
20150105.100847,2811.47,0,1068360,0,0,0,0,0,0
20150105.100848,2811.47,0,1068360,0,0,0,0,0,0
20150105.100849,2811.47,0,1068360,0,0,0,0,0,0
20150105.10085,2811.47,0,1068360,0,0,0,0,0,0
20150105.100851,2811.47,0,1068360,0,0,0,0,0,0
20150105.100852,2811.47,0,1068360,0,0,0,0,0,0
20150105.100853,2811.47,0,1068360,0,0,0,0,0,0
20150105.100854,2811.47,0,1068360,0,0,0,0,0,0
20150105.100855,2811.47,0,1068360,0,0,0,0,0,0
20150105.100856,2811.47,0,1068360,0,0,0,0,0,0
20150105.100857,2811.47,0,1068360,0,0,0,0,0,0
20150105.100858,2811.47,0,1068360,0,0,0,0,0,0
20150105.100859,2811.47,0,1068360,0,0,0,0,0,0
20150105.1009,2811.47,0,1068360,0,0,0,0,0,0
20150105.100901,2811.47,0,1068360,0,0,0,0,0,0
20150105.100902,2811.47,0,1068360,0,0,0,0,0,0
20150105.100903,2811.47,0,1068360,0,0,0,0,0,0
20150105.100904,2811.47,0,1068360,0,0,0,0,0,0
20150105.100905,2811.47,0,1068360,0,0,0,0,0,0
20150105.100906,2811.47,0,1068360,0,0,0,0,0,0
20150105.100907,2811.47,0,1068360,0,0,0,0,0,0
20150105.100908,2811.47,0,1068360,0,0,0,0,0,0
20150105.100909,2811.47,0,1068360,0,0,0,0,0,0
20150105.10091,2811.47,0,1068360,0,0,0,0,0,0
20150105.100911,2811.47,0,1068360,0,0,0,0,0,0
20150105.100912,2811.47,0,1068360,0,0,0,0,0,0
20150105.100913,2811.47,0,1068360,0,0,0,0,0,0
20150105.100914,2811.47,0,1068360,0,0,0,0,0,0
20150105.100915,2811.47,0,1068360,0,0,0,0,0,0
20150105.100916,2811.47,0,1068360,0,0,0,0,0,0
20150105.100917,2811.47,0,1068360,0,0,0,0,0,0
20150105.100918,2811.47,0,1068360,0,0,0,0,0,0
20150105.100919,2811.47,0,1068360,0,0,0,0,0,0
20150105.10092,2811.47,0,1068360,0,0,0,0,0,0
20150105.100921,2811.47,0,1068360,0,0,0,0,0,0
20150105.100922,2811.47,0,1068360,0,0,0,0,0,0
20150105.100923,2811.47,0,1068360,0,0,0,0,0,0
20150105.100924,2811.47,0,1068360,0,0,0,0,0,0
20150105.100925,2811.47,0,1068360,0,0,0,0,0,0
20150105.100926,2811.47,0,1068360,0,0,0,0,0,0
20150105.100927,2811.47,0,1068360,0,0,0,0,0,0
20150105.100928,2811.47,0,1068360,0,0,0,0,0,0
20150105.100929,2811.47,0,1068360,0,0,0,0,0,0
20150105.10093,2811.47,0,1068360,0,0,0,0,0,0
20150105.100931,2811.47,0,1068360,0,0,0,0,0,0
20150105.100932,2811.47,0,1068360,0,0,0,0,0,0
20150105.100933,2811.47,0,1068360,0,0,0,0,0,0
20150105.100934,2811.47,0,1068360,0,0,0,0,0,0
20150105.100935,2811.47,0,1068360,0,0,0,0,0,0
20150105.100936,2811.47,0,1068360,0,0,0,0,0,0
20150105.100937,2811.47,0,1068360,0,0,0,0,0,0
20150105.100938,2811.47,0,1068360,0,0,0,0,0,0
20150105.100939,2811.47,0,1068360,0,0,0,0,0,0
20150105.10094,2811.47,0,1068360,0,0,0,0,0,0
20150105.100941,2811.47,0,1068360,0,0,0,0,0,0
20150105.100942,2811.47,0,1068360,0,0,0,0,0,0
20150105.100943,2811.47,0,1068360,0,0,0,0,0,0
20150105.100944,2811.47,0,1068360,0,0,0,0,0,0
20150105.100945,2811.47,0,1068360,0,0,0,0,0,0
20150105.100946,2811.47,0,1068360,0,0,0,0,0,0
20150105.100947,2811.47,0,1068360,0,0,0,0,0,0
20150105.100948,2811.47,0,1068360,0,0,0,0,0,0
20150105.100949,2811.47,0,1068360,0,0,0,0,0,0
20150105.10095,2811.47,0,1068360,0,0,0,0,0,0
20150105.100951,2811.47,0,1068360,0,0,0,0,0,0
20150105.100952,2811.47,0,1068360,0,0,0,0,0,0
20150105.100953,2811.47,0,1068360,0,0,0,0,0,0
20150105.100954,2811.47,0,1068360,0,0,0,0,0,0
20150105.100955,2811.47,0,1068360,0,0,0,0,0,0
20150105.100956,2811.47,0,1068360,0,0,0,0,0,0
20150105.100957,2811.47,0,1068360,0,0,0,0,0,0
20150105.100958,2811.47,0,1068360,0,0,0,0,0,0
20150105.100959,2811.47,0,1068360,0,0,0,0,0,0
20150105.101,2811.47,0,1068360,0,0,0,0,0,0
20150105.101001,2811.47,0,1068360,0,0,0,0,0,0
20150105.101002,2811.47,0,1068360,0,0,0,0,0,0
20150105.101003,2811.47,0,1068360,0,0,0,0,0,0
20150105.101004,2811.47,0,1068360,0,0,0,0,0,0
20150105.101005,2811.47,0,1068360,0,0,0,0,0,0
20150105.101006,2811.47,0,1068360,0,0,0,0,0,0
20150105.101007,2811.47,0,1068360,0,0,0,0,0,0
20150105.101008,2811.47,0,1068360,0,0,0,0,0,0
20150105.101009,2811.47,0,1068360,0,0,0,0,0,0
20150105.10101,2811.47,0,1068360,0,0,0,0,0,0
20150105.101011,2811.47,0,1068360,0,0,0,0,0,0
20150105.101012,2811.47,0,1068360,0,0,0,0,0,0
20150105.101013,2811.47,0,1068360,0,0,0,0,0,0
20150105.101014,2811.47,0,1068360,0,0,0,0,0,0
20150105.101015,2811.47,0,1068360,0,0,0,0,0,0
20150105.101016,2811.47,0,1068360,0,0,0,0,0,0
20150105.101017,2811.47,0,1068360,0,0,0,0,0,0
20150105.101018,2811.47,0,1068360,0,0,0,0,0,0
20150105.101019,2811.47,0,1068360,0,0,0,0,0,0
20150105.10102,2811.47,0,1068360,0,0,0,0,0,0
20150105.101021,2811.47,0,1068360,0,0,0,0,0,0
20150105.101022,2811.47,0,1068360,0,0,0,0,0,0
20150105.101023,2811.47,0,1068360,0,0,0,0,0,0
20150105.101024,2811.47,0,1068360,0,0,0,0,0,0
20150105.101025,2811.47,0,1068360,0,0,0,0,0,0
20150105.101026,2811.47,0,1068360,0,0,0,0,0,0
20150105.101027,2811.47,0,1068360,0,0,0,0,0,0
20150105.101028,2811.47,0,1068360,0,0,0,0,0,0
20150105.101029,2811.47,0,1068360,0,0,0,0,0,0
20150105.10103,2811.47,0,1068360,0,0,0,0,0,0
20150105.101031,2811.47,0,1068360,0,0,0,0,0,0
20150105.101032,2811.47,0,1068360,0,0,0,0,0,0
20150105.101033,2811.47,0,1068360,0,0,0,0,0,0
20150105.101034,2811.47,0,1068360,0,0,0,0,0,0
20150105.101035,2811.47,0,1068360,0,0,0,0,0,0
20150105.101036,2811.47,0,1068360,0,0,0,0,0,0
20150105.101037,2811.47,0,1068360,0,0,0,0,0,0
20150105.101038,2811.47,0,1068360,0,0,0,0,0,0
20150105.101039,2811.47,0,1068360,0,0,0,0,0,0
20150105.10104,2811.47,0,1068360,0,0,0,0,0,0
20150105.101041,2811.47,0,1068360,0,0,0,0,0,0
20150105.101042,2811.47,0,1068360,0,0,0,0,0,0
20150105.101043,2811.47,0,1068360,0,0,0,0,0,0
20150105.101044,2811.47,0,1068360,0,0,0,0,0,0
20150105.101045,2811.47,0,1068360,0,0,0,0,0,0
20150105.101046,2811.47,0,1068360,0,0,0,0,0,0
20150105.101047,2811.47,0,1068360,0,0,0,0,0,0
20150105.101048,2811.47,0,1068360,0,0,0,0,0,0
20150105.101049,2811.47,0,1068360,0,0,0,0,0,0
20150105.10105,2811.47,0,1068360,0,0,0,0,0,0
20150105.101051,2811.47,0,1068360,0,0,0,0,0,0
20150105.101052,2811.47,0,1068360,0,0,0,0,0,0
20150105.101053,2811.47,0,1068360,0,0,0,0,0,0
20150105.101054,2811.47,0,1068360,0,0,0,0,0,0
20150105.101055,2811.47,0,1068360,0,0,0,0,0,0
20150105.101056,2811.47,0,1068360,0,0,0,0,0,0
20150105.101057,2811.47,0,1068360,0,0,0,0,0,0
20150105.101058,2811.47,0,1068360,0,0,0,0,0,0
20150105.101059,2811.47,0,1068360,0,0,0,0,0,0
20150105.1011,2811.47,0,1068360,0,0,0,0,0,0
20150105.101101,2811.47,0,1068360,0,0,0,0,0,0
20150105.101102,2811.47,0,1068360,0,0,0,0,0,0
20150105.101103,2811.47,0,1068360,0,0,0,0,0,0
20150105.101104,2811.47,0,1068360,0,0,0,0,0,0
20150105.101105,2811.47,0,1068360,0,0,0,0,0,0
20150105.101106,2811.47,0,1068360,0,0,0,0,0,0
20150105.101107,2811.47,0,1068360,0,0,0,0,0,0
20150105.101108,2811.47,0,1068360,0,0,0,0,0,0
20150105.101109,2811.47,0,1068360,0,0,0,0,0,0
20150105.10111,2811.47,0,1068360,0,0,0,0,0,0
20150105.101111,2811.47,0,1068360,0,0,0,0,0,0
20150105.101112,2811.47,0,1068360,0,0,0,0,0,0
20150105.101113,2811.47,0,1068360,0,0,0,0,0,0
20150105.101114,2811.47,0,1068360,0,0,0,0,0,0
20150105.101115,2811.47,0,1068360,0,0,0,0,0,0
20150105.101116,2811.47,0,1068360,0,0,0,0,0,0
20150105.101117,2811.47,0,1068360,0,0,0,0,0,0
20150105.101118,2811.47,0,1068360,0,0,0,0,0,0
20150105.101119,2811.47,0,1068360,0,0,0,0,0,0
20150105.10112,2811.47,0,1068360,0,0,0,0,0,0
20150105.101121,2811.47,0,1068360,0,0,0,0,0,0
20150105.101122,2811.47,0,1068360,0,0,0,0,0,0
20150105.101123,2811.47,0,1068360,0,0,0,0,0,0
20150105.101124,2811.47,0,1068360,0,0,0,0,0,0
20150105.101125,2811.47,0,1068360,0,0,0,0,0,0
20150105.101126,2811.47,0,1068360,0,0,0,0,0,0
20150105.101127,2811.47,0,1068360,0,0,0,0,0,0
20150105.101128,2811.47,0,1068360,0,0,0,0,0,0
20150105.101129,2811.47,0,1068360,0,0,0,0,0,0
20150105.10113,2811.47,0,1068360,0,0,0,0,0,0
20150105.101131,2811.47,0,1068360,0,0,0,0,0,0
20150105.101132,2811.47,0,1068360,0,0,0,0,0,0
20150105.101133,2811.47,0,1068360,0,0,0,0,0,0
20150105.101134,2811.47,0,1068360,0,0,0,0,0,0
20150105.101135,2811.47,0,1068360,0,0,0,0,0,0
20150105.101136,2811.47,0,1068360,0,0,0,0,0,0
20150105.101137,2811.47,0,1068360,0,0,0,0,0,0
20150105.101138,2811.47,0,1068360,0,0,0,0,0,0
20150105.101139,2811.47,0,1068360,0,0,0,0,0,0
20150105.10114,2811.47,0,1068360,0,0,0,0,0,0
20150105.101141,2811.47,0,1068360,0,0,0,0,0,0
20150105.101142,2811.47,0,1068360,0,0,0,0,0,0
20150105.101143,2811.47,0,1068360,0,0,0,0,0,0
20150105.101144,2811.47,0,1068360,0,0,0,0,0,0
20150105.101145,2811.47,0,1068360,0,0,0,0,0,0
20150105.101146,2811.47,0,1068360,0,0,0,0,0,0
20150105.101147,2811.47,0,1068360,0,0,0,0,0,0
20150105.101148,2811.47,0,1068360,0,0,0,0,0,0
20150105.101149,2811.47,0,1068360,0,0,0,0,0,0
20150105.10115,2811.47,0,1068360,0,0,0,0,0,0
20150105.101151,2811.47,0,1068360,0,0,0,0,0,0
20150105.101152,2811.47,0,1068360,0,0,0,0,0,0
20150105.101153,2811.47,0,1068360,0,0,0,0,0,0
20150105.101154,2811.47,0,1068360,0,0,0,0,0,0
20150105.101155,2811.47,0,1068360,0,0,0,0,0,0
20150105.101156,2811.47,0,1068360,0,0,0,0,0,0
20150105.101157,2811.47,0,1068360,0,0,0,0,0,0
20150105.101158,2811.47,0,1068360,0,0,0,0,0,0
20150105.101159,2811.47,0,1068360,0,0,0,0,0,0
20150105.1012,2811.47,0,1068360,0,0,0,0,0,0
20150105.101201,2811.47,0,1068360,0,0,0,0,0,0
20150105.101202,2811.47,0,1068360,0,0,0,0,0,0
20150105.101203,2811.47,0,1068360,0,0,0,0,0,0
20150105.101204,2811.47,0,1068360,0,0,0,0,0,0
20150105.101205,2811.47,0,1068360,0,0,0,0,0,0
20150105.101206,2811.47,0,1068360,0,0,0,0,0,0
20150105.101207,2811.47,0,1068360,0,0,0,0,0,0
20150105.101208,2811.47,0,1068360,0,0,0,0,0,0
20150105.101209,2811.47,0,1068360,0,0,0,0,0,0
20150105.10121,2811.47,0,1068360,0,0,0,0,0,0
20150105.101211,2811.47,0,1068360,0,0,0,0,0,0
20150105.101212,2811.47,0,1068360,0,0,0,0,0,0
20150105.101213,2811.47,0,1068360,0,0,0,0,0,0
20150105.101214,2811.47,0,1068360,0,0,0,0,0,0
20150105.101215,2811.47,0,1068360,0,0,0,0,0,0
20150105.101216,2811.47,0,1068360,0,0,0,0,0,0
20150105.101217,2811.47,0,1068360,0,0,0,0,0,0
20150105.101218,2811.47,0,1068360,0,0,0,0,0,0
20150105.101219,2811.47,0,1068360,0,0,0,0,0,0
20150105.10122,2811.47,0,1068360,0,0,0,0,0,0
20150105.101221,2811.47,0,1068360,0,0,0,0,0,0
20150105.101222,2811.47,0,1068360,0,0,0,0,0,0
20150105.101223,2811.47,0,1068360,0,0,0,0,0,0
20150105.101224,2811.47,0,1068360,0,0,0,0,0,0
20150105.101225,2811.47,0,1068360,0,0,0,0,0,0
20150105.101226,2811.47,0,1068360,0,0,0,0,0,0
20150105.101227,2811.47,0,1068360,0,0,0,0,0,0
20150105.101228,2811.47,0,1068360,0,0,0,0,0,0
20150105.101229,2811.47,0,1068360,0,0,0,0,0,0
20150105.10123,2811.47,0,1068360,0,0,0,0,0,0
20150105.101231,2811.47,0,1068360,0,0,0,0,0,0
20150105.101232,2811.47,0,1068360,0,0,0,0,0,0
20150105.101233,2811.47,0,1068360,0,0,0,0,0,0
20150105.101234,2811.47,0,1068360,0,0,0,0,0,0
20150105.101235,2811.47,0,1068360,0,0,0,0,0,0
20150105.101236,2811.47,0,1068360,0,0,0,0,0,0
20150105.101237,2811.47,0,1068360,0,0,0,0,0,0
20150105.101238,2811.47,0,1068360,0,0,0,0,0,0
20150105.101239,2811.47,0,1068360,0,0,0,0,0,0
20150105.10124,2811.47,0,1068360,0,0,0,0,0,0
20150105.101241,2811.47,0,1068360,0,0,0,0,0,0
20150105.101242,2811.47,0,1068360,0,0,0,0,0,0
20150105.101243,2811.47,0,1068360,0,0,0,0,0,0
20150105.101244,2811.47,0,1068360,0,0,0,0,0,0
20150105.101245,2811.47,0,1068360,0,0,0,0,0,0
20150105.101246,2811.47,0,1068360,0,0,0,0,0,0
20150105.101247,2811.47,0,1068360,0,0,0,0,0,0
20150105.101248,2811.47,0,1068360,0,0,0,0,0,0
20150105.101249,2811.47,0,1068360,0,0,0,0,0,0
20150105.10125,2811.47,0,1068360,0,0,0,0,0,0
20150105.101251,2811.47,0,1068360,0,0,0,0,0,0
20150105.101252,2811.47,0,1068360,0,0,0,0,0,0
20150105.101253,2811.47,0,1068360,0,0,0,0,0,0
20150105.101254,2811.47,0,1068360,0,0,0,0,0,0
20150105.101255,2811.47,0,1068360,0,0,0,0,0,0
20150105.101256,2811.47,0,1068360,0,0,0,0,0,0
20150105.101257,2811.47,0,1068360,0,0,0,0,0,0
20150105.101258,2811.47,0,1068360,0,0,0,0,0,0
20150105.101259,2811.47,0,1068360,0,0,0,0,0,0
20150105.1013,2811.47,0,1068360,0,0,0,0,0,0
20150105.101301,2811.47,0,1068360,0,0,0,0,0,0
20150105.101302,2811.47,0,1068360,0,0,0,0,0,0
20150105.101303,2811.47,0,1068360,0,0,0,0,0,0
20150105.101304,2811.47,0,1068360,0,0,0,0,0,0
20150105.101305,2811.47,0,1068360,0,0,0,0,0,0
20150105.101306,2811.47,0,1068360,0,0,0,0,0,0
20150105.101307,2811.47,0,1068360,0,0,0,0,0,0
20150105.101308,2811.47,0,1068360,0,0,0,0,0,0
20150105.101309,2811.47,0,1068360,0,0,0,0,0,0
20150105.10131,2811.47,0,1068360,0,0,0,0,0,0
20150105.101311,2811.47,0,1068360,0,0,0,0,0,0
20150105.101312,2811.47,0,1068360,0,0,0,0,0,0
20150105.101313,2811.47,0,1068360,0,0,0,0,0,0
20150105.101314,2811.47,0,1068360,0,0,0,0,0,0
20150105.101315,2811.47,0,1068360,0,0,0,0,0,0
20150105.101316,2811.47,0,1068360,0,0,0,0,0,0
20150105.101317,2811.47,0,1068360,0,0,0,0,0,0
20150105.101318,2811.47,0,1068360,0,0,0,0,0,0
20150105.101319,2811.47,0,1068360,0,0,0,0,0,0
20150105.10132,2811.47,0,1068360,0,0,0,0,0,0
20150105.101321,2811.47,0,1068360,0,0,0,0,0,0
20150105.101322,2811.47,0,1068360,0,0,0,0,0,0
20150105.101323,2811.47,0,1068360,0,0,0,0,0,0
20150105.101324,2811.47,0,1068360,0,0,0,0,0,0
20150105.101325,2811.47,0,1068360,0,0,0,0,0,0
20150105.101326,2811.47,0,1068360,0,0,0,0,0,0
20150105.101327,2811.47,0,1068360,0,0,0,0,0,0
20150105.101328,2811.47,0,1068360,0,0,0,0,0,0
20150105.101329,2811.47,0,1068360,0,0,0,0,0,0
20150105.10133,2811.47,0,1068360,0,0,0,0,0,0
20150105.101331,2811.47,0,1068360,0,0,0,0,0,0
20150105.101332,2811.47,0,1068360,0,0,0,0,0,0
20150105.101333,2811.47,0,1068360,0,0,0,0,0,0
20150105.101334,2811.47,0,1068360,0,0,0,0,0,0
20150105.101335,2811.47,0,1068360,0,0,0,0,0,0
20150105.101336,2811.47,0,1068360,0,0,0,0,0,0
20150105.101337,2811.47,0,1068360,0,0,0,0,0,0
20150105.101338,2811.47,0,1068360,0,0,0,0,0,0
20150105.101339,2811.47,0,1068360,0,0,0,0,0,0
20150105.10134,2811.47,0,1068360,0,0,0,0,0,0
20150105.101341,2811.47,0,1068360,0,0,0,0,0,0
20150105.101342,2811.47,0,1068360,0,0,0,0,0,0
20150105.101343,2811.47,0,1068360,0,0,0,0,0,0
20150105.101344,2811.47,0,1068360,0,0,0,0,0,0
20150105.101345,2811.47,0,1068360,0,0,0,0,0,0
20150105.101346,2811.47,0,1068360,0,0,0,0,0,0
20150105.101347,2811.47,0,1068360,0,0,0,0,0,0
20150105.101348,2811.47,0,1068360,0,0,0,0,0,0
20150105.101349,2811.47,0,1068360,0,0,0,0,0,0
20150105.10135,2811.47,0,1068360,0,0,0,0,0,0
20150105.101351,2811.47,0,1068360,0,0,0,0,0,0
20150105.101352,2811.47,0,1068360,0,0,0,0,0,0
20150105.101353,2811.47,0,1068360,0,0,0,0,0,0
20150105.101354,2811.47,0,1068360,0,0,0,0,0,0
20150105.101355,2811.47,0,1068360,0,0,0,0,0,0
20150105.101356,2811.47,0,1068360,0,0,0,0,0,0
20150105.101357,2811.47,0,1068360,0,0,0,0,0,0
20150105.101358,2811.47,0,1068360,0,0,0,0,0,0
20150105.101359,2811.47,0,1068360,0,0,0,0,0,0
20150105.1014,2811.47,0,1068360,0,0,0,0,0,0
20150105.101401,2811.47,0,1068360,0,0,0,0,0,0
20150105.101402,2811.47,0,1068360,0,0,0,0,0,0
20150105.101403,2811.47,0,1068360,0,0,0,0,0,0
20150105.101404,2811.47,0,1068360,0,0,0,0,0,0
20150105.101405,2811.47,0,1068360,0,0,0,0,0,0
20150105.101406,2811.47,0,1068360,0,0,0,0,0,0
20150105.101407,2811.47,0,1068360,0,0,0,0,0,0
20150105.101408,2811.47,0,1068360,0,0,0,0,0,0
20150105.101409,2811.47,0,1068360,0,0,0,0,0,0
20150105.10141,2811.47,0,1068360,0,0,0,0,0,0
20150105.101411,2811.47,0,1068360,0,0,0,0,0,0
20150105.101412,2811.47,0,1068360,0,0,0,0,0,0
20150105.101413,2811.47,0,1068360,0,0,0,0,0,0
20150105.101414,2811.47,0,1068360,0,0,0,0,0,0
20150105.101415,2811.47,0,1068360,0,0,0,0,0,0
20150105.101416,2811.47,0,1068360,0,0,0,0,0,0
20150105.101417,2811.47,0,1068360,0,0,0,0,0,0
20150105.101418,2811.47,0,1068360,0,0,0,0,0,0
20150105.101419,2811.47,0,1068360,0,0,0,0,0,0
20150105.10142,2811.47,0,1068360,0,0,0,0,0,0
20150105.101421,2811.47,0,1068360,0,0,0,0,0,0
20150105.101422,2811.47,0,1068360,0,0,0,0,0,0
20150105.101423,2811.47,0,1068360,0,0,0,0,0,0
20150105.101424,2811.47,0,1068360,0,0,0,0,0,0
20150105.101425,2811.47,0,1068360,0,0,0,0,0,0
20150105.101426,2811.47,0,1068360,0,0,0,0,0,0
20150105.101427,2811.47,0,1068360,0,0,0,0,0,0
20150105.101428,2811.47,0,1068360,0,0,0,0,0,0
20150105.101429,2811.47,0,1068360,0,0,0,0,0,0
20150105.10143,2811.47,0,1068360,0,0,0,0,0,0
20150105.101431,2811.47,0,1068360,0,0,0,0,0,0
20150105.101432,2811.47,0,1068360,0,0,0,0,0,0
20150105.101433,2811.47,0,1068360,0,0,0,0,0,0
20150105.101434,2811.47,0,1068360,0,0,0,0,0,0
20150105.101435,2811.47,0,1068360,0,0,0,0,0,0
20150105.101436,2811.47,0,1068360,0,0,0,0,0,0
20150105.101437,2811.47,0,1068360,0,0,0,0,0,0
20150105.101438,2811.47,0,1068360,0,0,0,0,0,0
20150105.101439,2811.47,0,1068360,0,0,0,0,0,0
20150105.10144,2811.47,0,1068360,0,0,0,0,0,0
20150105.101441,2811.47,0,1068360,0,0,0,0,0,0
20150105.101442,2811.47,0,1068360,0,0,0,0,0,0
20150105.101443,2811.47,0,1068360,0,0,0,0,0,0
20150105.101444,2811.47,0,1068360,0,0,0,0,0,0
20150105.101445,2811.47,0,1068360,0,0,0,0,0,0
20150105.101446,2811.47,0,1068360,0,0,0,0,0,0
20150105.101447,2811.47,0,1068360,0,0,0,0,0,0
20150105.101448,2811.47,0,1068360,0,0,0,0,0,0
20150105.101449,2811.47,0,1068360,0,0,0,0,0,0
20150105.10145,2811.47,0,1068360,0,0,0,0,0,0
20150105.101451,2811.47,0,1068360,0,0,0,0,0,0
20150105.101452,2811.47,0,1068360,0,0,0,0,0,0
20150105.101453,2811.47,0,1068360,0,0,0,0,0,0
20150105.101454,2811.47,0,1068360,0,0,0,0,0,0
20150105.101455,2811.47,0,1068360,0,0,0,0,0,0
20150105.101456,2811.47,0,1068360,0,0,0,0,0,0
20150105.101457,2811.47,0,1068360,0,0,0,0,0,0
20150105.101458,2811.47,0,1068360,0,0,0,0,0,0
20150105.101459,2811.47,0,1068360,0,0,0,0,0,0
20150105.103,2811.47,0,1068360,0,0,0,0,0,0
20150105.103001,2811.47,0,1068360,0,0,0,0,0,0
20150105.103002,2811.47,0,1068360,0,0,0,0,0,0
20150105.103003,2811.47,0,1068360,0,0,0,0,0,0
20150105.103004,2811.47,0,1068360,0,0,0,0,0,0
20150105.103005,2811.47,0,1068360,0,0,0,0,0,0
20150105.103006,2811.47,0,1068360,0,0,0,0,0,0
20150105.103007,2811.47,0,1068360,0,0,0,0,0,0
20150105.103008,2811.47,0,1068360,0,0,0,0,0,0
20150105.103009,2811.47,0,1068360,0,0,0,0,0,0
20150105.10301,2811.47,0,1068360,0,0,0,0,0,0
20150105.103011,2811.47,0,1068360,0,0,0,0,0,0
20150105.103012,2811.47,0,1068360,0,0,0,0,0,0
20150105.103013,2811.47,0,1068360,0,0,0,0,0,0
20150105.103014,2811.47,0,1068360,0,0,0,0,0,0
20150105.103015,2811.47,0,1068360,0,0,0,0,0,0
20150105.103016,2811.47,0,1068360,0,0,0,0,0,0
20150105.103017,2811.47,0,1068360,0,0,0,0,0,0
20150105.103018,2811.47,0,1068360,0,0,0,0,0,0
20150105.103019,2811.47,0,1068360,0,0,0,0,0,0
20150105.10302,2811.47,0,1068360,0,0,0,0,0,0
20150105.103021,2811.47,0,1068360,0,0,0,0,0,0
20150105.103022,2811.47,0,1068360,0,0,0,0,0,0
20150105.103023,2811.47,0,1068360,0,0,0,0,0,0
20150105.103024,2811.47,0,1068360,0,0,0,0,0,0
20150105.103025,2811.47,0,1068360,0,0,0,0,0,0
20150105.103026,2811.47,0,1068360,0,0,0,0,0,0
20150105.103027,2811.47,0,1068360,0,0,0,0,0,0
20150105.103028,2811.47,0,1068360,0,0,0,0,0,0
20150105.103029,2811.47,0,1068360,0,0,0,0,0,0
20150105.10303,2811.47,0,1068360,0,0,0,0,0,0
20150105.103031,2811.47,0,1068360,0,0,0,0,0,0
20150105.103032,2811.47,0,1068360,0,0,0,0,0,0
20150105.103033,2811.47,0,1068360,0,0,0,0,0,0
20150105.103034,2811.47,0,1068360,0,0,0,0,0,0
20150105.103035,2811.47,0,1068360,0,0,0,0,0,0
20150105.103036,2811.47,0,1068360,0,0,0,0,0,0
20150105.103037,2811.47,0,1068360,0,0,0,0,0,0
20150105.103038,2811.47,0,1068360,0,0,0,0,0,0
20150105.103039,2811.47,0,1068360,0,0,0,0,0,0
20150105.10304,2811.47,0,1068360,0,0,0,0,0,0
20150105.103041,2811.47,0,1068360,0,0,0,0,0,0
20150105.103042,2811.47,0,1068360,0,0,0,0,0,0
20150105.103043,2811.47,0,1068360,0,0,0,0,0,0
20150105.103044,2811.47,0,1068360,0,0,0,0,0,0
20150105.103045,2811.47,0,1068360,0,0,0,0,0,0
20150105.103046,2811.47,0,1068360,0,0,0,0,0,0
20150105.103047,2811.47,0,1068360,0,0,0,0,0,0
20150105.103048,2811.47,0,1068360,0,0,0,0,0,0
20150105.103049,2811.47,0,1068360,0,0,0,0,0,0
20150105.10305,2811.47,0,1068360,0,0,0,0,0,0
20150105.103051,2811.47,0,1068360,0,0,0,0,0,0
20150105.103052,2811.47,0,1068360,0,0,0,0,0,0
20150105.103053,2811.47,0,1068360,0,0,0,0,0,0
20150105.103054,2811.47,0,1068360,0,0,0,0,0,0
20150105.103055,2811.47,0,1068360,0,0,0,0,0,0
20150105.103056,2811.47,0,1068360,0,0,0,0,0,0
20150105.103057,2811.47,0,1068360,0,0,0,0,0,0
20150105.103058,2811.47,0,1068360,0,0,0,0,0,0
20150105.103059,2811.47,0,1068360,0,0,0,0,0,0
20150105.1031,2811.47,0,1068360,0,0,0,0,0,0
20150105.103101,2811.47,0,1068360,0,0,0,0,0,0
20150105.103102,2811.47,0,1068360,0,0,0,0,0,0
20150105.103103,2811.47,0,1068360,0,0,0,0,0,0
20150105.103104,2811.47,0,1068360,0,0,0,0,0,0
20150105.103105,2811.47,0,1068360,0,0,0,0,0,0
20150105.103106,2811.47,0,1068360,0,0,0,0,0,0
20150105.103107,2811.47,0,1068360,0,0,0,0,0,0
20150105.103108,2811.47,0,1068360,0,0,0,0,0,0
20150105.103109,2811.47,0,1068360,0,0,0,0,0,0
20150105.10311,2811.47,0,1068360,0,0,0,0,0,0
20150105.103111,2811.47,0,1068360,0,0,0,0,0,0
20150105.103112,2811.47,0,1068360,0,0,0,0,0,0
20150105.103113,2811.47,0,1068360,0,0,0,0,0,0
20150105.103114,2811.47,0,1068360,0,0,0,0,0,0
20150105.103115,2811.47,0,1068360,0,0,0,0,0,0
20150105.103116,2811.47,0,1068360,0,0,0,0,0,0
20150105.103117,2811.47,0,1068360,0,0,0,0,0,0
20150105.103118,2811.47,0,1068360,0,0,0,0,0,0
20150105.103119,2811.47,0,1068360,0,0,0,0,0,0
20150105.10312,2811.47,0,1068360,0,0,0,0,0,0
20150105.103121,2811.47,0,1068360,0,0,0,0,0,0
20150105.103122,2811.47,0,1068360,0,0,0,0,0,0
20150105.103123,2811.47,0,1068360,0,0,0,0,0,0
20150105.103124,2811.47,0,1068360,0,0,0,0,0,0
20150105.103125,2811.47,0,1068360,0,0,0,0,0,0
20150105.103126,2811.47,0,1068360,0,0,0,0,0,0
20150105.103127,2811.47,0,1068360,0,0,0,0,0,0
20150105.103128,2811.47,0,1068360,0,0,0,0,0,0
20150105.103129,2811.47,0,1068360,0,0,0,0,0,0
20150105.10313,2811.47,0,1068360,0,0,0,0,0,0
20150105.103131,2811.47,0,1068360,0,0,0,0,0,0
20150105.103132,2811.47,0,1068360,0,0,0,0,0,0
20150105.103133,2811.47,0,1068360,0,0,0,0,0,0
20150105.103134,2811.47,0,1068360,0,0,0,0,0,0
20150105.103135,2811.47,0,1068360,0,0,0,0,0,0
20150105.103136,2811.47,0,1068360,0,0,0,0,0,0
20150105.103137,2811.47,0,1068360,0,0,0,0,0,0
20150105.103138,2811.47,0,1068360,0,0,0,0,0,0
20150105.103139,2811.47,0,1068360,0,0,0,0,0,0
20150105.10314,2811.47,0,1068360,0,0,0,0,0,0
20150105.103141,2811.47,0,1068360,0,0,0,0,0,0
20150105.103142,2811.47,0,1068360,0,0,0,0,0,0
20150105.103143,2811.47,0,1068360,0,0,0,0,0,0
20150105.103144,2811.47,0,1068360,0,0,0,0,0,0
20150105.103145,2811.47,0,1068360,0,0,0,0,0,0
20150105.103146,2811.47,0,1068360,0,0,0,0,0,0
20150105.103147,2811.47,0,1068360,0,0,0,0,0,0
20150105.103148,2811.47,0,1068360,0,0,0,0,0,0
20150105.103149,2811.47,0,1068360,0,0,0,0,0,0
20150105.10315,2811.47,0,1068360,0,0,0,0,0,0
20150105.103151,2811.47,0,1068360,0,0,0,0,0,0
20150105.103152,2811.47,0,1068360,0,0,0,0,0,0
20150105.103153,2811.47,0,1068360,0,0,0,0,0,0
20150105.103154,2811.47,0,1068360,0,0,0,0,0,0
20150105.103155,2811.47,0,1068360,0,0,0,0,0,0
20150105.103156,2811.47,0,1068360,0,0,0,0,0,0
20150105.103157,2811.47,0,1068360,0,0,0,0,0,0
20150105.103158,2811.47,0,1068360,0,0,0,0,0,0
20150105.103159,2811.47,0,1068360,0,0,0,0,0,0
20150105.1032,2811.47,0,1068360,0,0,0,0,0,0
20150105.103201,2811.47,0,1068360,0,0,0,0,0,0
20150105.103202,2811.47,0,1068360,0,0,0,0,0,0
20150105.103203,2811.47,0,1068360,0,0,0,0,0,0
20150105.103204,2811.47,0,1068360,0,0,0,0,0,0
20150105.103205,2811.47,0,1068360,0,0,0,0,0,0
20150105.103206,2811.47,0,1068360,0,0,0,0,0,0
20150105.103207,2811.47,0,1068360,0,0,0,0,0,0
20150105.103208,2811.47,0,1068360,0,0,0,0,0,0
20150105.103209,2811.47,0,1068360,0,0,0,0,0,0
20150105.10321,2811.47,0,1068360,0,0,0,0,0,0
20150105.103211,2811.47,0,1068360,0,0,0,0,0,0
20150105.103212,2811.47,0,1068360,0,0,0,0,0,0
20150105.103213,2811.47,0,1068360,0,0,0,0,0,0
20150105.103214,2811.47,0,1068360,0,0,0,0,0,0
20150105.103215,2811.47,0,1068360,0,0,0,0,0,0
20150105.103216,2811.47,0,1068360,0,0,0,0,0,0
20150105.103217,2811.47,0,1068360,0,0,0,0,0,0
20150105.103218,2811.47,0,1068360,0,0,0,0,0,0
20150105.103219,2811.47,0,1068360,0,0,0,0,0,0
20150105.10322,2811.47,0,1068360,0,0,0,0,0,0
20150105.103221,2811.47,0,1068360,0,0,0,0,0,0
20150105.103222,2811.47,0,1068360,0,0,0,0,0,0
20150105.103223,2811.47,0,1068360,0,0,0,0,0,0
20150105.103224,2811.47,0,1068360,0,0,0,0,0,0
20150105.103225,2811.47,0,1068360,0,0,0,0,0,0
20150105.103226,2811.47,0,1068360,0,0,0,0,0,0
20150105.103227,2811.47,0,1068360,0,0,0,0,0,0
20150105.103228,2811.47,0,1068360,0,0,0,0,0,0
20150105.103229,2811.47,0,1068360,0,0,0,0,0,0
20150105.10323,2811.47,0,1068360,0,0,0,0,0,0
20150105.103231,2811.47,0,1068360,0,0,0,0,0,0
20150105.103232,2811.47,0,1068360,0,0,0,0,0,0
20150105.103233,2811.47,0,1068360,0,0,0,0,0,0
20150105.103234,2811.47,0,1068360,0,0,0,0,0,0
20150105.103235,2811.47,0,1068360,0,0,0,0,0,0
20150105.103236,2811.47,0,1068360,0,0,0,0,0,0
20150105.103237,2811.47,0,1068360,0,0,0,0,0,0
20150105.103238,2811.47,0,1068360,0,0,0,0,0,0
20150105.103239,2811.47,0,1068360,0,0,0,0,0,0
20150105.10324,2811.47,0,1068360,0,0,0,0,0,0
20150105.103241,2811.47,0,1068360,0,0,0,0,0,0
20150105.103242,2811.47,0,1068360,0,0,0,0,0,0
20150105.103243,2811.47,0,1068360,0,0,0,0,0,0
20150105.103244,2811.47,0,1068360,0,0,0,0,0,0
20150105.103245,2811.47,0,1068360,0,0,0,0,0,0
20150105.103246,2811.47,0,1068360,0,0,0,0,0,0
20150105.103247,2811.47,0,1068360,0,0,0,0,0,0
20150105.103248,2811.47,0,1068360,0,0,0,0,0,0
20150105.103249,2811.47,0,1068360,0,0,0,0,0,0
20150105.10325,2811.47,0,1068360,0,0,0,0,0,0
20150105.103251,2811.47,0,1068360,0,0,0,0,0,0
20150105.103252,2811.47,0,1068360,0,0,0,0,0,0
20150105.103253,2811.47,0,1068360,0,0,0,0,0,0
20150105.103254,2811.47,0,1068360,0,0,0,0,0,0
20150105.103255,2811.47,0,1068360,0,0,0,0,0,0
20150105.103256,2811.47,0,1068360,0,0,0,0,0,0
20150105.103257,2811.47,0,1068360,0,0,0,0,0,0
20150105.103258,2811.47,0,1068360,0,0,0,0,0,0
20150105.103259,2811.47,0,1068360,0,0,0,0,0,0
20150105.1033,2811.47,0,1068360,0,0,0,0,0,0
20150105.103301,2811.47,0,1068360,0,0,0,0,0,0
20150105.103302,2811.47,0,1068360,0,0,0,0,0,0
20150105.103303,2811.47,0,1068360,0,0,0,0,0,0
20150105.103304,2811.47,0,1068360,0,0,0,0,0,0
20150105.103305,2811.47,0,1068360,0,0,0,0,0,0
20150105.103306,2811.47,0,1068360,0,0,0,0,0,0
20150105.103307,2811.47,0,1068360,0,0,0,0,0,0
20150105.103308,2811.47,0,1068360,0,0,0,0,0,0
20150105.103309,2811.47,0,1068360,0,0,0,0,0,0
20150105.10331,2811.47,0,1068360,0,0,0,0,0,0
20150105.103311,2811.47,0,1068360,0,0,0,0,0,0
20150105.103312,2811.47,0,1068360,0,0,0,0,0,0
20150105.103313,2811.47,0,1068360,0,0,0,0,0,0
20150105.103314,2811.47,0,1068360,0,0,0,0,0,0
20150105.103315,2811.47,0,1068360,0,0,0,0,0,0
20150105.103316,2811.47,0,1068360,0,0,0,0,0,0
20150105.103317,2811.47,0,1068360,0,0,0,0,0,0
20150105.103318,2811.47,0,1068360,0,0,0,0,0,0
20150105.103319,2811.47,0,1068360,0,0,0,0,0,0
20150105.10332,2811.47,0,1068360,0,0,0,0,0,0
20150105.103321,2811.47,0,1068360,0,0,0,0,0,0
20150105.103322,2811.47,0,1068360,0,0,0,0,0,0
20150105.103323,2811.47,0,1068360,0,0,0,0,0,0
20150105.103324,2811.47,0,1068360,0,0,0,0,0,0
20150105.103325,2811.47,0,1068360,0,0,0,0,0,0
20150105.103326,2811.47,0,1068360,0,0,0,0,0,0
20150105.103327,2811.47,0,1068360,0,0,0,0,0,0
20150105.103328,2811.47,0,1068360,0,0,0,0,0,0
20150105.103329,2811.47,0,1068360,0,0,0,0,0,0
20150105.10333,2811.47,0,1068360,0,0,0,0,0,0
20150105.103331,2811.47,0,1068360,0,0,0,0,0,0
20150105.103332,2811.47,0,1068360,0,0,0,0,0,0
20150105.103333,2811.47,0,1068360,0,0,0,0,0,0
20150105.103334,2811.47,0,1068360,0,0,0,0,0,0
20150105.103335,2811.47,0,1068360,0,0,0,0,0,0
20150105.103336,2811.47,0,1068360,0,0,0,0,0,0
20150105.103337,2811.47,0,1068360,0,0,0,0,0,0
20150105.103338,2811.47,0,1068360,0,0,0,0,0,0
20150105.103339,2811.47,0,1068360,0,0,0,0,0,0
20150105.10334,2811.47,0,1068360,0,0,0,0,0,0
20150105.103341,2811.47,0,1068360,0,0,0,0,0,0
20150105.103342,2811.47,0,1068360,0,0,0,0,0,0
20150105.103343,2811.47,0,1068360,0,0,0,0,0,0
20150105.103344,2811.47,0,1068360,0,0,0,0,0,0
20150105.103345,2811.47,0,1068360,0,0,0,0,0,0
20150105.103346,2811.47,0,1068360,0,0,0,0,0,0
20150105.103347,2811.47,0,1068360,0,0,0,0,0,0
20150105.103348,2811.47,0,1068360,0,0,0,0,0,0
20150105.103349,2811.47,0,1068360,0,0,0,0,0,0
20150105.10335,2811.47,0,1068360,0,0,0,0,0,0
20150105.103351,2811.47,0,1068360,0,0,0,0,0,0
20150105.103352,2811.47,0,1068360,0,0,0,0,0,0
20150105.103353,2811.47,0,1068360,0,0,0,0,0,0
20150105.103354,2811.47,0,1068360,0,0,0,0,0,0
20150105.103355,2811.47,0,1068360,0,0,0,0,0,0
20150105.103356,2811.47,0,1068360,0,0,0,0,0,0
20150105.103357,2811.47,0,1068360,0,0,0,0,0,0
20150105.103358,2811.47,0,1068360,0,0,0,0,0,0
20150105.103359,2811.47,0,1068360,0,0,0,0,0,0
20150105.1034,2811.47,0,1068360,0,0,0,0,0,0
20150105.103401,2811.47,0,1068360,0,0,0,0,0,0
20150105.103402,2811.47,0,1068360,0,0,0,0,0,0
20150105.103403,2811.47,0,1068360,0,0,0,0,0,0
20150105.103404,2811.47,0,1068360,0,0,0,0,0,0
20150105.103405,2811.47,0,1068360,0,0,0,0,0,0
20150105.103406,2811.47,0,1068360,0,0,0,0,0,0
20150105.103407,2811.47,0,1068360,0,0,0,0,0,0
20150105.103408,2811.47,0,1068360,0,0,0,0,0,0
20150105.103409,2811.47,0,1068360,0,0,0,0,0,0
20150105.10341,2811.47,0,1068360,0,0,0,0,0,0
20150105.103411,2811.47,0,1068360,0,0,0,0,0,0
20150105.103412,2811.47,0,1068360,0,0,0,0,0,0
20150105.103413,2811.47,0,1068360,0,0,0,0,0,0
20150105.103414,2811.47,0,1068360,0,0,0,0,0,0
20150105.103415,2811.47,0,1068360,0,0,0,0,0,0
20150105.103416,2811.47,0,1068360,0,0,0,0,0,0
20150105.103417,2811.47,0,1068360,0,0,0,0,0,0
20150105.103418,2811.47,0,1068360,0,0,0,0,0,0
20150105.103419,2811.47,0,1068360,0,0,0,0,0,0
20150105.10342,2811.47,0,1068360,0,0,0,0,0,0
20150105.103421,2811.47,0,1068360,0,0,0,0,0,0
20150105.103422,2811.47,0,1068360,0,0,0,0,0,0
20150105.103423,2811.47,0,1068360,0,0,0,0,0,0
20150105.103424,2811.47,0,1068360,0,0,0,0,0,0
20150105.103425,2811.47,0,1068360,0,0,0,0,0,0
20150105.103426,2811.47,0,1068360,0,0,0,0,0,0
20150105.103427,2811.47,0,1068360,0,0,0,0,0,0
20150105.103428,2811.47,0,1068360,0,0,0,0,0,0
20150105.103429,2811.47,0,1068360,0,0,0,0,0,0
20150105.10343,2811.47,0,1068360,0,0,0,0,0,0
20150105.103431,2811.47,0,1068360,0,0,0,0,0,0
20150105.103432,2811.47,0,1068360,0,0,0,0,0,0
20150105.103433,2811.47,0,1068360,0,0,0,0,0,0
20150105.103434,2811.47,0,1068360,0,0,0,0,0,0
20150105.103435,2811.47,0,1068360,0,0,0,0,0,0
20150105.103436,2811.47,0,1068360,0,0,0,0,0,0
20150105.103437,2811.47,0,1068360,0,0,0,0,0,0
20150105.103438,2811.47,0,1068360,0,0,0,0,0,0
20150105.103439,2811.47,0,1068360,0,0,0,0,0,0
20150105.10344,2811.47,0,1068360,0,0,0,0,0,0
20150105.103441,2811.47,0,1068360,0,0,0,0,0,0
20150105.103442,2811.47,0,1068360,0,0,0,0,0,0
20150105.103443,2811.47,0,1068360,0,0,0,0,0,0
20150105.103444,2811.47,0,1068360,0,0,0,0,0,0
20150105.103445,2811.47,0,1068360,0,0,0,0,0,0
20150105.103446,2811.47,0,1068360,0,0,0,0,0,0
20150105.103447,2811.47,0,1068360,0,0,0,0,0,0
20150105.103448,2811.47,0,1068360,0,0,0,0,0,0
20150105.103449,2811.47,0,1068360,0,0,0,0,0,0
20150105.10345,2811.47,0,1068360,0,0,0,0,0,0
20150105.103451,2811.47,0,1068360,0,0,0,0,0,0
20150105.103452,2811.47,0,1068360,0,0,0,0,0,0
20150105.103453,2811.47,0,1068360,0,0,0,0,0,0
20150105.103454,2811.47,0,1068360,0,0,0,0,0,0
20150105.103455,2811.47,0,1068360,0,0,0,0,0,0
20150105.103456,2811.47,0,1068360,0,0,0,0,0,0
20150105.103457,2811.47,0,1068360,0,0,0,0,0,0
20150105.103458,2811.47,0,1068360,0,0,0,0,0,0
20150105.103459,2811.47,0,1068360,0,0,0,0,0,0
20150105.1035,2811.47,0,1068360,0,0,0,0,0,0
20150105.103501,2811.47,0,1068360,0,0,0,0,0,0
20150105.103502,2811.47,0,1068360,0,0,0,0,0,0
20150105.103503,2811.47,0,1068360,0,0,0,0,0,0
20150105.103504,2811.47,0,1068360,0,0,0,0,0,0
20150105.103505,2811.47,0,1068360,0,0,0,0,0,0
20150105.103506,2811.47,0,1068360,0,0,0,0,0,0
20150105.103507,2811.47,0,1068360,0,0,0,0,0,0
20150105.103508,2811.47,0,1068360,0,0,0,0,0,0
20150105.103509,2811.47,0,1068360,0,0,0,0,0,0
20150105.10351,2811.47,0,1068360,0,0,0,0,0,0
20150105.103511,2811.47,0,1068360,0,0,0,0,0,0
20150105.103512,2811.47,0,1068360,0,0,0,0,0,0
20150105.103513,2811.47,0,1068360,0,0,0,0,0,0
20150105.103514,2811.47,0,1068360,0,0,0,0,0,0
20150105.103515,2811.47,0,1068360,0,0,0,0,0,0
20150105.103516,2811.47,0,1068360,0,0,0,0,0,0
20150105.103517,2811.47,0,1068360,0,0,0,0,0,0
20150105.103518,2811.47,0,1068360,0,0,0,0,0,0
20150105.103519,2811.47,0,1068360,0,0,0,0,0,0
20150105.10352,2811.47,0,1068360,0,0,0,0,0,0
20150105.103521,2811.47,0,1068360,0,0,0,0,0,0
20150105.103522,2811.47,0,1068360,0,0,0,0,0,0
20150105.103523,2811.47,0,1068360,0,0,0,0,0,0
20150105.103524,2811.47,0,1068360,0,0,0,0,0,0
20150105.103525,2811.47,0,1068360,0,0,0,0,0,0
20150105.103526,2811.47,0,1068360,0,0,0,0,0,0
20150105.103527,2811.47,0,1068360,0,0,0,0,0,0
20150105.103528,2811.47,0,1068360,0,0,0,0,0,0
20150105.103529,2811.47,0,1068360,0,0,0,0,0,0
20150105.10353,2811.47,0,1068360,0,0,0,0,0,0
20150105.103531,2811.47,0,1068360,0,0,0,0,0,0
20150105.103532,2811.47,0,1068360,0,0,0,0,0,0
20150105.103533,2811.47,0,1068360,0,0,0,0,0,0
20150105.103534,2811.47,0,1068360,0,0,0,0,0,0
20150105.103535,2811.47,0,1068360,0,0,0,0,0,0
20150105.103536,2811.47,0,1068360,0,0,0,0,0,0
20150105.103537,2811.47,0,1068360,0,0,0,0,0,0
20150105.103538,2811.47,0,1068360,0,0,0,0,0,0
20150105.103539,2811.47,0,1068360,0,0,0,0,0,0
20150105.10354,2811.47,0,1068360,0,0,0,0,0,0
20150105.103541,2811.47,0,1068360,0,0,0,0,0,0
20150105.103542,2811.47,0,1068360,0,0,0,0,0,0
20150105.103543,2811.47,0,1068360,0,0,0,0,0,0
20150105.103544,2811.47,0,1068360,0,0,0,0,0,0
20150105.103545,2811.47,0,1068360,0,0,0,0,0,0
20150105.103546,2811.47,0,1068360,0,0,0,0,0,0
20150105.103547,2811.47,0,1068360,0,0,0,0,0,0
20150105.103548,2811.47,0,1068360,0,0,0,0,0,0
20150105.103549,2811.47,0,1068360,0,0,0,0,0,0
20150105.10355,2811.47,0,1068360,0,0,0,0,0,0
20150105.103551,2811.47,0,1068360,0,0,0,0,0,0
20150105.103552,2811.47,0,1068360,0,0,0,0,0,0
20150105.103553,2811.47,0,1068360,0,0,0,0,0,0
20150105.103554,2811.47,0,1068360,0,0,0,0,0,0
20150105.103555,2811.47,0,1068360,0,0,0,0,0,0
20150105.103556,2811.47,0,1068360,0,0,0,0,0,0
20150105.103557,2811.47,0,1068360,0,0,0,0,0,0
20150105.103558,2811.47,0,1068360,0,0,0,0,0,0
20150105.103559,2811.47,0,1068360,0,0,0,0,0,0
20150105.1036,2811.47,0,1068360,0,0,0,0,0,0
20150105.103601,2811.47,0,1068360,0,0,0,0,0,0
20150105.103602,2811.47,0,1068360,0,0,0,0,0,0
20150105.103603,2811.47,0,1068360,0,0,0,0,0,0
20150105.103604,2811.47,0,1068360,0,0,0,0,0,0
20150105.103605,2811.47,0,1068360,0,0,0,0,0,0
20150105.103606,2811.47,0,1068360,0,0,0,0,0,0
20150105.103607,2811.47,0,1068360,0,0,0,0,0,0
20150105.103608,2811.47,0,1068360,0,0,0,0,0,0
20150105.103609,2811.47,0,1068360,0,0,0,0,0,0
20150105.10361,2811.47,0,1068360,0,0,0,0,0,0
20150105.103611,2811.47,0,1068360,0,0,0,0,0,0
20150105.103612,2811.47,0,1068360,0,0,0,0,0,0
20150105.103613,2811.47,0,1068360,0,0,0,0,0,0
20150105.103614,2811.47,0,1068360,0,0,0,0,0,0
20150105.103615,2811.47,0,1068360,0,0,0,0,0,0
20150105.103616,2811.47,0,1068360,0,0,0,0,0,0
20150105.103617,2811.47,0,1068360,0,0,0,0,0,0
20150105.103618,2811.47,0,1068360,0,0,0,0,0,0
20150105.103619,2811.47,0,1068360,0,0,0,0,0,0
20150105.10362,2811.47,0,1068360,0,0,0,0,0,0
20150105.103621,2811.47,0,1068360,0,0,0,0,0,0
20150105.103622,2811.47,0,1068360,0,0,0,0,0,0
20150105.103623,2811.47,0,1068360,0,0,0,0,0,0
20150105.103624,2811.47,0,1068360,0,0,0,0,0,0
20150105.103625,2811.47,0,1068360,0,0,0,0,0,0
20150105.103626,2811.47,0,1068360,0,0,0,0,0,0
20150105.103627,2811.47,0,1068360,0,0,0,0,0,0
20150105.103628,2811.47,0,1068360,0,0,0,0,0,0
20150105.103629,2811.47,0,1068360,0,0,0,0,0,0
20150105.10363,2811.47,0,1068360,0,0,0,0,0,0
20150105.103631,2811.47,0,1068360,0,0,0,0,0,0
20150105.103632,2811.47,0,1068360,0,0,0,0,0,0
20150105.103633,2811.47,0,1068360,0,0,0,0,0,0
20150105.103634,2811.47,0,1068360,0,0,0,0,0,0
20150105.103635,2811.47,0,1068360,0,0,0,0,0,0
20150105.103636,2811.47,0,1068360,0,0,0,0,0,0
20150105.103637,2811.47,0,1068360,0,0,0,0,0,0
20150105.103638,2811.47,0,1068360,0,0,0,0,0,0
20150105.103639,2811.47,0,1068360,0,0,0,0,0,0
20150105.10364,2811.47,0,1068360,0,0,0,0,0,0
20150105.103641,2811.47,0,1068360,0,0,0,0,0,0
20150105.103642,2811.47,0,1068360,0,0,0,0,0,0
20150105.103643,2811.47,0,1068360,0,0,0,0,0,0
20150105.103644,2811.47,0,1068360,0,0,0,0,0,0
20150105.103645,2811.47,0,1068360,0,0,0,0,0,0
20150105.103646,2811.47,0,1068360,0,0,0,0,0,0
20150105.103647,2811.47,0,1068360,0,0,0,0,0,0
20150105.103648,2811.47,0,1068360,0,0,0,0,0,0
20150105.103649,2811.47,0,1068360,0,0,0,0,0,0
20150105.10365,2811.47,0,1068360,0,0,0,0,0,0
20150105.103651,2811.47,0,1068360,0,0,0,0,0,0
20150105.103652,2811.47,0,1068360,0,0,0,0,0,0
20150105.103653,2811.47,0,1068360,0,0,0,0,0,0
20150105.103654,2811.47,0,1068360,0,0,0,0,0,0
20150105.103655,2811.47,0,1068360,0,0,0,0,0,0
20150105.103656,2811.47,0,1068360,0,0,0,0,0,0
20150105.103657,2811.47,0,1068360,0,0,0,0,0,0
20150105.103658,2811.47,0,1068360,0,0,0,0,0,0
20150105.103659,2811.47,0,1068360,0,0,0,0,0,0
20150105.1037,2811.47,0,1068360,0,0,0,0,0,0
20150105.103701,2811.47,0,1068360,0,0,0,0,0,0
20150105.103702,2811.47,0,1068360,0,0,0,0,0,0
20150105.103703,2811.47,0,1068360,0,0,0,0,0,0
20150105.103704,2811.47,0,1068360,0,0,0,0,0,0
20150105.103705,2811.47,0,1068360,0,0,0,0,0,0
20150105.103706,2811.47,0,1068360,0,0,0,0,0,0
20150105.103707,2811.47,0,1068360,0,0,0,0,0,0
20150105.103708,2811.47,0,1068360,0,0,0,0,0,0
20150105.103709,2811.47,0,1068360,0,0,0,0,0,0
20150105.10371,2811.47,0,1068360,0,0,0,0,0,0
20150105.103711,2811.47,0,1068360,0,0,0,0,0,0
20150105.103712,2811.47,0,1068360,0,0,0,0,0,0
20150105.103713,2811.47,0,1068360,0,0,0,0,0,0
20150105.103714,2811.47,0,1068360,0,0,0,0,0,0
20150105.103715,2811.47,0,1068360,0,0,0,0,0,0
20150105.103716,2811.47,0,1068360,0,0,0,0,0,0
20150105.103717,2811.47,0,1068360,0,0,0,0,0,0
20150105.103718,2811.47,0,1068360,0,0,0,0,0,0
20150105.103719,2811.47,0,1068360,0,0,0,0,0,0
20150105.10372,2811.47,0,1068360,0,0,0,0,0,0
20150105.103721,2811.47,0,1068360,0,0,0,0,0,0
20150105.103722,2811.47,0,1068360,0,0,0,0,0,0
20150105.103723,2811.47,0,1068360,0,0,0,0,0,0
20150105.103724,2811.47,0,1068360,0,0,0,0,0,0
20150105.103725,2811.47,0,1068360,0,0,0,0,0,0
20150105.103726,2811.47,0,1068360,0,0,0,0,0,0
20150105.103727,2811.47,0,1068360,0,0,0,0,0,0
20150105.103728,2811.47,0,1068360,0,0,0,0,0,0
20150105.103729,2811.47,0,1068360,0,0,0,0,0,0
20150105.10373,2811.47,0,1068360,0,0,0,0,0,0
20150105.103731,2811.47,0,1068360,0,0,0,0,0,0
20150105.103732,2811.47,0,1068360,0,0,0,0,0,0
20150105.103733,2811.47,0,1068360,0,0,0,0,0,0
20150105.103734,2811.47,0,1068360,0,0,0,0,0,0
20150105.103735,2811.47,0,1068360,0,0,0,0,0,0
20150105.103736,2811.47,0,1068360,0,0,0,0,0,0
20150105.103737,2811.47,0,1068360,0,0,0,0,0,0
20150105.103738,2811.47,0,1068360,0,0,0,0,0,0
20150105.103739,2811.47,0,1068360,0,0,0,0,0,0
20150105.10374,2811.47,0,1068360,0,0,0,0,0,0
20150105.103741,2811.47,0,1068360,0,0,0,0,0,0
20150105.103742,2811.47,0,1068360,0,0,0,0,0,0
20150105.103743,2811.47,0,1068360,0,0,0,0,0,0
20150105.103744,2811.47,0,1068360,0,0,0,0,0,0
20150105.103745,2811.47,0,1068360,0,0,0,0,0,0
20150105.103746,2811.47,0,1068360,0,0,0,0,0,0
20150105.103747,2811.47,0,1068360,0,0,0,0,0,0
20150105.103748,2811.47,0,1068360,0,0,0,0,0,0
20150105.103749,2811.47,0,1068360,0,0,0,0,0,0
20150105.10375,2811.47,0,1068360,0,0,0,0,0,0
20150105.103751,2811.47,0,1068360,0,0,0,0,0,0
20150105.103752,2811.47,0,1068360,0,0,0,0,0,0
20150105.103753,2811.47,0,1068360,0,0,0,0,0,0
20150105.103754,2811.47,0,1068360,0,0,0,0,0,0
20150105.103755,2811.47,0,1068360,0,0,0,0,0,0
20150105.103756,2811.47,0,1068360,0,0,0,0,0,0
20150105.103757,2811.47,0,1068360,0,0,0,0,0,0
20150105.103758,2811.47,0,1068360,0,0,0,0,0,0
20150105.103759,2811.47,0,1068360,0,0,0,0,0,0
20150105.1038,2811.47,0,1068360,0,0,0,0,0,0
20150105.103801,2811.47,0,1068360,0,0,0,0,0,0
20150105.103802,2811.47,0,1068360,0,0,0,0,0,0
20150105.103803,2811.47,0,1068360,0,0,0,0,0,0
20150105.103804,2811.47,0,1068360,0,0,0,0,0,0
20150105.103805,2811.47,0,1068360,0,0,0,0,0,0
20150105.103806,2811.47,0,1068360,0,0,0,0,0,0
20150105.103807,2811.47,0,1068360,0,0,0,0,0,0
20150105.103808,2811.47,0,1068360,0,0,0,0,0,0
20150105.103809,2811.47,0,1068360,0,0,0,0,0,0
20150105.10381,2811.47,0,1068360,0,0,0,0,0,0
20150105.103811,2811.47,0,1068360,0,0,0,0,0,0
20150105.103812,2811.47,0,1068360,0,0,0,0,0,0
20150105.103813,2811.47,0,1068360,0,0,0,0,0,0
20150105.103814,2811.47,0,1068360,0,0,0,0,0,0
20150105.103815,2811.47,0,1068360,0,0,0,0,0,0
20150105.103816,2811.47,0,1068360,0,0,0,0,0,0
20150105.103817,2811.47,0,1068360,0,0,0,0,0,0
20150105.103818,2811.47,0,1068360,0,0,0,0,0,0
20150105.103819,2811.47,0,1068360,0,0,0,0,0,0
20150105.10382,2811.47,0,1068360,0,0,0,0,0,0
20150105.103821,2811.47,0,1068360,0,0,0,0,0,0
20150105.103822,2811.47,0,1068360,0,0,0,0,0,0
20150105.103823,2811.47,0,1068360,0,0,0,0,0,0
20150105.103824,2811.47,0,1068360,0,0,0,0,0,0
20150105.103825,2811.47,0,1068360,0,0,0,0,0,0
20150105.103826,2811.47,0,1068360,0,0,0,0,0,0
20150105.103827,2811.47,0,1068360,0,0,0,0,0,0
20150105.103828,2811.47,0,1068360,0,0,0,0,0,0
20150105.103829,2811.47,0,1068360,0,0,0,0,0,0
20150105.10383,2811.47,0,1068360,0,0,0,0,0,0
20150105.103831,2811.47,0,1068360,0,0,0,0,0,0
20150105.103832,2811.47,0,1068360,0,0,0,0,0,0
20150105.103833,2811.47,0,1068360,0,0,0,0,0,0
20150105.103834,2811.47,0,1068360,0,0,0,0,0,0
20150105.103835,2811.47,0,1068360,0,0,0,0,0,0
20150105.103836,2811.47,0,1068360,0,0,0,0,0,0
20150105.103837,2811.47,0,1068360,0,0,0,0,0,0
20150105.103838,2811.47,0,1068360,0,0,0,0,0,0
20150105.103839,2811.47,0,1068360,0,0,0,0,0,0
20150105.10384,2811.47,0,1068360,0,0,0,0,0,0
20150105.103841,2811.47,0,1068360,0,0,0,0,0,0
20150105.103842,2811.47,0,1068360,0,0,0,0,0,0
20150105.103843,2811.47,0,1068360,0,0,0,0,0,0
20150105.103844,2811.47,0,1068360,0,0,0,0,0,0
20150105.103845,2811.47,0,1068360,0,0,0,0,0,0
20150105.103846,2811.47,0,1068360,0,0,0,0,0,0
20150105.103847,2811.47,0,1068360,0,0,0,0,0,0
20150105.103848,2811.47,0,1068360,0,0,0,0,0,0
20150105.103849,2811.47,0,1068360,0,0,0,0,0,0
20150105.10385,2811.47,0,1068360,0,0,0,0,0,0
20150105.103851,2811.47,0,1068360,0,0,0,0,0,0
20150105.103852,2811.47,0,1068360,0,0,0,0,0,0
20150105.103853,2811.47,0,1068360,0,0,0,0,0,0
20150105.103854,2811.47,0,1068360,0,0,0,0,0,0
20150105.103855,2811.47,0,1068360,0,0,0,0,0,0
20150105.103856,2811.47,0,1068360,0,0,0,0,0,0
20150105.103857,2811.47,0,1068360,0,0,0,0,0,0
20150105.103858,2811.47,0,1068360,0,0,0,0,0,0
20150105.103859,2811.47,0,1068360,0,0,0,0,0,0
20150105.1039,2811.47,0,1068360,0,0,0,0,0,0
20150105.103901,2811.47,0,1068360,0,0,0,0,0,0
20150105.103902,2811.47,0,1068360,0,0,0,0,0,0
20150105.103903,2811.47,0,1068360,0,0,0,0,0,0
20150105.103904,2811.47,0,1068360,0,0,0,0,0,0
20150105.103905,2811.47,0,1068360,0,0,0,0,0,0
20150105.103906,2811.47,0,1068360,0,0,0,0,0,0
20150105.103907,2811.47,0,1068360,0,0,0,0,0,0
20150105.103908,2811.47,0,1068360,0,0,0,0,0,0
20150105.103909,2811.47,0,1068360,0,0,0,0,0,0
20150105.10391,2811.47,0,1068360,0,0,0,0,0,0
20150105.103911,2811.47,0,1068360,0,0,0,0,0,0
20150105.103912,2811.47,0,1068360,0,0,0,0,0,0
20150105.103913,2811.47,0,1068360,0,0,0,0,0,0
20150105.103914,2811.47,0,1068360,0,0,0,0,0,0
20150105.103915,2811.47,0,1068360,0,0,0,0,0,0
20150105.103916,2811.47,0,1068360,0,0,0,0,0,0
20150105.103917,2811.47,0,1068360,0,0,0,0,0,0
20150105.103918,2811.47,0,1068360,0,0,0,0,0,0
20150105.103919,2811.47,0,1068360,0,0,0,0,0,0
20150105.10392,2811.47,0,1068360,0,0,0,0,0,0
20150105.103921,2811.47,0,1068360,0,0,0,0,0,0
20150105.103922,2811.47,0,1068360,0,0,0,0,0,0
20150105.103923,2811.47,0,1068360,0,0,0,0,0,0
20150105.103924,2811.47,0,1068360,0,0,0,0,0,0
20150105.103925,2811.47,0,1068360,0,0,0,0,0,0
20150105.103926,2811.47,0,1068360,0,0,0,0,0,0
20150105.103927,2811.47,0,1068360,0,0,0,0,0,0
20150105.103928,2811.47,0,1068360,0,0,0,0,0,0
20150105.103929,2811.47,0,1068360,0,0,0,0,0,0
20150105.10393,2811.47,0,1068360,0,0,0,0,0,0
20150105.103931,2811.47,0,1068360,0,0,0,0,0,0
20150105.103932,2811.47,0,1068360,0,0,0,0,0,0
20150105.103933,2811.47,0,1068360,0,0,0,0,0,0
20150105.103934,2811.47,0,1068360,0,0,0,0,0,0
20150105.103935,2811.47,0,1068360,0,0,0,0,0,0
20150105.103936,2811.47,0,1068360,0,0,0,0,0,0
20150105.103937,2811.47,0,1068360,0,0,0,0,0,0
20150105.103938,2811.47,0,1068360,0,0,0,0,0,0
20150105.103939,2811.47,0,1068360,0,0,0,0,0,0
20150105.10394,2811.47,0,1068360,0,0,0,0,0,0
20150105.103941,2811.47,0,1068360,0,0,0,0,0,0
20150105.103942,2811.47,0,1068360,0,0,0,0,0,0
20150105.103943,2811.47,0,1068360,0,0,0,0,0,0
20150105.103944,2811.47,0,1068360,0,0,0,0,0,0
20150105.103945,2811.47,0,1068360,0,0,0,0,0,0
20150105.103946,2811.47,0,1068360,0,0,0,0,0,0
20150105.103947,2811.47,0,1068360,0,0,0,0,0,0
20150105.103948,2811.47,0,1068360,0,0,0,0,0,0
20150105.103949,2811.47,0,1068360,0,0,0,0,0,0
20150105.10395,2811.47,0,1068360,0,0,0,0,0,0
20150105.103951,2811.47,0,1068360,0,0,0,0,0,0
20150105.103952,2811.47,0,1068360,0,0,0,0,0,0
20150105.103953,2811.47,0,1068360,0,0,0,0,0,0
20150105.103954,2811.47,0,1068360,0,0,0,0,0,0
20150105.103955,2811.47,0,1068360,0,0,0,0,0,0
20150105.103956,2811.47,0,1068360,0,0,0,0,0,0
20150105.103957,2811.47,0,1068360,0,0,0,0,0,0
20150105.103958,2811.47,0,1068360,0,0,0,0,0,0
20150105.103959,2811.47,0,1068360,0,0,0,0,0,0
20150105.104,2811.47,0,1068360,0,0,0,0,0,0
20150105.104001,2811.47,0,1068360,0,0,0,0,0,0
20150105.104002,2811.47,0,1068360,0,0,0,0,0,0
20150105.104003,2811.47,0,1068360,0,0,0,0,0,0
20150105.104004,2811.47,0,1068360,0,0,0,0,0,0
20150105.104005,2811.47,0,1068360,0,0,0,0,0,0
20150105.104006,2811.47,0,1068360,0,0,0,0,0,0
20150105.104007,2811.47,0,1068360,0,0,0,0,0,0
20150105.104008,2811.47,0,1068360,0,0,0,0,0,0
20150105.104009,2811.47,0,1068360,0,0,0,0,0,0
20150105.10401,2811.47,0,1068360,0,0,0,0,0,0
20150105.104011,2811.47,0,1068360,0,0,0,0,0,0
20150105.104012,2811.47,0,1068360,0,0,0,0,0,0
20150105.104013,2811.47,0,1068360,0,0,0,0,0,0
20150105.104014,2811.47,0,1068360,0,0,0,0,0,0
20150105.104015,2811.47,0,1068360,0,0,0,0,0,0
20150105.104016,2811.47,0,1068360,0,0,0,0,0,0
20150105.104017,2811.47,0,1068360,0,0,0,0,0,0
20150105.104018,2811.47,0,1068360,0,0,0,0,0,0
20150105.104019,2811.47,0,1068360,0,0,0,0,0,0
20150105.10402,2811.47,0,1068360,0,0,0,0,0,0
20150105.104021,2811.47,0,1068360,0,0,0,0,0,0
20150105.104022,2811.47,0,1068360,0,0,0,0,0,0
20150105.104023,2811.47,0,1068360,0,0,0,0,0,0
20150105.104024,2811.47,0,1068360,0,0,0,0,0,0
20150105.104025,2811.47,0,1068360,0,0,0,0,0,0
20150105.104026,2811.47,0,1068360,0,0,0,0,0,0
20150105.104027,2811.47,0,1068360,0,0,0,0,0,0
20150105.104028,2811.47,0,1068360,0,0,0,0,0,0
20150105.104029,2811.47,0,1068360,0,0,0,0,0,0
20150105.10403,2811.47,0,1068360,0,0,0,0,0,0
20150105.104031,2811.47,0,1068360,0,0,0,0,0,0
20150105.104032,2811.47,0,1068360,0,0,0,0,0,0
20150105.104033,2811.47,0,1068360,0,0,0,0,0,0
20150105.104034,2811.47,0,1068360,0,0,0,0,0,0
20150105.104035,2811.47,0,1068360,0,0,0,0,0,0
20150105.104036,2811.47,0,1068360,0,0,0,0,0,0
20150105.104037,2811.47,0,1068360,0,0,0,0,0,0
20150105.104038,2811.47,0,1068360,0,0,0,0,0,0
20150105.104039,2811.47,0,1068360,0,0,0,0,0,0
20150105.10404,2811.47,0,1068360,0,0,0,0,0,0
20150105.104041,2811.47,0,1068360,0,0,0,0,0,0
20150105.104042,2811.47,0,1068360,0,0,0,0,0,0
20150105.104043,2811.47,0,1068360,0,0,0,0,0,0
20150105.104044,2811.47,0,1068360,0,0,0,0,0,0
20150105.104045,2811.47,0,1068360,0,0,0,0,0,0
20150105.104046,2811.47,0,1068360,0,0,0,0,0,0
20150105.104047,2811.47,0,1068360,0,0,0,0,0,0
20150105.104048,2811.47,0,1068360,0,0,0,0,0,0
20150105.104049,2811.47,0,1068360,0,0,0,0,0,0
20150105.10405,2811.47,0,1068360,0,0,0,0,0,0
20150105.104051,2811.47,0,1068360,0,0,0,0,0,0
20150105.104052,2811.47,0,1068360,0,0,0,0,0,0
20150105.104053,2811.47,0,1068360,0,0,0,0,0,0
20150105.104054,2811.47,0,1068360,0,0,0,0,0,0
20150105.104055,2811.47,0,1068360,0,0,0,0,0,0
20150105.104056,2811.47,0,1068360,0,0,0,0,0,0
20150105.104057,2811.47,0,1068360,0,0,0,0,0,0
20150105.104058,2811.47,0,1068360,0,0,0,0,0,0
20150105.104059,2811.47,0,1068360,0,0,0,0,0,0
20150105.1041,2811.47,0,1068360,0,0,0,0,0,0
20150105.104101,2811.47,0,1068360,0,0,0,0,0,0
20150105.104102,2811.47,0,1068360,0,0,0,0,0,0
20150105.104103,2811.47,0,1068360,0,0,0,0,0,0
20150105.104104,2811.47,0,1068360,0,0,0,0,0,0
20150105.104105,2811.47,0,1068360,0,0,0,0,0,0
20150105.104106,2811.47,0,1068360,0,0,0,0,0,0
20150105.104107,2811.47,0,1068360,0,0,0,0,0,0
20150105.104108,2811.47,0,1068360,0,0,0,0,0,0
20150105.104109,2811.47,0,1068360,0,0,0,0,0,0
20150105.10411,2811.47,0,1068360,0,0,0,0,0,0
20150105.104111,2811.47,0,1068360,0,0,0,0,0,0
20150105.104112,2811.47,0,1068360,0,0,0,0,0,0
20150105.104113,2811.47,0,1068360,0,0,0,0,0,0
20150105.104114,2811.47,0,1068360,0,0,0,0,0,0
20150105.104115,2811.47,0,1068360,0,0,0,0,0,0
20150105.104116,2811.47,0,1068360,0,0,0,0,0,0
20150105.104117,2811.47,0,1068360,0,0,0,0,0,0
20150105.104118,2811.47,0,1068360,0,0,0,0,0,0
20150105.104119,2811.47,0,1068360,0,0,0,0,0,0
20150105.10412,2811.47,0,1068360,0,0,0,0,0,0
20150105.104121,2811.47,0,1068360,0,0,0,0,0,0
20150105.104122,2811.47,0,1068360,0,0,0,0,0,0
20150105.104123,2811.47,0,1068360,0,0,0,0,0,0
20150105.104124,2811.47,0,1068360,0,0,0,0,0,0
20150105.104125,2811.47,0,1068360,0,0,0,0,0,0
20150105.104126,2811.47,0,1068360,0,0,0,0,0,0
20150105.104127,2811.47,0,1068360,0,0,0,0,0,0
20150105.104128,2811.47,0,1068360,0,0,0,0,0,0
20150105.104129,2811.47,0,1068360,0,0,0,0,0,0
20150105.10413,2811.47,0,1068360,0,0,0,0,0,0
20150105.104131,2811.47,0,1068360,0,0,0,0,0,0
20150105.104132,2811.47,0,1068360,0,0,0,0,0,0
20150105.104133,2811.47,0,1068360,0,0,0,0,0,0
20150105.104134,2811.47,0,1068360,0,0,0,0,0,0
20150105.104135,2811.47,0,1068360,0,0,0,0,0,0
20150105.104136,2811.47,0,1068360,0,0,0,0,0,0
20150105.104137,2811.47,0,1068360,0,0,0,0,0,0
20150105.104138,2811.47,0,1068360,0,0,0,0,0,0
20150105.104139,2811.47,0,1068360,0,0,0,0,0,0
20150105.10414,2811.47,0,1068360,0,0,0,0,0,0
20150105.104141,2811.47,0,1068360,0,0,0,0,0,0
20150105.104142,2811.47,0,1068360,0,0,0,0,0,0
20150105.104143,2811.47,0,1068360,0,0,0,0,0,0
20150105.104144,2811.47,0,1068360,0,0,0,0,0,0
20150105.104145,2811.47,0,1068360,0,0,0,0,0,0
20150105.104146,2811.47,0,1068360,0,0,0,0,0,0
20150105.104147,2811.47,0,1068360,0,0,0,0,0,0
20150105.104148,2811.47,0,1068360,0,0,0,0,0,0
20150105.104149,2811.47,0,1068360,0,0,0,0,0,0
20150105.10415,2811.47,0,1068360,0,0,0,0,0,0
20150105.104151,2811.47,0,1068360,0,0,0,0,0,0
20150105.104152,2811.47,0,1068360,0,0,0,0,0,0
20150105.104153,2811.47,0,1068360,0,0,0,0,0,0
20150105.104154,2811.47,0,1068360,0,0,0,0,0,0
20150105.104155,2811.47,0,1068360,0,0,0,0,0,0
20150105.104156,2811.47,0,1068360,0,0,0,0,0,0
20150105.104157,2811.47,0,1068360,0,0,0,0,0,0
20150105.104158,2811.47,0,1068360,0,0,0,0,0,0
20150105.104159,2811.47,0,1068360,0,0,0,0,0,0
20150105.1042,2811.47,0,1068360,0,0,0,0,0,0
20150105.104201,2811.47,0,1068360,0,0,0,0,0,0
20150105.104202,2811.47,0,1068360,0,0,0,0,0,0
20150105.104203,2811.47,0,1068360,0,0,0,0,0,0
20150105.104204,2811.47,0,1068360,0,0,0,0,0,0
20150105.104205,2811.47,0,1068360,0,0,0,0,0,0
20150105.104206,2811.47,0,1068360,0,0,0,0,0,0
20150105.104207,2811.47,0,1068360,0,0,0,0,0,0
20150105.104208,2811.47,0,1068360,0,0,0,0,0,0
20150105.104209,2811.47,0,1068360,0,0,0,0,0,0
20150105.10421,2811.47,0,1068360,0,0,0,0,0,0
20150105.104211,2811.47,0,1068360,0,0,0,0,0,0
20150105.104212,2811.47,0,1068360,0,0,0,0,0,0
20150105.104213,2811.47,0,1068360,0,0,0,0,0,0
20150105.104214,2811.47,0,1068360,0,0,0,0,0,0
20150105.104215,2811.47,0,1068360,0,0,0,0,0,0
20150105.104216,2811.47,0,1068360,0,0,0,0,0,0
20150105.104217,2811.47,0,1068360,0,0,0,0,0,0
20150105.104218,2811.47,0,1068360,0,0,0,0,0,0
20150105.104219,2811.47,0,1068360,0,0,0,0,0,0
20150105.10422,2811.47,0,1068360,0,0,0,0,0,0
20150105.104221,2811.47,0,1068360,0,0,0,0,0,0
20150105.104222,2811.47,0,1068360,0,0,0,0,0,0
20150105.104223,2811.47,0,1068360,0,0,0,0,0,0
20150105.104224,2811.47,0,1068360,0,0,0,0,0,0
20150105.104225,2811.47,0,1068360,0,0,0,0,0,0
20150105.104226,2811.47,0,1068360,0,0,0,0,0,0
20150105.104227,2811.47,0,1068360,0,0,0,0,0,0
20150105.104228,2811.47,0,1068360,0,0,0,0,0,0
20150105.104229,2811.47,0,1068360,0,0,0,0,0,0
20150105.10423,2811.47,0,1068360,0,0,0,0,0,0
20150105.104231,2811.47,0,1068360,0,0,0,0,0,0
20150105.104232,2811.47,0,1068360,0,0,0,0,0,0
20150105.104233,2811.47,0,1068360,0,0,0,0,0,0
20150105.104234,2811.47,0,1068360,0,0,0,0,0,0
20150105.104235,2811.47,0,1068360,0,0,0,0,0,0
20150105.104236,2811.47,0,1068360,0,0,0,0,0,0
20150105.104237,2811.47,0,1068360,0,0,0,0,0,0
20150105.104238,2811.47,0,1068360,0,0,0,0,0,0
20150105.104239,2811.47,0,1068360,0,0,0,0,0,0
20150105.10424,2811.47,0,1068360,0,0,0,0,0,0
20150105.104241,2811.47,0,1068360,0,0,0,0,0,0
20150105.104242,2811.47,0,1068360,0,0,0,0,0,0
20150105.104243,2811.47,0,1068360,0,0,0,0,0,0
20150105.104244,2811.47,0,1068360,0,0,0,0,0,0
20150105.104245,2811.47,0,1068360,0,0,0,0,0,0
20150105.104246,2811.47,0,1068360,0,0,0,0,0,0
20150105.104247,2811.47,0,1068360,0,0,0,0,0,0
20150105.104248,2811.47,0,1068360,0,0,0,0,0,0
20150105.104249,2811.47,0,1068360,0,0,0,0,0,0
20150105.10425,2811.47,0,1068360,0,0,0,0,0,0
20150105.104251,2811.47,0,1068360,0,0,0,0,0,0
20150105.104252,2811.47,0,1068360,0,0,0,0,0,0
20150105.104253,2811.47,0,1068360,0,0,0,0,0,0
20150105.104254,2811.47,0,1068360,0,0,0,0,0,0
20150105.104255,2811.47,0,1068360,0,0,0,0,0,0
20150105.104256,2811.47,0,1068360,0,0,0,0,0,0
20150105.104257,2811.47,0,1068360,0,0,0,0,0,0
20150105.104258,2811.47,0,1068360,0,0,0,0,0,0
20150105.104259,2811.47,0,1068360,0,0,0,0,0,0
20150105.1043,2811.47,0,1068360,0,0,0,0,0,0
20150105.104301,2811.47,0,1068360,0,0,0,0,0,0
20150105.104302,2811.47,0,1068360,0,0,0,0,0,0
20150105.104303,2811.47,0,1068360,0,0,0,0,0,0
20150105.104304,2811.47,0,1068360,0,0,0,0,0,0
20150105.104305,2811.47,0,1068360,0,0,0,0,0,0
20150105.104306,2811.47,0,1068360,0,0,0,0,0,0
20150105.104307,2811.47,0,1068360,0,0,0,0,0,0
20150105.104308,2811.47,0,1068360,0,0,0,0,0,0
20150105.104309,2811.47,0,1068360,0,0,0,0,0,0
20150105.10431,2811.47,0,1068360,0,0,0,0,0,0
20150105.104311,2811.47,0,1068360,0,0,0,0,0,0
20150105.104312,2811.47,0,1068360,0,0,0,0,0,0
20150105.104313,2811.47,0,1068360,0,0,0,0,0,0
20150105.104314,2811.47,0,1068360,0,0,0,0,0,0
20150105.104315,2811.47,0,1068360,0,0,0,0,0,0
20150105.104316,2811.47,0,1068360,0,0,0,0,0,0
20150105.104317,2811.47,0,1068360,0,0,0,0,0,0
20150105.104318,2811.47,0,1068360,0,0,0,0,0,0
20150105.104319,2811.47,0,1068360,0,0,0,0,0,0
20150105.10432,2811.47,0,1068360,0,0,0,0,0,0
20150105.104321,2811.47,0,1068360,0,0,0,0,0,0
20150105.104322,2811.47,0,1068360,0,0,0,0,0,0
20150105.104323,2811.47,0,1068360,0,0,0,0,0,0
20150105.104324,2811.47,0,1068360,0,0,0,0,0,0
20150105.104325,2811.47,0,1068360,0,0,0,0,0,0
20150105.104326,2811.47,0,1068360,0,0,0,0,0,0
20150105.104327,2811.47,0,1068360,0,0,0,0,0,0
20150105.104328,2811.47,0,1068360,0,0,0,0,0,0
20150105.104329,2811.47,0,1068360,0,0,0,0,0,0
20150105.10433,2811.47,0,1068360,0,0,0,0,0,0
20150105.104331,2811.47,0,1068360,0,0,0,0,0,0
20150105.104332,2811.47,0,1068360,0,0,0,0,0,0
20150105.104333,2811.47,0,1068360,0,0,0,0,0,0
20150105.104334,2811.47,0,1068360,0,0,0,0,0,0
20150105.104335,2811.47,0,1068360,0,0,0,0,0,0
20150105.104336,2811.47,0,1068360,0,0,0,0,0,0
20150105.104337,2811.47,0,1068360,0,0,0,0,0,0
20150105.104338,2811.47,0,1068360,0,0,0,0,0,0
20150105.104339,2811.47,0,1068360,0,0,0,0,0,0
20150105.10434,2811.47,0,1068360,0,0,0,0,0,0
20150105.104341,2811.47,0,1068360,0,0,0,0,0,0
20150105.104342,2811.47,0,1068360,0,0,0,0,0,0
20150105.104343,2811.47,0,1068360,0,0,0,0,0,0
20150105.104344,2811.47,0,1068360,0,0,0,0,0,0
20150105.104345,2811.47,0,1068360,0,0,0,0,0,0
20150105.104346,2811.47,0,1068360,0,0,0,0,0,0
20150105.104347,2811.47,0,1068360,0,0,0,0,0,0
20150105.104348,2811.47,0,1068360,0,0,0,0,0,0
20150105.104349,2811.47,0,1068360,0,0,0,0,0,0
20150105.10435,2811.47,0,1068360,0,0,0,0,0,0
20150105.104351,2811.47,0,1068360,0,0,0,0,0,0
20150105.104352,2811.47,0,1068360,0,0,0,0,0,0
20150105.104353,2811.47,0,1068360,0,0,0,0,0,0
20150105.104354,2811.47,0,1068360,0,0,0,0,0,0
20150105.104355,2811.47,0,1068360,0,0,0,0,0,0
20150105.104356,2811.47,0,1068360,0,0,0,0,0,0
20150105.104357,2811.47,0,1068360,0,0,0,0,0,0
20150105.104358,2811.47,0,1068360,0,0,0,0,0,0
20150105.104359,2811.47,0,1068360,0,0,0,0,0,0
20150105.1044,2811.47,0,1068360,0,0,0,0,0,0
20150105.104401,2811.47,0,1068360,0,0,0,0,0,0
20150105.104402,2811.47,0,1068360,0,0,0,0,0,0
20150105.104403,2811.47,0,1068360,0,0,0,0,0,0
20150105.104404,2811.47,0,1068360,0,0,0,0,0,0
20150105.104405,2811.47,0,1068360,0,0,0,0,0,0
20150105.104406,2811.47,0,1068360,0,0,0,0,0,0
20150105.104407,2811.47,0,1068360,0,0,0,0,0,0
20150105.104408,2811.47,0,1068360,0,0,0,0,0,0
20150105.104409,2811.47,0,1068360,0,0,0,0,0,0
20150105.10441,2811.47,0,1068360,0,0,0,0,0,0
20150105.104411,2811.47,0,1068360,0,0,0,0,0,0
20150105.104412,2811.47,0,1068360,0,0,0,0,0,0
20150105.104413,2811.47,0,1068360,0,0,0,0,0,0
20150105.104414,2811.47,0,1068360,0,0,0,0,0,0
20150105.104415,2811.47,0,1068360,0,0,0,0,0,0
20150105.104416,2811.47,0,1068360,0,0,0,0,0,0
20150105.104417,2811.47,0,1068360,0,0,0,0,0,0
20150105.104418,2811.47,0,1068360,0,0,0,0,0,0
20150105.104419,2811.47,0,1068360,0,0,0,0,0,0
20150105.10442,2811.47,0,1068360,0,0,0,0,0,0
20150105.104421,2811.47,0,1068360,0,0,0,0,0,0
20150105.104422,2811.47,0,1068360,0,0,0,0,0,0
20150105.104423,2811.47,0,1068360,0,0,0,0,0,0
20150105.104424,2811.47,0,1068360,0,0,0,0,0,0
20150105.104425,2811.47,0,1068360,0,0,0,0,0,0
20150105.104426,2811.47,0,1068360,0,0,0,0,0,0
20150105.104427,2811.47,0,1068360,0,0,0,0,0,0
20150105.104428,2811.47,0,1068360,0,0,0,0,0,0
20150105.104429,2811.47,0,1068360,0,0,0,0,0,0
20150105.10443,2811.47,0,1068360,0,0,0,0,0,0
20150105.104431,2811.47,0,1068360,0,0,0,0,0,0
20150105.104432,2811.47,0,1068360,0,0,0,0,0,0
20150105.104433,2811.47,0,1068360,0,0,0,0,0,0
20150105.104434,2811.47,0,1068360,0,0,0,0,0,0
20150105.104435,2811.47,0,1068360,0,0,0,0,0,0
20150105.104436,2811.47,0,1068360,0,0,0,0,0,0
20150105.104437,2811.47,0,1068360,0,0,0,0,0,0
20150105.104438,2811.47,0,1068360,0,0,0,0,0,0
20150105.104439,2811.47,0,1068360,0,0,0,0,0,0
20150105.10444,2811.47,0,1068360,0,0,0,0,0,0
20150105.104441,2811.47,0,1068360,0,0,0,0,0,0
20150105.104442,2811.47,0,1068360,0,0,0,0,0,0
20150105.104443,2811.47,0,1068360,0,0,0,0,0,0
20150105.104444,2811.47,0,1068360,0,0,0,0,0,0
20150105.104445,2811.47,0,1068360,0,0,0,0,0,0
20150105.104446,2811.47,0,1068360,0,0,0,0,0,0
20150105.104447,2811.47,0,1068360,0,0,0,0,0,0
20150105.104448,2811.47,0,1068360,0,0,0,0,0,0
20150105.104449,2811.47,0,1068360,0,0,0,0,0,0
20150105.10445,2811.47,0,1068360,0,0,0,0,0,0
20150105.104451,2811.47,0,1068360,0,0,0,0,0,0
20150105.104452,2811.47,0,1068360,0,0,0,0,0,0
20150105.104453,2811.47,0,1068360,0,0,0,0,0,0
20150105.104454,2811.47,0,1068360,0,0,0,0,0,0
20150105.104455,2811.47,0,1068360,0,0,0,0,0,0
20150105.104456,2811.47,0,1068360,0,0,0,0,0,0
20150105.104457,2811.47,0,1068360,0,0,0,0,0,0
20150105.104458,2811.47,0,1068360,0,0,0,0,0,0
20150105.104459,2811.47,0,1068360,0,0,0,0,0,0
20150105.1045,2811.47,0,1068360,0,0,0,0,0,0
20150105.104501,2811.47,0,1068360,0,0,0,0,0,0
20150105.104502,2811.47,0,1068360,0,0,0,0,0,0
20150105.104503,2811.47,0,1068360,0,0,0,0,0,0
20150105.104504,2811.47,0,1068360,0,0,0,0,0,0
20150105.104505,2811.47,0,1068360,0,0,0,0,0,0
20150105.104506,2811.47,0,1068360,0,0,0,0,0,0
20150105.104507,2811.47,0,1068360,0,0,0,0,0,0
20150105.104508,2811.47,0,1068360,0,0,0,0,0,0
20150105.104509,2811.47,0,1068360,0,0,0,0,0,0
20150105.10451,2811.47,0,1068360,0,0,0,0,0,0
20150105.104511,2811.47,0,1068360,0,0,0,0,0,0
20150105.104512,2811.47,0,1068360,0,0,0,0,0,0
20150105.104513,2811.47,0,1068360,0,0,0,0,0,0
20150105.104514,2811.47,0,1068360,0,0,0,0,0,0
20150105.104515,2811.47,0,1068360,0,0,0,0,0,0
20150105.104516,2811.47,0,1068360,0,0,0,0,0,0
20150105.104517,2811.47,0,1068360,0,0,0,0,0,0
20150105.104518,2811.47,0,1068360,0,0,0,0,0,0
20150105.104519,2811.47,0,1068360,0,0,0,0,0,0
20150105.10452,2811.47,0,1068360,0,0,0,0,0,0
20150105.104521,2811.47,0,1068360,0,0,0,0,0,0
20150105.104522,2811.47,0,1068360,0,0,0,0,0,0
20150105.104523,2811.47,0,1068360,0,0,0,0,0,0
20150105.104524,2811.47,0,1068360,0,0,0,0,0,0
20150105.104525,2811.47,0,1068360,0,0,0,0,0,0
20150105.104526,2811.47,0,1068360,0,0,0,0,0,0
20150105.104527,2811.47,0,1068360,0,0,0,0,0,0
20150105.104528,2811.47,0,1068360,0,0,0,0,0,0
20150105.104529,2811.47,0,1068360,0,0,0,0,0,0
20150105.10453,2811.47,0,1068360,0,0,0,0,0,0
20150105.104531,2811.47,0,1068360,0,0,0,0,0,0
20150105.104532,2811.47,0,1068360,0,0,0,0,0,0
20150105.104533,2811.47,0,1068360,0,0,0,0,0,0
20150105.104534,2811.47,0,1068360,0,0,0,0,0,0
20150105.104535,2811.47,0,1068360,0,0,0,0,0,0
20150105.104536,2811.47,0,1068360,0,0,0,0,0,0
20150105.104537,2811.47,0,1068360,0,0,0,0,0,0
20150105.104538,2811.47,0,1068360,0,0,0,0,0,0
20150105.104539,2811.47,0,1068360,0,0,0,0,0,0
20150105.10454,2811.47,0,1068360,0,0,0,0,0,0
20150105.104541,2811.47,0,1068360,0,0,0,0,0,0
20150105.104542,2811.47,0,1068360,0,0,0,0,0,0
20150105.104543,2811.47,0,1068360,0,0,0,0,0,0
20150105.104544,2811.47,0,1068360,0,0,0,0,0,0
20150105.104545,2811.47,0,1068360,0,0,0,0,0,0
20150105.104546,2811.47,0,1068360,0,0,0,0,0,0
20150105.104547,2811.47,0,1068360,0,0,0,0,0,0
20150105.104548,2811.47,0,1068360,0,0,0,0,0,0
20150105.104549,2811.47,0,1068360,0,0,0,0,0,0
20150105.10455,2811.47,0,1068360,0,0,0,0,0,0
20150105.104551,2811.47,0,1068360,0,0,0,0,0,0
20150105.104552,2811.47,0,1068360,0,0,0,0,0,0
20150105.104553,2811.47,0,1068360,0,0,0,0,0,0
20150105.104554,2811.47,0,1068360,0,0,0,0,0,0
20150105.104555,2811.47,0,1068360,0,0,0,0,0,0
20150105.104556,2811.47,0,1068360,0,0,0,0,0,0
20150105.104557,2811.47,0,1068360,0,0,0,0,0,0
20150105.104558,2811.47,0,1068360,0,0,0,0,0,0
20150105.104559,2811.47,0,1068360,0,0,0,0,0,0
20150105.1046,2811.47,0,1068360,0,0,0,0,0,0
20150105.104601,2811.47,0,1068360,0,0,0,0,0,0
20150105.104602,2811.47,0,1068360,0,0,0,0,0,0
20150105.104603,2811.47,0,1068360,0,0,0,0,0,0
20150105.104604,2811.47,0,1068360,0,0,0,0,0,0
20150105.104605,2811.47,0,1068360,0,0,0,0,0,0
20150105.104606,2811.47,0,1068360,0,0,0,0,0,0
20150105.104607,2811.47,0,1068360,0,0,0,0,0,0
20150105.104608,2811.47,0,1068360,0,0,0,0,0,0
20150105.104609,2811.47,0,1068360,0,0,0,0,0,0
20150105.10461,2811.47,0,1068360,0,0,0,0,0,0
20150105.104611,2811.47,0,1068360,0,0,0,0,0,0
20150105.104612,2811.47,0,1068360,0,0,0,0,0,0
20150105.104613,2811.47,0,1068360,0,0,0,0,0,0
20150105.104614,2811.47,0,1068360,0,0,0,0,0,0
20150105.104615,2811.47,0,1068360,0,0,0,0,0,0
20150105.104616,2811.47,0,1068360,0,0,0,0,0,0
20150105.104617,2811.47,0,1068360,0,0,0,0,0,0
20150105.104618,2811.47,0,1068360,0,0,0,0,0,0
20150105.104619,2811.47,0,1068360,0,0,0,0,0,0
20150105.10462,2811.47,0,1068360,0,0,0,0,0,0
20150105.104621,2811.47,0,1068360,0,0,0,0,0,0
20150105.104622,2811.47,0,1068360,0,0,0,0,0,0
20150105.104623,2811.47,0,1068360,0,0,0,0,0,0
20150105.104624,2811.47,0,1068360,0,0,0,0,0,0
20150105.104625,2811.47,0,1068360,0,0,0,0,0,0
20150105.104626,2811.47,0,1068360,0,0,0,0,0,0
20150105.104627,2811.47,0,1068360,0,0,0,0,0,0
20150105.104628,2811.47,0,1068360,0,0,0,0,0,0
20150105.104629,2811.47,0,1068360,0,0,0,0,0,0
20150105.10463,2811.47,0,1068360,0,0,0,0,0,0
20150105.104631,2811.47,0,1068360,0,0,0,0,0,0
20150105.104632,2811.47,0,1068360,0,0,0,0,0,0
20150105.104633,2811.47,0,1068360,0,0,0,0,0,0
20150105.104634,2811.47,0,1068360,0,0,0,0,0,0
20150105.104635,2811.47,0,1068360,0,0,0,0,0,0
20150105.104636,2811.47,0,1068360,0,0,0,0,0,0
20150105.104637,2811.47,0,1068360,0,0,0,0,0,0
20150105.104638,2811.47,0,1068360,0,0,0,0,0,0
20150105.104639,2811.47,0,1068360,0,0,0,0,0,0
20150105.10464,2811.47,0,1068360,0,0,0,0,0,0
20150105.104641,2811.47,0,1068360,0,0,0,0,0,0
20150105.104642,2811.47,0,1068360,0,0,0,0,0,0
20150105.104643,2811.47,0,1068360,0,0,0,0,0,0
20150105.104644,2811.47,0,1068360,0,0,0,0,0,0
20150105.104645,2811.47,0,1068360,0,0,0,0,0,0
20150105.104646,2811.47,0,1068360,0,0,0,0,0,0
20150105.104647,2811.47,0,1068360,0,0,0,0,0,0
20150105.104648,2811.47,0,1068360,0,0,0,0,0,0
20150105.104649,2811.47,0,1068360,0,0,0,0,0,0
20150105.10465,2811.47,0,1068360,0,0,0,0,0,0
20150105.104651,2811.47,0,1068360,0,0,0,0,0,0
20150105.104652,2811.47,0,1068360,0,0,0,0,0,0
20150105.104653,2811.47,0,1068360,0,0,0,0,0,0
20150105.104654,2811.47,0,1068360,0,0,0,0,0,0
20150105.104655,2811.47,0,1068360,0,0,0,0,0,0
20150105.104656,2811.47,0,1068360,0,0,0,0,0,0
20150105.104657,2811.47,0,1068360,0,0,0,0,0,0
20150105.104658,2811.47,0,1068360,0,0,0,0,0,0
20150105.104659,2811.47,0,1068360,0,0,0,0,0,0
20150105.1047,2811.47,0,1068360,0,0,0,0,0,0
20150105.104701,2811.47,0,1068360,0,0,0,0,0,0
20150105.104702,2811.47,0,1068360,0,0,0,0,0,0
20150105.104703,2811.47,0,1068360,0,0,0,0,0,0
20150105.104704,2811.47,0,1068360,0,0,0,0,0,0
20150105.104705,2811.47,0,1068360,0,0,0,0,0,0
20150105.104706,2811.47,0,1068360,0,0,0,0,0,0
20150105.104707,2811.47,0,1068360,0,0,0,0,0,0
20150105.104708,2811.47,0,1068360,0,0,0,0,0,0
20150105.104709,2811.47,0,1068360,0,0,0,0,0,0
20150105.10471,2811.47,0,1068360,0,0,0,0,0,0
20150105.104711,2811.47,0,1068360,0,0,0,0,0,0
20150105.104712,2811.47,0,1068360,0,0,0,0,0,0
20150105.104713,2811.47,0,1068360,0,0,0,0,0,0
20150105.104714,2811.47,0,1068360,0,0,0,0,0,0
20150105.104715,2811.47,0,1068360,0,0,0,0,0,0
20150105.104716,2811.47,0,1068360,0,0,0,0,0,0
20150105.104717,2811.47,0,1068360,0,0,0,0,0,0
20150105.104718,2811.47,0,1068360,0,0,0,0,0,0
20150105.104719,2811.47,0,1068360,0,0,0,0,0,0
20150105.10472,2811.47,0,1068360,0,0,0,0,0,0
20150105.104721,2811.47,0,1068360,0,0,0,0,0,0
20150105.104722,2811.47,0,1068360,0,0,0,0,0,0
20150105.104723,2811.47,0,1068360,0,0,0,0,0,0
20150105.104724,2811.47,0,1068360,0,0,0,0,0,0
20150105.104725,2811.47,0,1068360,0,0,0,0,0,0
20150105.104726,2811.47,0,1068360,0,0,0,0,0,0
20150105.104727,2811.47,0,1068360,0,0,0,0,0,0
20150105.104728,2811.47,0,1068360,0,0,0,0,0,0
20150105.104729,2811.47,0,1068360,0,0,0,0,0,0
20150105.10473,2811.47,0,1068360,0,0,0,0,0,0
20150105.104731,2811.47,0,1068360,0,0,0,0,0,0
20150105.104732,2811.47,0,1068360,0,0,0,0,0,0
20150105.104733,2811.47,0,1068360,0,0,0,0,0,0
20150105.104734,2811.47,0,1068360,0,0,0,0,0,0
20150105.104735,2811.47,0,1068360,0,0,0,0,0,0
20150105.104736,2811.47,0,1068360,0,0,0,0,0,0
20150105.104737,2811.47,0,1068360,0,0,0,0,0,0
20150105.104738,2811.47,0,1068360,0,0,0,0,0,0
20150105.104739,2811.47,0,1068360,0,0,0,0,0,0
20150105.10474,2811.47,0,1068360,0,0,0,0,0,0
20150105.104741,2811.47,0,1068360,0,0,0,0,0,0
20150105.104742,2811.47,0,1068360,0,0,0,0,0,0
20150105.104743,2811.47,0,1068360,0,0,0,0,0,0
20150105.104744,2811.47,0,1068360,0,0,0,0,0,0
20150105.104745,2811.47,0,1068360,0,0,0,0,0,0
20150105.104746,2811.47,0,1068360,0,0,0,0,0,0
20150105.104747,2811.47,0,1068360,0,0,0,0,0,0
20150105.104748,2811.47,0,1068360,0,0,0,0,0,0
20150105.104749,2811.47,0,1068360,0,0,0,0,0,0
20150105.10475,2811.47,0,1068360,0,0,0,0,0,0
20150105.104751,2811.47,0,1068360,0,0,0,0,0,0
20150105.104752,2811.47,0,1068360,0,0,0,0,0,0
20150105.104753,2811.47,0,1068360,0,0,0,0,0,0
20150105.104754,2811.47,0,1068360,0,0,0,0,0,0
20150105.104755,2811.47,0,1068360,0,0,0,0,0,0
20150105.104756,2811.47,0,1068360,0,0,0,0,0,0
20150105.104757,2811.47,0,1068360,0,0,0,0,0,0
20150105.104758,2811.47,0,1068360,0,0,0,0,0,0
20150105.104759,2811.47,0,1068360,0,0,0,0,0,0
20150105.1048,2811.47,0,1068360,0,0,0,0,0,0
20150105.104801,2811.47,0,1068360,0,0,0,0,0,0
20150105.104802,2811.47,0,1068360,0,0,0,0,0,0
20150105.104803,2811.47,0,1068360,0,0,0,0,0,0
20150105.104804,2811.47,0,1068360,0,0,0,0,0,0
20150105.104805,2811.47,0,1068360,0,0,0,0,0,0
20150105.104806,2811.47,0,1068360,0,0,0,0,0,0
20150105.104807,2811.47,0,1068360,0,0,0,0,0,0
20150105.104808,2811.47,0,1068360,0,0,0,0,0,0
20150105.104809,2811.47,0,1068360,0,0,0,0,0,0
20150105.10481,2811.47,0,1068360,0,0,0,0,0,0
20150105.104811,2811.47,0,1068360,0,0,0,0,0,0
20150105.104812,2811.47,0,1068360,0,0,0,0,0,0
20150105.104813,2811.47,0,1068360,0,0,0,0,0,0
20150105.104814,2811.47,0,1068360,0,0,0,0,0,0
20150105.104815,2811.47,0,1068360,0,0,0,0,0,0
20150105.104816,2811.47,0,1068360,0,0,0,0,0,0
20150105.104817,2811.47,0,1068360,0,0,0,0,0,0
20150105.104818,2811.47,0,1068360,0,0,0,0,0,0
20150105.104819,2811.47,0,1068360,0,0,0,0,0,0
20150105.10482,2811.47,0,1068360,0,0,0,0,0,0
20150105.104821,2811.47,0,1068360,0,0,0,0,0,0
20150105.104822,2811.47,0,1068360,0,0,0,0,0,0
20150105.104823,2811.47,0,1068360,0,0,0,0,0,0
20150105.104824,2811.47,0,1068360,0,0,0,0,0,0
20150105.104825,2811.47,0,1068360,0,0,0,0,0,0
20150105.104826,2811.47,0,1068360,0,0,0,0,0,0
20150105.104827,2811.47,0,1068360,0,0,0,0,0,0
20150105.104828,2811.47,0,1068360,0,0,0,0,0,0
20150105.104829,2811.47,0,1068360,0,0,0,0,0,0
20150105.10483,2811.47,0,1068360,0,0,0,0,0,0
20150105.104831,2811.47,0,1068360,0,0,0,0,0,0
20150105.104832,2811.47,0,1068360,0,0,0,0,0,0
20150105.104833,2811.47,0,1068360,0,0,0,0,0,0
20150105.104834,2811.47,0,1068360,0,0,0,0,0,0
20150105.104835,2811.47,0,1068360,0,0,0,0,0,0
20150105.104836,2811.47,0,1068360,0,0,0,0,0,0
20150105.104837,2811.47,0,1068360,0,0,0,0,0,0
20150105.104838,2811.47,0,1068360,0,0,0,0,0,0
20150105.104839,2811.47,0,1068360,0,0,0,0,0,0
20150105.10484,2811.47,0,1068360,0,0,0,0,0,0
20150105.104841,2811.47,0,1068360,0,0,0,0,0,0
20150105.104842,2811.47,0,1068360,0,0,0,0,0,0
20150105.104843,2811.47,0,1068360,0,0,0,0,0,0
20150105.104844,2811.47,0,1068360,0,0,0,0,0,0
20150105.104845,2811.47,0,1068360,0,0,0,0,0,0
20150105.104846,2811.47,0,1068360,0,0,0,0,0,0
20150105.104847,2811.47,0,1068360,0,0,0,0,0,0
20150105.104848,2811.47,0,1068360,0,0,0,0,0,0
20150105.104849,2811.47,0,1068360,0,0,0,0,0,0
20150105.10485,2811.47,0,1068360,0,0,0,0,0,0
20150105.104851,2811.47,0,1068360,0,0,0,0,0,0
20150105.104852,2811.47,0,1068360,0,0,0,0,0,0
20150105.104853,2811.47,0,1068360,0,0,0,0,0,0
20150105.104854,2811.47,0,1068360,0,0,0,0,0,0
20150105.104855,2811.47,0,1068360,0,0,0,0,0,0
20150105.104856,2811.47,0,1068360,0,0,0,0,0,0
20150105.104857,2811.47,0,1068360,0,0,0,0,0,0
20150105.104858,2811.47,0,1068360,0,0,0,0,0,0
20150105.104859,2811.47,0,1068360,0,0,0,0,0,0
20150105.1049,2811.47,0,1068360,0,0,0,0,0,0
20150105.104901,2811.47,0,1068360,0,0,0,0,0,0
20150105.104902,2811.47,0,1068360,0,0,0,0,0,0
20150105.104903,2811.47,0,1068360,0,0,0,0,0,0
20150105.104904,2811.47,0,1068360,0,0,0,0,0,0
20150105.104905,2811.47,0,1068360,0,0,0,0,0,0
20150105.104906,2811.47,0,1068360,0,0,0,0,0,0
20150105.104907,2811.47,0,1068360,0,0,0,0,0,0
20150105.104908,2811.47,0,1068360,0,0,0,0,0,0
20150105.104909,2811.47,0,1068360,0,0,0,0,0,0
20150105.10491,2811.47,0,1068360,0,0,0,0,0,0
20150105.104911,2811.47,0,1068360,0,0,0,0,0,0
20150105.104912,2811.47,0,1068360,0,0,0,0,0,0
20150105.104913,2811.47,0,1068360,0,0,0,0,0,0
20150105.104914,2811.47,0,1068360,0,0,0,0,0,0
20150105.104915,2811.47,0,1068360,0,0,0,0,0,0
20150105.104916,2811.47,0,1068360,0,0,0,0,0,0
20150105.104917,2811.47,0,1068360,0,0,0,0,0,0
20150105.104918,2811.47,0,1068360,0,0,0,0,0,0
20150105.104919,2811.47,0,1068360,0,0,0,0,0,0
20150105.10492,2811.47,0,1068360,0,0,0,0,0,0
20150105.104921,2811.47,0,1068360,0,0,0,0,0,0
20150105.104922,2811.47,0,1068360,0,0,0,0,0,0
20150105.104923,2811.47,0,1068360,0,0,0,0,0,0
20150105.104924,2811.47,0,1068360,0,0,0,0,0,0
20150105.104925,2811.47,0,1068360,0,0,0,0,0,0
20150105.104926,2811.47,0,1068360,0,0,0,0,0,0
20150105.104927,2811.47,0,1068360,0,0,0,0,0,0
20150105.104928,2811.47,0,1068360,0,0,0,0,0,0
20150105.104929,2811.47,0,1068360,0,0,0,0,0,0
20150105.10493,2811.47,0,1068360,0,0,0,0,0,0
20150105.104931,2811.47,0,1068360,0,0,0,0,0,0
20150105.104932,2811.47,0,1068360,0,0,0,0,0,0
20150105.104933,2811.47,0,1068360,0,0,0,0,0,0
20150105.104934,2811.47,0,1068360,0,0,0,0,0,0
20150105.104935,2811.47,0,1068360,0,0,0,0,0,0
20150105.104936,2811.47,0,1068360,0,0,0,0,0,0
20150105.104937,2811.47,0,1068360,0,0,0,0,0,0
20150105.104938,2811.47,0,1068360,0,0,0,0,0,0
20150105.104939,2811.47,0,1068360,0,0,0,0,0,0
20150105.10494,2811.47,0,1068360,0,0,0,0,0,0
20150105.104941,2811.47,0,1068360,0,0,0,0,0,0
20150105.104942,2811.47,0,1068360,0,0,0,0,0,0
20150105.104943,2811.47,0,1068360,0,0,0,0,0,0
20150105.104944,2811.47,0,1068360,0,0,0,0,0,0
20150105.104945,2811.47,0,1068360,0,0,0,0,0,0
20150105.104946,2811.47,0,1068360,0,0,0,0,0,0
20150105.104947,2811.47,0,1068360,0,0,0,0,0,0
20150105.104948,2811.47,0,1068360,0,0,0,0,0,0
20150105.104949,2811.47,0,1068360,0,0,0,0,0,0
20150105.10495,2811.47,0,1068360,0,0,0,0,0,0
20150105.104951,2811.47,0,1068360,0,0,0,0,0,0
20150105.104952,2811.47,0,1068360,0,0,0,0,0,0
20150105.104953,2811.47,0,1068360,0,0,0,0,0,0
20150105.104954,2811.47,0,1068360,0,0,0,0,0,0
20150105.104955,2811.47,0,1068360,0,0,0,0,0,0
20150105.104956,2811.47,0,1068360,0,0,0,0,0,0
20150105.104957,2811.47,0,1068360,0,0,0,0,0,0
20150105.104958,2811.47,0,1068360,0,0,0,0,0,0
20150105.104959,2811.47,0,1068360,0,0,0,0,0,0
20150105.105,2811.47,0,1068360,0,0,0,0,0,0
20150105.105001,2811.47,0,1068360,0,0,0,0,0,0
20150105.105002,2811.47,0,1068360,0,0,0,0,0,0
20150105.105003,2811.47,0,1068360,0,0,0,0,0,0
20150105.105004,2811.47,0,1068360,0,0,0,0,0,0
20150105.105005,2811.47,0,1068360,0,0,0,0,0,0
20150105.105006,2811.47,0,1068360,0,0,0,0,0,0
20150105.105007,2811.47,0,1068360,0,0,0,0,0,0
20150105.105008,2811.47,0,1068360,0,0,0,0,0,0
20150105.105009,2811.47,0,1068360,0,0,0,0,0,0
20150105.10501,2811.47,0,1068360,0,0,0,0,0,0
20150105.105011,2811.47,0,1068360,0,0,0,0,0,0
20150105.105012,2811.47,0,1068360,0,0,0,0,0,0
20150105.105013,2811.47,0,1068360,0,0,0,0,0,0
20150105.105014,2811.47,0,1068360,0,0,0,0,0,0
20150105.105015,2811.47,0,1068360,0,0,0,0,0,0
20150105.105016,2811.47,0,1068360,0,0,0,0,0,0
20150105.105017,2811.47,0,1068360,0,0,0,0,0,0
20150105.105018,2811.47,0,1068360,0,0,0,0,0,0
20150105.105019,2811.47,0,1068360,0,0,0,0,0,0
20150105.10502,2811.47,0,1068360,0,0,0,0,0,0
20150105.105021,2811.47,0,1068360,0,0,0,0,0,0
20150105.105022,2811.47,0,1068360,0,0,0,0,0,0
20150105.105023,2811.47,0,1068360,0,0,0,0,0,0
20150105.105024,2811.47,0,1068360,0,0,0,0,0,0
20150105.105025,2811.47,0,1068360,0,0,0,0,0,0
20150105.105026,2811.47,0,1068360,0,0,0,0,0,0
20150105.105027,2811.47,0,1068360,0,0,0,0,0,0
20150105.105028,2811.47,0,1068360,0,0,0,0,0,0
20150105.105029,2811.47,0,1068360,0,0,0,0,0,0
20150105.10503,2811.47,0,1068360,0,0,0,0,0,0
20150105.105031,2811.47,0,1068360,0,0,0,0,0,0
20150105.105032,2811.47,0,1068360,0,0,0,0,0,0
20150105.105033,2811.47,0,1068360,0,0,0,0,0,0
20150105.105034,2811.47,0,1068360,0,0,0,0,0,0
20150105.105035,2811.47,0,1068360,0,0,0,0,0,0
20150105.105036,2811.47,0,1068360,0,0,0,0,0,0
20150105.105037,2811.47,0,1068360,0,0,0,0,0,0
20150105.105038,2811.47,0,1068360,0,0,0,0,0,0
20150105.105039,2811.47,0,1068360,0,0,0,0,0,0
20150105.10504,2811.47,0,1068360,0,0,0,0,0,0
20150105.105041,2811.47,0,1068360,0,0,0,0,0,0
20150105.105042,2811.47,0,1068360,0,0,0,0,0,0
20150105.105043,2811.47,0,1068360,0,0,0,0,0,0
20150105.105044,2811.47,0,1068360,0,0,0,0,0,0
20150105.105045,2811.47,0,1068360,0,0,0,0,0,0
20150105.105046,2811.47,0,1068360,0,0,0,0,0,0
20150105.105047,2811.47,0,1068360,0,0,0,0,0,0
20150105.105048,2811.47,0,1068360,0,0,0,0,0,0
20150105.105049,2811.47,0,1068360,0,0,0,0,0,0
20150105.10505,2811.47,0,1068360,0,0,0,0,0,0
20150105.105051,2811.47,0,1068360,0,0,0,0,0,0
20150105.105052,2811.47,0,1068360,0,0,0,0,0,0
20150105.105053,2811.47,0,1068360,0,0,0,0,0,0
20150105.105054,2811.47,0,1068360,0,0,0,0,0,0
20150105.105055,2811.47,0,1068360,0,0,0,0,0,0
20150105.105056,2811.47,0,1068360,0,0,0,0,0,0
20150105.105057,2811.47,0,1068360,0,0,0,0,0,0
20150105.105058,2811.47,0,1068360,0,0,0,0,0,0
20150105.105059,2811.47,0,1068360,0,0,0,0,0,0
20150105.1051,2811.47,0,1068360,0,0,0,0,0,0
20150105.105101,2811.47,0,1068360,0,0,0,0,0,0
20150105.105102,2811.47,0,1068360,0,0,0,0,0,0
20150105.105103,2811.47,0,1068360,0,0,0,0,0,0
20150105.105104,2811.47,0,1068360,0,0,0,0,0,0
20150105.105105,2811.47,0,1068360,0,0,0,0,0,0
20150105.105106,2811.47,0,1068360,0,0,0,0,0,0
20150105.105107,2811.47,0,1068360,0,0,0,0,0,0
20150105.105108,2811.47,0,1068360,0,0,0,0,0,0
20150105.105109,2811.47,0,1068360,0,0,0,0,0,0
20150105.10511,2811.47,0,1068360,0,0,0,0,0,0
20150105.105111,2811.47,0,1068360,0,0,0,0,0,0
20150105.105112,2811.47,0,1068360,0,0,0,0,0,0
20150105.105113,2811.47,0,1068360,0,0,0,0,0,0
20150105.105114,2811.47,0,1068360,0,0,0,0,0,0
20150105.105115,2811.47,0,1068360,0,0,0,0,0,0
20150105.105116,2811.47,0,1068360,0,0,0,0,0,0
20150105.105117,2811.47,0,1068360,0,0,0,0,0,0
20150105.105118,2811.47,0,1068360,0,0,0,0,0,0
20150105.105119,2811.47,0,1068360,0,0,0,0,0,0
20150105.10512,2811.47,0,1068360,0,0,0,0,0,0
20150105.105121,2811.47,0,1068360,0,0,0,0,0,0
20150105.105122,2811.47,0,1068360,0,0,0,0,0,0
20150105.105123,2811.47,0,1068360,0,0,0,0,0,0
20150105.105124,2811.47,0,1068360,0,0,0,0,0,0
20150105.105125,2811.47,0,1068360,0,0,0,0,0,0
20150105.105126,2811.47,0,1068360,0,0,0,0,0,0
20150105.105127,2811.47,0,1068360,0,0,0,0,0,0
20150105.105128,2811.47,0,1068360,0,0,0,0,0,0
20150105.105129,2811.47,0,1068360,0,0,0,0,0,0
20150105.10513,2811.47,0,1068360,0,0,0,0,0,0
20150105.105131,2811.47,0,1068360,0,0,0,0,0,0
20150105.105132,2811.47,0,1068360,0,0,0,0,0,0
20150105.105133,2811.47,0,1068360,0,0,0,0,0,0
20150105.105134,2811.47,0,1068360,0,0,0,0,0,0
20150105.105135,2811.47,0,1068360,0,0,0,0,0,0
20150105.105136,2811.47,0,1068360,0,0,0,0,0,0
20150105.105137,2811.47,0,1068360,0,0,0,0,0,0
20150105.105138,2811.47,0,1068360,0,0,0,0,0,0
20150105.105139,2811.47,0,1068360,0,0,0,0,0,0
20150105.10514,2811.47,0,1068360,0,0,0,0,0,0
20150105.105141,2811.47,0,1068360,0,0,0,0,0,0
20150105.105142,2811.47,0,1068360,0,0,0,0,0,0
20150105.105143,2811.47,0,1068360,0,0,0,0,0,0
20150105.105144,2811.47,0,1068360,0,0,0,0,0,0
20150105.105145,2811.47,0,1068360,0,0,0,0,0,0
20150105.105146,2811.47,0,1068360,0,0,0,0,0,0
20150105.105147,2811.47,0,1068360,0,0,0,0,0,0
20150105.105148,2811.47,0,1068360,0,0,0,0,0,0
20150105.105149,2811.47,0,1068360,0,0,0,0,0,0
20150105.10515,2811.47,0,1068360,0,0,0,0,0,0
20150105.105151,2811.47,0,1068360,0,0,0,0,0,0
20150105.105152,2811.47,0,1068360,0,0,0,0,0,0
20150105.105153,2811.47,0,1068360,0,0,0,0,0,0
20150105.105154,2811.47,0,1068360,0,0,0,0,0,0
20150105.105155,2811.47,0,1068360,0,0,0,0,0,0
20150105.105156,2811.47,0,1068360,0,0,0,0,0,0
20150105.105157,2811.47,0,1068360,0,0,0,0,0,0
20150105.105158,2811.47,0,1068360,0,0,0,0,0,0
20150105.105159,2811.47,0,1068360,0,0,0,0,0,0
20150105.1052,2811.47,0,1068360,0,0,0,0,0,0
20150105.105201,2811.47,0,1068360,0,0,0,0,0,0
20150105.105202,2811.47,0,1068360,0,0,0,0,0,0
20150105.105203,2811.47,0,1068360,0,0,0,0,0,0
20150105.105204,2811.47,0,1068360,0,0,0,0,0,0
20150105.105205,2811.47,0,1068360,0,0,0,0,0,0
20150105.105206,2811.47,0,1068360,0,0,0,0,0,0
20150105.105207,2811.47,0,1068360,0,0,0,0,0,0
20150105.105208,2811.47,0,1068360,0,0,0,0,0,0
20150105.105209,2811.47,0,1068360,0,0,0,0,0,0
20150105.10521,2811.47,0,1068360,0,0,0,0,0,0
20150105.105211,2811.47,0,1068360,0,0,0,0,0,0
20150105.105212,2811.47,0,1068360,0,0,0,0,0,0
20150105.105213,2811.47,0,1068360,0,0,0,0,0,0
20150105.105214,2811.47,0,1068360,0,0,0,0,0,0
20150105.105215,2811.47,0,1068360,0,0,0,0,0,0
20150105.105216,2811.47,0,1068360,0,0,0,0,0,0
20150105.105217,2811.47,0,1068360,0,0,0,0,0,0
20150105.105218,2811.47,0,1068360,0,0,0,0,0,0
20150105.105219,2811.47,0,1068360,0,0,0,0,0,0
20150105.10522,2811.47,0,1068360,0,0,0,0,0,0
20150105.105221,2811.47,0,1068360,0,0,0,0,0,0
20150105.105222,2811.47,0,1068360,0,0,0,0,0,0
20150105.105223,2811.47,0,1068360,0,0,0,0,0,0
20150105.105224,2811.47,0,1068360,0,0,0,0,0,0
20150105.105225,2811.47,0,1068360,0,0,0,0,0,0
20150105.105226,2811.47,0,1068360,0,0,0,0,0,0
20150105.105227,2811.47,0,1068360,0,0,0,0,0,0
20150105.105228,2811.47,0,1068360,0,0,0,0,0,0
20150105.105229,2811.47,0,1068360,0,0,0,0,0,0
20150105.10523,2811.47,0,1068360,0,0,0,0,0,0
20150105.105231,2811.47,0,1068360,0,0,0,0,0,0
20150105.105232,2811.47,0,1068360,0,0,0,0,0,0
20150105.105233,2811.47,0,1068360,0,0,0,0,0,0
20150105.105234,2811.47,0,1068360,0,0,0,0,0,0
20150105.105235,2811.47,0,1068360,0,0,0,0,0,0
20150105.105236,2811.47,0,1068360,0,0,0,0,0,0
20150105.105237,2811.47,0,1068360,0,0,0,0,0,0
20150105.105238,2811.47,0,1068360,0,0,0,0,0,0
20150105.105239,2811.47,0,1068360,0,0,0,0,0,0
20150105.10524,2811.47,0,1068360,0,0,0,0,0,0
20150105.105241,2811.47,0,1068360,0,0,0,0,0,0
20150105.105242,2811.47,0,1068360,0,0,0,0,0,0
20150105.105243,2811.47,0,1068360,0,0,0,0,0,0
20150105.105244,2811.47,0,1068360,0,0,0,0,0,0
20150105.105245,2811.47,0,1068360,0,0,0,0,0,0
20150105.105246,2811.47,0,1068360,0,0,0,0,0,0
20150105.105247,2811.47,0,1068360,0,0,0,0,0,0
20150105.105248,2811.47,0,1068360,0,0,0,0,0,0
20150105.105249,2811.47,0,1068360,0,0,0,0,0,0
20150105.10525,2811.47,0,1068360,0,0,0,0,0,0
20150105.105251,2811.47,0,1068360,0,0,0,0,0,0
20150105.105252,2811.47,0,1068360,0,0,0,0,0,0
20150105.105253,2811.47,0,1068360,0,0,0,0,0,0
20150105.105254,2811.47,0,1068360,0,0,0,0,0,0
20150105.105255,2811.47,0,1068360,0,0,0,0,0,0
20150105.105256,2811.47,0,1068360,0,0,0,0,0,0
20150105.105257,2811.47,0,1068360,0,0,0,0,0,0
20150105.105258,2811.47,0,1068360,0,0,0,0,0,0
20150105.105259,2811.47,0,1068360,0,0,0,0,0,0
20150105.1053,2811.47,0,1068360,0,0,0,0,0,0
20150105.105301,2811.47,0,1068360,0,0,0,0,0,0
20150105.105302,2811.47,0,1068360,0,0,0,0,0,0
20150105.105303,2811.47,0,1068360,0,0,0,0,0,0
20150105.105304,2811.47,0,1068360,0,0,0,0,0,0
20150105.105305,2811.47,0,1068360,0,0,0,0,0,0
20150105.105306,2811.47,0,1068360,0,0,0,0,0,0
20150105.105307,2811.47,0,1068360,0,0,0,0,0,0
20150105.105308,2811.47,0,1068360,0,0,0,0,0,0
20150105.105309,2811.47,0,1068360,0,0,0,0,0,0
20150105.10531,2811.47,0,1068360,0,0,0,0,0,0
20150105.105311,2811.47,0,1068360,0,0,0,0,0,0
20150105.105312,2811.47,0,1068360,0,0,0,0,0,0
20150105.105313,2811.47,0,1068360,0,0,0,0,0,0
20150105.105314,2811.47,0,1068360,0,0,0,0,0,0
20150105.105315,2811.47,0,1068360,0,0,0,0,0,0
20150105.105316,2811.47,0,1068360,0,0,0,0,0,0
20150105.105317,2811.47,0,1068360,0,0,0,0,0,0
20150105.105318,2811.47,0,1068360,0,0,0,0,0,0
20150105.105319,2811.47,0,1068360,0,0,0,0,0,0
20150105.10532,2811.47,0,1068360,0,0,0,0,0,0
20150105.105321,2811.47,0,1068360,0,0,0,0,0,0
20150105.105322,2811.47,0,1068360,0,0,0,0,0,0
20150105.105323,2811.47,0,1068360,0,0,0,0,0,0
20150105.105324,2811.47,0,1068360,0,0,0,0,0,0
20150105.105325,2811.47,0,1068360,0,0,0,0,0,0
20150105.105326,2811.47,0,1068360,0,0,0,0,0,0
20150105.105327,2811.47,0,1068360,0,0,0,0,0,0
20150105.105328,2811.47,0,1068360,0,0,0,0,0,0
20150105.105329,2811.47,0,1068360,0,0,0,0,0,0
20150105.10533,2811.47,0,1068360,0,0,0,0,0,0
20150105.105331,2811.47,0,1068360,0,0,0,0,0,0
20150105.105332,2811.47,0,1068360,0,0,0,0,0,0
20150105.105333,2811.47,0,1068360,0,0,0,0,0,0
20150105.105334,2811.47,0,1068360,0,0,0,0,0,0
20150105.105335,2811.47,0,1068360,0,0,0,0,0,0
20150105.105336,2811.47,0,1068360,0,0,0,0,0,0
20150105.105337,2811.47,0,1068360,0,0,0,0,0,0
20150105.105338,2811.47,0,1068360,0,0,0,0,0,0
20150105.105339,2811.47,0,1068360,0,0,0,0,0,0
20150105.10534,2811.47,0,1068360,0,0,0,0,0,0
20150105.105341,2811.47,0,1068360,0,0,0,0,0,0
20150105.105342,2811.47,0,1068360,0,0,0,0,0,0
20150105.105343,2811.47,0,1068360,0,0,0,0,0,0
20150105.105344,2811.47,0,1068360,0,0,0,0,0,0
20150105.105345,2811.47,0,1068360,0,0,0,0,0,0
20150105.105346,2811.47,0,1068360,0,0,0,0,0,0
20150105.105347,2811.47,0,1068360,0,0,0,0,0,0
20150105.105348,2811.47,0,1068360,0,0,0,0,0,0
20150105.105349,2811.47,0,1068360,0,0,0,0,0,0
20150105.10535,2811.47,0,1068360,0,0,0,0,0,0
20150105.105351,2811.47,0,1068360,0,0,0,0,0,0
20150105.105352,2811.47,0,1068360,0,0,0,0,0,0
20150105.105353,2811.47,0,1068360,0,0,0,0,0,0
20150105.105354,2811.47,0,1068360,0,0,0,0,0,0
20150105.105355,2811.47,0,1068360,0,0,0,0,0,0
20150105.105356,2811.47,0,1068360,0,0,0,0,0,0
20150105.105357,2811.47,0,1068360,0,0,0,0,0,0
20150105.105358,2811.47,0,1068360,0,0,0,0,0,0
20150105.105359,2811.47,0,1068360,0,0,0,0,0,0
20150105.1054,2811.47,0,1068360,0,0,0,0,0,0
20150105.105401,2811.47,0,1068360,0,0,0,0,0,0
20150105.105402,2811.47,0,1068360,0,0,0,0,0,0
20150105.105403,2811.47,0,1068360,0,0,0,0,0,0
20150105.105404,2811.47,0,1068360,0,0,0,0,0,0
20150105.105405,2811.47,0,1068360,0,0,0,0,0,0
20150105.105406,2811.47,0,1068360,0,0,0,0,0,0
20150105.105407,2811.47,0,1068360,0,0,0,0,0,0
20150105.105408,2811.47,0,1068360,0,0,0,0,0,0
20150105.105409,2811.47,0,1068360,0,0,0,0,0,0
20150105.10541,2811.47,0,1068360,0,0,0,0,0,0
20150105.105411,2811.47,0,1068360,0,0,0,0,0,0
20150105.105412,2811.47,0,1068360,0,0,0,0,0,0
20150105.105413,2811.47,0,1068360,0,0,0,0,0,0
20150105.105414,2811.47,0,1068360,0,0,0,0,0,0
20150105.105415,2811.47,0,1068360,0,0,0,0,0,0
20150105.105416,2811.47,0,1068360,0,0,0,0,0,0
20150105.105417,2811.47,0,1068360,0,0,0,0,0,0
20150105.105418,2811.47,0,1068360,0,0,0,0,0,0
20150105.105419,2811.47,0,1068360,0,0,0,0,0,0
20150105.10542,2811.47,0,1068360,0,0,0,0,0,0
20150105.105421,2811.47,0,1068360,0,0,0,0,0,0
20150105.105422,2811.47,0,1068360,0,0,0,0,0,0
20150105.105423,2811.47,0,1068360,0,0,0,0,0,0
20150105.105424,2811.47,0,1068360,0,0,0,0,0,0
20150105.105425,2811.47,0,1068360,0,0,0,0,0,0
20150105.105426,2811.47,0,1068360,0,0,0,0,0,0
20150105.105427,2811.47,0,1068360,0,0,0,0,0,0
20150105.105428,2811.47,0,1068360,0,0,0,0,0,0
20150105.105429,2811.47,0,1068360,0,0,0,0,0,0
20150105.10543,2811.47,0,1068360,0,0,0,0,0,0
20150105.105431,2811.47,0,1068360,0,0,0,0,0,0
20150105.105432,2811.47,0,1068360,0,0,0,0,0,0
20150105.105433,2811.47,0,1068360,0,0,0,0,0,0
20150105.105434,2811.47,0,1068360,0,0,0,0,0,0
20150105.105435,2811.47,0,1068360,0,0,0,0,0,0
20150105.105436,2811.47,0,1068360,0,0,0,0,0,0
20150105.105437,2811.47,0,1068360,0,0,0,0,0,0
20150105.105438,2811.47,0,1068360,0,0,0,0,0,0
20150105.105439,2811.47,0,1068360,0,0,0,0,0,0
20150105.10544,2811.47,0,1068360,0,0,0,0,0,0
20150105.105441,2811.47,0,1068360,0,0,0,0,0,0
20150105.105442,2811.47,0,1068360,0,0,0,0,0,0
20150105.105443,2811.47,0,1068360,0,0,0,0,0,0
20150105.105444,2811.47,0,1068360,0,0,0,0,0,0
20150105.105445,2811.47,0,1068360,0,0,0,0,0,0
20150105.105446,2811.47,0,1068360,0,0,0,0,0,0
20150105.105447,2811.47,0,1068360,0,0,0,0,0,0
20150105.105448,2811.47,0,1068360,0,0,0,0,0,0
20150105.105449,2811.47,0,1068360,0,0,0,0,0,0
20150105.10545,2811.47,0,1068360,0,0,0,0,0,0
20150105.105451,2811.47,0,1068360,0,0,0,0,0,0
20150105.105452,2811.47,0,1068360,0,0,0,0,0,0
20150105.105453,2811.47,0,1068360,0,0,0,0,0,0
20150105.105454,2811.47,0,1068360,0,0,0,0,0,0
20150105.105455,2811.47,0,1068360,0,0,0,0,0,0
20150105.105456,2811.47,0,1068360,0,0,0,0,0,0
20150105.105457,2811.47,0,1068360,0,0,0,0,0,0
20150105.105458,2811.47,0,1068360,0,0,0,0,0,0
20150105.105459,2811.47,0,1068360,0,0,0,0,0,0
20150105.1055,2811.47,0,1068360,0,0,0,0,0,0
20150105.105501,2811.47,0,1068360,0,0,0,0,0,0
20150105.105502,2811.47,0,1068360,0,0,0,0,0,0
20150105.105503,2811.47,0,1068360,0,0,0,0,0,0
20150105.105504,2811.47,0,1068360,0,0,0,0,0,0
20150105.105505,2811.47,0,1068360,0,0,0,0,0,0
20150105.105506,2811.47,0,1068360,0,0,0,0,0,0
20150105.105507,2811.47,0,1068360,0,0,0,0,0,0
20150105.105508,2811.47,0,1068360,0,0,0,0,0,0
20150105.105509,2811.47,0,1068360,0,0,0,0,0,0
20150105.10551,2811.47,0,1068360,0,0,0,0,0,0
20150105.105511,2811.47,0,1068360,0,0,0,0,0,0
20150105.105512,2811.47,0,1068360,0,0,0,0,0,0
20150105.105513,2811.47,0,1068360,0,0,0,0,0,0
20150105.105514,2811.47,0,1068360,0,0,0,0,0,0
20150105.105515,2811.47,0,1068360,0,0,0,0,0,0
20150105.105516,2811.47,0,1068360,0,0,0,0,0,0
20150105.105517,2811.47,0,1068360,0,0,0,0,0,0
20150105.105518,2811.47,0,1068360,0,0,0,0,0,0
20150105.105519,2811.47,0,1068360,0,0,0,0,0,0
20150105.10552,2811.47,0,1068360,0,0,0,0,0,0
20150105.105521,2811.47,0,1068360,0,0,0,0,0,0
20150105.105522,2811.47,0,1068360,0,0,0,0,0,0
20150105.105523,2811.47,0,1068360,0,0,0,0,0,0
20150105.105524,2811.47,0,1068360,0,0,0,0,0,0
20150105.105525,2811.47,0,1068360,0,0,0,0,0,0
20150105.105526,2811.47,0,1068360,0,0,0,0,0,0
20150105.105527,2811.47,0,1068360,0,0,0,0,0,0
20150105.105528,2811.47,0,1068360,0,0,0,0,0,0
20150105.105529,2811.47,0,1068360,0,0,0,0,0,0
20150105.10553,2811.47,0,1068360,0,0,0,0,0,0
20150105.105531,2811.47,0,1068360,0,0,0,0,0,0
20150105.105532,2811.47,0,1068360,0,0,0,0,0,0
20150105.105533,2811.47,0,1068360,0,0,0,0,0,0
20150105.105534,2811.47,0,1068360,0,0,0,0,0,0
20150105.105535,2811.47,0,1068360,0,0,0,0,0,0
20150105.105536,2811.47,0,1068360,0,0,0,0,0,0
20150105.105537,2811.47,0,1068360,0,0,0,0,0,0
20150105.105538,2811.47,0,1068360,0,0,0,0,0,0
20150105.105539,2811.47,0,1068360,0,0,0,0,0,0
20150105.10554,2811.47,0,1068360,0,0,0,0,0,0
20150105.105541,2811.47,0,1068360,0,0,0,0,0,0
20150105.105542,2811.47,0,1068360,0,0,0,0,0,0
20150105.105543,2811.47,0,1068360,0,0,0,0,0,0
20150105.105544,2811.47,0,1068360,0,0,0,0,0,0
20150105.105545,2811.47,0,1068360,0,0,0,0,0,0
20150105.105546,2811.47,0,1068360,0,0,0,0,0,0
20150105.105547,2811.47,0,1068360,0,0,0,0,0,0
20150105.105548,2811.47,0,1068360,0,0,0,0,0,0
20150105.105549,2811.47,0,1068360,0,0,0,0,0,0
20150105.10555,2811.47,0,1068360,0,0,0,0,0,0
20150105.105551,2811.47,0,1068360,0,0,0,0,0,0
20150105.105552,2811.47,0,1068360,0,0,0,0,0,0
20150105.105553,2811.47,0,1068360,0,0,0,0,0,0
20150105.105554,2811.47,0,1068360,0,0,0,0,0,0
20150105.105555,2811.47,0,1068360,0,0,0,0,0,0
20150105.105556,2811.47,0,1068360,0,0,0,0,0,0
20150105.105557,2811.47,0,1068360,0,0,0,0,0,0
20150105.105558,2811.47,0,1068360,0,0,0,0,0,0
20150105.105559,2811.47,0,1068360,0,0,0,0,0,0
20150105.1056,2811.47,0,1068360,0,0,0,0,0,0
20150105.105601,2811.47,0,1068360,0,0,0,0,0,0
20150105.105602,2811.47,0,1068360,0,0,0,0,0,0
20150105.105603,2811.47,0,1068360,0,0,0,0,0,0
20150105.105604,2811.47,0,1068360,0,0,0,0,0,0
20150105.105605,2811.47,0,1068360,0,0,0,0,0,0
20150105.105606,2811.47,0,1068360,0,0,0,0,0,0
20150105.105607,2811.47,0,1068360,0,0,0,0,0,0
20150105.105608,2811.47,0,1068360,0,0,0,0,0,0
20150105.105609,2811.47,0,1068360,0,0,0,0,0,0
20150105.10561,2811.47,0,1068360,0,0,0,0,0,0
20150105.105611,2811.47,0,1068360,0,0,0,0,0,0
20150105.105612,2811.47,0,1068360,0,0,0,0,0,0
20150105.105613,2811.47,0,1068360,0,0,0,0,0,0
20150105.105614,2811.47,0,1068360,0,0,0,0,0,0
20150105.105615,2811.47,0,1068360,0,0,0,0,0,0
20150105.105616,2811.47,0,1068360,0,0,0,0,0,0
20150105.105617,2811.47,0,1068360,0,0,0,0,0,0
20150105.105618,2811.47,0,1068360,0,0,0,0,0,0
20150105.105619,2811.47,0,1068360,0,0,0,0,0,0
20150105.10562,2811.47,0,1068360,0,0,0,0,0,0
20150105.105621,2811.47,0,1068360,0,0,0,0,0,0
20150105.105622,2811.47,0,1068360,0,0,0,0,0,0
20150105.105623,2811.47,0,1068360,0,0,0,0,0,0
20150105.105624,2811.47,0,1068360,0,0,0,0,0,0
20150105.105625,2811.47,0,1068360,0,0,0,0,0,0
20150105.105626,2811.47,0,1068360,0,0,0,0,0,0
20150105.105627,2811.47,0,1068360,0,0,0,0,0,0
20150105.105628,2811.47,0,1068360,0,0,0,0,0,0
20150105.105629,2811.47,0,1068360,0,0,0,0,0,0
20150105.10563,2811.47,0,1068360,0,0,0,0,0,0
20150105.105631,2811.47,0,1068360,0,0,0,0,0,0
20150105.105632,2811.47,0,1068360,0,0,0,0,0,0
20150105.105633,2811.47,0,1068360,0,0,0,0,0,0
20150105.105634,2811.47,0,1068360,0,0,0,0,0,0
20150105.105635,2811.47,0,1068360,0,0,0,0,0,0
20150105.105636,2811.47,0,1068360,0,0,0,0,0,0
20150105.105637,2811.47,0,1068360,0,0,0,0,0,0
20150105.105638,2811.47,0,1068360,0,0,0,0,0,0
20150105.105639,2811.47,0,1068360,0,0,0,0,0,0
20150105.10564,2811.47,0,1068360,0,0,0,0,0,0
20150105.105641,2811.47,0,1068360,0,0,0,0,0,0
20150105.105642,2811.47,0,1068360,0,0,0,0,0,0
20150105.105643,2811.47,0,1068360,0,0,0,0,0,0
20150105.105644,2811.47,0,1068360,0,0,0,0,0,0
20150105.105645,2811.47,0,1068360,0,0,0,0,0,0
20150105.105646,2811.47,0,1068360,0,0,0,0,0,0
20150105.105647,2811.47,0,1068360,0,0,0,0,0,0
20150105.105648,2811.47,0,1068360,0,0,0,0,0,0
20150105.105649,2811.47,0,1068360,0,0,0,0,0,0
20150105.10565,2811.47,0,1068360,0,0,0,0,0,0
20150105.105651,2811.47,0,1068360,0,0,0,0,0,0
20150105.105652,2811.47,0,1068360,0,0,0,0,0,0
20150105.105653,2811.47,0,1068360,0,0,0,0,0,0
20150105.105654,2811.47,0,1068360,0,0,0,0,0,0
20150105.105655,2811.47,0,1068360,0,0,0,0,0,0
20150105.105656,2811.47,0,1068360,0,0,0,0,0,0
20150105.105657,2811.47,0,1068360,0,0,0,0,0,0
20150105.105658,2811.47,0,1068360,0,0,0,0,0,0
20150105.105659,2811.47,0,1068360,0,0,0,0,0,0
20150105.1057,2811.47,0,1068360,0,0,0,0,0,0
20150105.105701,2811.47,0,1068360,0,0,0,0,0,0
20150105.105702,2811.47,0,1068360,0,0,0,0,0,0
20150105.105703,2811.47,0,1068360,0,0,0,0,0,0
20150105.105704,2811.47,0,1068360,0,0,0,0,0,0
20150105.105705,2811.47,0,1068360,0,0,0,0,0,0
20150105.105706,2811.47,0,1068360,0,0,0,0,0,0
20150105.105707,2811.47,0,1068360,0,0,0,0,0,0
20150105.105708,2811.47,0,1068360,0,0,0,0,0,0
20150105.105709,2811.47,0,1068360,0,0,0,0,0,0
20150105.10571,2811.47,0,1068360,0,0,0,0,0,0
20150105.105711,2811.47,0,1068360,0,0,0,0,0,0
20150105.105712,2811.47,0,1068360,0,0,0,0,0,0
20150105.105713,2811.47,0,1068360,0,0,0,0,0,0
20150105.105714,2811.47,0,1068360,0,0,0,0,0,0
20150105.105715,2811.47,0,1068360,0,0,0,0,0,0
20150105.105716,2811.47,0,1068360,0,0,0,0,0,0
20150105.105717,2811.47,0,1068360,0,0,0,0,0,0
20150105.105718,2811.47,0,1068360,0,0,0,0,0,0
20150105.105719,2811.47,0,1068360,0,0,0,0,0,0
20150105.10572,2811.47,0,1068360,0,0,0,0,0,0
20150105.105721,2811.47,0,1068360,0,0,0,0,0,0
20150105.105722,2811.47,0,1068360,0,0,0,0,0,0
20150105.105723,2811.47,0,1068360,0,0,0,0,0,0
20150105.105724,2811.47,0,1068360,0,0,0,0,0,0
20150105.105725,2811.47,0,1068360,0,0,0,0,0,0
20150105.105726,2811.47,0,1068360,0,0,0,0,0,0
20150105.105727,2811.47,0,1068360,0,0,0,0,0,0
20150105.105728,2811.47,0,1068360,0,0,0,0,0,0
20150105.105729,2811.47,0,1068360,0,0,0,0,0,0
20150105.10573,2811.47,0,1068360,0,0,0,0,0,0
20150105.105731,2811.47,0,1068360,0,0,0,0,0,0
20150105.105732,2811.47,0,1068360,0,0,0,0,0,0
20150105.105733,2811.47,0,1068360,0,0,0,0,0,0
20150105.105734,2811.47,0,1068360,0,0,0,0,0,0
20150105.105735,2811.47,0,1068360,0,0,0,0,0,0
20150105.105736,2811.47,0,1068360,0,0,0,0,0,0
20150105.105737,2811.47,0,1068360,0,0,0,0,0,0
20150105.105738,2811.47,0,1068360,0,0,0,0,0,0
20150105.105739,2811.47,0,1068360,0,0,0,0,0,0
20150105.10574,2811.47,0,1068360,0,0,0,0,0,0
20150105.105741,2811.47,0,1068360,0,0,0,0,0,0
20150105.105742,2811.47,0,1068360,0,0,0,0,0,0
20150105.105743,2811.47,0,1068360,0,0,0,0,0,0
20150105.105744,2811.47,0,1068360,0,0,0,0,0,0
20150105.105745,2811.47,0,1068360,0,0,0,0,0,0
20150105.105746,2811.47,0,1068360,0,0,0,0,0,0
20150105.105747,2811.47,0,1068360,0,0,0,0,0,0
20150105.105748,2811.47,0,1068360,0,0,0,0,0,0
20150105.105749,2811.47,0,1068360,0,0,0,0,0,0
20150105.10575,2811.47,0,1068360,0,0,0,0,0,0
20150105.105751,2811.47,0,1068360,0,0,0,0,0,0
20150105.105752,2811.47,0,1068360,0,0,0,0,0,0
20150105.105753,2811.47,0,1068360,0,0,0,0,0,0
20150105.105754,2811.47,0,1068360,0,0,0,0,0,0
20150105.105755,2811.47,0,1068360,0,0,0,0,0,0
20150105.105756,2811.47,0,1068360,0,0,0,0,0,0
20150105.105757,2811.47,0,1068360,0,0,0,0,0,0
20150105.105758,2811.47,0,1068360,0,0,0,0,0,0
20150105.105759,2811.47,0,1068360,0,0,0,0,0,0
20150105.1058,2811.47,0,1068360,0,0,0,0,0,0
20150105.105801,2811.47,0,1068360,0,0,0,0,0,0
20150105.105802,2811.47,0,1068360,0,0,0,0,0,0
20150105.105803,2811.47,0,1068360,0,0,0,0,0,0
20150105.105804,2811.47,0,1068360,0,0,0,0,0,0
20150105.105805,2811.47,0,1068360,0,0,0,0,0,0
20150105.105806,2811.47,0,1068360,0,0,0,0,0,0
20150105.105807,2811.47,0,1068360,0,0,0,0,0,0
20150105.105808,2811.47,0,1068360,0,0,0,0,0,0
20150105.105809,2811.47,0,1068360,0,0,0,0,0,0
20150105.10581,2811.47,0,1068360,0,0,0,0,0,0
20150105.105811,2811.47,0,1068360,0,0,0,0,0,0
20150105.105812,2811.47,0,1068360,0,0,0,0,0,0
20150105.105813,2811.47,0,1068360,0,0,0,0,0,0
20150105.105814,2811.47,0,1068360,0,0,0,0,0,0
20150105.105815,2811.47,0,1068360,0,0,0,0,0,0
20150105.105816,2811.47,0,1068360,0,0,0,0,0,0
20150105.105817,2811.47,0,1068360,0,0,0,0,0,0
20150105.105818,2811.47,0,1068360,0,0,0,0,0,0
20150105.105819,2811.47,0,1068360,0,0,0,0,0,0
20150105.10582,2811.47,0,1068360,0,0,0,0,0,0
20150105.105821,2811.47,0,1068360,0,0,0,0,0,0
20150105.105822,2811.47,0,1068360,0,0,0,0,0,0
20150105.105823,2811.47,0,1068360,0,0,0,0,0,0
20150105.105824,2811.47,0,1068360,0,0,0,0,0,0
20150105.105825,2811.47,0,1068360,0,0,0,0,0,0
20150105.105826,2811.47,0,1068360,0,0,0,0,0,0
20150105.105827,2811.47,0,1068360,0,0,0,0,0,0
20150105.105828,2811.47,0,1068360,0,0,0,0,0,0
20150105.105829,2811.47,0,1068360,0,0,0,0,0,0
20150105.10583,2811.47,0,1068360,0,0,0,0,0,0
20150105.105831,2811.47,0,1068360,0,0,0,0,0,0
20150105.105832,2811.47,0,1068360,0,0,0,0,0,0
20150105.105833,2811.47,0,1068360,0,0,0,0,0,0
20150105.105834,2811.47,0,1068360,0,0,0,0,0,0
20150105.105835,2811.47,0,1068360,0,0,0,0,0,0
20150105.105836,2811.47,0,1068360,0,0,0,0,0,0
20150105.105837,2811.47,0,1068360,0,0,0,0,0,0
20150105.105838,2811.47,0,1068360,0,0,0,0,0,0
20150105.105839,2811.47,0,1068360,0,0,0,0,0,0
20150105.10584,2811.47,0,1068360,0,0,0,0,0,0
20150105.105841,2811.47,0,1068360,0,0,0,0,0,0
20150105.105842,2811.47,0,1068360,0,0,0,0,0,0
20150105.105843,2811.47,0,1068360,0,0,0,0,0,0
20150105.105844,2811.47,0,1068360,0,0,0,0,0,0
20150105.105845,2811.47,0,1068360,0,0,0,0,0,0
20150105.105846,2811.47,0,1068360,0,0,0,0,0,0
20150105.105847,2811.47,0,1068360,0,0,0,0,0,0
20150105.105848,2811.47,0,1068360,0,0,0,0,0,0
20150105.105849,2811.47,0,1068360,0,0,0,0,0,0
20150105.10585,2811.47,0,1068360,0,0,0,0,0,0
20150105.105851,2811.47,0,1068360,0,0,0,0,0,0
20150105.105852,2811.47,0,1068360,0,0,0,0,0,0
20150105.105853,2811.47,0,1068360,0,0,0,0,0,0
20150105.105854,2811.47,0,1068360,0,0,0,0,0,0
20150105.105855,2811.47,0,1068360,0,0,0,0,0,0
20150105.105856,2811.47,0,1068360,0,0,0,0,0,0
20150105.105857,2811.47,0,1068360,0,0,0,0,0,0
20150105.105858,2811.47,0,1068360,0,0,0,0,0,0
20150105.105859,2811.47,0,1068360,0,0,0,0,0,0
20150105.1059,2811.47,0,1068360,0,0,0,0,0,0
20150105.105901,2811.47,0,1068360,0,0,0,0,0,0
20150105.105902,2811.47,0,1068360,0,0,0,0,0,0
20150105.105903,2811.47,0,1068360,0,0,0,0,0,0
20150105.105904,2811.47,0,1068360,0,0,0,0,0,0
20150105.105905,2811.47,0,1068360,0,0,0,0,0,0
20150105.105906,2811.47,0,1068360,0,0,0,0,0,0
20150105.105907,2811.47,0,1068360,0,0,0,0,0,0
20150105.105908,2811.47,0,1068360,0,0,0,0,0,0
20150105.105909,2811.47,0,1068360,0,0,0,0,0,0
20150105.10591,2811.47,0,1068360,0,0,0,0,0,0
20150105.105911,2811.47,0,1068360,0,0,0,0,0,0
20150105.105912,2811.47,0,1068360,0,0,0,0,0,0
20150105.105913,2811.47,0,1068360,0,0,0,0,0,0
20150105.105914,2811.47,0,1068360,0,0,0,0,0,0
20150105.105915,2811.47,0,1068360,0,0,0,0,0,0
20150105.105916,2811.47,0,1068360,0,0,0,0,0,0
20150105.105917,2811.47,0,1068360,0,0,0,0,0,0
20150105.105918,2811.47,0,1068360,0,0,0,0,0,0
20150105.105919,2811.47,0,1068360,0,0,0,0,0,0
20150105.10592,2811.47,0,1068360,0,0,0,0,0,0
20150105.105921,2811.47,0,1068360,0,0,0,0,0,0
20150105.105922,2811.47,0,1068360,0,0,0,0,0,0
20150105.105923,2811.47,0,1068360,0,0,0,0,0,0
20150105.105924,2811.47,0,1068360,0,0,0,0,0,0
20150105.105925,2811.47,0,1068360,0,0,0,0,0,0
20150105.105926,2811.47,0,1068360,0,0,0,0,0,0
20150105.105927,2811.47,0,1068360,0,0,0,0,0,0
20150105.105928,2811.47,0,1068360,0,0,0,0,0,0
20150105.105929,2811.47,0,1068360,0,0,0,0,0,0
20150105.10593,2811.47,0,1068360,0,0,0,0,0,0
20150105.105931,2811.47,0,1068360,0,0,0,0,0,0
20150105.105932,2811.47,0,1068360,0,0,0,0,0,0
20150105.105933,2811.47,0,1068360,0,0,0,0,0,0
20150105.105934,2811.47,0,1068360,0,0,0,0,0,0
20150105.105935,2811.47,0,1068360,0,0,0,0,0,0
20150105.105936,2811.47,0,1068360,0,0,0,0,0,0
20150105.105937,2811.47,0,1068360,0,0,0,0,0,0
20150105.105938,2811.47,0,1068360,0,0,0,0,0,0
20150105.105939,2811.47,0,1068360,0,0,0,0,0,0
20150105.10594,2811.47,0,1068360,0,0,0,0,0,0
20150105.105941,2811.47,0,1068360,0,0,0,0,0,0
20150105.105942,2811.47,0,1068360,0,0,0,0,0,0
20150105.105943,2811.47,0,1068360,0,0,0,0,0,0
20150105.105944,2811.47,0,1068360,0,0,0,0,0,0
20150105.105945,2811.47,0,1068360,0,0,0,0,0,0
20150105.105946,2811.47,0,1068360,0,0,0,0,0,0
20150105.105947,2811.47,0,1068360,0,0,0,0,0,0
20150105.105948,2811.47,0,1068360,0,0,0,0,0,0
20150105.105949,2811.47,0,1068360,0,0,0,0,0,0
20150105.10595,2811.47,0,1068360,0,0,0,0,0,0
20150105.105951,2811.47,0,1068360,0,0,0,0,0,0
20150105.105952,2811.47,0,1068360,0,0,0,0,0,0
20150105.105953,2811.47,0,1068360,0,0,0,0,0,0
20150105.105954,2811.47,0,1068360,0,0,0,0,0,0
20150105.105955,2811.47,0,1068360,0,0,0,0,0,0
20150105.105956,2811.47,0,1068360,0,0,0,0,0,0
20150105.105957,2811.47,0,1068360,0,0,0,0,0,0
20150105.105958,2811.47,0,1068360,0,0,0,0,0,0
20150105.105959,2811.47,0,1068360,0,0,0,0,0,0
20150105.11,2811.47,0,1068360,0,0,0,0,0,0
20150105.110001,2811.47,0,1068360,0,0,0,0,0,0
20150105.110002,2811.47,0,1068360,0,0,0,0,0,0
20150105.110003,2811.47,0,1068360,0,0,0,0,0,0
20150105.110004,2811.47,0,1068360,0,0,0,0,0,0
20150105.110005,2811.47,0,1068360,0,0,0,0,0,0
20150105.110006,2811.47,0,1068360,0,0,0,0,0,0
20150105.110007,2811.47,0,1068360,0,0,0,0,0,0
20150105.110008,2811.47,0,1068360,0,0,0,0,0,0
20150105.110009,2811.47,0,1068360,0,0,0,0,0,0
20150105.11001,2811.47,0,1068360,0,0,0,0,0,0
20150105.110011,2811.47,0,1068360,0,0,0,0,0,0
20150105.110012,2811.47,0,1068360,0,0,0,0,0,0
20150105.110013,2811.47,0,1068360,0,0,0,0,0,0
20150105.110014,2811.47,0,1068360,0,0,0,0,0,0
20150105.110015,2811.47,0,1068360,0,0,0,0,0,0
20150105.110016,2811.47,0,1068360,0,0,0,0,0,0
20150105.110017,2811.47,0,1068360,0,0,0,0,0,0
20150105.110018,2811.47,0,1068360,0,0,0,0,0,0
20150105.110019,2811.47,0,1068360,0,0,0,0,0,0
20150105.11002,2811.47,0,1068360,0,0,0,0,0,0
20150105.110021,2811.47,0,1068360,0,0,0,0,0,0
20150105.110022,2811.47,0,1068360,0,0,0,0,0,0
20150105.110023,2811.47,0,1068360,0,0,0,0,0,0
20150105.110024,2811.47,0,1068360,0,0,0,0,0,0
20150105.110025,2811.47,0,1068360,0,0,0,0,0,0
20150105.110026,2811.47,0,1068360,0,0,0,0,0,0
20150105.110027,2811.47,0,1068360,0,0,0,0,0,0
20150105.110028,2811.47,0,1068360,0,0,0,0,0,0
20150105.110029,2811.47,0,1068360,0,0,0,0,0,0
20150105.11003,2811.47,0,1068360,0,0,0,0,0,0
20150105.110031,2811.47,0,1068360,0,0,0,0,0,0
20150105.110032,2811.47,0,1068360,0,0,0,0,0,0
20150105.110033,2811.47,0,1068360,0,0,0,0,0,0
20150105.110034,2811.47,0,1068360,0,0,0,0,0,0
20150105.110035,2811.47,0,1068360,0,0,0,0,0,0
20150105.110036,2811.47,0,1068360,0,0,0,0,0,0
20150105.110037,2811.47,0,1068360,0,0,0,0,0,0
20150105.110038,2811.47,0,1068360,0,0,0,0,0,0
20150105.110039,2811.47,0,1068360,0,0,0,0,0,0
20150105.11004,2811.47,0,1068360,0,0,0,0,0,0
20150105.110041,2811.47,0,1068360,0,0,0,0,0,0
20150105.110042,2811.47,0,1068360,0,0,0,0,0,0
20150105.110043,2811.47,0,1068360,0,0,0,0,0,0
20150105.110044,2811.47,0,1068360,0,0,0,0,0,0
20150105.110045,2811.47,0,1068360,0,0,0,0,0,0
20150105.110046,2811.47,0,1068360,0,0,0,0,0,0
20150105.110047,2811.47,0,1068360,0,0,0,0,0,0
20150105.110048,2811.47,0,1068360,0,0,0,0,0,0
20150105.110049,2811.47,0,1068360,0,0,0,0,0,0
20150105.11005,2811.47,0,1068360,0,0,0,0,0,0
20150105.110051,2811.47,0,1068360,0,0,0,0,0,0
20150105.110052,2811.47,0,1068360,0,0,0,0,0,0
20150105.110053,2811.47,0,1068360,0,0,0,0,0,0
20150105.110054,2811.47,0,1068360,0,0,0,0,0,0
20150105.110055,2811.47,0,1068360,0,0,0,0,0,0
20150105.110056,2811.47,0,1068360,0,0,0,0,0,0
20150105.110057,2811.47,0,1068360,0,0,0,0,0,0
20150105.110058,2811.47,0,1068360,0,0,0,0,0,0
20150105.110059,2811.47,0,1068360,0,0,0,0,0,0
20150105.1101,2811.47,0,1068360,0,0,0,0,0,0
20150105.110101,2811.47,0,1068360,0,0,0,0,0,0
20150105.110102,2811.47,0,1068360,0,0,0,0,0,0
20150105.110103,2811.47,0,1068360,0,0,0,0,0,0
20150105.110104,2811.47,0,1068360,0,0,0,0,0,0
20150105.110105,2811.47,0,1068360,0,0,0,0,0,0
20150105.110106,2811.47,0,1068360,0,0,0,0,0,0
20150105.110107,2811.47,0,1068360,0,0,0,0,0,0
20150105.110108,2811.47,0,1068360,0,0,0,0,0,0
20150105.110109,2811.47,0,1068360,0,0,0,0,0,0
20150105.11011,2811.47,0,1068360,0,0,0,0,0,0
20150105.110111,2811.47,0,1068360,0,0,0,0,0,0
20150105.110112,2811.47,0,1068360,0,0,0,0,0,0
20150105.110113,2811.47,0,1068360,0,0,0,0,0,0
20150105.110114,2811.47,0,1068360,0,0,0,0,0,0
20150105.110115,2811.47,0,1068360,0,0,0,0,0,0
20150105.110116,2811.47,0,1068360,0,0,0,0,0,0
20150105.110117,2811.47,0,1068360,0,0,0,0,0,0
20150105.110118,2811.47,0,1068360,0,0,0,0,0,0
20150105.110119,2811.47,0,1068360,0,0,0,0,0,0
20150105.11012,2811.47,0,1068360,0,0,0,0,0,0
20150105.110121,2811.47,0,1068360,0,0,0,0,0,0
20150105.110122,2811.47,0,1068360,0,0,0,0,0,0
20150105.110123,2811.47,0,1068360,0,0,0,0,0,0
20150105.110124,2811.47,0,1068360,0,0,0,0,0,0
20150105.110125,2811.47,0,1068360,0,0,0,0,0,0
20150105.110126,2811.47,0,1068360,0,0,0,0,0,0
20150105.110127,2811.47,0,1068360,0,0,0,0,0,0
20150105.110128,2811.47,0,1068360,0,0,0,0,0,0
20150105.110129,2811.47,0,1068360,0,0,0,0,0,0
20150105.11013,2811.47,0,1068360,0,0,0,0,0,0
20150105.110131,2811.47,0,1068360,0,0,0,0,0,0
20150105.110132,2811.47,0,1068360,0,0,0,0,0,0
20150105.110133,2811.47,0,1068360,0,0,0,0,0,0
20150105.110134,2811.47,0,1068360,0,0,0,0,0,0
20150105.110135,2811.47,0,1068360,0,0,0,0,0,0
20150105.110136,2811.47,0,1068360,0,0,0,0,0,0
20150105.110137,2811.47,0,1068360,0,0,0,0,0,0
20150105.110138,2811.47,0,1068360,0,0,0,0,0,0
20150105.110139,2811.47,0,1068360,0,0,0,0,0,0
20150105.11014,2811.47,0,1068360,0,0,0,0,0,0
20150105.110141,2811.47,0,1068360,0,0,0,0,0,0
20150105.110142,2811.47,0,1068360,0,0,0,0,0,0
20150105.110143,2811.47,0,1068360,0,0,0,0,0,0
20150105.110144,2811.47,0,1068360,0,0,0,0,0,0
20150105.110145,2811.47,0,1068360,0,0,0,0,0,0
20150105.110146,2811.47,0,1068360,0,0,0,0,0,0
20150105.110147,2811.47,0,1068360,0,0,0,0,0,0
20150105.110148,2811.47,0,1068360,0,0,0,0,0,0
20150105.110149,2811.47,0,1068360,0,0,0,0,0,0
20150105.11015,2811.47,0,1068360,0,0,0,0,0,0
20150105.110151,2811.47,0,1068360,0,0,0,0,0,0
20150105.110152,2811.47,0,1068360,0,0,0,0,0,0
20150105.110153,2811.47,0,1068360,0,0,0,0,0,0
20150105.110154,2811.47,0,1068360,0,0,0,0,0,0
20150105.110155,2811.47,0,1068360,0,0,0,0,0,0
20150105.110156,2811.47,0,1068360,0,0,0,0,0,0
20150105.110157,2811.47,0,1068360,0,0,0,0,0,0
20150105.110158,2811.47,0,1068360,0,0,0,0,0,0
20150105.110159,2811.47,0,1068360,0,0,0,0,0,0
20150105.1102,2811.47,0,1068360,0,0,0,0,0,0
20150105.110201,2811.47,0,1068360,0,0,0,0,0,0
20150105.110202,2811.47,0,1068360,0,0,0,0,0,0
20150105.110203,2811.47,0,1068360,0,0,0,0,0,0
20150105.110204,2811.47,0,1068360,0,0,0,0,0,0
20150105.110205,2811.47,0,1068360,0,0,0,0,0,0
20150105.110206,2811.47,0,1068360,0,0,0,0,0,0
20150105.110207,2811.47,0,1068360,0,0,0,0,0,0
20150105.110208,2811.47,0,1068360,0,0,0,0,0,0
20150105.110209,2811.47,0,1068360,0,0,0,0,0,0
20150105.11021,2811.47,0,1068360,0,0,0,0,0,0
20150105.110211,2811.47,0,1068360,0,0,0,0,0,0
20150105.110212,2811.47,0,1068360,0,0,0,0,0,0
20150105.110213,2811.47,0,1068360,0,0,0,0,0,0
20150105.110214,2811.47,0,1068360,0,0,0,0,0,0
20150105.110215,2811.47,0,1068360,0,0,0,0,0,0
20150105.110216,2811.47,0,1068360,0,0,0,0,0,0
20150105.110217,2811.47,0,1068360,0,0,0,0,0,0
20150105.110218,2811.47,0,1068360,0,0,0,0,0,0
20150105.110219,2811.47,0,1068360,0,0,0,0,0,0
20150105.11022,2811.47,0,1068360,0,0,0,0,0,0
20150105.110221,2811.47,0,1068360,0,0,0,0,0,0
20150105.110222,2811.47,0,1068360,0,0,0,0,0,0
20150105.110223,2811.47,0,1068360,0,0,0,0,0,0
20150105.110224,2811.47,0,1068360,0,0,0,0,0,0
20150105.110225,2811.47,0,1068360,0,0,0,0,0,0
20150105.110226,2811.47,0,1068360,0,0,0,0,0,0
20150105.110227,2811.47,0,1068360,0,0,0,0,0,0
20150105.110228,2811.47,0,1068360,0,0,0,0,0,0
20150105.110229,2811.47,0,1068360,0,0,0,0,0,0
20150105.11023,2811.47,0,1068360,0,0,0,0,0,0
20150105.110231,2811.47,0,1068360,0,0,0,0,0,0
20150105.110232,2811.47,0,1068360,0,0,0,0,0,0
20150105.110233,2811.47,0,1068360,0,0,0,0,0,0
20150105.110234,2811.47,0,1068360,0,0,0,0,0,0
20150105.110235,2811.47,0,1068360,0,0,0,0,0,0
20150105.110236,2811.47,0,1068360,0,0,0,0,0,0
20150105.110237,2811.47,0,1068360,0,0,0,0,0,0
20150105.110238,2811.47,0,1068360,0,0,0,0,0,0
20150105.110239,2811.47,0,1068360,0,0,0,0,0,0
20150105.11024,2811.47,0,1068360,0,0,0,0,0,0
20150105.110241,2811.47,0,1068360,0,0,0,0,0,0
20150105.110242,2811.47,0,1068360,0,0,0,0,0,0
20150105.110243,2811.47,0,1068360,0,0,0,0,0,0
20150105.110244,2811.47,0,1068360,0,0,0,0,0,0
20150105.110245,2811.47,0,1068360,0,0,0,0,0,0
20150105.110246,2811.47,0,1068360,0,0,0,0,0,0
20150105.110247,2811.47,0,1068360,0,0,0,0,0,0
20150105.110248,2811.47,0,1068360,0,0,0,0,0,0
20150105.110249,2811.47,0,1068360,0,0,0,0,0,0
20150105.11025,2811.47,0,1068360,0,0,0,0,0,0
20150105.110251,2811.47,0,1068360,0,0,0,0,0,0
20150105.110252,2811.47,0,1068360,0,0,0,0,0,0
20150105.110253,2811.47,0,1068360,0,0,0,0,0,0
20150105.110254,2811.47,0,1068360,0,0,0,0,0,0
20150105.110255,2811.47,0,1068360,0,0,0,0,0,0
20150105.110256,2811.47,0,1068360,0,0,0,0,0,0
20150105.110257,2811.47,0,1068360,0,0,0,0,0,0
20150105.110258,2811.47,0,1068360,0,0,0,0,0,0
20150105.110259,2811.47,0,1068360,0,0,0,0,0,0
20150105.1103,2811.47,0,1068360,0,0,0,0,0,0
20150105.110301,2811.47,0,1068360,0,0,0,0,0,0
20150105.110302,2811.47,0,1068360,0,0,0,0,0,0
20150105.110303,2811.47,0,1068360,0,0,0,0,0,0
20150105.110304,2811.47,0,1068360,0,0,0,0,0,0
20150105.110305,2811.47,0,1068360,0,0,0,0,0,0
20150105.110306,2811.47,0,1068360,0,0,0,0,0,0
20150105.110307,2811.47,0,1068360,0,0,0,0,0,0
20150105.110308,2811.47,0,1068360,0,0,0,0,0,0
20150105.110309,2811.47,0,1068360,0,0,0,0,0,0
20150105.11031,2811.47,0,1068360,0,0,0,0,0,0
20150105.110311,2811.47,0,1068360,0,0,0,0,0,0
20150105.110312,2811.47,0,1068360,0,0,0,0,0,0
20150105.110313,2811.47,0,1068360,0,0,0,0,0,0
20150105.110314,2811.47,0,1068360,0,0,0,0,0,0
20150105.110315,2811.47,0,1068360,0,0,0,0,0,0
20150105.110316,2811.47,0,1068360,0,0,0,0,0,0
20150105.110317,2811.47,0,1068360,0,0,0,0,0,0
20150105.110318,2811.47,0,1068360,0,0,0,0,0,0
20150105.110319,2811.47,0,1068360,0,0,0,0,0,0
20150105.11032,2811.47,0,1068360,0,0,0,0,0,0
20150105.110321,2811.47,0,1068360,0,0,0,0,0,0
20150105.110322,2811.47,0,1068360,0,0,0,0,0,0
20150105.110323,2811.47,0,1068360,0,0,0,0,0,0
20150105.110324,2811.47,0,1068360,0,0,0,0,0,0
20150105.110325,2811.47,0,1068360,0,0,0,0,0,0
20150105.110326,2811.47,0,1068360,0,0,0,0,0,0
20150105.110327,2811.47,0,1068360,0,0,0,0,0,0
20150105.110328,2811.47,0,1068360,0,0,0,0,0,0
20150105.110329,2811.47,0,1068360,0,0,0,0,0,0
20150105.11033,2811.47,0,1068360,0,0,0,0,0,0
20150105.110331,2811.47,0,1068360,0,0,0,0,0,0
20150105.110332,2811.47,0,1068360,0,0,0,0,0,0
20150105.110333,2811.47,0,1068360,0,0,0,0,0,0
20150105.110334,2811.47,0,1068360,0,0,0,0,0,0
20150105.110335,2811.47,0,1068360,0,0,0,0,0,0
20150105.110336,2811.47,0,1068360,0,0,0,0,0,0
20150105.110337,2811.47,0,1068360,0,0,0,0,0,0
20150105.110338,2811.47,0,1068360,0,0,0,0,0,0
20150105.110339,2811.47,0,1068360,0,0,0,0,0,0
20150105.11034,2811.47,0,1068360,0,0,0,0,0,0
20150105.110341,2811.47,0,1068360,0,0,0,0,0,0
20150105.110342,2811.47,0,1068360,0,0,0,0,0,0
20150105.110343,2811.47,0,1068360,0,0,0,0,0,0
20150105.110344,2811.47,0,1068360,0,0,0,0,0,0
20150105.110345,2811.47,0,1068360,0,0,0,0,0,0
20150105.110346,2811.47,0,1068360,0,0,0,0,0,0
20150105.110347,2811.47,0,1068360,0,0,0,0,0,0
20150105.110348,2811.47,0,1068360,0,0,0,0,0,0
20150105.110349,2811.47,0,1068360,0,0,0,0,0,0
20150105.11035,2811.47,0,1068360,0,0,0,0,0,0
20150105.110351,2811.47,0,1068360,0,0,0,0,0,0
20150105.110352,2811.47,0,1068360,0,0,0,0,0,0
20150105.110353,2811.47,0,1068360,0,0,0,0,0,0
20150105.110354,2811.47,0,1068360,0,0,0,0,0,0
20150105.110355,2811.47,0,1068360,0,0,0,0,0,0
20150105.110356,2811.47,0,1068360,0,0,0,0,0,0
20150105.110357,2811.47,0,1068360,0,0,0,0,0,0
20150105.110358,2811.47,0,1068360,0,0,0,0,0,0
20150105.110359,2811.47,0,1068360,0,0,0,0,0,0
20150105.1104,2811.47,0,1068360,0,0,0,0,0,0
20150105.110401,2811.47,0,1068360,0,0,0,0,0,0
20150105.110402,2811.47,0,1068360,0,0,0,0,0,0
20150105.110403,2811.47,0,1068360,0,0,0,0,0,0
20150105.110404,2811.47,0,1068360,0,0,0,0,0,0
20150105.110405,2811.47,0,1068360,0,0,0,0,0,0
20150105.110406,2811.47,0,1068360,0,0,0,0,0,0
20150105.110407,2811.47,0,1068360,0,0,0,0,0,0
20150105.110408,2811.47,0,1068360,0,0,0,0,0,0
20150105.110409,2811.47,0,1068360,0,0,0,0,0,0
20150105.11041,2811.47,0,1068360,0,0,0,0,0,0
20150105.110411,2811.47,0,1068360,0,0,0,0,0,0
20150105.110412,2811.47,0,1068360,0,0,0,0,0,0
20150105.110413,2811.47,0,1068360,0,0,0,0,0,0
20150105.110414,2811.47,0,1068360,0,0,0,0,0,0
20150105.110415,2811.47,0,1068360,0,0,0,0,0,0
20150105.110416,2811.47,0,1068360,0,0,0,0,0,0
20150105.110417,2811.47,0,1068360,0,0,0,0,0,0
20150105.110418,2811.47,0,1068360,0,0,0,0,0,0
20150105.110419,2811.47,0,1068360,0,0,0,0,0,0
20150105.11042,2811.47,0,1068360,0,0,0,0,0,0
20150105.110421,2811.47,0,1068360,0,0,0,0,0,0
20150105.110422,2811.47,0,1068360,0,0,0,0,0,0
20150105.110423,2811.47,0,1068360,0,0,0,0,0,0
20150105.110424,2811.47,0,1068360,0,0,0,0,0,0
20150105.110425,2811.47,0,1068360,0,0,0,0,0,0
20150105.110426,2811.47,0,1068360,0,0,0,0,0,0
20150105.110427,2811.47,0,1068360,0,0,0,0,0,0
20150105.110428,2811.47,0,1068360,0,0,0,0,0,0
20150105.110429,2811.47,0,1068360,0,0,0,0,0,0
20150105.11043,2811.47,0,1068360,0,0,0,0,0,0
20150105.110431,2811.47,0,1068360,0,0,0,0,0,0
20150105.110432,2811.47,0,1068360,0,0,0,0,0,0
20150105.110433,2811.47,0,1068360,0,0,0,0,0,0
20150105.110434,2811.47,0,1068360,0,0,0,0,0,0
20150105.110435,2811.47,0,1068360,0,0,0,0,0,0
20150105.110436,2811.47,0,1068360,0,0,0,0,0,0
20150105.110437,2811.47,0,1068360,0,0,0,0,0,0
20150105.110438,2811.47,0,1068360,0,0,0,0,0,0
20150105.110439,2811.47,0,1068360,0,0,0,0,0,0
20150105.11044,2811.47,0,1068360,0,0,0,0,0,0
20150105.110441,2811.47,0,1068360,0,0,0,0,0,0
20150105.110442,2811.47,0,1068360,0,0,0,0,0,0
20150105.110443,2811.47,0,1068360,0,0,0,0,0,0
20150105.110444,2811.47,0,1068360,0,0,0,0,0,0
20150105.110445,2811.47,0,1068360,0,0,0,0,0,0
20150105.110446,2811.47,0,1068360,0,0,0,0,0,0
20150105.110447,2811.47,0,1068360,0,0,0,0,0,0
20150105.110448,2811.47,0,1068360,0,0,0,0,0,0
20150105.110449,2811.47,0,1068360,0,0,0,0,0,0
20150105.11045,2811.47,0,1068360,0,0,0,0,0,0
20150105.110451,2811.47,0,1068360,0,0,0,0,0,0
20150105.110452,2811.47,0,1068360,0,0,0,0,0,0
20150105.110453,2811.47,0,1068360,0,0,0,0,0,0
20150105.110454,2811.47,0,1068360,0,0,0,0,0,0
20150105.110455,2811.47,0,1068360,0,0,0,0,0,0
20150105.110456,2811.47,0,1068360,0,0,0,0,0,0
20150105.110457,2811.47,0,1068360,0,0,0,0,0,0
20150105.110458,2811.47,0,1068360,0,0,0,0,0,0
20150105.110459,2811.47,0,1068360,0,0,0,0,0,0
20150105.1105,2811.47,0,1068360,0,0,0,0,0,0
20150105.110501,2811.47,0,1068360,0,0,0,0,0,0
20150105.110502,2811.47,0,1068360,0,0,0,0,0,0
20150105.110503,2811.47,0,1068360,0,0,0,0,0,0
20150105.110504,2811.47,0,1068360,0,0,0,0,0,0
20150105.110505,2811.47,0,1068360,0,0,0,0,0,0
20150105.110506,2811.47,0,1068360,0,0,0,0,0,0
20150105.110507,2811.47,0,1068360,0,0,0,0,0,0
20150105.110508,2811.47,0,1068360,0,0,0,0,0,0
20150105.110509,2811.47,0,1068360,0,0,0,0,0,0
20150105.11051,2811.47,0,1068360,0,0,0,0,0,0
20150105.110511,2811.47,0,1068360,0,0,0,0,0,0
20150105.110512,2811.47,0,1068360,0,0,0,0,0,0
20150105.110513,2811.47,0,1068360,0,0,0,0,0,0
20150105.110514,2811.47,0,1068360,0,0,0,0,0,0
20150105.110515,2811.47,0,1068360,0,0,0,0,0,0
20150105.110516,2811.47,0,1068360,0,0,0,0,0,0
20150105.110517,2811.47,0,1068360,0,0,0,0,0,0
20150105.110518,2811.47,0,1068360,0,0,0,0,0,0
20150105.110519,2811.47,0,1068360,0,0,0,0,0,0
20150105.11052,2811.47,0,1068360,0,0,0,0,0,0
20150105.110521,2811.47,0,1068360,0,0,0,0,0,0
20150105.110522,2811.47,0,1068360,0,0,0,0,0,0
20150105.110523,2811.47,0,1068360,0,0,0,0,0,0
20150105.110524,2811.47,0,1068360,0,0,0,0,0,0
20150105.110525,2811.47,0,1068360,0,0,0,0,0,0
20150105.110526,2811.47,0,1068360,0,0,0,0,0,0
20150105.110527,2811.47,0,1068360,0,0,0,0,0,0
20150105.110528,2811.47,0,1068360,0,0,0,0,0,0
20150105.110529,2811.47,0,1068360,0,0,0,0,0,0
20150105.11053,2811.47,0,1068360,0,0,0,0,0,0
20150105.110531,2811.47,0,1068360,0,0,0,0,0,0
20150105.110532,2811.47,0,1068360,0,0,0,0,0,0
20150105.110533,2811.47,0,1068360,0,0,0,0,0,0
20150105.110534,2811.47,0,1068360,0,0,0,0,0,0
20150105.110535,2811.47,0,1068360,0,0,0,0,0,0
20150105.110536,2811.47,0,1068360,0,0,0,0,0,0
20150105.110537,2811.47,0,1068360,0,0,0,0,0,0
20150105.110538,2811.47,0,1068360,0,0,0,0,0,0
20150105.110539,2811.47,0,1068360,0,0,0,0,0,0
20150105.11054,2811.47,0,1068360,0,0,0,0,0,0
20150105.110541,2811.47,0,1068360,0,0,0,0,0,0
20150105.110542,2811.47,0,1068360,0,0,0,0,0,0
20150105.110543,2811.47,0,1068360,0,0,0,0,0,0
20150105.110544,2811.47,0,1068360,0,0,0,0,0,0
20150105.110545,2811.47,0,1068360,0,0,0,0,0,0
20150105.110546,2811.47,0,1068360,0,0,0,0,0,0
20150105.110547,2811.47,0,1068360,0,0,0,0,0,0
20150105.110548,2811.47,0,1068360,0,0,0,0,0,0
20150105.110549,2811.47,0,1068360,0,0,0,0,0,0
20150105.11055,2811.47,0,1068360,0,0,0,0,0,0
20150105.110551,2811.47,0,1068360,0,0,0,0,0,0
20150105.110552,2811.47,0,1068360,0,0,0,0,0,0
20150105.110553,2811.47,0,1068360,0,0,0,0,0,0
20150105.110554,2811.47,0,1068360,0,0,0,0,0,0
20150105.110555,2811.47,0,1068360,0,0,0,0,0,0
20150105.110556,2811.47,0,1068360,0,0,0,0,0,0
20150105.110557,2811.47,0,1068360,0,0,0,0,0,0
20150105.110558,2811.47,0,1068360,0,0,0,0,0,0
20150105.110559,2811.47,0,1068360,0,0,0,0,0,0
20150105.1106,2811.47,0,1068360,0,0,0,0,0,0
20150105.110601,2811.47,0,1068360,0,0,0,0,0,0
20150105.110602,2811.47,0,1068360,0,0,0,0,0,0
20150105.110603,2811.47,0,1068360,0,0,0,0,0,0
20150105.110604,2811.47,0,1068360,0,0,0,0,0,0
20150105.110605,2811.47,0,1068360,0,0,0,0,0,0
20150105.110606,2811.47,0,1068360,0,0,0,0,0,0
20150105.110607,2811.47,0,1068360,0,0,0,0,0,0
20150105.110608,2811.47,0,1068360,0,0,0,0,0,0
20150105.110609,2811.47,0,1068360,0,0,0,0,0,0
20150105.11061,2811.47,0,1068360,0,0,0,0,0,0
20150105.110611,2811.47,0,1068360,0,0,0,0,0,0
20150105.110612,2811.47,0,1068360,0,0,0,0,0,0
20150105.110613,2811.47,0,1068360,0,0,0,0,0,0
20150105.110614,2811.47,0,1068360,0,0,0,0,0,0
20150105.110615,2811.47,0,1068360,0,0,0,0,0,0
20150105.110616,2811.47,0,1068360,0,0,0,0,0,0
20150105.110617,2811.47,0,1068360,0,0,0,0,0,0
20150105.110618,2811.47,0,1068360,0,0,0,0,0,0
20150105.110619,2811.47,0,1068360,0,0,0,0,0,0
20150105.11062,2811.47,0,1068360,0,0,0,0,0,0
20150105.110621,2811.47,0,1068360,0,0,0,0,0,0
20150105.110622,2811.47,0,1068360,0,0,0,0,0,0
20150105.110623,2811.47,0,1068360,0,0,0,0,0,0
20150105.110624,2811.47,0,1068360,0,0,0,0,0,0
20150105.110625,2811.47,0,1068360,0,0,0,0,0,0
20150105.110626,2811.47,0,1068360,0,0,0,0,0,0
20150105.110627,2811.47,0,1068360,0,0,0,0,0,0
20150105.110628,2811.47,0,1068360,0,0,0,0,0,0
20150105.110629,2811.47,0,1068360,0,0,0,0,0,0
20150105.11063,2811.47,0,1068360,0,0,0,0,0,0
20150105.110631,2811.47,0,1068360,0,0,0,0,0,0
20150105.110632,2811.47,0,1068360,0,0,0,0,0,0
20150105.110633,2811.47,0,1068360,0,0,0,0,0,0
20150105.110634,2811.47,0,1068360,0,0,0,0,0,0
20150105.110635,2811.47,0,1068360,0,0,0,0,0,0
20150105.110636,2811.47,0,1068360,0,0,0,0,0,0
20150105.110637,2811.47,0,1068360,0,0,0,0,0,0
20150105.110638,2811.47,0,1068360,0,0,0,0,0,0
20150105.110639,2811.47,0,1068360,0,0,0,0,0,0
20150105.11064,2811.47,0,1068360,0,0,0,0,0,0
20150105.110641,2811.47,0,1068360,0,0,0,0,0,0
20150105.110642,2811.47,0,1068360,0,0,0,0,0,0
20150105.110643,2811.47,0,1068360,0,0,0,0,0,0
20150105.110644,2811.47,0,1068360,0,0,0,0,0,0
20150105.110645,2811.47,0,1068360,0,0,0,0,0,0
20150105.110646,2811.47,0,1068360,0,0,0,0,0,0
20150105.110647,2811.47,0,1068360,0,0,0,0,0,0
20150105.110648,2811.47,0,1068360,0,0,0,0,0,0
20150105.110649,2811.47,0,1068360,0,0,0,0,0,0
20150105.11065,2811.47,0,1068360,0,0,0,0,0,0
20150105.110651,2811.47,0,1068360,0,0,0,0,0,0
20150105.110652,2811.47,0,1068360,0,0,0,0,0,0
20150105.110653,2811.47,0,1068360,0,0,0,0,0,0
20150105.110654,2811.47,0,1068360,0,0,0,0,0,0
20150105.110655,2811.47,0,1068360,0,0,0,0,0,0
20150105.110656,2811.47,0,1068360,0,0,0,0,0,0
20150105.110657,2811.47,0,1068360,0,0,0,0,0,0
20150105.110658,2811.47,0,1068360,0,0,0,0,0,0
20150105.110659,2811.47,0,1068360,0,0,0,0,0,0
20150105.1107,2811.47,0,1068360,0,0,0,0,0,0
20150105.110701,2811.47,0,1068360,0,0,0,0,0,0
20150105.110702,2811.47,0,1068360,0,0,0,0,0,0
20150105.110703,2811.47,0,1068360,0,0,0,0,0,0
20150105.110704,2811.47,0,1068360,0,0,0,0,0,0
20150105.110705,2811.47,0,1068360,0,0,0,0,0,0
20150105.110706,2811.47,0,1068360,0,0,0,0,0,0
20150105.110707,2811.47,0,1068360,0,0,0,0,0,0
20150105.110708,2811.47,0,1068360,0,0,0,0,0,0
20150105.110709,2811.47,0,1068360,0,0,0,0,0,0
20150105.11071,2811.47,0,1068360,0,0,0,0,0,0
20150105.110711,2811.47,0,1068360,0,0,0,0,0,0
20150105.110712,2811.47,0,1068360,0,0,0,0,0,0
20150105.110713,2811.47,0,1068360,0,0,0,0,0,0
20150105.110714,2811.47,0,1068360,0,0,0,0,0,0
20150105.110715,2811.47,0,1068360,0,0,0,0,0,0
20150105.110716,2811.47,0,1068360,0,0,0,0,0,0
20150105.110717,2811.47,0,1068360,0,0,0,0,0,0
20150105.110718,2811.47,0,1068360,0,0,0,0,0,0
20150105.110719,2811.47,0,1068360,0,0,0,0,0,0
20150105.11072,2811.47,0,1068360,0,0,0,0,0,0
20150105.110721,2811.47,0,1068360,0,0,0,0,0,0
20150105.110722,2811.47,0,1068360,0,0,0,0,0,0
20150105.110723,2811.47,0,1068360,0,0,0,0,0,0
20150105.110724,2811.47,0,1068360,0,0,0,0,0,0
20150105.110725,2811.47,0,1068360,0,0,0,0,0,0
20150105.110726,2811.47,0,1068360,0,0,0,0,0,0
20150105.110727,2811.47,0,1068360,0,0,0,0,0,0
20150105.110728,2811.47,0,1068360,0,0,0,0,0,0
20150105.110729,2811.47,0,1068360,0,0,0,0,0,0
20150105.11073,2811.47,0,1068360,0,0,0,0,0,0
20150105.110731,2811.47,0,1068360,0,0,0,0,0,0
20150105.110732,2811.47,0,1068360,0,0,0,0,0,0
20150105.110733,2811.47,0,1068360,0,0,0,0,0,0
20150105.110734,2811.47,0,1068360,0,0,0,0,0,0
20150105.110735,2811.47,0,1068360,0,0,0,0,0,0
20150105.110736,2811.47,0,1068360,0,0,0,0,0,0
20150105.110737,2811.47,0,1068360,0,0,0,0,0,0
20150105.110738,2811.47,0,1068360,0,0,0,0,0,0
20150105.110739,2811.47,0,1068360,0,0,0,0,0,0
20150105.11074,2811.47,0,1068360,0,0,0,0,0,0
20150105.110741,2811.47,0,1068360,0,0,0,0,0,0
20150105.110742,2811.47,0,1068360,0,0,0,0,0,0
20150105.110743,2811.47,0,1068360,0,0,0,0,0,0
20150105.110744,2811.47,0,1068360,0,0,0,0,0,0
20150105.110745,2811.47,0,1068360,0,0,0,0,0,0
20150105.110746,2811.47,0,1068360,0,0,0,0,0,0
20150105.110747,2811.47,0,1068360,0,0,0,0,0,0
20150105.110748,2811.47,0,1068360,0,0,0,0,0,0
20150105.110749,2811.47,0,1068360,0,0,0,0,0,0
20150105.11075,2811.47,0,1068360,0,0,0,0,0,0
20150105.110751,2811.47,0,1068360,0,0,0,0,0,0
20150105.110752,2811.47,0,1068360,0,0,0,0,0,0
20150105.110753,2811.47,0,1068360,0,0,0,0,0,0
20150105.110754,2811.47,0,1068360,0,0,0,0,0,0
20150105.110755,2811.47,0,1068360,0,0,0,0,0,0
20150105.110756,2811.47,0,1068360,0,0,0,0,0,0
20150105.110757,2811.47,0,1068360,0,0,0,0,0,0
20150105.110758,2811.47,0,1068360,0,0,0,0,0,0
20150105.110759,2811.47,0,1068360,0,0,0,0,0,0
20150105.1108,2811.47,0,1068360,0,0,0,0,0,0
20150105.110801,2811.47,0,1068360,0,0,0,0,0,0
20150105.110802,2811.47,0,1068360,0,0,0,0,0,0
20150105.110803,2811.47,0,1068360,0,0,0,0,0,0
20150105.110804,2811.47,0,1068360,0,0,0,0,0,0
20150105.110805,2811.47,0,1068360,0,0,0,0,0,0
20150105.110806,2811.47,0,1068360,0,0,0,0,0,0
20150105.110807,2811.47,0,1068360,0,0,0,0,0,0
20150105.110808,2811.47,0,1068360,0,0,0,0,0,0
20150105.110809,2811.47,0,1068360,0,0,0,0,0,0
20150105.11081,2811.47,0,1068360,0,0,0,0,0,0
20150105.110811,2811.47,0,1068360,0,0,0,0,0,0
20150105.110812,2811.47,0,1068360,0,0,0,0,0,0
20150105.110813,2811.47,0,1068360,0,0,0,0,0,0
20150105.110814,2811.47,0,1068360,0,0,0,0,0,0
20150105.110815,2811.47,0,1068360,0,0,0,0,0,0
20150105.110816,2811.47,0,1068360,0,0,0,0,0,0
20150105.110817,2811.47,0,1068360,0,0,0,0,0,0
20150105.110818,2811.47,0,1068360,0,0,0,0,0,0
20150105.110819,2811.47,0,1068360,0,0,0,0,0,0
20150105.11082,2811.47,0,1068360,0,0,0,0,0,0
20150105.110821,2811.47,0,1068360,0,0,0,0,0,0
20150105.110822,2811.47,0,1068360,0,0,0,0,0,0
20150105.110823,2811.47,0,1068360,0,0,0,0,0,0
20150105.110824,2811.47,0,1068360,0,0,0,0,0,0
20150105.110825,2811.47,0,1068360,0,0,0,0,0,0
20150105.110826,2811.47,0,1068360,0,0,0,0,0,0
20150105.110827,2811.47,0,1068360,0,0,0,0,0,0
20150105.110828,2811.47,0,1068360,0,0,0,0,0,0
20150105.110829,2811.47,0,1068360,0,0,0,0,0,0
20150105.11083,2811.47,0,1068360,0,0,0,0,0,0
20150105.110831,2811.47,0,1068360,0,0,0,0,0,0
20150105.110832,2811.47,0,1068360,0,0,0,0,0,0
20150105.110833,2811.47,0,1068360,0,0,0,0,0,0
20150105.110834,2811.47,0,1068360,0,0,0,0,0,0
20150105.110835,2811.47,0,1068360,0,0,0,0,0,0
20150105.110836,2811.47,0,1068360,0,0,0,0,0,0
20150105.110837,2811.47,0,1068360,0,0,0,0,0,0
20150105.110838,2811.47,0,1068360,0,0,0,0,0,0
20150105.110839,2811.47,0,1068360,0,0,0,0,0,0
20150105.11084,2811.47,0,1068360,0,0,0,0,0,0
20150105.110841,2811.47,0,1068360,0,0,0,0,0,0
20150105.110842,2811.47,0,1068360,0,0,0,0,0,0
20150105.110843,2811.47,0,1068360,0,0,0,0,0,0
20150105.110844,2811.47,0,1068360,0,0,0,0,0,0
20150105.110845,2811.47,0,1068360,0,0,0,0,0,0
20150105.110846,2811.47,0,1068360,0,0,0,0,0,0
20150105.110847,2811.47,0,1068360,0,0,0,0,0,0
20150105.110848,2811.47,0,1068360,0,0,0,0,0,0
20150105.110849,2811.47,0,1068360,0,0,0,0,0,0
20150105.11085,2811.47,0,1068360,0,0,0,0,0,0
20150105.110851,2811.47,0,1068360,0,0,0,0,0,0
20150105.110852,2811.47,0,1068360,0,0,0,0,0,0
20150105.110853,2811.47,0,1068360,0,0,0,0,0,0
20150105.110854,2811.47,0,1068360,0,0,0,0,0,0
20150105.110855,2811.47,0,1068360,0,0,0,0,0,0
20150105.110856,2811.47,0,1068360,0,0,0,0,0,0
20150105.110857,2811.47,0,1068360,0,0,0,0,0,0
20150105.110858,2811.47,0,1068360,0,0,0,0,0,0
20150105.110859,2811.47,0,1068360,0,0,0,0,0,0
20150105.1109,2811.47,0,1068360,0,0,0,0,0,0
20150105.110901,2811.47,0,1068360,0,0,0,0,0,0
20150105.110902,2811.47,0,1068360,0,0,0,0,0,0
20150105.110903,2811.47,0,1068360,0,0,0,0,0,0
20150105.110904,2811.47,0,1068360,0,0,0,0,0,0
20150105.110905,2811.47,0,1068360,0,0,0,0,0,0
20150105.110906,2811.47,0,1068360,0,0,0,0,0,0
20150105.110907,2811.47,0,1068360,0,0,0,0,0,0
20150105.110908,2811.47,0,1068360,0,0,0,0,0,0
20150105.110909,2811.47,0,1068360,0,0,0,0,0,0
20150105.11091,2811.47,0,1068360,0,0,0,0,0,0
20150105.110911,2811.47,0,1068360,0,0,0,0,0,0
20150105.110912,2811.47,0,1068360,0,0,0,0,0,0
20150105.110913,2811.47,0,1068360,0,0,0,0,0,0
20150105.110914,2811.47,0,1068360,0,0,0,0,0,0
20150105.110915,2811.47,0,1068360,0,0,0,0,0,0
20150105.110916,2811.47,0,1068360,0,0,0,0,0,0
20150105.110917,2811.47,0,1068360,0,0,0,0,0,0
20150105.110918,2811.47,0,1068360,0,0,0,0,0,0
20150105.110919,2811.47,0,1068360,0,0,0,0,0,0
20150105.11092,2811.47,0,1068360,0,0,0,0,0,0
20150105.110921,2811.47,0,1068360,0,0,0,0,0,0
20150105.110922,2811.47,0,1068360,0,0,0,0,0,0
20150105.110923,2811.47,0,1068360,0,0,0,0,0,0
20150105.110924,2811.47,0,1068360,0,0,0,0,0,0
20150105.110925,2811.47,0,1068360,0,0,0,0,0,0
20150105.110926,2811.47,0,1068360,0,0,0,0,0,0
20150105.110927,2811.47,0,1068360,0,0,0,0,0,0
20150105.110928,2811.47,0,1068360,0,0,0,0,0,0
20150105.110929,2811.47,0,1068360,0,0,0,0,0,0
20150105.11093,2811.47,0,1068360,0,0,0,0,0,0
20150105.110931,2811.47,0,1068360,0,0,0,0,0,0
20150105.110932,2811.47,0,1068360,0,0,0,0,0,0
20150105.110933,2811.47,0,1068360,0,0,0,0,0,0
20150105.110934,2811.47,0,1068360,0,0,0,0,0,0
20150105.110935,2811.47,0,1068360,0,0,0,0,0,0
20150105.110936,2811.47,0,1068360,0,0,0,0,0,0
20150105.110937,2811.47,0,1068360,0,0,0,0,0,0
20150105.110938,2811.47,0,1068360,0,0,0,0,0,0
20150105.110939,2811.47,0,1068360,0,0,0,0,0,0
20150105.11094,2811.47,0,1068360,0,0,0,0,0,0
20150105.110941,2811.47,0,1068360,0,0,0,0,0,0
20150105.110942,2811.47,0,1068360,0,0,0,0,0,0
20150105.110943,2811.47,0,1068360,0,0,0,0,0,0
20150105.110944,2811.47,0,1068360,0,0,0,0,0,0
20150105.110945,2811.47,0,1068360,0,0,0,0,0,0
20150105.110946,2811.47,0,1068360,0,0,0,0,0,0
20150105.110947,2811.47,0,1068360,0,0,0,0,0,0
20150105.110948,2811.47,0,1068360,0,0,0,0,0,0
20150105.110949,2811.47,0,1068360,0,0,0,0,0,0
20150105.11095,2811.47,0,1068360,0,0,0,0,0,0
20150105.110951,2811.47,0,1068360,0,0,0,0,0,0
20150105.110952,2811.47,0,1068360,0,0,0,0,0,0
20150105.110953,2811.47,0,1068360,0,0,0,0,0,0
20150105.110954,2811.47,0,1068360,0,0,0,0,0,0
20150105.110955,2811.47,0,1068360,0,0,0,0,0,0
20150105.110956,2811.47,0,1068360,0,0,0,0,0,0
20150105.110957,2811.47,0,1068360,0,0,0,0,0,0
20150105.110958,2811.47,0,1068360,0,0,0,0,0,0
20150105.110959,2811.47,0,1068360,0,0,0,0,0,0
20150105.111,2811.47,0,1068360,0,0,0,0,0,0
20150105.111001,2811.47,0,1068360,0,0,0,0,0,0
20150105.111002,2811.47,0,1068360,0,0,0,0,0,0
20150105.111003,2811.47,0,1068360,0,0,0,0,0,0
20150105.111004,2811.47,0,1068360,0,0,0,0,0,0
20150105.111005,2811.47,0,1068360,0,0,0,0,0,0
20150105.111006,2811.47,0,1068360,0,0,0,0,0,0
20150105.111007,2811.47,0,1068360,0,0,0,0,0,0
20150105.111008,2811.47,0,1068360,0,0,0,0,0,0
20150105.111009,2811.47,0,1068360,0,0,0,0,0,0
20150105.11101,2811.47,0,1068360,0,0,0,0,0,0
20150105.111011,2811.47,0,1068360,0,0,0,0,0,0
20150105.111012,2811.47,0,1068360,0,0,0,0,0,0
20150105.111013,2811.47,0,1068360,0,0,0,0,0,0
20150105.111014,2811.47,0,1068360,0,0,0,0,0,0
20150105.111015,2811.47,0,1068360,0,0,0,0,0,0
20150105.111016,2811.47,0,1068360,0,0,0,0,0,0
20150105.111017,2811.47,0,1068360,0,0,0,0,0,0
20150105.111018,2811.47,0,1068360,0,0,0,0,0,0
20150105.111019,2811.47,0,1068360,0,0,0,0,0,0
20150105.11102,2811.47,0,1068360,0,0,0,0,0,0
20150105.111021,2811.47,0,1068360,0,0,0,0,0,0
20150105.111022,2811.47,0,1068360,0,0,0,0,0,0
20150105.111023,2811.47,0,1068360,0,0,0,0,0,0
20150105.111024,2811.47,0,1068360,0,0,0,0,0,0
20150105.111025,2811.47,0,1068360,0,0,0,0,0,0
20150105.111026,2811.47,0,1068360,0,0,0,0,0,0
20150105.111027,2811.47,0,1068360,0,0,0,0,0,0
20150105.111028,2811.47,0,1068360,0,0,0,0,0,0
20150105.111029,2811.47,0,1068360,0,0,0,0,0,0
20150105.11103,2811.47,0,1068360,0,0,0,0,0,0
20150105.111031,2811.47,0,1068360,0,0,0,0,0,0
20150105.111032,2811.47,0,1068360,0,0,0,0,0,0
20150105.111033,2811.47,0,1068360,0,0,0,0,0,0
20150105.111034,2811.47,0,1068360,0,0,0,0,0,0
20150105.111035,2811.47,0,1068360,0,0,0,0,0,0
20150105.111036,2811.47,0,1068360,0,0,0,0,0,0
20150105.111037,2811.47,0,1068360,0,0,0,0,0,0
20150105.111038,2811.47,0,1068360,0,0,0,0,0,0
20150105.111039,2811.47,0,1068360,0,0,0,0,0,0
20150105.11104,2811.47,0,1068360,0,0,0,0,0,0
20150105.111041,2811.47,0,1068360,0,0,0,0,0,0
20150105.111042,2811.47,0,1068360,0,0,0,0,0,0
20150105.111043,2811.47,0,1068360,0,0,0,0,0,0
20150105.111044,2811.47,0,1068360,0,0,0,0,0,0
20150105.111045,2811.47,0,1068360,0,0,0,0,0,0
20150105.111046,2811.47,0,1068360,0,0,0,0,0,0
20150105.111047,2811.47,0,1068360,0,0,0,0,0,0
20150105.111048,2811.47,0,1068360,0,0,0,0,0,0
20150105.111049,2811.47,0,1068360,0,0,0,0,0,0
20150105.11105,2811.47,0,1068360,0,0,0,0,0,0
20150105.111051,2811.47,0,1068360,0,0,0,0,0,0
20150105.111052,2811.47,0,1068360,0,0,0,0,0,0
20150105.111053,2811.47,0,1068360,0,0,0,0,0,0
20150105.111054,2811.47,0,1068360,0,0,0,0,0,0
20150105.111055,2811.47,0,1068360,0,0,0,0,0,0
20150105.111056,2811.47,0,1068360,0,0,0,0,0,0
20150105.111057,2811.47,0,1068360,0,0,0,0,0,0
20150105.111058,2811.47,0,1068360,0,0,0,0,0,0
20150105.111059,2811.47,0,1068360,0,0,0,0,0,0
20150105.1111,2811.47,0,1068360,0,0,0,0,0,0
20150105.111101,2811.47,0,1068360,0,0,0,0,0,0
20150105.111102,2811.47,0,1068360,0,0,0,0,0,0
20150105.111103,2811.47,0,1068360,0,0,0,0,0,0
20150105.111104,2811.47,0,1068360,0,0,0,0,0,0
20150105.111105,2811.47,0,1068360,0,0,0,0,0,0
20150105.111106,2811.47,0,1068360,0,0,0,0,0,0
20150105.111107,2811.47,0,1068360,0,0,0,0,0,0
20150105.111108,2811.47,0,1068360,0,0,0,0,0,0
20150105.111109,2811.47,0,1068360,0,0,0,0,0,0
20150105.11111,2811.47,0,1068360,0,0,0,0,0,0
20150105.111111,2811.47,0,1068360,0,0,0,0,0,0
20150105.111112,2811.47,0,1068360,0,0,0,0,0,0
20150105.111113,2811.47,0,1068360,0,0,0,0,0,0
20150105.111114,2811.47,0,1068360,0,0,0,0,0,0
20150105.111115,2811.47,0,1068360,0,0,0,0,0,0
20150105.111116,2811.47,0,1068360,0,0,0,0,0,0
20150105.111117,2811.47,0,1068360,0,0,0,0,0,0
20150105.111118,2811.47,0,1068360,0,0,0,0,0,0
20150105.111119,2811.47,0,1068360,0,0,0,0,0,0
20150105.11112,2811.47,0,1068360,0,0,0,0,0,0
20150105.111121,2811.47,0,1068360,0,0,0,0,0,0
20150105.111122,2811.47,0,1068360,0,0,0,0,0,0
20150105.111123,2811.47,0,1068360,0,0,0,0,0,0
20150105.111124,2811.47,0,1068360,0,0,0,0,0,0
20150105.111125,2811.47,0,1068360,0,0,0,0,0,0
20150105.111126,2811.47,0,1068360,0,0,0,0,0,0
20150105.111127,2811.47,0,1068360,0,0,0,0,0,0
20150105.111128,2811.47,0,1068360,0,0,0,0,0,0
20150105.111129,2811.47,0,1068360,0,0,0,0,0,0
20150105.11113,2811.47,0,1068360,0,0,0,0,0,0
20150105.111131,2811.47,0,1068360,0,0,0,0,0,0
20150105.111132,2811.47,0,1068360,0,0,0,0,0,0
20150105.111133,2811.47,0,1068360,0,0,0,0,0,0
20150105.111134,2811.47,0,1068360,0,0,0,0,0,0
20150105.111135,2811.47,0,1068360,0,0,0,0,0,0
20150105.111136,2811.47,0,1068360,0,0,0,0,0,0
20150105.111137,2811.47,0,1068360,0,0,0,0,0,0
20150105.111138,2811.47,0,1068360,0,0,0,0,0,0
20150105.111139,2811.47,0,1068360,0,0,0,0,0,0
20150105.11114,2811.47,0,1068360,0,0,0,0,0,0
20150105.111141,2811.47,0,1068360,0,0,0,0,0,0
20150105.111142,2811.47,0,1068360,0,0,0,0,0,0
20150105.111143,2811.47,0,1068360,0,0,0,0,0,0
20150105.111144,2811.47,0,1068360,0,0,0,0,0,0
20150105.111145,2811.47,0,1068360,0,0,0,0,0,0
20150105.111146,2811.47,0,1068360,0,0,0,0,0,0
20150105.111147,2811.47,0,1068360,0,0,0,0,0,0
20150105.111148,2811.47,0,1068360,0,0,0,0,0,0
20150105.111149,2811.47,0,1068360,0,0,0,0,0,0
20150105.11115,2811.47,0,1068360,0,0,0,0,0,0
20150105.111151,2811.47,0,1068360,0,0,0,0,0,0
20150105.111152,2811.47,0,1068360,0,0,0,0,0,0
20150105.111153,2811.47,0,1068360,0,0,0,0,0,0
20150105.111154,2811.47,0,1068360,0,0,0,0,0,0
20150105.111155,2811.47,0,1068360,0,0,0,0,0,0
20150105.111156,2811.47,0,1068360,0,0,0,0,0,0
20150105.111157,2811.47,0,1068360,0,0,0,0,0,0
20150105.111158,2811.47,0,1068360,0,0,0,0,0,0
20150105.111159,2811.47,0,1068360,0,0,0,0,0,0
20150105.1112,2811.47,0,1068360,0,0,0,0,0,0
20150105.111201,2811.47,0,1068360,0,0,0,0,0,0
20150105.111202,2811.47,0,1068360,0,0,0,0,0,0
20150105.111203,2811.47,0,1068360,0,0,0,0,0,0
20150105.111204,2811.47,0,1068360,0,0,0,0,0,0
20150105.111205,2811.47,0,1068360,0,0,0,0,0,0
20150105.111206,2811.47,0,1068360,0,0,0,0,0,0
20150105.111207,2811.47,0,1068360,0,0,0,0,0,0
20150105.111208,2811.47,0,1068360,0,0,0,0,0,0
20150105.111209,2811.47,0,1068360,0,0,0,0,0,0
20150105.11121,2811.47,0,1068360,0,0,0,0,0,0
20150105.111211,2811.47,0,1068360,0,0,0,0,0,0
20150105.111212,2811.47,0,1068360,0,0,0,0,0,0
20150105.111213,2811.47,0,1068360,0,0,0,0,0,0
20150105.111214,2811.47,0,1068360,0,0,0,0,0,0
20150105.111215,2811.47,0,1068360,0,0,0,0,0,0
20150105.111216,2811.47,0,1068360,0,0,0,0,0,0
20150105.111217,2811.47,0,1068360,0,0,0,0,0,0
20150105.111218,2811.47,0,1068360,0,0,0,0,0,0
20150105.111219,2811.47,0,1068360,0,0,0,0,0,0
20150105.11122,2811.47,0,1068360,0,0,0,0,0,0
20150105.111221,2811.47,0,1068360,0,0,0,0,0,0
20150105.111222,2811.47,0,1068360,0,0,0,0,0,0
20150105.111223,2811.47,0,1068360,0,0,0,0,0,0
20150105.111224,2811.47,0,1068360,0,0,0,0,0,0
20150105.111225,2811.47,0,1068360,0,0,0,0,0,0
20150105.111226,2811.47,0,1068360,0,0,0,0,0,0
20150105.111227,2811.47,0,1068360,0,0,0,0,0,0
20150105.111228,2811.47,0,1068360,0,0,0,0,0,0
20150105.111229,2811.47,0,1068360,0,0,0,0,0,0
20150105.11123,2811.47,0,1068360,0,0,0,0,0,0
20150105.111231,2811.47,0,1068360,0,0,0,0,0,0
20150105.111232,2811.47,0,1068360,0,0,0,0,0,0
20150105.111233,2811.47,0,1068360,0,0,0,0,0,0
20150105.111234,2811.47,0,1068360,0,0,0,0,0,0
20150105.111235,2811.47,0,1068360,0,0,0,0,0,0
20150105.111236,2811.47,0,1068360,0,0,0,0,0,0
20150105.111237,2811.47,0,1068360,0,0,0,0,0,0
20150105.111238,2811.47,0,1068360,0,0,0,0,0,0
20150105.111239,2811.47,0,1068360,0,0,0,0,0,0
20150105.11124,2811.47,0,1068360,0,0,0,0,0,0
20150105.111241,2811.47,0,1068360,0,0,0,0,0,0
20150105.111242,2811.47,0,1068360,0,0,0,0,0,0
20150105.111243,2811.47,0,1068360,0,0,0,0,0,0
20150105.111244,2811.47,0,1068360,0,0,0,0,0,0
20150105.111245,2811.47,0,1068360,0,0,0,0,0,0
20150105.111246,2811.47,0,1068360,0,0,0,0,0,0
20150105.111247,2811.47,0,1068360,0,0,0,0,0,0
20150105.111248,2811.47,0,1068360,0,0,0,0,0,0
20150105.111249,2811.47,0,1068360,0,0,0,0,0,0
20150105.11125,2811.47,0,1068360,0,0,0,0,0,0
20150105.111251,2811.47,0,1068360,0,0,0,0,0,0
20150105.111252,2811.47,0,1068360,0,0,0,0,0,0
20150105.111253,2811.47,0,1068360,0,0,0,0,0,0
20150105.111254,2811.47,0,1068360,0,0,0,0,0,0
20150105.111255,2811.47,0,1068360,0,0,0,0,0,0
20150105.111256,2811.47,0,1068360,0,0,0,0,0,0
20150105.111257,2811.47,0,1068360,0,0,0,0,0,0
20150105.111258,2811.47,0,1068360,0,0,0,0,0,0
20150105.111259,2811.47,0,1068360,0,0,0,0,0,0
20150105.1113,2811.47,0,1068360,0,0,0,0,0,0
20150105.111301,2811.47,0,1068360,0,0,0,0,0,0
20150105.111302,2811.47,0,1068360,0,0,0,0,0,0
20150105.111303,2811.47,0,1068360,0,0,0,0,0,0
20150105.111304,2811.47,0,1068360,0,0,0,0,0,0
20150105.111305,2811.47,0,1068360,0,0,0,0,0,0
20150105.111306,2811.47,0,1068360,0,0,0,0,0,0
20150105.111307,2811.47,0,1068360,0,0,0,0,0,0
20150105.111308,2811.47,0,1068360,0,0,0,0,0,0
20150105.111309,2811.47,0,1068360,0,0,0,0,0,0
20150105.11131,2811.47,0,1068360,0,0,0,0,0,0
20150105.111311,2811.47,0,1068360,0,0,0,0,0,0
20150105.111312,2811.47,0,1068360,0,0,0,0,0,0
20150105.111313,2811.47,0,1068360,0,0,0,0,0,0
20150105.111314,2811.47,0,1068360,0,0,0,0,0,0
20150105.111315,2811.47,0,1068360,0,0,0,0,0,0
20150105.111316,2811.47,0,1068360,0,0,0,0,0,0
20150105.111317,2811.47,0,1068360,0,0,0,0,0,0
20150105.111318,2811.47,0,1068360,0,0,0,0,0,0
20150105.111319,2811.47,0,1068360,0,0,0,0,0,0
20150105.11132,2811.47,0,1068360,0,0,0,0,0,0
20150105.111321,2811.47,0,1068360,0,0,0,0,0,0
20150105.111322,2811.47,0,1068360,0,0,0,0,0,0
20150105.111323,2811.47,0,1068360,0,0,0,0,0,0
20150105.111324,2811.47,0,1068360,0,0,0,0,0,0
20150105.111325,2811.47,0,1068360,0,0,0,0,0,0
20150105.111326,2811.47,0,1068360,0,0,0,0,0,0
20150105.111327,2811.47,0,1068360,0,0,0,0,0,0
20150105.111328,2811.47,0,1068360,0,0,0,0,0,0
20150105.111329,2811.47,0,1068360,0,0,0,0,0,0
20150105.11133,2811.47,0,1068360,0,0,0,0,0,0
20150105.111331,2811.47,0,1068360,0,0,0,0,0,0
20150105.111332,2811.47,0,1068360,0,0,0,0,0,0
20150105.111333,2811.47,0,1068360,0,0,0,0,0,0
20150105.111334,2811.47,0,1068360,0,0,0,0,0,0
20150105.111335,2811.47,0,1068360,0,0,0,0,0,0
20150105.111336,2811.47,0,1068360,0,0,0,0,0,0
20150105.111337,2811.47,0,1068360,0,0,0,0,0,0
20150105.111338,2811.47,0,1068360,0,0,0,0,0,0
20150105.111339,2811.47,0,1068360,0,0,0,0,0,0
20150105.11134,2811.47,0,1068360,0,0,0,0,0,0
20150105.111341,2811.47,0,1068360,0,0,0,0,0,0
20150105.111342,2811.47,0,1068360,0,0,0,0,0,0
20150105.111343,2811.47,0,1068360,0,0,0,0,0,0
20150105.111344,2811.47,0,1068360,0,0,0,0,0,0
20150105.111345,2811.47,0,1068360,0,0,0,0,0,0
20150105.111346,2811.47,0,1068360,0,0,0,0,0,0
20150105.111347,2811.47,0,1068360,0,0,0,0,0,0
20150105.111348,2811.47,0,1068360,0,0,0,0,0,0
20150105.111349,2811.47,0,1068360,0,0,0,0,0,0
20150105.11135,2811.47,0,1068360,0,0,0,0,0,0
20150105.111351,2811.47,0,1068360,0,0,0,0,0,0
20150105.111352,2811.47,0,1068360,0,0,0,0,0,0
20150105.111353,2811.47,0,1068360,0,0,0,0,0,0
20150105.111354,2811.47,0,1068360,0,0,0,0,0,0
20150105.111355,2811.47,0,1068360,0,0,0,0,0,0
20150105.111356,2811.47,0,1068360,0,0,0,0,0,0
20150105.111357,2811.47,0,1068360,0,0,0,0,0,0
20150105.111358,2811.47,0,1068360,0,0,0,0,0,0
20150105.111359,2811.47,0,1068360,0,0,0,0,0,0
20150105.1114,2811.47,0,1068360,0,0,0,0,0,0
20150105.111401,2811.47,0,1068360,0,0,0,0,0,0
20150105.111402,2811.47,0,1068360,0,0,0,0,0,0
20150105.111403,2811.47,0,1068360,0,0,0,0,0,0
20150105.111404,2811.47,0,1068360,0,0,0,0,0,0
20150105.111405,2811.47,0,1068360,0,0,0,0,0,0
20150105.111406,2811.47,0,1068360,0,0,0,0,0,0
20150105.111407,2811.47,0,1068360,0,0,0,0,0,0
20150105.111408,2811.47,0,1068360,0,0,0,0,0,0
20150105.111409,2811.47,0,1068360,0,0,0,0,0,0
20150105.11141,2811.47,0,1068360,0,0,0,0,0,0
20150105.111411,2811.47,0,1068360,0,0,0,0,0,0
20150105.111412,2811.47,0,1068360,0,0,0,0,0,0
20150105.111413,2811.47,0,1068360,0,0,0,0,0,0
20150105.111414,2811.47,0,1068360,0,0,0,0,0,0
20150105.111415,2811.47,0,1068360,0,0,0,0,0,0
20150105.111416,2811.47,0,1068360,0,0,0,0,0,0
20150105.111417,2811.47,0,1068360,0,0,0,0,0,0
20150105.111418,2811.47,0,1068360,0,0,0,0,0,0
20150105.111419,2811.47,0,1068360,0,0,0,0,0,0
20150105.11142,2811.47,0,1068360,0,0,0,0,0,0
20150105.111421,2811.47,0,1068360,0,0,0,0,0,0
20150105.111422,2811.47,0,1068360,0,0,0,0,0,0
20150105.111423,2811.47,0,1068360,0,0,0,0,0,0
20150105.111424,2811.47,0,1068360,0,0,0,0,0,0
20150105.111425,2811.47,0,1068360,0,0,0,0,0,0
20150105.111426,2811.47,0,1068360,0,0,0,0,0,0
20150105.111427,2811.47,0,1068360,0,0,0,0,0,0
20150105.111428,2811.47,0,1068360,0,0,0,0,0,0
20150105.111429,2811.47,0,1068360,0,0,0,0,0,0
20150105.11143,2811.47,0,1068360,0,0,0,0,0,0
20150105.111431,2811.47,0,1068360,0,0,0,0,0,0
20150105.111432,2811.47,0,1068360,0,0,0,0,0,0
20150105.111433,2811.47,0,1068360,0,0,0,0,0,0
20150105.111434,2811.47,0,1068360,0,0,0,0,0,0
20150105.111435,2811.47,0,1068360,0,0,0,0,0,0
20150105.111436,2811.47,0,1068360,0,0,0,0,0,0
20150105.111437,2811.47,0,1068360,0,0,0,0,0,0
20150105.111438,2811.47,0,1068360,0,0,0,0,0,0
20150105.111439,2811.47,0,1068360,0,0,0,0,0,0
20150105.11144,2811.47,0,1068360,0,0,0,0,0,0
20150105.111441,2811.47,0,1068360,0,0,0,0,0,0
20150105.111442,2811.47,0,1068360,0,0,0,0,0,0
20150105.111443,2811.47,0,1068360,0,0,0,0,0,0
20150105.111444,2811.47,0,1068360,0,0,0,0,0,0
20150105.111445,2811.47,0,1068360,0,0,0,0,0,0
20150105.111446,2811.47,0,1068360,0,0,0,0,0,0
20150105.111447,2811.47,0,1068360,0,0,0,0,0,0
20150105.111448,2811.47,0,1068360,0,0,0,0,0,0
20150105.111449,2811.47,0,1068360,0,0,0,0,0,0
20150105.11145,2811.47,0,1068360,0,0,0,0,0,0
20150105.111451,2811.47,0,1068360,0,0,0,0,0,0
20150105.111452,2811.47,0,1068360,0,0,0,0,0,0
20150105.111453,2811.47,0,1068360,0,0,0,0,0,0
20150105.111454,2811.47,0,1068360,0,0,0,0,0,0
20150105.111455,2811.47,0,1068360,0,0,0,0,0,0
20150105.111456,2811.47,0,1068360,0,0,0,0,0,0
20150105.111457,2811.47,0,1068360,0,0,0,0,0,0
20150105.111458,2811.47,0,1068360,0,0,0,0,0,0
20150105.111459,2811.47,0,1068360,0,0,0,0,0,0
20150105.1115,2811.47,0,1068360,0,0,0,0,0,0
20150105.111501,2811.47,0,1068360,0,0,0,0,0,0
20150105.111502,2811.47,0,1068360,0,0,0,0,0,0
20150105.111503,2811.47,0,1068360,0,0,0,0,0,0
20150105.111504,2811.47,0,1068360,0,0,0,0,0,0
20150105.111505,2811.47,0,1068360,0,0,0,0,0,0
20150105.111506,2811.47,0,1068360,0,0,0,0,0,0
20150105.111507,2811.47,0,1068360,0,0,0,0,0,0
20150105.111508,2811.47,0,1068360,0,0,0,0,0,0
20150105.111509,2811.47,0,1068360,0,0,0,0,0,0
20150105.11151,2811.47,0,1068360,0,0,0,0,0,0
20150105.111511,2811.47,0,1068360,0,0,0,0,0,0
20150105.111512,2811.47,0,1068360,0,0,0,0,0,0
20150105.111513,2811.47,0,1068360,0,0,0,0,0,0
20150105.111514,2811.47,0,1068360,0,0,0,0,0,0
20150105.111515,2811.47,0,1068360,0,0,0,0,0,0
20150105.111516,2811.47,0,1068360,0,0,0,0,0,0
20150105.111517,2811.47,0,1068360,0,0,0,0,0,0
20150105.111518,2811.47,0,1068360,0,0,0,0,0,0
20150105.111519,2811.47,0,1068360,0,0,0,0,0,0
20150105.11152,2811.47,0,1068360,0,0,0,0,0,0
20150105.111521,2811.47,0,1068360,0,0,0,0,0,0
20150105.111522,2811.47,0,1068360,0,0,0,0,0,0
20150105.111523,2811.47,0,1068360,0,0,0,0,0,0
20150105.111524,2811.47,0,1068360,0,0,0,0,0,0
20150105.111525,2811.47,0,1068360,0,0,0,0,0,0
20150105.111526,2811.47,0,1068360,0,0,0,0,0,0
20150105.111527,2811.47,0,1068360,0,0,0,0,0,0
20150105.111528,2811.47,0,1068360,0,0,0,0,0,0
20150105.111529,2811.47,0,1068360,0,0,0,0,0,0
20150105.11153,2811.47,0,1068360,0,0,0,0,0,0
20150105.111531,2811.47,0,1068360,0,0,0,0,0,0
20150105.111532,2811.47,0,1068360,0,0,0,0,0,0
20150105.111533,2811.47,0,1068360,0,0,0,0,0,0
20150105.111534,2811.47,0,1068360,0,0,0,0,0,0
20150105.111535,2811.47,0,1068360,0,0,0,0,0,0
20150105.111536,2811.47,0,1068360,0,0,0,0,0,0
20150105.111537,2811.47,0,1068360,0,0,0,0,0,0
20150105.111538,2811.47,0,1068360,0,0,0,0,0,0
20150105.111539,2811.47,0,1068360,0,0,0,0,0,0
20150105.11154,2811.47,0,1068360,0,0,0,0,0,0
20150105.111541,2811.47,0,1068360,0,0,0,0,0,0
20150105.111542,2811.47,0,1068360,0,0,0,0,0,0
20150105.111543,2811.47,0,1068360,0,0,0,0,0,0
20150105.111544,2811.47,0,1068360,0,0,0,0,0,0
20150105.111545,2811.47,0,1068360,0,0,0,0,0,0
20150105.111546,2811.47,0,1068360,0,0,0,0,0,0
20150105.111547,2811.47,0,1068360,0,0,0,0,0,0
20150105.111548,2811.47,0,1068360,0,0,0,0,0,0
20150105.111549,2811.47,0,1068360,0,0,0,0,0,0
20150105.11155,2811.47,0,1068360,0,0,0,0,0,0
20150105.111551,2811.47,0,1068360,0,0,0,0,0,0
20150105.111552,2811.47,0,1068360,0,0,0,0,0,0
20150105.111553,2811.47,0,1068360,0,0,0,0,0,0
20150105.111554,2811.47,0,1068360,0,0,0,0,0,0
20150105.111555,2811.47,0,1068360,0,0,0,0,0,0
20150105.111556,2811.47,0,1068360,0,0,0,0,0,0
20150105.111557,2811.47,0,1068360,0,0,0,0,0,0
20150105.111558,2811.47,0,1068360,0,0,0,0,0,0
20150105.111559,2811.47,0,1068360,0,0,0,0,0,0
20150105.1116,2811.47,0,1068360,0,0,0,0,0,0
20150105.111601,2811.47,0,1068360,0,0,0,0,0,0
20150105.111602,2811.47,0,1068360,0,0,0,0,0,0
20150105.111603,2811.47,0,1068360,0,0,0,0,0,0
20150105.111604,2811.47,0,1068360,0,0,0,0,0,0
20150105.111605,2811.47,0,1068360,0,0,0,0,0,0
20150105.111606,2811.47,0,1068360,0,0,0,0,0,0
20150105.111607,2811.47,0,1068360,0,0,0,0,0,0
20150105.111608,2811.47,0,1068360,0,0,0,0,0,0
20150105.111609,2811.47,0,1068360,0,0,0,0,0,0
20150105.11161,2811.47,0,1068360,0,0,0,0,0,0
20150105.111611,2811.47,0,1068360,0,0,0,0,0,0
20150105.111612,2811.47,0,1068360,0,0,0,0,0,0
20150105.111613,2811.47,0,1068360,0,0,0,0,0,0
20150105.111614,2811.47,0,1068360,0,0,0,0,0,0
20150105.111615,2811.47,0,1068360,0,0,0,0,0,0
20150105.111616,2811.47,0,1068360,0,0,0,0,0,0
20150105.111617,2811.47,0,1068360,0,0,0,0,0,0
20150105.111618,2811.47,0,1068360,0,0,0,0,0,0
20150105.111619,2811.47,0,1068360,0,0,0,0,0,0
20150105.11162,2811.47,0,1068360,0,0,0,0,0,0
20150105.111621,2811.47,0,1068360,0,0,0,0,0,0
20150105.111622,2811.47,0,1068360,0,0,0,0,0,0
20150105.111623,2811.47,0,1068360,0,0,0,0,0,0
20150105.111624,2811.47,0,1068360,0,0,0,0,0,0
20150105.111625,2811.47,0,1068360,0,0,0,0,0,0
20150105.111626,2811.47,0,1068360,0,0,0,0,0,0
20150105.111627,2811.47,0,1068360,0,0,0,0,0,0
20150105.111628,2811.47,0,1068360,0,0,0,0,0,0
20150105.111629,2811.47,0,1068360,0,0,0,0,0,0
20150105.11163,2811.47,0,1068360,0,0,0,0,0,0
20150105.111631,2811.47,0,1068360,0,0,0,0,0,0
20150105.111632,2811.47,0,1068360,0,0,0,0,0,0
20150105.111633,2811.47,0,1068360,0,0,0,0,0,0
20150105.111634,2811.47,0,1068360,0,0,0,0,0,0
20150105.111635,2811.47,0,1068360,0,0,0,0,0,0
20150105.111636,2811.47,0,1068360,0,0,0,0,0,0
20150105.111637,2811.47,0,1068360,0,0,0,0,0,0
20150105.111638,2811.47,0,1068360,0,0,0,0,0,0
20150105.111639,2811.47,0,1068360,0,0,0,0,0,0
20150105.11164,2811.47,0,1068360,0,0,0,0,0,0
20150105.111641,2811.47,0,1068360,0,0,0,0,0,0
20150105.111642,2811.47,0,1068360,0,0,0,0,0,0
20150105.111643,2811.47,0,1068360,0,0,0,0,0,0
20150105.111644,2811.47,0,1068360,0,0,0,0,0,0
20150105.111645,2811.47,0,1068360,0,0,0,0,0,0
20150105.111646,2811.47,0,1068360,0,0,0,0,0,0
20150105.111647,2811.47,0,1068360,0,0,0,0,0,0
20150105.111648,2811.47,0,1068360,0,0,0,0,0,0
20150105.111649,2811.47,0,1068360,0,0,0,0,0,0
20150105.11165,2811.47,0,1068360,0,0,0,0,0,0
20150105.111651,2811.47,0,1068360,0,0,0,0,0,0
20150105.111652,2811.47,0,1068360,0,0,0,0,0,0
20150105.111653,2811.47,0,1068360,0,0,0,0,0,0
20150105.111654,2811.47,0,1068360,0,0,0,0,0,0
20150105.111655,2811.47,0,1068360,0,0,0,0,0,0
20150105.111656,2811.47,0,1068360,0,0,0,0,0,0
20150105.111657,2811.47,0,1068360,0,0,0,0,0,0
20150105.111658,2811.47,0,1068360,0,0,0,0,0,0
20150105.111659,2811.47,0,1068360,0,0,0,0,0,0
20150105.1117,2811.47,0,1068360,0,0,0,0,0,0
20150105.111701,2811.47,0,1068360,0,0,0,0,0,0
20150105.111702,2811.47,0,1068360,0,0,0,0,0,0
20150105.111703,2811.47,0,1068360,0,0,0,0,0,0
20150105.111704,2811.47,0,1068360,0,0,0,0,0,0
20150105.111705,2811.47,0,1068360,0,0,0,0,0,0
20150105.111706,2811.47,0,1068360,0,0,0,0,0,0
20150105.111707,2811.47,0,1068360,0,0,0,0,0,0
20150105.111708,2811.47,0,1068360,0,0,0,0,0,0
20150105.111709,2811.47,0,1068360,0,0,0,0,0,0
20150105.11171,2811.47,0,1068360,0,0,0,0,0,0
20150105.111711,2811.47,0,1068360,0,0,0,0,0,0
20150105.111712,2811.47,0,1068360,0,0,0,0,0,0
20150105.111713,2811.47,0,1068360,0,0,0,0,0,0
20150105.111714,2811.47,0,1068360,0,0,0,0,0,0
20150105.111715,2811.47,0,1068360,0,0,0,0,0,0
20150105.111716,2811.47,0,1068360,0,0,0,0,0,0
20150105.111717,2811.47,0,1068360,0,0,0,0,0,0
20150105.111718,2811.47,0,1068360,0,0,0,0,0,0
20150105.111719,2811.47,0,1068360,0,0,0,0,0,0
20150105.11172,2811.47,0,1068360,0,0,0,0,0,0
20150105.111721,2811.47,0,1068360,0,0,0,0,0,0
20150105.111722,2811.47,0,1068360,0,0,0,0,0,0
20150105.111723,2811.47,0,1068360,0,0,0,0,0,0
20150105.111724,2811.47,0,1068360,0,0,0,0,0,0
20150105.111725,2811.47,0,1068360,0,0,0,0,0,0
20150105.111726,2811.47,0,1068360,0,0,0,0,0,0
20150105.111727,2811.47,0,1068360,0,0,0,0,0,0
20150105.111728,2811.47,0,1068360,0,0,0,0,0,0
20150105.111729,2811.47,0,1068360,0,0,0,0,0,0
20150105.11173,2811.47,0,1068360,0,0,0,0,0,0
20150105.111731,2811.47,0,1068360,0,0,0,0,0,0
20150105.111732,2811.47,0,1068360,0,0,0,0,0,0
20150105.111733,2811.47,0,1068360,0,0,0,0,0,0
20150105.111734,2811.47,0,1068360,0,0,0,0,0,0
20150105.111735,2811.47,0,1068360,0,0,0,0,0,0
20150105.111736,2811.47,0,1068360,0,0,0,0,0,0
20150105.111737,2811.47,0,1068360,0,0,0,0,0,0
20150105.111738,2811.47,0,1068360,0,0,0,0,0,0
20150105.111739,2811.47,0,1068360,0,0,0,0,0,0
20150105.11174,2811.47,0,1068360,0,0,0,0,0,0
20150105.111741,2811.47,0,1068360,0,0,0,0,0,0
20150105.111742,2811.47,0,1068360,0,0,0,0,0,0
20150105.111743,2811.47,0,1068360,0,0,0,0,0,0
20150105.111744,2811.47,0,1068360,0,0,0,0,0,0
20150105.111745,2811.47,0,1068360,0,0,0,0,0,0
20150105.111746,2811.47,0,1068360,0,0,0,0,0,0
20150105.111747,2811.47,0,1068360,0,0,0,0,0,0
20150105.111748,2811.47,0,1068360,0,0,0,0,0,0
20150105.111749,2811.47,0,1068360,0,0,0,0,0,0
20150105.11175,2811.47,0,1068360,0,0,0,0,0,0
20150105.111751,2811.47,0,1068360,0,0,0,0,0,0
20150105.111752,2811.47,0,1068360,0,0,0,0,0,0
20150105.111753,2811.47,0,1068360,0,0,0,0,0,0
20150105.111754,2811.47,0,1068360,0,0,0,0,0,0
20150105.111755,2811.47,0,1068360,0,0,0,0,0,0
20150105.111756,2811.47,0,1068360,0,0,0,0,0,0
20150105.111757,2811.47,0,1068360,0,0,0,0,0,0
20150105.111758,2811.47,0,1068360,0,0,0,0,0,0
20150105.111759,2811.47,0,1068360,0,0,0,0,0,0
20150105.1118,2811.47,0,1068360,0,0,0,0,0,0
20150105.111801,2811.47,0,1068360,0,0,0,0,0,0
20150105.111802,2811.47,0,1068360,0,0,0,0,0,0
20150105.111803,2811.47,0,1068360,0,0,0,0,0,0
20150105.111804,2811.47,0,1068360,0,0,0,0,0,0
20150105.111805,2811.47,0,1068360,0,0,0,0,0,0
20150105.111806,2811.47,0,1068360,0,0,0,0,0,0
20150105.111807,2811.47,0,1068360,0,0,0,0,0,0
20150105.111808,2811.47,0,1068360,0,0,0,0,0,0
20150105.111809,2811.47,0,1068360,0,0,0,0,0,0
20150105.11181,2811.47,0,1068360,0,0,0,0,0,0
20150105.111811,2811.47,0,1068360,0,0,0,0,0,0
20150105.111812,2811.47,0,1068360,0,0,0,0,0,0
20150105.111813,2811.47,0,1068360,0,0,0,0,0,0
20150105.111814,2811.47,0,1068360,0,0,0,0,0,0
20150105.111815,2811.47,0,1068360,0,0,0,0,0,0
20150105.111816,2811.47,0,1068360,0,0,0,0,0,0
20150105.111817,2811.47,0,1068360,0,0,0,0,0,0
20150105.111818,2811.47,0,1068360,0,0,0,0,0,0
20150105.111819,2811.47,0,1068360,0,0,0,0,0,0
20150105.11182,2811.47,0,1068360,0,0,0,0,0,0
20150105.111821,2811.47,0,1068360,0,0,0,0,0,0
20150105.111822,2811.47,0,1068360,0,0,0,0,0,0
20150105.111823,2811.47,0,1068360,0,0,0,0,0,0
20150105.111824,2811.47,0,1068360,0,0,0,0,0,0
20150105.111825,2811.47,0,1068360,0,0,0,0,0,0
20150105.111826,2811.47,0,1068360,0,0,0,0,0,0
20150105.111827,2811.47,0,1068360,0,0,0,0,0,0
20150105.111828,2811.47,0,1068360,0,0,0,0,0,0
20150105.111829,2811.47,0,1068360,0,0,0,0,0,0
20150105.11183,2811.47,0,1068360,0,0,0,0,0,0
20150105.111831,2811.47,0,1068360,0,0,0,0,0,0
20150105.111832,2811.47,0,1068360,0,0,0,0,0,0
20150105.111833,2811.47,0,1068360,0,0,0,0,0,0
20150105.111834,2811.47,0,1068360,0,0,0,0,0,0
20150105.111835,2811.47,0,1068360,0,0,0,0,0,0
20150105.111836,2811.47,0,1068360,0,0,0,0,0,0
20150105.111837,2811.47,0,1068360,0,0,0,0,0,0
20150105.111838,2811.47,0,1068360,0,0,0,0,0,0
20150105.111839,2811.47,0,1068360,0,0,0,0,0,0
20150105.11184,2811.47,0,1068360,0,0,0,0,0,0
20150105.111841,2811.47,0,1068360,0,0,0,0,0,0
20150105.111842,2811.47,0,1068360,0,0,0,0,0,0
20150105.111843,2811.47,0,1068360,0,0,0,0,0,0
20150105.111844,2811.47,0,1068360,0,0,0,0,0,0
20150105.111845,2811.47,0,1068360,0,0,0,0,0,0
20150105.111846,2811.47,0,1068360,0,0,0,0,0,0
20150105.111847,2811.47,0,1068360,0,0,0,0,0,0
20150105.111848,2811.47,0,1068360,0,0,0,0,0,0
20150105.111849,2811.47,0,1068360,0,0,0,0,0,0
20150105.11185,2811.47,0,1068360,0,0,0,0,0,0
20150105.111851,2811.47,0,1068360,0,0,0,0,0,0
20150105.111852,2811.47,0,1068360,0,0,0,0,0,0
20150105.111853,2811.47,0,1068360,0,0,0,0,0,0
20150105.111854,2811.47,0,1068360,0,0,0,0,0,0
20150105.111855,2811.47,0,1068360,0,0,0,0,0,0
20150105.111856,2811.47,0,1068360,0,0,0,0,0,0
20150105.111857,2811.47,0,1068360,0,0,0,0,0,0
20150105.111858,2811.47,0,1068360,0,0,0,0,0,0
20150105.111859,2811.47,0,1068360,0,0,0,0,0,0
20150105.1119,2811.47,0,1068360,0,0,0,0,0,0
20150105.111901,2811.47,0,1068360,0,0,0,0,0,0
20150105.111902,2811.47,0,1068360,0,0,0,0,0,0
20150105.111903,2811.47,0,1068360,0,0,0,0,0,0
20150105.111904,2811.47,0,1068360,0,0,0,0,0,0
20150105.111905,2811.47,0,1068360,0,0,0,0,0,0
20150105.111906,2811.47,0,1068360,0,0,0,0,0,0
20150105.111907,2811.47,0,1068360,0,0,0,0,0,0
20150105.111908,2811.47,0,1068360,0,0,0,0,0,0
20150105.111909,2811.47,0,1068360,0,0,0,0,0,0
20150105.11191,2811.47,0,1068360,0,0,0,0,0,0
20150105.111911,2811.47,0,1068360,0,0,0,0,0,0
20150105.111912,2811.47,0,1068360,0,0,0,0,0,0
20150105.111913,2811.47,0,1068360,0,0,0,0,0,0
20150105.111914,2811.47,0,1068360,0,0,0,0,0,0
20150105.111915,2811.47,0,1068360,0,0,0,0,0,0
20150105.111916,2811.47,0,1068360,0,0,0,0,0,0
20150105.111917,2811.47,0,1068360,0,0,0,0,0,0
20150105.111918,2811.47,0,1068360,0,0,0,0,0,0
20150105.111919,2811.47,0,1068360,0,0,0,0,0,0
20150105.11192,2811.47,0,1068360,0,0,0,0,0,0
20150105.111921,2811.47,0,1068360,0,0,0,0,0,0
20150105.111922,2811.47,0,1068360,0,0,0,0,0,0
20150105.111923,2811.47,0,1068360,0,0,0,0,0,0
20150105.111924,2811.47,0,1068360,0,0,0,0,0,0
20150105.111925,2811.47,0,1068360,0,0,0,0,0,0
20150105.111926,2811.47,0,1068360,0,0,0,0,0,0
20150105.111927,2811.47,0,1068360,0,0,0,0,0,0
20150105.111928,2811.47,0,1068360,0,0,0,0,0,0
20150105.111929,2811.47,0,1068360,0,0,0,0,0,0
20150105.11193,2811.47,0,1068360,0,0,0,0,0,0
20150105.111931,2811.47,0,1068360,0,0,0,0,0,0
20150105.111932,2811.47,0,1068360,0,0,0,0,0,0
20150105.111933,2811.47,0,1068360,0,0,0,0,0,0
20150105.111934,2811.47,0,1068360,0,0,0,0,0,0
20150105.111935,2811.47,0,1068360,0,0,0,0,0,0
20150105.111936,2811.47,0,1068360,0,0,0,0,0,0
20150105.111937,2811.47,0,1068360,0,0,0,0,0,0
20150105.111938,2811.47,0,1068360,0,0,0,0,0,0
20150105.111939,2811.47,0,1068360,0,0,0,0,0,0
20150105.11194,2811.47,0,1068360,0,0,0,0,0,0
20150105.111941,2811.47,0,1068360,0,0,0,0,0,0
20150105.111942,2811.47,0,1068360,0,0,0,0,0,0
20150105.111943,2811.47,0,1068360,0,0,0,0,0,0
20150105.111944,2811.47,0,1068360,0,0,0,0,0,0
20150105.111945,2811.47,0,1068360,0,0,0,0,0,0
20150105.111946,2811.47,0,1068360,0,0,0,0,0,0
20150105.111947,2811.47,0,1068360,0,0,0,0,0,0
20150105.111948,2811.47,0,1068360,0,0,0,0,0,0
20150105.111949,2811.47,0,1068360,0,0,0,0,0,0
20150105.11195,2811.47,0,1068360,0,0,0,0,0,0
20150105.111951,2811.47,0,1068360,0,0,0,0,0,0
20150105.111952,2811.47,0,1068360,0,0,0,0,0,0
20150105.111953,2811.47,0,1068360,0,0,0,0,0,0
20150105.111954,2811.47,0,1068360,0,0,0,0,0,0
20150105.111955,2811.47,0,1068360,0,0,0,0,0,0
20150105.111956,2811.47,0,1068360,0,0,0,0,0,0
20150105.111957,2811.47,0,1068360,0,0,0,0,0,0
20150105.111958,2811.47,0,1068360,0,0,0,0,0,0
20150105.111959,2811.47,0,1068360,0,0,0,0,0,0
20150105.112,2811.47,0,1068360,0,0,0,0,0,0
20150105.112001,2811.47,0,1068360,0,0,0,0,0,0
20150105.112002,2811.47,0,1068360,0,0,0,0,0,0
20150105.112003,2811.47,0,1068360,0,0,0,0,0,0
20150105.112004,2811.47,0,1068360,0,0,0,0,0,0
20150105.112005,2811.47,0,1068360,0,0,0,0,0,0
20150105.112006,2811.47,0,1068360,0,0,0,0,0,0
20150105.112007,2811.47,0,1068360,0,0,0,0,0,0
20150105.112008,2811.47,0,1068360,0,0,0,0,0,0
20150105.112009,2811.47,0,1068360,0,0,0,0,0,0
20150105.11201,2811.47,0,1068360,0,0,0,0,0,0
20150105.112011,2811.47,0,1068360,0,0,0,0,0,0
20150105.112012,2811.47,0,1068360,0,0,0,0,0,0
20150105.112013,2811.47,0,1068360,0,0,0,0,0,0
20150105.112014,2811.47,0,1068360,0,0,0,0,0,0
20150105.112015,2811.47,0,1068360,0,0,0,0,0,0
20150105.112016,2811.47,0,1068360,0,0,0,0,0,0
20150105.112017,2811.47,0,1068360,0,0,0,0,0,0
20150105.112018,2811.47,0,1068360,0,0,0,0,0,0
20150105.112019,2811.47,0,1068360,0,0,0,0,0,0
20150105.11202,2811.47,0,1068360,0,0,0,0,0,0
20150105.112021,2811.47,0,1068360,0,0,0,0,0,0
20150105.112022,2811.47,0,1068360,0,0,0,0,0,0
20150105.112023,2811.47,0,1068360,0,0,0,0,0,0
20150105.112024,2811.47,0,1068360,0,0,0,0,0,0
20150105.112025,2811.47,0,1068360,0,0,0,0,0,0
20150105.112026,2811.47,0,1068360,0,0,0,0,0,0
20150105.112027,2811.47,0,1068360,0,0,0,0,0,0
20150105.112028,2811.47,0,1068360,0,0,0,0,0,0
20150105.112029,2811.47,0,1068360,0,0,0,0,0,0
20150105.11203,2811.47,0,1068360,0,0,0,0,0,0
20150105.112031,2811.47,0,1068360,0,0,0,0,0,0
20150105.112032,2811.47,0,1068360,0,0,0,0,0,0
20150105.112033,2811.47,0,1068360,0,0,0,0,0,0
20150105.112034,2811.47,0,1068360,0,0,0,0,0,0
20150105.112035,2811.47,0,1068360,0,0,0,0,0,0
20150105.112036,2811.47,0,1068360,0,0,0,0,0,0
20150105.112037,2811.47,0,1068360,0,0,0,0,0,0
20150105.112038,2811.47,0,1068360,0,0,0,0,0,0
20150105.112039,2811.47,0,1068360,0,0,0,0,0,0
20150105.11204,2811.47,0,1068360,0,0,0,0,0,0
20150105.112041,2811.47,0,1068360,0,0,0,0,0,0
20150105.112042,2811.47,0,1068360,0,0,0,0,0,0
20150105.112043,2811.47,0,1068360,0,0,0,0,0,0
20150105.112044,2811.47,0,1068360,0,0,0,0,0,0
20150105.112045,2811.47,0,1068360,0,0,0,0,0,0
20150105.112046,2811.47,0,1068360,0,0,0,0,0,0
20150105.112047,2811.47,0,1068360,0,0,0,0,0,0
20150105.112048,2811.47,0,1068360,0,0,0,0,0,0
20150105.112049,2811.47,0,1068360,0,0,0,0,0,0
20150105.11205,2811.47,0,1068360,0,0,0,0,0,0
20150105.112051,2811.47,0,1068360,0,0,0,0,0,0
20150105.112052,2811.47,0,1068360,0,0,0,0,0,0
20150105.112053,2811.47,0,1068360,0,0,0,0,0,0
20150105.112054,2811.47,0,1068360,0,0,0,0,0,0
20150105.112055,2811.47,0,1068360,0,0,0,0,0,0
20150105.112056,2811.47,0,1068360,0,0,0,0,0,0
20150105.112057,2811.47,0,1068360,0,0,0,0,0,0
20150105.112058,2811.47,0,1068360,0,0,0,0,0,0
20150105.112059,2811.47,0,1068360,0,0,0,0,0,0
20150105.1121,2811.47,0,1068360,0,0,0,0,0,0
20150105.112101,2811.47,0,1068360,0,0,0,0,0,0
20150105.112102,2811.47,0,1068360,0,0,0,0,0,0
20150105.112103,2811.47,0,1068360,0,0,0,0,0,0
20150105.112104,2811.47,0,1068360,0,0,0,0,0,0
20150105.112105,2811.47,0,1068360,0,0,0,0,0,0
20150105.112106,2811.47,0,1068360,0,0,0,0,0,0
20150105.112107,2811.47,0,1068360,0,0,0,0,0,0
20150105.112108,2811.47,0,1068360,0,0,0,0,0,0
20150105.112109,2811.47,0,1068360,0,0,0,0,0,0
20150105.11211,2811.47,0,1068360,0,0,0,0,0,0
20150105.112111,2811.47,0,1068360,0,0,0,0,0,0
20150105.112112,2811.47,0,1068360,0,0,0,0,0,0
20150105.112113,2811.47,0,1068360,0,0,0,0,0,0
20150105.112114,2811.47,0,1068360,0,0,0,0,0,0
20150105.112115,2811.47,0,1068360,0,0,0,0,0,0
20150105.112116,2811.47,0,1068360,0,0,0,0,0,0
20150105.112117,2811.47,0,1068360,0,0,0,0,0,0
20150105.112118,2811.47,0,1068360,0,0,0,0,0,0
20150105.112119,2811.47,0,1068360,0,0,0,0,0,0
20150105.11212,2811.47,0,1068360,0,0,0,0,0,0
20150105.112121,2811.47,0,1068360,0,0,0,0,0,0
20150105.112122,2811.47,0,1068360,0,0,0,0,0,0
20150105.112123,2811.47,0,1068360,0,0,0,0,0,0
20150105.112124,2811.47,0,1068360,0,0,0,0,0,0
20150105.112125,2811.47,0,1068360,0,0,0,0,0,0
20150105.112126,2811.47,0,1068360,0,0,0,0,0,0
20150105.112127,2811.47,0,1068360,0,0,0,0,0,0
20150105.112128,2811.47,0,1068360,0,0,0,0,0,0
20150105.112129,2811.47,0,1068360,0,0,0,0,0,0
20150105.11213,2811.47,0,1068360,0,0,0,0,0,0
20150105.112131,2811.47,0,1068360,0,0,0,0,0,0
20150105.112132,2811.47,0,1068360,0,0,0,0,0,0
20150105.112133,2811.47,0,1068360,0,0,0,0,0,0
20150105.112134,2811.47,0,1068360,0,0,0,0,0,0
20150105.112135,2811.47,0,1068360,0,0,0,0,0,0
20150105.112136,2811.47,0,1068360,0,0,0,0,0,0
20150105.112137,2811.47,0,1068360,0,0,0,0,0,0
20150105.112138,2811.47,0,1068360,0,0,0,0,0,0
20150105.112139,2811.47,0,1068360,0,0,0,0,0,0
20150105.11214,2811.47,0,1068360,0,0,0,0,0,0
20150105.112141,2811.47,0,1068360,0,0,0,0,0,0
20150105.112142,2811.47,0,1068360,0,0,0,0,0,0
20150105.112143,2811.47,0,1068360,0,0,0,0,0,0
20150105.112144,2811.47,0,1068360,0,0,0,0,0,0
20150105.112145,2811.47,0,1068360,0,0,0,0,0,0
20150105.112146,2811.47,0,1068360,0,0,0,0,0,0
20150105.112147,2811.47,0,1068360,0,0,0,0,0,0
20150105.112148,2811.47,0,1068360,0,0,0,0,0,0
20150105.112149,2811.47,0,1068360,0,0,0,0,0,0
20150105.11215,2811.47,0,1068360,0,0,0,0,0,0
20150105.112151,2811.47,0,1068360,0,0,0,0,0,0
20150105.112152,2811.47,0,1068360,0,0,0,0,0,0
20150105.112153,2811.47,0,1068360,0,0,0,0,0,0
20150105.112154,2811.47,0,1068360,0,0,0,0,0,0
20150105.112155,2811.47,0,1068360,0,0,0,0,0,0
20150105.112156,2811.47,0,1068360,0,0,0,0,0,0
20150105.112157,2811.47,0,1068360,0,0,0,0,0,0
20150105.112158,2811.47,0,1068360,0,0,0,0,0,0
20150105.112159,2811.47,0,1068360,0,0,0,0,0,0
20150105.1122,2811.47,0,1068360,0,0,0,0,0,0
20150105.112201,2811.47,0,1068360,0,0,0,0,0,0
20150105.112202,2811.47,0,1068360,0,0,0,0,0,0
20150105.112203,2811.47,0,1068360,0,0,0,0,0,0
20150105.112204,2811.47,0,1068360,0,0,0,0,0,0
20150105.112205,2811.47,0,1068360,0,0,0,0,0,0
20150105.112206,2811.47,0,1068360,0,0,0,0,0,0
20150105.112207,2811.47,0,1068360,0,0,0,0,0,0
20150105.112208,2811.47,0,1068360,0,0,0,0,0,0
20150105.112209,2811.47,0,1068360,0,0,0,0,0,0
20150105.11221,2811.47,0,1068360,0,0,0,0,0,0
20150105.112211,2811.47,0,1068360,0,0,0,0,0,0
20150105.112212,2811.47,0,1068360,0,0,0,0,0,0
20150105.112213,2811.47,0,1068360,0,0,0,0,0,0
20150105.112214,2811.47,0,1068360,0,0,0,0,0,0
20150105.112215,2811.47,0,1068360,0,0,0,0,0,0
20150105.112216,2811.47,0,1068360,0,0,0,0,0,0
20150105.112217,2811.47,0,1068360,0,0,0,0,0,0
20150105.112218,2811.47,0,1068360,0,0,0,0,0,0
20150105.112219,2811.47,0,1068360,0,0,0,0,0,0
20150105.11222,2811.47,0,1068360,0,0,0,0,0,0
20150105.112221,2811.47,0,1068360,0,0,0,0,0,0
20150105.112222,2811.47,0,1068360,0,0,0,0,0,0
20150105.112223,2811.47,0,1068360,0,0,0,0,0,0
20150105.112224,2811.47,0,1068360,0,0,0,0,0,0
20150105.112225,2811.47,0,1068360,0,0,0,0,0,0
20150105.112226,2811.47,0,1068360,0,0,0,0,0,0
20150105.112227,2811.47,0,1068360,0,0,0,0,0,0
20150105.112228,2811.47,0,1068360,0,0,0,0,0,0
20150105.112229,2811.47,0,1068360,0,0,0,0,0,0
20150105.11223,2811.47,0,1068360,0,0,0,0,0,0
20150105.112231,2811.47,0,1068360,0,0,0,0,0,0
20150105.112232,2811.47,0,1068360,0,0,0,0,0,0
20150105.112233,2811.47,0,1068360,0,0,0,0,0,0
20150105.112234,2811.47,0,1068360,0,0,0,0,0,0
20150105.112235,2811.47,0,1068360,0,0,0,0,0,0
20150105.112236,2811.47,0,1068360,0,0,0,0,0,0
20150105.112237,2811.47,0,1068360,0,0,0,0,0,0
20150105.112238,2811.47,0,1068360,0,0,0,0,0,0
20150105.112239,2811.47,0,1068360,0,0,0,0,0,0
20150105.11224,2811.47,0,1068360,0,0,0,0,0,0
20150105.112241,2811.47,0,1068360,0,0,0,0,0,0
20150105.112242,2811.47,0,1068360,0,0,0,0,0,0
20150105.112243,2811.47,0,1068360,0,0,0,0,0,0
20150105.112244,2811.47,0,1068360,0,0,0,0,0,0
20150105.112245,2811.47,0,1068360,0,0,0,0,0,0
20150105.112246,2811.47,0,1068360,0,0,0,0,0,0
20150105.112247,2811.47,0,1068360,0,0,0,0,0,0
20150105.112248,2811.47,0,1068360,0,0,0,0,0,0
20150105.112249,2811.47,0,1068360,0,0,0,0,0,0
20150105.11225,2811.47,0,1068360,0,0,0,0,0,0
20150105.112251,2811.47,0,1068360,0,0,0,0,0,0
20150105.112252,2811.47,0,1068360,0,0,0,0,0,0
20150105.112253,2811.47,0,1068360,0,0,0,0,0,0
20150105.112254,2811.47,0,1068360,0,0,0,0,0,0
20150105.112255,2811.47,0,1068360,0,0,0,0,0,0
20150105.112256,2811.47,0,1068360,0,0,0,0,0,0
20150105.112257,2811.47,0,1068360,0,0,0,0,0,0
20150105.112258,2811.47,0,1068360,0,0,0,0,0,0
20150105.112259,2811.47,0,1068360,0,0,0,0,0,0
20150105.1123,2811.47,0,1068360,0,0,0,0,0,0
20150105.112301,2811.47,0,1068360,0,0,0,0,0,0
20150105.112302,2811.47,0,1068360,0,0,0,0,0,0
20150105.112303,2811.47,0,1068360,0,0,0,0,0,0
20150105.112304,2811.47,0,1068360,0,0,0,0,0,0
20150105.112305,2811.47,0,1068360,0,0,0,0,0,0
20150105.112306,2811.47,0,1068360,0,0,0,0,0,0
20150105.112307,2811.47,0,1068360,0,0,0,0,0,0
20150105.112308,2811.47,0,1068360,0,0,0,0,0,0
20150105.112309,2811.47,0,1068360,0,0,0,0,0,0
20150105.11231,2811.47,0,1068360,0,0,0,0,0,0
20150105.112311,2811.47,0,1068360,0,0,0,0,0,0
20150105.112312,2811.47,0,1068360,0,0,0,0,0,0
20150105.112313,2811.47,0,1068360,0,0,0,0,0,0
20150105.112314,2811.47,0,1068360,0,0,0,0,0,0
20150105.112315,2811.47,0,1068360,0,0,0,0,0,0
20150105.112316,2811.47,0,1068360,0,0,0,0,0,0
20150105.112317,2811.47,0,1068360,0,0,0,0,0,0
20150105.112318,2811.47,0,1068360,0,0,0,0,0,0
20150105.112319,2811.47,0,1068360,0,0,0,0,0,0
20150105.11232,2811.47,0,1068360,0,0,0,0,0,0
20150105.112321,2811.47,0,1068360,0,0,0,0,0,0
20150105.112322,2811.47,0,1068360,0,0,0,0,0,0
20150105.112323,2811.47,0,1068360,0,0,0,0,0,0
20150105.112324,2811.47,0,1068360,0,0,0,0,0,0
20150105.112325,2811.47,0,1068360,0,0,0,0,0,0
20150105.112326,2811.47,0,1068360,0,0,0,0,0,0
20150105.112327,2811.47,0,1068360,0,0,0,0,0,0
20150105.112328,2811.47,0,1068360,0,0,0,0,0,0
20150105.112329,2811.47,0,1068360,0,0,0,0,0,0
20150105.11233,2811.47,0,1068360,0,0,0,0,0,0
20150105.112331,2811.47,0,1068360,0,0,0,0,0,0
20150105.112332,2811.47,0,1068360,0,0,0,0,0,0
20150105.112333,2811.47,0,1068360,0,0,0,0,0,0
20150105.112334,2811.47,0,1068360,0,0,0,0,0,0
20150105.112335,2811.47,0,1068360,0,0,0,0,0,0
20150105.112336,2811.47,0,1068360,0,0,0,0,0,0
20150105.112337,2811.47,0,1068360,0,0,0,0,0,0
20150105.112338,2811.47,0,1068360,0,0,0,0,0,0
20150105.112339,2811.47,0,1068360,0,0,0,0,0,0
20150105.11234,2811.47,0,1068360,0,0,0,0,0,0
20150105.112341,2811.47,0,1068360,0,0,0,0,0,0
20150105.112342,2811.47,0,1068360,0,0,0,0,0,0
20150105.112343,2811.47,0,1068360,0,0,0,0,0,0
20150105.112344,2811.47,0,1068360,0,0,0,0,0,0
20150105.112345,2811.47,0,1068360,0,0,0,0,0,0
20150105.112346,2811.47,0,1068360,0,0,0,0,0,0
20150105.112347,2811.47,0,1068360,0,0,0,0,0,0
20150105.112348,2811.47,0,1068360,0,0,0,0,0,0
20150105.112349,2811.47,0,1068360,0,0,0,0,0,0
20150105.11235,2811.47,0,1068360,0,0,0,0,0,0
20150105.112351,2811.47,0,1068360,0,0,0,0,0,0
20150105.112352,2811.47,0,1068360,0,0,0,0,0,0
20150105.112353,2811.47,0,1068360,0,0,0,0,0,0
20150105.112354,2811.47,0,1068360,0,0,0,0,0,0
20150105.112355,2811.47,0,1068360,0,0,0,0,0,0
20150105.112356,2811.47,0,1068360,0,0,0,0,0,0
20150105.112357,2811.47,0,1068360,0,0,0,0,0,0
20150105.112358,2811.47,0,1068360,0,0,0,0,0,0
20150105.112359,2811.47,0,1068360,0,0,0,0,0,0
20150105.1124,2811.47,0,1068360,0,0,0,0,0,0
20150105.112401,2811.47,0,1068360,0,0,0,0,0,0
20150105.112402,2811.47,0,1068360,0,0,0,0,0,0
20150105.112403,2811.47,0,1068360,0,0,0,0,0,0
20150105.112404,2811.47,0,1068360,0,0,0,0,0,0
20150105.112405,2811.47,0,1068360,0,0,0,0,0,0
20150105.112406,2811.47,0,1068360,0,0,0,0,0,0
20150105.112407,2811.47,0,1068360,0,0,0,0,0,0
20150105.112408,2811.47,0,1068360,0,0,0,0,0,0
20150105.112409,2811.47,0,1068360,0,0,0,0,0,0
20150105.11241,2811.47,0,1068360,0,0,0,0,0,0
20150105.112411,2811.47,0,1068360,0,0,0,0,0,0
20150105.112412,2811.47,0,1068360,0,0,0,0,0,0
20150105.112413,2811.47,0,1068360,0,0,0,0,0,0
20150105.112414,2811.47,0,1068360,0,0,0,0,0,0
20150105.112415,2811.47,0,1068360,0,0,0,0,0,0
20150105.112416,2811.47,0,1068360,0,0,0,0,0,0
20150105.112417,2811.47,0,1068360,0,0,0,0,0,0
20150105.112418,2811.47,0,1068360,0,0,0,0,0,0
20150105.112419,2811.47,0,1068360,0,0,0,0,0,0
20150105.11242,2811.47,0,1068360,0,0,0,0,0,0
20150105.112421,2811.47,0,1068360,0,0,0,0,0,0
20150105.112422,2811.47,0,1068360,0,0,0,0,0,0
20150105.112423,2811.47,0,1068360,0,0,0,0,0,0
20150105.112424,2811.47,0,1068360,0,0,0,0,0,0
20150105.112425,2811.47,0,1068360,0,0,0,0,0,0
20150105.112426,2811.47,0,1068360,0,0,0,0,0,0
20150105.112427,2811.47,0,1068360,0,0,0,0,0,0
20150105.112428,2811.47,0,1068360,0,0,0,0,0,0
20150105.112429,2811.47,0,1068360,0,0,0,0,0,0
20150105.11243,2811.47,0,1068360,0,0,0,0,0,0
20150105.112431,2811.47,0,1068360,0,0,0,0,0,0
20150105.112432,2811.47,0,1068360,0,0,0,0,0,0
20150105.112433,2811.47,0,1068360,0,0,0,0,0,0
20150105.112434,2811.47,0,1068360,0,0,0,0,0,0
20150105.112435,2811.47,0,1068360,0,0,0,0,0,0
20150105.112436,2811.47,0,1068360,0,0,0,0,0,0
20150105.112437,2811.47,0,1068360,0,0,0,0,0,0
20150105.112438,2811.47,0,1068360,0,0,0,0,0,0
20150105.112439,2811.47,0,1068360,0,0,0,0,0,0
20150105.11244,2811.47,0,1068360,0,0,0,0,0,0
20150105.112441,2811.47,0,1068360,0,0,0,0,0,0
20150105.112442,2811.47,0,1068360,0,0,0,0,0,0
20150105.112443,2811.47,0,1068360,0,0,0,0,0,0
20150105.112444,2811.47,0,1068360,0,0,0,0,0,0
20150105.112445,2811.47,0,1068360,0,0,0,0,0,0
20150105.112446,2811.47,0,1068360,0,0,0,0,0,0
20150105.112447,2811.47,0,1068360,0,0,0,0,0,0
20150105.112448,2811.47,0,1068360,0,0,0,0,0,0
20150105.112449,2811.47,0,1068360,0,0,0,0,0,0
20150105.11245,2811.47,0,1068360,0,0,0,0,0,0
20150105.112451,2811.47,0,1068360,0,0,0,0,0,0
20150105.112452,2811.47,0,1068360,0,0,0,0,0,0
20150105.112453,2811.47,0,1068360,0,0,0,0,0,0
20150105.112454,2811.47,0,1068360,0,0,0,0,0,0
20150105.112455,2811.47,0,1068360,0,0,0,0,0,0
20150105.112456,2811.47,0,1068360,0,0,0,0,0,0
20150105.112457,2811.47,0,1068360,0,0,0,0,0,0
20150105.112458,2811.47,0,1068360,0,0,0,0,0,0
20150105.112459,2811.47,0,1068360,0,0,0,0,0,0
20150105.1125,2811.47,0,1068360,0,0,0,0,0,0
20150105.112501,2811.47,0,1068360,0,0,0,0,0,0
20150105.112502,2811.47,0,1068360,0,0,0,0,0,0
20150105.112503,2811.47,0,1068360,0,0,0,0,0,0
20150105.112504,2811.47,0,1068360,0,0,0,0,0,0
20150105.112505,2811.47,0,1068360,0,0,0,0,0,0
20150105.112506,2811.47,0,1068360,0,0,0,0,0,0
20150105.112507,2811.47,0,1068360,0,0,0,0,0,0
20150105.112508,2811.47,0,1068360,0,0,0,0,0,0
20150105.112509,2811.47,0,1068360,0,0,0,0,0,0
20150105.11251,2811.47,0,1068360,0,0,0,0,0,0
20150105.112511,2811.47,0,1068360,0,0,0,0,0,0
20150105.112512,2811.47,0,1068360,0,0,0,0,0,0
20150105.112513,2811.47,0,1068360,0,0,0,0,0,0
20150105.112514,2811.47,0,1068360,0,0,0,0,0,0
20150105.112515,2811.47,0,1068360,0,0,0,0,0,0
20150105.112516,2811.47,0,1068360,0,0,0,0,0,0
20150105.112517,2811.47,0,1068360,0,0,0,0,0,0
20150105.112518,2811.47,0,1068360,0,0,0,0,0,0
20150105.112519,2811.47,0,1068360,0,0,0,0,0,0
20150105.11252,2811.47,0,1068360,0,0,0,0,0,0
20150105.112521,2811.47,0,1068360,0,0,0,0,0,0
20150105.112522,2811.47,0,1068360,0,0,0,0,0,0
20150105.112523,2811.47,0,1068360,0,0,0,0,0,0
20150105.112524,2811.47,0,1068360,0,0,0,0,0,0
20150105.112525,2811.47,0,1068360,0,0,0,0,0,0
20150105.112526,2811.47,0,1068360,0,0,0,0,0,0
20150105.112527,2811.47,0,1068360,0,0,0,0,0,0
20150105.112528,2811.47,0,1068360,0,0,0,0,0,0
20150105.112529,2811.47,0,1068360,0,0,0,0,0,0
20150105.11253,2811.47,0,1068360,0,0,0,0,0,0
20150105.112531,2811.47,0,1068360,0,0,0,0,0,0
20150105.112532,2811.47,0,1068360,0,0,0,0,0,0
20150105.112533,2811.47,0,1068360,0,0,0,0,0,0
20150105.112534,2811.47,0,1068360,0,0,0,0,0,0
20150105.112535,2811.47,0,1068360,0,0,0,0,0,0
20150105.112536,2811.47,0,1068360,0,0,0,0,0,0
20150105.112537,2811.47,0,1068360,0,0,0,0,0,0
20150105.112538,2811.47,0,1068360,0,0,0,0,0,0
20150105.112539,2811.47,0,1068360,0,0,0,0,0,0
20150105.11254,2811.47,0,1068360,0,0,0,0,0,0
20150105.112541,2811.47,0,1068360,0,0,0,0,0,0
20150105.112542,2811.47,0,1068360,0,0,0,0,0,0
20150105.112543,2811.47,0,1068360,0,0,0,0,0,0
20150105.112544,2811.47,0,1068360,0,0,0,0,0,0
20150105.112545,2811.47,0,1068360,0,0,0,0,0,0
20150105.112546,2811.47,0,1068360,0,0,0,0,0,0
20150105.112547,2811.47,0,1068360,0,0,0,0,0,0
20150105.112548,2811.47,0,1068360,0,0,0,0,0,0
20150105.112549,2811.47,0,1068360,0,0,0,0,0,0
20150105.11255,2811.47,0,1068360,0,0,0,0,0,0
20150105.112551,2811.47,0,1068360,0,0,0,0,0,0
20150105.112552,2811.47,0,1068360,0,0,0,0,0,0
20150105.112553,2811.47,0,1068360,0,0,0,0,0,0
20150105.112554,2811.47,0,1068360,0,0,0,0,0,0
20150105.112555,2811.47,0,1068360,0,0,0,0,0,0
20150105.112556,2811.47,0,1068360,0,0,0,0,0,0
20150105.112557,2811.47,0,1068360,0,0,0,0,0,0
20150105.112558,2811.47,0,1068360,0,0,0,0,0,0
20150105.112559,2811.47,0,1068360,0,0,0,0,0,0
20150105.1126,2811.47,0,1068360,0,0,0,0,0,0
20150105.112601,2811.47,0,1068360,0,0,0,0,0,0
20150105.112602,2811.47,0,1068360,0,0,0,0,0,0
20150105.112603,2811.47,0,1068360,0,0,0,0,0,0
20150105.112604,2811.47,0,1068360,0,0,0,0,0,0
20150105.112605,2811.47,0,1068360,0,0,0,0,0,0
20150105.112606,2811.47,0,1068360,0,0,0,0,0,0
20150105.112607,2811.47,0,1068360,0,0,0,0,0,0
20150105.112608,2811.47,0,1068360,0,0,0,0,0,0
20150105.112609,2811.47,0,1068360,0,0,0,0,0,0
20150105.11261,2811.47,0,1068360,0,0,0,0,0,0
20150105.112611,2811.47,0,1068360,0,0,0,0,0,0
20150105.112612,2811.47,0,1068360,0,0,0,0,0,0
20150105.112613,2811.47,0,1068360,0,0,0,0,0,0
20150105.112614,2811.47,0,1068360,0,0,0,0,0,0
20150105.112615,2811.47,0,1068360,0,0,0,0,0,0
20150105.112616,2811.47,0,1068360,0,0,0,0,0,0
20150105.112617,2811.47,0,1068360,0,0,0,0,0,0
20150105.112618,2811.47,0,1068360,0,0,0,0,0,0
20150105.112619,2811.47,0,1068360,0,0,0,0,0,0
20150105.11262,2811.47,0,1068360,0,0,0,0,0,0
20150105.112621,2811.47,0,1068360,0,0,0,0,0,0
20150105.112622,2811.47,0,1068360,0,0,0,0,0,0
20150105.112623,2811.47,0,1068360,0,0,0,0,0,0
20150105.112624,2811.47,0,1068360,0,0,0,0,0,0
20150105.112625,2811.47,0,1068360,0,0,0,0,0,0
20150105.112626,2811.47,0,1068360,0,0,0,0,0,0
20150105.112627,2811.47,0,1068360,0,0,0,0,0,0
20150105.112628,2811.47,0,1068360,0,0,0,0,0,0
20150105.112629,2811.47,0,1068360,0,0,0,0,0,0
20150105.11263,2811.47,0,1068360,0,0,0,0,0,0
20150105.112631,2811.47,0,1068360,0,0,0,0,0,0
20150105.112632,2811.47,0,1068360,0,0,0,0,0,0
20150105.112633,2811.47,0,1068360,0,0,0,0,0,0
20150105.112634,2811.47,0,1068360,0,0,0,0,0,0
20150105.112635,2811.47,0,1068360,0,0,0,0,0,0
20150105.112636,2811.47,0,1068360,0,0,0,0,0,0
20150105.112637,2811.47,0,1068360,0,0,0,0,0,0
20150105.112638,2811.47,0,1068360,0,0,0,0,0,0
20150105.112639,2811.47,0,1068360,0,0,0,0,0,0
20150105.11264,2811.47,0,1068360,0,0,0,0,0,0
20150105.112641,2811.47,0,1068360,0,0,0,0,0,0
20150105.112642,2811.47,0,1068360,0,0,0,0,0,0
20150105.112643,2811.47,0,1068360,0,0,0,0,0,0
20150105.112644,2811.47,0,1068360,0,0,0,0,0,0
20150105.112645,2811.47,0,1068360,0,0,0,0,0,0
20150105.112646,2811.47,0,1068360,0,0,0,0,0,0
20150105.112647,2811.47,0,1068360,0,0,0,0,0,0
20150105.112648,2811.47,0,1068360,0,0,0,0,0,0
20150105.112649,2811.47,0,1068360,0,0,0,0,0,0
20150105.11265,2811.47,0,1068360,0,0,0,0,0,0
20150105.112651,2811.47,0,1068360,0,0,0,0,0,0
20150105.112652,2811.47,0,1068360,0,0,0,0,0,0
20150105.112653,2811.47,0,1068360,0,0,0,0,0,0
20150105.112654,2811.47,0,1068360,0,0,0,0,0,0
20150105.112655,2811.47,0,1068360,0,0,0,0,0,0
20150105.112656,2811.47,0,1068360,0,0,0,0,0,0
20150105.112657,2811.47,0,1068360,0,0,0,0,0,0
20150105.112658,2811.47,0,1068360,0,0,0,0,0,0
20150105.112659,2811.47,0,1068360,0,0,0,0,0,0
20150105.1127,2811.47,0,1068360,0,0,0,0,0,0
20150105.112701,2811.47,0,1068360,0,0,0,0,0,0
20150105.112702,2811.47,0,1068360,0,0,0,0,0,0
20150105.112703,2811.47,0,1068360,0,0,0,0,0,0
20150105.112704,2811.47,0,1068360,0,0,0,0,0,0
20150105.112705,2811.47,0,1068360,0,0,0,0,0,0
20150105.112706,2811.47,0,1068360,0,0,0,0,0,0
20150105.112707,2811.47,0,1068360,0,0,0,0,0,0
20150105.112708,2811.47,0,1068360,0,0,0,0,0,0
20150105.112709,2811.47,0,1068360,0,0,0,0,0,0
20150105.11271,2811.47,0,1068360,0,0,0,0,0,0
20150105.112711,2811.47,0,1068360,0,0,0,0,0,0
20150105.112712,2811.47,0,1068360,0,0,0,0,0,0
20150105.112713,2811.47,0,1068360,0,0,0,0,0,0
20150105.112714,2811.47,0,1068360,0,0,0,0,0,0
20150105.112715,2811.47,0,1068360,0,0,0,0,0,0
20150105.112716,2811.47,0,1068360,0,0,0,0,0,0
20150105.112717,2811.47,0,1068360,0,0,0,0,0,0
20150105.112718,2811.47,0,1068360,0,0,0,0,0,0
20150105.112719,2811.47,0,1068360,0,0,0,0,0,0
20150105.11272,2811.47,0,1068360,0,0,0,0,0,0
20150105.112721,2811.47,0,1068360,0,0,0,0,0,0
20150105.112722,2811.47,0,1068360,0,0,0,0,0,0
20150105.112723,2811.47,0,1068360,0,0,0,0,0,0
20150105.112724,2811.47,0,1068360,0,0,0,0,0,0
20150105.112725,2811.47,0,1068360,0,0,0,0,0,0
20150105.112726,2811.47,0,1068360,0,0,0,0,0,0
20150105.112727,2811.47,0,1068360,0,0,0,0,0,0
20150105.112728,2811.47,0,1068360,0,0,0,0,0,0
20150105.112729,2811.47,0,1068360,0,0,0,0,0,0
20150105.11273,2811.47,0,1068360,0,0,0,0,0,0
20150105.112731,2811.47,0,1068360,0,0,0,0,0,0
20150105.112732,2811.47,0,1068360,0,0,0,0,0,0
20150105.112733,2811.47,0,1068360,0,0,0,0,0,0
20150105.112734,2811.47,0,1068360,0,0,0,0,0,0
20150105.112735,2811.47,0,1068360,0,0,0,0,0,0
20150105.112736,2811.47,0,1068360,0,0,0,0,0,0
20150105.112737,2811.47,0,1068360,0,0,0,0,0,0
20150105.112738,2811.47,0,1068360,0,0,0,0,0,0
20150105.112739,2811.47,0,1068360,0,0,0,0,0,0
20150105.11274,2811.47,0,1068360,0,0,0,0,0,0
20150105.112741,2811.47,0,1068360,0,0,0,0,0,0
20150105.112742,2811.47,0,1068360,0,0,0,0,0,0
20150105.112743,2811.47,0,1068360,0,0,0,0,0,0
20150105.112744,2811.47,0,1068360,0,0,0,0,0,0
20150105.112745,2811.47,0,1068360,0,0,0,0,0,0
20150105.112746,2811.47,0,1068360,0,0,0,0,0,0
20150105.112747,2811.47,0,1068360,0,0,0,0,0,0
20150105.112748,2811.47,0,1068360,0,0,0,0,0,0
20150105.112749,2811.47,0,1068360,0,0,0,0,0,0
20150105.11275,2811.47,0,1068360,0,0,0,0,0,0
20150105.112751,2811.47,0,1068360,0,0,0,0,0,0
20150105.112752,2811.47,0,1068360,0,0,0,0,0,0
20150105.112753,2811.47,0,1068360,0,0,0,0,0,0
20150105.112754,2811.47,0,1068360,0,0,0,0,0,0
20150105.112755,2811.47,0,1068360,0,0,0,0,0,0
20150105.112756,2811.47,0,1068360,0,0,0,0,0,0
20150105.112757,2811.47,0,1068360,0,0,0,0,0,0
20150105.112758,2811.47,0,1068360,0,0,0,0,0,0
20150105.112759,2811.47,0,1068360,0,0,0,0,0,0
20150105.1128,2811.47,0,1068360,0,0,0,0,0,0
20150105.112801,2811.47,0,1068360,0,0,0,0,0,0
20150105.112802,2811.47,0,1068360,0,0,0,0,0,0
20150105.112803,2811.47,0,1068360,0,0,0,0,0,0
20150105.112804,2811.47,0,1068360,0,0,0,0,0,0
20150105.112805,2811.47,0,1068360,0,0,0,0,0,0
20150105.112806,2811.47,0,1068360,0,0,0,0,0,0
20150105.112807,2811.47,0,1068360,0,0,0,0,0,0
20150105.112808,2811.47,0,1068360,0,0,0,0,0,0
20150105.112809,2811.47,0,1068360,0,0,0,0,0,0
20150105.11281,2811.47,0,1068360,0,0,0,0,0,0
20150105.112811,2811.47,0,1068360,0,0,0,0,0,0
20150105.112812,2811.47,0,1068360,0,0,0,0,0,0
20150105.112813,2811.47,0,1068360,0,0,0,0,0,0
20150105.112814,2811.47,0,1068360,0,0,0,0,0,0
20150105.112815,2811.47,0,1068360,0,0,0,0,0,0
20150105.112816,2811.47,0,1068360,0,0,0,0,0,0
20150105.112817,2811.47,0,1068360,0,0,0,0,0,0
20150105.112818,2811.47,0,1068360,0,0,0,0,0,0
20150105.112819,2811.47,0,1068360,0,0,0,0,0,0
20150105.11282,2811.47,0,1068360,0,0,0,0,0,0
20150105.112821,2811.47,0,1068360,0,0,0,0,0,0
20150105.112822,2811.47,0,1068360,0,0,0,0,0,0
20150105.112823,2811.47,0,1068360,0,0,0,0,0,0
20150105.112824,2811.47,0,1068360,0,0,0,0,0,0
20150105.112825,2811.47,0,1068360,0,0,0,0,0,0
20150105.112826,2811.47,0,1068360,0,0,0,0,0,0
20150105.112827,2811.47,0,1068360,0,0,0,0,0,0
20150105.112828,2811.47,0,1068360,0,0,0,0,0,0
20150105.112829,2811.47,0,1068360,0,0,0,0,0,0
20150105.11283,2811.47,0,1068360,0,0,0,0,0,0
20150105.112831,2811.47,0,1068360,0,0,0,0,0,0
20150105.112832,2811.47,0,1068360,0,0,0,0,0,0
20150105.112833,2811.47,0,1068360,0,0,0,0,0,0
20150105.112834,2811.47,0,1068360,0,0,0,0,0,0
20150105.112835,2811.47,0,1068360,0,0,0,0,0,0
20150105.112836,2811.47,0,1068360,0,0,0,0,0,0
20150105.112837,2811.47,0,1068360,0,0,0,0,0,0
20150105.112838,2811.47,0,1068360,0,0,0,0,0,0
20150105.112839,2811.47,0,1068360,0,0,0,0,0,0
20150105.11284,2811.47,0,1068360,0,0,0,0,0,0
20150105.112841,2811.47,0,1068360,0,0,0,0,0,0
20150105.112842,2811.47,0,1068360,0,0,0,0,0,0
20150105.112843,2811.47,0,1068360,0,0,0,0,0,0
20150105.112844,2811.47,0,1068360,0,0,0,0,0,0
20150105.112845,2811.47,0,1068360,0,0,0,0,0,0
20150105.112846,2811.47,0,1068360,0,0,0,0,0,0
20150105.112847,2811.47,0,1068360,0,0,0,0,0,0
20150105.112848,2811.47,0,1068360,0,0,0,0,0,0
20150105.112849,2811.47,0,1068360,0,0,0,0,0,0
20150105.11285,2811.47,0,1068360,0,0,0,0,0,0
20150105.112851,2811.47,0,1068360,0,0,0,0,0,0
20150105.112852,2811.47,0,1068360,0,0,0,0,0,0
20150105.112853,2811.47,0,1068360,0,0,0,0,0,0
20150105.112854,2811.47,0,1068360,0,0,0,0,0,0
20150105.112855,2811.47,0,1068360,0,0,0,0,0,0
20150105.112856,2811.47,0,1068360,0,0,0,0,0,0
20150105.112857,2811.47,0,1068360,0,0,0,0,0,0
20150105.112858,2811.47,0,1068360,0,0,0,0,0,0
20150105.112859,2811.47,0,1068360,0,0,0,0,0,0
20150105.1129,2811.47,0,1068360,0,0,0,0,0,0
20150105.112901,2811.47,0,1068360,0,0,0,0,0,0
20150105.112902,2811.47,0,1068360,0,0,0,0,0,0
20150105.112903,2811.47,0,1068360,0,0,0,0,0,0
20150105.112904,2811.47,0,1068360,0,0,0,0,0,0
20150105.112905,2811.47,0,1068360,0,0,0,0,0,0
20150105.112906,2811.47,0,1068360,0,0,0,0,0,0
20150105.112907,2811.47,0,1068360,0,0,0,0,0,0
20150105.112908,2811.47,0,1068360,0,0,0,0,0,0
20150105.112909,2811.47,0,1068360,0,0,0,0,0,0
20150105.11291,2811.47,0,1068360,0,0,0,0,0,0
20150105.112911,2811.47,0,1068360,0,0,0,0,0,0
20150105.112912,2811.47,0,1068360,0,0,0,0,0,0
20150105.112913,2811.47,0,1068360,0,0,0,0,0,0
20150105.112914,2811.47,0,1068360,0,0,0,0,0,0
20150105.112915,2811.47,0,1068360,0,0,0,0,0,0
20150105.112916,2811.47,0,1068360,0,0,0,0,0,0
20150105.112917,2811.47,0,1068360,0,0,0,0,0,0
20150105.112918,2811.47,0,1068360,0,0,0,0,0,0
20150105.112919,2811.47,0,1068360,0,0,0,0,0,0
20150105.11292,2811.47,0,1068360,0,0,0,0,0,0
20150105.112921,2811.47,0,1068360,0,0,0,0,0,0
20150105.112922,2811.47,0,1068360,0,0,0,0,0,0
20150105.112923,2811.47,0,1068360,0,0,0,0,0,0
20150105.112924,2811.47,0,1068360,0,0,0,0,0,0
20150105.112925,2811.47,0,1068360,0,0,0,0,0,0
20150105.112926,2811.47,0,1068360,0,0,0,0,0,0
20150105.112927,2811.47,0,1068360,0,0,0,0,0,0
20150105.112928,2811.47,0,1068360,0,0,0,0,0,0
20150105.112929,2811.47,0,1068360,0,0,0,0,0,0
20150105.11293,2811.47,0,1068360,0,0,0,0,0,0
20150105.112931,2811.47,0,1068360,0,0,0,0,0,0
20150105.112932,2811.47,0,1068360,0,0,0,0,0,0
20150105.112933,2811.47,0,1068360,0,0,0,0,0,0
20150105.112934,2811.47,0,1068360,0,0,0,0,0,0
20150105.112935,2811.47,0,1068360,0,0,0,0,0,0
20150105.112936,2811.47,0,1068360,0,0,0,0,0,0
20150105.112937,2811.47,0,1068360,0,0,0,0,0,0
20150105.112938,2811.47,0,1068360,0,0,0,0,0,0
20150105.112939,2811.47,0,1068360,0,0,0,0,0,0
20150105.11294,2811.47,0,1068360,0,0,0,0,0,0
20150105.112941,2811.47,0,1068360,0,0,0,0,0,0
20150105.112942,2811.47,0,1068360,0,0,0,0,0,0
20150105.112943,2811.47,0,1068360,0,0,0,0,0,0
20150105.112944,2811.47,0,1068360,0,0,0,0,0,0
20150105.112945,2811.47,0,1068360,0,0,0,0,0,0
20150105.112946,2811.47,0,1068360,0,0,0,0,0,0
20150105.112947,2811.47,0,1068360,0,0,0,0,0,0
20150105.112948,2811.47,0,1068360,0,0,0,0,0,0
20150105.112949,2811.47,0,1068360,0,0,0,0,0,0
20150105.11295,2811.47,0,1068360,0,0,0,0,0,0
20150105.112951,2811.47,0,1068360,0,0,0,0,0,0
20150105.112952,2811.47,0,1068360,0,0,0,0,0,0
20150105.112953,2811.47,0,1068360,0,0,0,0,0,0
20150105.112954,2811.47,0,1068360,0,0,0,0,0,0
20150105.112955,2811.47,0,1068360,0,0,0,0,0,0
20150105.112956,2811.47,0,1068360,0,0,0,0,0,0
20150105.112957,2811.47,0,1068360,0,0,0,0,0,0
20150105.112958,2811.47,0,1068360,0,0,0,0,0,0
20150105.112959,2811.47,0,1068360,0,0,0,0,0,0
20150105.133,2811.47,0,1068360,0,0,0,0,0,0
20150105.133001,2811.47,0,1068360,0,0,0,0,0,0
20150105.133002,2811.47,0,1068360,0,0,0,0,0,0
20150105.133003,2811.47,0,1068360,0,0,0,0,0,0
20150105.133004,2811.47,0,1068360,0,0,0,0,0,0
20150105.133005,2811.47,0,1068360,0,0,0,0,0,0
20150105.133006,2811.47,0,1068360,0,0,0,0,0,0
20150105.133007,2811.47,0,1068360,0,0,0,0,0,0
20150105.133008,2811.47,0,1068360,0,0,0,0,0,0
20150105.133009,2811.47,0,1068360,0,0,0,0,0,0
20150105.13301,2811.47,0,1068360,0,0,0,0,0,0
20150105.133011,2811.47,0,1068360,0,0,0,0,0,0
20150105.133012,2811.47,0,1068360,0,0,0,0,0,0
20150105.133013,2811.47,0,1068360,0,0,0,0,0,0
20150105.133014,2811.47,0,1068360,0,0,0,0,0,0
20150105.133015,2811.47,0,1068360,0,0,0,0,0,0
20150105.133016,2811.47,0,1068360,0,0,0,0,0,0
20150105.133017,2811.47,0,1068360,0,0,0,0,0,0
20150105.133018,2811.47,0,1068360,0,0,0,0,0,0
20150105.133019,2811.47,0,1068360,0,0,0,0,0,0
20150105.13302,2811.47,0,1068360,0,0,0,0,0,0
20150105.133021,2811.47,0,1068360,0,0,0,0,0,0
20150105.133022,2811.47,0,1068360,0,0,0,0,0,0
20150105.133023,2811.47,0,1068360,0,0,0,0,0,0
20150105.133024,2811.47,0,1068360,0,0,0,0,0,0
20150105.133025,2811.47,0,1068360,0,0,0,0,0,0
20150105.133026,2811.47,0,1068360,0,0,0,0,0,0
20150105.133027,2811.47,0,1068360,0,0,0,0,0,0
20150105.133028,2811.47,0,1068360,0,0,0,0,0,0
20150105.133029,2811.47,0,1068360,0,0,0,0,0,0
20150105.13303,2811.47,0,1068360,0,0,0,0,0,0
20150105.133031,2811.47,0,1068360,0,0,0,0,0,0
20150105.133032,2811.47,0,1068360,0,0,0,0,0,0
20150105.133033,2811.47,0,1068360,0,0,0,0,0,0
20150105.133034,2811.47,0,1068360,0,0,0,0,0,0
20150105.133035,2811.47,0,1068360,0,0,0,0,0,0
20150105.133036,2811.47,0,1068360,0,0,0,0,0,0
20150105.133037,2811.47,0,1068360,0,0,0,0,0,0
20150105.133038,2811.47,0,1068360,0,0,0,0,0,0
20150105.133039,2811.47,0,1068360,0,0,0,0,0,0
20150105.13304,2811.47,0,1068360,0,0,0,0,0,0
20150105.133041,2811.47,0,1068360,0,0,0,0,0,0
20150105.133042,2811.47,0,1068360,0,0,0,0,0,0
20150105.133043,2811.47,0,1068360,0,0,0,0,0,0
20150105.133044,2811.47,0,1068360,0,0,0,0,0,0
20150105.133045,2811.47,0,1068360,0,0,0,0,0,0
20150105.133046,2811.47,0,1068360,0,0,0,0,0,0
20150105.133047,2811.47,0,1068360,0,0,0,0,0,0
20150105.133048,2811.47,0,1068360,0,0,0,0,0,0
20150105.133049,2811.47,0,1068360,0,0,0,0,0,0
20150105.13305,2811.47,0,1068360,0,0,0,0,0,0
20150105.133051,2811.47,0,1068360,0,0,0,0,0,0
20150105.133052,2811.47,0,1068360,0,0,0,0,0,0
20150105.133053,2811.47,0,1068360,0,0,0,0,0,0
20150105.133054,2811.47,0,1068360,0,0,0,0,0,0
20150105.133055,2811.47,0,1068360,0,0,0,0,0,0
20150105.133056,2811.47,0,1068360,0,0,0,0,0,0
20150105.133057,2811.47,0,1068360,0,0,0,0,0,0
20150105.133058,2811.47,0,1068360,0,0,0,0,0,0
20150105.133059,2811.47,0,1068360,0,0,0,0,0,0
20150105.1331,2811.47,0,1068360,0,0,0,0,0,0
20150105.133101,2811.47,0,1068360,0,0,0,0,0,0
20150105.133102,2811.47,0,1068360,0,0,0,0,0,0
20150105.133103,2811.47,0,1068360,0,0,0,0,0,0
20150105.133104,2811.47,0,1068360,0,0,0,0,0,0
20150105.133105,2811.47,0,1068360,0,0,0,0,0,0
20150105.133106,2811.47,0,1068360,0,0,0,0,0,0
20150105.133107,2811.47,0,1068360,0,0,0,0,0,0
20150105.133108,2811.47,0,1068360,0,0,0,0,0,0
20150105.133109,2811.47,0,1068360,0,0,0,0,0,0
20150105.13311,2811.47,0,1068360,0,0,0,0,0,0
20150105.133111,2811.47,0,1068360,0,0,0,0,0,0
20150105.133112,2811.47,0,1068360,0,0,0,0,0,0
20150105.133113,2811.47,0,1068360,0,0,0,0,0,0
20150105.133114,2811.47,0,1068360,0,0,0,0,0,0
20150105.133115,2811.47,0,1068360,0,0,0,0,0,0
20150105.133116,2811.47,0,1068360,0,0,0,0,0,0
20150105.133117,2811.47,0,1068360,0,0,0,0,0,0
20150105.133118,2811.47,0,1068360,0,0,0,0,0,0
20150105.133119,2811.47,0,1068360,0,0,0,0,0,0
20150105.13312,2811.47,0,1068360,0,0,0,0,0,0
20150105.133121,2811.47,0,1068360,0,0,0,0,0,0
20150105.133122,2811.47,0,1068360,0,0,0,0,0,0
20150105.133123,2811.47,0,1068360,0,0,0,0,0,0
20150105.133124,2811.47,0,1068360,0,0,0,0,0,0
20150105.133125,2811.47,0,1068360,0,0,0,0,0,0
20150105.133126,2811.47,0,1068360,0,0,0,0,0,0
20150105.133127,2811.47,0,1068360,0,0,0,0,0,0
20150105.133128,2811.47,0,1068360,0,0,0,0,0,0
20150105.133129,2811.47,0,1068360,0,0,0,0,0,0
20150105.13313,2811.47,0,1068360,0,0,0,0,0,0
20150105.133131,2811.47,0,1068360,0,0,0,0,0,0
20150105.133132,2811.47,0,1068360,0,0,0,0,0,0
20150105.133133,2811.47,0,1068360,0,0,0,0,0,0
20150105.133134,2811.47,0,1068360,0,0,0,0,0,0
20150105.133135,2811.47,0,1068360,0,0,0,0,0,0
20150105.133136,2811.47,0,1068360,0,0,0,0,0,0
20150105.133137,2811.47,0,1068360,0,0,0,0,0,0
20150105.133138,2811.47,0,1068360,0,0,0,0,0,0
20150105.133139,2811.47,0,1068360,0,0,0,0,0,0
20150105.13314,2811.47,0,1068360,0,0,0,0,0,0
20150105.133141,2811.47,0,1068360,0,0,0,0,0,0
20150105.133142,2811.47,0,1068360,0,0,0,0,0,0
20150105.133143,2811.47,0,1068360,0,0,0,0,0,0
20150105.133144,2811.47,0,1068360,0,0,0,0,0,0
20150105.133145,2811.47,0,1068360,0,0,0,0,0,0
20150105.133146,2811.47,0,1068360,0,0,0,0,0,0
20150105.133147,2811.47,0,1068360,0,0,0,0,0,0
20150105.133148,2811.47,0,1068360,0,0,0,0,0,0
20150105.133149,2811.47,0,1068360,0,0,0,0,0,0
20150105.13315,2811.47,0,1068360,0,0,0,0,0,0
20150105.133151,2811.47,0,1068360,0,0,0,0,0,0
20150105.133152,2811.47,0,1068360,0,0,0,0,0,0
20150105.133153,2811.47,0,1068360,0,0,0,0,0,0
20150105.133154,2811.47,0,1068360,0,0,0,0,0,0
20150105.133155,2811.47,0,1068360,0,0,0,0,0,0
20150105.133156,2811.47,0,1068360,0,0,0,0,0,0
20150105.133157,2811.47,0,1068360,0,0,0,0,0,0
20150105.133158,2811.47,0,1068360,0,0,0,0,0,0
20150105.133159,2811.47,0,1068360,0,0,0,0,0,0
20150105.1332,2811.47,0,1068360,0,0,0,0,0,0
20150105.133201,2811.47,0,1068360,0,0,0,0,0,0
20150105.133202,2811.47,0,1068360,0,0,0,0,0,0
20150105.133203,2811.47,0,1068360,0,0,0,0,0,0
20150105.133204,2811.47,0,1068360,0,0,0,0,0,0
20150105.133205,2811.47,0,1068360,0,0,0,0,0,0
20150105.133206,2811.47,0,1068360,0,0,0,0,0,0
20150105.133207,2811.47,0,1068360,0,0,0,0,0,0
20150105.133208,2811.47,0,1068360,0,0,0,0,0,0
20150105.133209,2811.47,0,1068360,0,0,0,0,0,0
20150105.13321,2811.47,0,1068360,0,0,0,0,0,0
20150105.133211,2811.47,0,1068360,0,0,0,0,0,0
20150105.133212,2811.47,0,1068360,0,0,0,0,0,0
20150105.133213,2811.47,0,1068360,0,0,0,0,0,0
20150105.133214,2811.47,0,1068360,0,0,0,0,0,0
20150105.133215,2811.47,0,1068360,0,0,0,0,0,0
20150105.133216,2811.47,0,1068360,0,0,0,0,0,0
20150105.133217,2811.47,0,1068360,0,0,0,0,0,0
20150105.133218,2811.47,0,1068360,0,0,0,0,0,0
20150105.133219,2811.47,0,1068360,0,0,0,0,0,0
20150105.13322,2811.47,0,1068360,0,0,0,0,0,0
20150105.133221,2811.47,0,1068360,0,0,0,0,0,0
20150105.133222,2811.47,0,1068360,0,0,0,0,0,0
20150105.133223,2811.47,0,1068360,0,0,0,0,0,0
20150105.133224,2811.47,0,1068360,0,0,0,0,0,0
20150105.133225,2811.47,0,1068360,0,0,0,0,0,0
20150105.133226,2811.47,0,1068360,0,0,0,0,0,0
20150105.133227,2811.47,0,1068360,0,0,0,0,0,0
20150105.133228,2811.47,0,1068360,0,0,0,0,0,0
20150105.133229,2811.47,0,1068360,0,0,0,0,0,0
20150105.13323,2811.47,0,1068360,0,0,0,0,0,0
20150105.133231,2811.47,0,1068360,0,0,0,0,0,0
20150105.133232,2811.47,0,1068360,0,0,0,0,0,0
20150105.133233,2811.47,0,1068360,0,0,0,0,0,0
20150105.133234,2811.47,0,1068360,0,0,0,0,0,0
20150105.133235,2811.47,0,1068360,0,0,0,0,0,0
20150105.133236,2811.47,0,1068360,0,0,0,0,0,0
20150105.133237,2811.47,0,1068360,0,0,0,0,0,0
20150105.133238,2811.47,0,1068360,0,0,0,0,0,0
20150105.133239,2811.47,0,1068360,0,0,0,0,0,0
20150105.13324,2811.47,0,1068360,0,0,0,0,0,0
20150105.133241,2811.47,0,1068360,0,0,0,0,0,0
20150105.133242,2811.47,0,1068360,0,0,0,0,0,0
20150105.133243,2811.47,0,1068360,0,0,0,0,0,0
20150105.133244,2811.47,0,1068360,0,0,0,0,0,0
20150105.133245,2811.47,0,1068360,0,0,0,0,0,0
20150105.133246,2811.47,0,1068360,0,0,0,0,0,0
20150105.133247,2811.47,0,1068360,0,0,0,0,0,0
20150105.133248,2811.47,0,1068360,0,0,0,0,0,0
20150105.133249,2811.47,0,1068360,0,0,0,0,0,0
20150105.13325,2811.47,0,1068360,0,0,0,0,0,0
20150105.133251,2811.47,0,1068360,0,0,0,0,0,0
20150105.133252,2811.47,0,1068360,0,0,0,0,0,0
20150105.133253,2811.47,0,1068360,0,0,0,0,0,0
20150105.133254,2811.47,0,1068360,0,0,0,0,0,0
20150105.133255,2811.47,0,1068360,0,0,0,0,0,0
20150105.133256,2811.47,0,1068360,0,0,0,0,0,0
20150105.133257,2811.47,0,1068360,0,0,0,0,0,0
20150105.133258,2811.47,0,1068360,0,0,0,0,0,0
20150105.133259,2811.47,0,1068360,0,0,0,0,0,0
20150105.1333,2811.47,0,1068360,0,0,0,0,0,0
20150105.133301,2811.47,0,1068360,0,0,0,0,0,0
20150105.133302,2811.47,0,1068360,0,0,0,0,0,0
20150105.133303,2811.47,0,1068360,0,0,0,0,0,0
20150105.133304,2811.47,0,1068360,0,0,0,0,0,0
20150105.133305,2811.47,0,1068360,0,0,0,0,0,0
20150105.133306,2811.47,0,1068360,0,0,0,0,0,0
20150105.133307,2811.47,0,1068360,0,0,0,0,0,0
20150105.133308,2811.47,0,1068360,0,0,0,0,0,0
20150105.133309,2811.47,0,1068360,0,0,0,0,0,0
20150105.13331,2811.47,0,1068360,0,0,0,0,0,0
20150105.133311,2811.47,0,1068360,0,0,0,0,0,0
20150105.133312,2811.47,0,1068360,0,0,0,0,0,0
20150105.133313,2811.47,0,1068360,0,0,0,0,0,0
20150105.133314,2811.47,0,1068360,0,0,0,0,0,0
20150105.133315,2811.47,0,1068360,0,0,0,0,0,0
20150105.133316,2811.47,0,1068360,0,0,0,0,0,0
20150105.133317,2811.47,0,1068360,0,0,0,0,0,0
20150105.133318,2811.47,0,1068360,0,0,0,0,0,0
20150105.133319,2811.47,0,1068360,0,0,0,0,0,0
20150105.13332,2811.47,0,1068360,0,0,0,0,0,0
20150105.133321,2811.47,0,1068360,0,0,0,0,0,0
20150105.133322,2811.47,0,1068360,0,0,0,0,0,0
20150105.133323,2811.47,0,1068360,0,0,0,0,0,0
20150105.133324,2811.47,0,1068360,0,0,0,0,0,0
20150105.133325,2811.47,0,1068360,0,0,0,0,0,0
20150105.133326,2811.47,0,1068360,0,0,0,0,0,0
20150105.133327,2811.47,0,1068360,0,0,0,0,0,0
20150105.133328,2811.47,0,1068360,0,0,0,0,0,0
20150105.133329,2811.47,0,1068360,0,0,0,0,0,0
20150105.13333,2811.47,0,1068360,0,0,0,0,0,0
20150105.133331,2811.47,0,1068360,0,0,0,0,0,0
20150105.133332,2811.47,0,1068360,0,0,0,0,0,0
20150105.133333,2811.47,0,1068360,0,0,0,0,0,0
20150105.133334,2811.47,0,1068360,0,0,0,0,0,0
20150105.133335,2811.47,0,1068360,0,0,0,0,0,0
20150105.133336,2811.47,0,1068360,0,0,0,0,0,0
20150105.133337,2811.47,0,1068360,0,0,0,0,0,0
20150105.133338,2811.47,0,1068360,0,0,0,0,0,0
20150105.133339,2811.47,0,1068360,0,0,0,0,0,0
20150105.13334,2811.47,0,1068360,0,0,0,0,0,0
20150105.133341,2811.47,0,1068360,0,0,0,0,0,0
20150105.133342,2811.47,0,1068360,0,0,0,0,0,0
20150105.133343,2811.47,0,1068360,0,0,0,0,0,0
20150105.133344,2811.47,0,1068360,0,0,0,0,0,0
20150105.133345,2811.47,0,1068360,0,0,0,0,0,0
20150105.133346,2811.47,0,1068360,0,0,0,0,0,0
20150105.133347,2811.47,0,1068360,0,0,0,0,0,0
20150105.133348,2811.47,0,1068360,0,0,0,0,0,0
20150105.133349,2811.47,0,1068360,0,0,0,0,0,0
20150105.13335,2811.47,0,1068360,0,0,0,0,0,0
20150105.133351,2811.47,0,1068360,0,0,0,0,0,0
20150105.133352,2811.47,0,1068360,0,0,0,0,0,0
20150105.133353,2811.47,0,1068360,0,0,0,0,0,0
20150105.133354,2811.47,0,1068360,0,0,0,0,0,0
20150105.133355,2811.47,0,1068360,0,0,0,0,0,0
20150105.133356,2811.47,0,1068360,0,0,0,0,0,0
20150105.133357,2811.47,0,1068360,0,0,0,0,0,0
20150105.133358,2811.47,0,1068360,0,0,0,0,0,0
20150105.133359,2811.47,0,1068360,0,0,0,0,0,0
20150105.1334,2811.47,0,1068360,0,0,0,0,0,0
20150105.133401,2811.47,0,1068360,0,0,0,0,0,0
20150105.133402,2811.47,0,1068360,0,0,0,0,0,0
20150105.133403,2811.47,0,1068360,0,0,0,0,0,0
20150105.133404,2811.47,0,1068360,0,0,0,0,0,0
20150105.133405,2811.47,0,1068360,0,0,0,0,0,0
20150105.133406,2811.47,0,1068360,0,0,0,0,0,0
20150105.133407,2811.47,0,1068360,0,0,0,0,0,0
20150105.133408,2811.47,0,1068360,0,0,0,0,0,0
20150105.133409,2811.47,0,1068360,0,0,0,0,0,0
20150105.13341,2811.47,0,1068360,0,0,0,0,0,0
20150105.133411,2811.47,0,1068360,0,0,0,0,0,0
20150105.133412,2811.47,0,1068360,0,0,0,0,0,0
20150105.133413,2811.47,0,1068360,0,0,0,0,0,0
20150105.133414,2811.47,0,1068360,0,0,0,0,0,0
20150105.133415,2811.47,0,1068360,0,0,0,0,0,0
20150105.133416,2811.47,0,1068360,0,0,0,0,0,0
20150105.133417,2811.47,0,1068360,0,0,0,0,0,0
20150105.133418,2811.47,0,1068360,0,0,0,0,0,0
20150105.133419,2811.47,0,1068360,0,0,0,0,0,0
20150105.13342,2811.47,0,1068360,0,0,0,0,0,0
20150105.133421,2811.47,0,1068360,0,0,0,0,0,0
20150105.133422,2811.47,0,1068360,0,0,0,0,0,0
20150105.133423,2811.47,0,1068360,0,0,0,0,0,0
20150105.133424,2811.47,0,1068360,0,0,0,0,0,0
20150105.133425,2811.47,0,1068360,0,0,0,0,0,0
20150105.133426,2811.47,0,1068360,0,0,0,0,0,0
20150105.133427,2811.47,0,1068360,0,0,0,0,0,0
20150105.133428,2811.47,0,1068360,0,0,0,0,0,0
20150105.133429,2811.47,0,1068360,0,0,0,0,0,0
20150105.13343,2811.47,0,1068360,0,0,0,0,0,0
20150105.133431,2810.85,6,1068366,-4,0,0,0,0,0
20150105.133432,2811.48,974,1069340,808,0,0,0,0,0
20150105.133433,2811.48,232,1069572,-98,0,0,0,0,0
20150105.133434,2811.48,8,1069580,2,0,0,0,0,0
20150105.133435,2811.48,2,1069582,2,0,0,0,0,0
20150105.133436,2811.48,12,1069594,10,0,0,0,0,0
20150105.133437,2811.48,20,1069614,20,0,0,0,0,0
20150105.133438,2811.48,294,1069908,126,0,0,0,0,0
20150105.133439,2811.48,6,1069914,-4,0,0,0,0,0
20150105.13344,2811.48,14,1069928,-10,0,0,0,0,0
20150105.133441,2811.48,2,1069930,0,0,0,0,0,0
20150105.133442,2811.48,260,1070190,-254,0,0,0,0,0
20150105.133443,2811.48,26,1070216,-20,0,0,0,0,0
20150105.133444,2811.48,26,1070242,0,0,0,0,0,0
20150105.133445,2811.48,2,1070244,0,0,0,0,0,0
20150105.133446,2811.48,2,1070246,-2,0,0,0,0,0
20150105.133447,2811.48,42,1070288,0,0,0,0,0,0
20150105.133448,2811.48,10,1070298,0,0,0,0,0,0
20150105.133449,2811.48,4,1070302,0,0,0,0,0,0
20150105.13345,2811.48,4,1070306,2,0,0,0,0,0
20150105.133451,2810.85,46,1070352,36,0,0,0,0,0
20150105.133452,2811.48,2,1070354,0,0,0,0,0,0
20150105.133453,2811.48,2,1070356,0,0,0,0,0,0
20150105.133454,2810.85,2,1070358,2,0,0,0,0,0
20150105.133455,2811.48,2,1070360,0,0,0,0,0,0
20150105.133456,2810.85,6,1070366,4,0,0,0,0,0
20150105.133457,2811.48,2,1070368,0,0,0,0,0,0
20150105.133458,2811.48,38,1070406,20,0,0,0,0,0
20150105.133459,2811.48,2,1070408,2,0,0,0,0,0
20150105.1335,2810.85,24,1070432,4,0,0,0,0,0
20150105.133501,2810.85,2,1070434,2,0,0,0,0,0
20150105.133502,2810.85,2,1070436,2,0,0,0,0,0
20150105.133503,2810.85,0,1070436,0,0,0,0,0,0
20150105.133504,2810.85,0,1070436,0,0,0,0,0,0
20150105.133505,2811.48,2,1070438,2,0,0,0,0,0
20150105.133506,2811.48,2,1070440,2,0,0,0,0,0
20150105.133507,2810.85,16,1070456,0,0,0,0,0,0
20150105.133508,2810.85,20,1070476,0,0,0,0,0,0
20150105.133509,2810.85,2,1070478,2,0,0,0,0,0
20150105.13351,2810.85,2,1070480,0,0,0,0,0,0
20150105.133511,2810.85,4,1070484,2,0,0,0,0,0
20150105.133512,2811.48,44,1070528,40,0,0,0,0,0
20150105.133513,2811.48,4,1070532,0,0,0,0,0,0
20150105.133514,2811.48,2,1070534,0,0,0,0,0,0
20150105.133515,2811.48,0,1070534,0,0,0,0,0,0
20150105.133516,2811.48,0,1070534,0,0,0,0,0,0
20150105.133517,2811.48,2,1070536,0,0,0,0,0,0
20150105.133518,2811.48,10,1070546,10,0,0,0,0,0
20150105.133519,2811.48,8,1070554,8,0,0,0,0,0
20150105.13352,2811.48,14,1070568,4,0,0,0,0,0
20150105.133521,2810.85,2,1070570,0,0,0,0,0,0
20150105.133522,2810.85,2,1070572,2,0,0,0,0,0
20150105.133523,2811.48,20,1070592,20,0,0,0,0,0
20150105.133524,2811.48,4,1070596,4,0,0,0,0,0
20150105.133525,2811.48,0,1070596,0,0,0,0,0,0
20150105.133526,2810.85,2,1070598,0,0,0,0,0,0
20150105.133527,2811.48,2,1070600,2,0,0,0,0,0
20150105.133528,2811.48,0,1070600,0,0,0,0,0,0
20150105.133529,2811.48,0,1070600,0,0,0,0,0,0
20150105.13353,2811.48,0,1070600,0,0,0,0,0,0
20150105.133531,2811.48,0,1070600,0,0,0,0,0,0
20150105.133532,2810.85,6,1070606,6,0,0,0,0,0
20150105.133533,2811.48,2,1070608,-2,0,0,0,0,0
20150105.133534,2811.48,400,1071008,360,0,0,0,0,0
20150105.133535,2810.85,242,1071250,188,0,0,0,0,0
20150105.133536,2810.85,6,1071256,6,0,0,0,0,0
20150105.133537,2810.85,0,1071256,0,0,0,0,0,0
20150105.133538,2811.48,40,1071296,0,0,0,0,0,0
20150105.133539,2811.48,2,1071298,2,0,0,0,0,0
20150105.13354,2811.48,2,1071300,2,0,0,0,0,0
20150105.133541,2811.48,0,1071300,0,0,0,0,0,0
20150105.133542,2811.48,2,1071302,2,0,0,0,0,0
20150105.133543,2811.48,0,1071302,0,0,0,0,0,0
20150105.133544,2810.85,14,1071316,4,0,0,0,0,0
20150105.133545,2810.85,2,1071318,0,0,0,0,0,0
20150105.133546,2811.48,22,1071340,2,0,0,0,0,0
20150105.133547,2811.48,2,1071342,0,0,0,0,0,0
20150105.133548,2811.48,0,1071342,0,0,0,0,0,0
20150105.133549,2811.48,6,1071348,0,0,0,0,0,0
20150105.13355,2811.48,0,1071348,0,0,0,0,0,0
20150105.133551,2811.48,2,1071350,2,0,0,0,0,0
20150105.133552,2811.48,2,1071352,0,0,0,0,0,0
20150105.133553,2811.48,200,1071552,-34,0,0,0,0,0
20150105.133554,2811.48,2,1071554,-2,0,0,0,0,0
20150105.133555,2811.48,0,1071554,0,0,0,0,0,0
20150105.133556,2811.48,4,1071558,0,0,0,0,0,0
20150105.133557,2811.48,14,1071572,0,0,0,0,0,0
20150105.133558,2810.85,20,1071592,0,0,0,0,0,0
20150105.133559,2811.48,30,1071622,-30,0,0,0,0,0
20150105.1336,2811.48,2,1071624,0,0,0,0,0,0
20150105.133601,2811.48,0,1071624,0,0,0,0,0,0
20150105.133602,2811.48,0,1071624,0,0,0,0,0,0
20150105.133603,2811.48,10,1071634,0,0,0,0,0,0
20150105.133604,2810.85,4,1071638,2,0,0,0,0,0
20150105.133605,2811.48,2,1071640,0,0,0,0,0,0
20150105.133606,2811.48,0,1071640,0,0,0,0,0,0
20150105.133607,2810.85,40,1071680,0,0,0,0,0,0
20150105.133608,2810.85,0,1071680,0,0,0,0,0,0
20150105.133609,2810.85,0,1071680,0,0,0,0,0,0
20150105.13361,2810.85,2,1071682,2,0,0,0,0,0
20150105.133611,2810.85,0,1071682,0,0,0,0,0,0
20150105.133612,2810.85,2,1071684,0,0,0,0,0,0
20150105.133613,2810.85,118,1071802,114,0,0,0,0,0
20150105.133614,2811.48,4,1071806,2,0,0,0,0,0
20150105.133615,2810.86,4,1071810,0,0,0,0,0,0
20150105.133616,2811.48,20,1071830,2,0,0,0,0,0
20150105.133617,2811.48,0,1071830,0,0,0,0,0,0
20150105.133618,2811.48,4,1071834,-2,0,0,0,0,0
20150105.133619,2811.48,0,1071834,0,0,0,0,0,0
20150105.13362,2811.48,2,1071836,2,0,0,0,0,0
20150105.133621,2810.85,2,1071838,0,0,0,0,0,0
20150105.133622,2811.48,1026,1072864,926,0,0,0,0,0
20150105.133623,2811.48,200,1073064,4,0,0,0,0,0
20150105.133624,2811.48,60,1073124,-40,0,0,0,0,0
20150105.133625,2811.48,60,1073184,-16,0,0,0,0,0
20150105.133626,2811.48,50,1073234,-50,0,0,0,0,0
20150105.133627,2811.48,172,1073406,-84,0,0,0,0,0
20150105.133628,2811.48,10,1073416,0,0,0,0,0,0
20150105.133629,2811.48,216,1073632,100,0,0,0,0,0
20150105.13363,2811.48,2,1073634,0,0,0,0,0,0
20150105.133631,2811.48,12,1073646,0,0,0,0,0,0
20150105.133632,2811.48,60,1073706,0,0,0,0,0,0
20150105.133633,2811.48,62,1073768,62,0,0,0,0,0
20150105.133634,2811.48,2,1073770,0,0,0,0,0,0
20150105.133635,2811.48,0,1073770,0,0,0,0,0,0
20150105.133636,2811.48,106,1073876,0,0,0,0,0,0
20150105.133637,2812.1,2,1073878,2,0,0,0,0,0
20150105.133638,2811.48,2,1073880,2,0,0,0,0,0
20150105.133639,2811.48,1110,1074990,784,0,0,0,0,0
20150105.13364,2811.48,62,1075052,6,0,0,0,0,0
20150105.133641,2811.48,2,1075054,2,0,0,0,0,0
20150105.133642,2810.86,8,1075062,0,0,0,0,0,0
20150105.133643,2810.86,6,1075068,0,0,0,0,0,0
20150105.133644,2811.48,4,1075072,4,0,0,0,0,0
20150105.133645,2811.48,2,1075074,2,0,0,0,0,0
20150105.133646,2811.48,100,1075174,100,0,0,0,0,0
20150105.133647,2811.48,26,1075200,24,0,0,0,0,0
20150105.133648,2811.48,20,1075220,0,0,0,0,0,0
20150105.133649,2811.48,2,1075222,0,0,0,0,0,0
20150105.13365,2811.48,2,1075224,0,0,0,0,0,0
20150105.133651,2811.48,4,1075228,4,0,0,0,0,0
20150105.133652,2811.48,4,1075232,2,0,0,0,0,0
20150105.133653,2811.48,6,1075238,6,0,0,0,0,0
20150105.133654,2811.48,94,1075332,0,0,0,0,0,0
20150105.133655,2811.48,2,1075334,2,0,0,0,0,0
20150105.133656,2811.48,2,1075336,0,0,0,0,0,0
20150105.133657,2810.86,4,1075340,4,0,0,0,0,0
20150105.133658,2811.48,2,1075342,0,0,0,0,0,0
20150105.133659,2811.48,42,1075384,2,0,0,0,0,0
20150105.1337,2811.48,2,1075386,2,0,0,0,0,0
20150105.133701,2811.48,2,1075388,2,0,0,0,0,0
20150105.133702,2811.48,4,1075392,2,0,0,0,0,0
20150105.133703,2810.86,4,1075396,0,0,0,0,0,0
20150105.133704,2810.86,2404,1077800,574,0,0,0,0,0
20150105.133705,2810.86,108,1077908,-106,0,0,0,0,0
20150105.133706,2811.48,66,1077974,0,0,0,0,0,0
20150105.133707,2810.24,174,1078148,-12,0,0,0,0,0
20150105.133708,2810.24,2,1078150,-2,0,0,0,0,0
20150105.133709,2810.24,26,1078176,-26,0,0,0,0,0
20150105.13371,2810.24,2,1078178,0,0,0,0,0,0
20150105.133711,2810.86,2,1078180,0,0,0,0,0,0
20150105.133712,2810.86,4,1078184,-4,0,0,0,0,0
20150105.133713,2810.86,14,1078198,-14,0,0,0,0,0
20150105.133714,2810.86,26,1078224,-12,0,0,0,0,0
20150105.133715,2810.86,52,1078276,52,0,0,0,0,0
20150105.133716,2810.86,134,1078410,-102,0,0,0,0,0
20150105.133717,2810.24,2,1078412,-2,0,0,0,0,0
20150105.133718,2810.86,74,1078486,-26,0,0,0,0,0
20150105.133719,2810.24,2,1078488,0,0,0,0,0,0
20150105.13372,2810.86,4,1078492,2,0,0,0,0,0
20150105.133721,2810.86,2,1078494,2,0,0,0,0,0
20150105.133722,2810.86,4,1078498,0,0,0,0,0,0
20150105.133723,2810.86,2,1078500,0,0,0,0,0,0
20150105.133724,2810.24,2,1078502,2,0,0,0,0,0
20150105.133725,2810.24,24,1078526,20,0,0,0,0,0
20150105.133726,2810.24,34,1078560,24,0,0,0,0,0
20150105.133727,2810.24,2,1078562,0,0,0,0,0,0
20150105.133728,2810.86,2,1078564,2,0,0,0,0,0
20150105.133729,2810.86,10,1078574,10,0,0,0,0,0
20150105.13373,2810.24,2,1078576,2,0,0,0,0,0
20150105.133731,2810.24,2012,1080588,1468,0,0,0,0,0
20150105.133732,2810.24,130,1080718,128,0,0,0,0,0
20150105.133733,2810.24,12,1080730,0,0,0,0,0,0
20150105.133734,2810.24,8,1080738,0,0,0,0,0,0
20150105.133735,2810.24,20,1080758,20,0,0,0,0,0
20150105.133736,2810.86,12,1080770,12,0,0,0,0,0
20150105.133737,2810.24,20,1080790,20,0,0,0,0,0
20150105.133738,2810.24,1914,1082704,1488,0,0,0,0,0
20150105.133739,2810.24,2,1082706,2,0,0,0,0,0
20150105.13374,2810.24,70,1082776,22,0,0,0,0,0
20150105.133741,2809.62,10,1082786,-10,0,0,0,0,0
20150105.133742,2810.24,114,1082900,16,0,0,0,0,0
20150105.133743,2810.24,190,1083090,-30,0,0,0,0,0
20150105.133744,2810.24,6,1083096,-2,0,0,0,0,0
20150105.133745,2810.87,2,1083098,2,0,0,0,0,0
20150105.133746,2810.24,4,1083102,2,0,0,0,0,0
20150105.133747,2810.24,208,1083310,200,0,0,0,0,0
20150105.133748,2810.24,210,1083520,4,0,0,0,0,0
20150105.133749,2810.24,40,1083560,-26,0,0,0,0,0
20150105.13375,2810.24,20,1083580,6,0,0,0,0,0
20150105.133751,2810.24,230,1083810,-62,0,0,0,0,0
20150105.133752,2809.62,544,1084354,404,0,0,0,0,0
20150105.133753,2810.24,2,1084356,0,0,0,0,0,0
20150105.133754,2809.62,2,1084358,2,0,0,0,0,0
20150105.133755,2809.62,8,1084366,0,0,0,0,0,0
20150105.133756,2809.62,12,1084378,0,0,0,0,0,0
20150105.133757,2809.62,10,1084388,2,0,0,0,0,0
20150105.133758,2809.62,10,1084398,10,0,0,0,0,0
20150105.133759,2810.24,2,1084400,0,0,0,0,0,0
20150105.1338,2809.62,302,1084702,-298,0,0,0,0,0
20150105.133801,2810.24,2,1084704,0,0,0,0,0,0
20150105.133802,2810.24,2,1084706,0,0,0,0,0,0
20150105.133803,2810.24,42,1084748,6,0,0,0,0,0
20150105.133804,2810.24,2,1084750,2,0,0,0,0,0
20150105.133805,2809.62,10,1084760,0,0,0,0,0,0
20150105.133806,2809.62,6,1084766,0,0,0,0,0,0
20150105.133807,2810.24,2,1084768,0,0,0,0,0,0
20150105.133808,2810.24,2,1084770,0,0,0,0,0,0
20150105.133809,2810.24,40,1084810,0,0,0,0,0,0
20150105.13381,2809.62,8,1084818,8,0,0,0,0,0
20150105.133811,2810.24,2,1084820,2,0,0,0,0,0
20150105.133812,2810.24,20,1084840,20,0,0,0,0,0
20150105.133813,2810.24,2,1084842,2,0,0,0,0,0
20150105.133814,2810.24,2,1084844,0,0,0,0,0,0
20150105.133815,2809.62,4,1084848,4,0,0,0,0,0
20150105.133816,2809.62,24,1084872,18,0,0,0,0,0
20150105.133817,2809.62,4,1084876,0,0,0,0,0,0
20150105.133818,2809.62,10,1084886,10,0,0,0,0,0
20150105.133819,2809.62,8,1084894,0,0,0,0,0,0
20150105.13382,2810.24,2,1084896,0,0,0,0,0,0
20150105.133821,2809.62,2,1084898,2,0,0,0,0,0
20150105.133822,2810.24,2,1084900,2,0,0,0,0,0
20150105.133823,2809.62,2,1084902,2,0,0,0,0,0
20150105.133824,2810.24,2,1084904,2,0,0,0,0,0
20150105.133825,2810.24,4,1084908,4,0,0,0,0,0
20150105.133826,2809.62,2,1084910,2,0,0,0,0,0
20150105.133827,2810.24,2,1084912,2,0,0,0,0,0
20150105.133828,2810.24,4,1084916,4,0,0,0,0,0
20150105.133829,2810.24,2,1084918,2,0,0,0,0,0
20150105.13383,2809.62,14,1084932,4,0,0,0,0,0
20150105.133831,2809.62,2,1084934,2,0,0,0,0,0
20150105.133832,2809.62,2,1084936,2,0,0,0,0,0
20150105.133833,2810.24,2,1084938,2,0,0,0,0,0
20150105.133834,2810.24,2,1084940,2,0,0,0,0,0
20150105.133835,2810.24,2,1084942,0,0,0,0,0,0
20150105.133836,2809.62,2,1084944,2,0,0,0,0,0
20150105.133837,2810.24,6,1084950,4,0,0,0,0,0
20150105.133838,2810.24,18,1084968,0,0,0,0,0,0
20150105.133839,2810.24,0,1084968,0,0,0,0,0,0
20150105.13384,2809.62,10,1084978,10,0,0,0,0,0
20150105.133841,2810.24,2,1084980,0,0,0,0,0,0
20150105.133842,2810.24,2,1084982,2,0,0,0,0,0
20150105.133843,2810.24,2,1084984,2,0,0,0,0,0
20150105.133844,2810.24,0,1084984,0,0,0,0,0,0
20150105.133845,2810.24,2,1084986,2,0,0,0,0,0
20150105.133846,2810.24,0,1084986,0,0,0,0,0,0
20150105.133847,2810.24,2,1084988,0,0,0,0,0,0
20150105.133848,2809.62,2,1084990,0,0,0,0,0,0
20150105.133849,2810.24,36,1085026,2,0,0,0,0,0
20150105.13385,2809.62,4,1085030,2,0,0,0,0,0
20150105.133851,2809.62,0,1085030,0,0,0,0,0,0
20150105.133852,2809.62,0,1085030,0,0,0,0,0,0
20150105.133853,2809.62,0,1085030,0,0,0,0,0,0
20150105.133854,2809.62,0,1085030,0,0,0,0,0,0
20150105.133855,2809.62,0,1085030,0,0,0,0,0,0
20150105.133856,2809.62,0,1085030,0,0,0,0,0,0
20150105.133857,2809.62,20,1085050,0,0,0,0,0,0
20150105.133858,2810.24,22,1085072,22,0,0,0,0,0
20150105.133859,2810.24,2,1085074,2,0,0,0,0,0
20150105.1339,2810.24,0,1085074,0,0,0,0,0,0
20150105.133901,2810.24,0,1085074,0,0,0,0,0,0
20150105.133902,2810.24,0,1085074,0,0,0,0,0,0
20150105.133903,2810.24,0,1085074,0,0,0,0,0,0
20150105.133904,2810.24,0,1085074,0,0,0,0,0,0
20150105.133905,2810.24,0,1085074,0,0,0,0,0,0
20150105.133906,2810.24,2,1085076,2,0,0,0,0,0
20150105.133907,2810.24,0,1085076,0,0,0,0,0,0
20150105.133908,2810.24,0,1085076,0,0,0,0,0,0
20150105.133909,2810.24,0,1085076,0,0,0,0,0,0
20150105.13391,2809.62,28,1085104,0,0,0,0,0,0
20150105.133911,2809.62,0,1085104,0,0,0,0,0,0
20150105.133912,2809.62,0,1085104,0,0,0,0,0,0
20150105.133913,2809.62,2,1085106,2,0,0,0,0,0
20150105.133914,2809.62,0,1085106,0,0,0,0,0,0
20150105.133915,2809.62,0,1085106,0,0,0,0,0,0
20150105.133916,2809.62,0,1085106,0,0,0,0,0,0
20150105.133917,2810.24,2,1085108,2,0,0,0,0,0
20150105.133918,2810.24,0,1085108,0,0,0,0,0,0
20150105.133919,2810.24,0,1085108,0,0,0,0,0,0
20150105.13392,2809.62,1000,1086108,1000,0,0,0,0,0
20150105.133921,2809.62,0,1086108,0,0,0,0,0,0
20150105.133922,2809.62,12,1086120,12,0,0,0,0,0
20150105.133923,2810.25,6,1086126,0,0,0,0,0,0
20150105.133924,2809.62,2,1086128,0,0,0,0,0,0
20150105.133925,2809.63,1000,1087128,998,0,0,0,0,0
20150105.133926,2809.63,22,1087150,0,0,0,0,0,0
20150105.133927,2810.25,2,1087152,2,0,0,0,0,0
20150105.133928,2809.63,6,1087158,-6,0,0,0,0,0
20150105.133929,2809.63,4,1087162,0,0,0,0,0,0
20150105.13393,2810.25,20,1087182,20,0,0,0,0,0
20150105.133931,2810.25,2,1087184,0,0,0,0,0,0
20150105.133932,2809.63,2,1087186,-2,0,0,0,0,0
20150105.133933,2809.63,2,1087188,-2,0,0,0,0,0
20150105.133934,2809.63,0,1087188,0,0,0,0,0,0
20150105.133935,2809.63,2,1087190,0,0,0,0,0,0
20150105.133936,2809.63,0,1087190,0,0,0,0,0,0
20150105.133937,2810.25,2,1087192,0,0,0,0,0,0
20150105.133938,2810.25,0,1087192,0,0,0,0,0,0
20150105.133939,2809.63,2,1087194,-2,0,0,0,0,0
20150105.13394,2809.63,0,1087194,0,0,0,0,0,0
20150105.133941,2809.63,0,1087194,0,0,0,0,0,0
20150105.133942,2810.25,20,1087214,0,0,0,0,0,0
20150105.133943,2810.25,4,1087218,0,0,0,0,0,0
20150105.133944,2810.25,0,1087218,0,0,0,0,0,0
20150105.133945,2810.25,0,1087218,0,0,0,0,0,0
20150105.133946,2809.63,2,1087220,0,0,0,0,0,0
20150105.133947,2810.25,2,1087222,2,0,0,0,0,0
20150105.133948,2810.25,0,1087222,0,0,0,0,0,0
20150105.133949,2809.63,2,1087224,-2,0,0,0,0,0
20150105.13395,2809.63,4,1087228,0,0,0,0,0,0
20150105.133951,2809.63,2,1087230,-2,0,0,0,0,0
20150105.133952,2809.63,20,1087250,-20,0,0,0,0,0
20150105.133953,2810.25,12,1087262,-10,0,0,0,0,0
20150105.133954,2809.63,10,1087272,0,0,0,0,0,0
20150105.133955,2809.63,2,1087274,0,0,0,0,0,0
20150105.133956,2809.63,2,1087276,-2,0,0,0,0,0
20150105.133957,2809.63,4,1087280,0,0,0,0,0,0
20150105.133958,2809.63,0,1087280,0,0,0,0,0,0
20150105.133959,2810.25,10,1087290,10,0,0,0,0,0
20150105.134,2809.63,2,1087292,0,0,0,0,0,0
20150105.134001,2810.25,14,1087306,0,0,0,0,0,0
20150105.134002,2810.25,0,1087306,0,0,0,0,0,0
20150105.134003,2810.25,0,1087306,0,0,0,0,0,0
20150105.134004,2809.63,2,1087308,0,0,0,0,0,0
20150105.134005,2810.25,2,1087310,2,0,0,0,0,0
20150105.134006,2810.25,0,1087310,0,0,0,0,0,0
20150105.134007,2810.25,0,1087310,0,0,0,0,0,0
20150105.134008,2810.25,0,1087310,0,0,0,0,0,0
20150105.134009,2810.25,0,1087310,0,0,0,0,0,0
20150105.13401,2810.25,0,1087310,0,0,0,0,0,0
20150105.134011,2809.63,2,1087312,0,0,0,0,0,0
20150105.134012,2810.25,10,1087322,-8,0,0,0,0,0
20150105.134013,2810.25,0,1087322,0,0,0,0,0,0
20150105.134014,2809.63,2,1087324,0,0,0,0,0,0
20150105.134015,2809.63,0,1087324,0,0,0,0,0,0
20150105.134016,2809.63,0,1087324,0,0,0,0,0,0
20150105.134017,2809.63,12,1087336,-12,0,0,0,0,0
20150105.134018,2809.63,0,1087336,0,0,0,0,0,0
20150105.134019,2809.63,4,1087340,0,0,0,0,0,0
20150105.13402,2810.25,40,1087380,34,0,0,0,0,0
20150105.134021,2810.25,0,1087380,0,0,0,0,0,0
20150105.134022,2809.63,2,1087382,-2,0,0,0,0,0
20150105.134023,2810.25,10,1087392,10,0,0,0,0,0
20150105.134024,2810.25,20,1087412,0,0,0,0,0,0
20150105.134025,2810.25,0,1087412,0,0,0,0,0,0
20150105.134026,2810.25,0,1087412,0,0,0,0,0,0
20150105.134027,2809.63,20,1087432,-20,0,0,0,0,0
20150105.134028,2809.63,0,1087432,0,0,0,0,0,0
20150105.134029,2809.63,0,1087432,0,0,0,0,0,0
20150105.13403,2809.63,28,1087460,-20,0,0,0,0,0
20150105.134031,2809.63,2,1087462,0,0,0,0,0,0
20150105.134032,2809.63,10,1087472,-10,0,0,0,0,0
20150105.134033,2809.63,0,1087472,0,0,0,0,0,0
20150105.134034,2810.25,4,1087476,0,0,0,0,0,0
20150105.134035,2810.25,0,1087476,0,0,0,0,0,0
20150105.134036,2809.63,10,1087486,-10,0,0,0,0,0
20150105.134037,2809.63,12,1087498,-12,0,0,0,0,0
20150105.134038,2809.63,2,1087500,0,0,0,0,0,0
20150105.134039,2809,1222,1088722,378,0,0,0,0,0
20150105.13404,2809,86,1088808,-16,0,0,0,0,0
20150105.134041,2809.63,16,1088824,-14,0,0,0,0,0
20150105.134042,2810.25,672,1089496,-22,0,0,0,0,0
20150105.134043,2809.63,4,1089500,-2,0,0,0,0,0
20150105.134044,2810.25,14,1089514,-14,0,0,0,0,0
20150105.134045,2809.63,4,1089518,0,0,0,0,0,0
20150105.134046,2809.63,4,1089522,-4,0,0,0,0,0
20150105.134047,2809.63,2,1089524,0,0,0,0,0,0
20150105.134048,2809.63,4,1089528,0,0,0,0,0,0
20150105.134049,2809.63,6,1089534,-2,0,0,0,0,0
20150105.13405,2809.63,2,1089536,0,0,0,0,0,0
20150105.134051,2809.63,4,1089540,0,0,0,0,0,0
20150105.134052,2809.63,4,1089544,0,0,0,0,0,0
20150105.134053,2809.63,0,1089544,0,0,0,0,0,0
20150105.134054,2809.63,2,1089546,0,0,0,0,0,0
20150105.134055,2809.63,28,1089574,0,0,0,0,0,0
20150105.134056,2809.63,4,1089578,0,0,0,0,0,0
20150105.134057,2810.25,2,1089580,0,0,0,0,0,0
20150105.134058,2809.63,4,1089584,0,0,0,0,0,0
20150105.134059,2810.25,2,1089586,0,0,0,0,0,0
20150105.1341,2809.63,6,1089592,-6,0,0,0,0,0
20150105.134101,2809.63,4,1089596,-4,0,0,0,0,0
20150105.134102,2809.63,40,1089636,-30,0,0,0,0,0
20150105.134103,2810.25,2,1089638,0,0,0,0,0,0
20150105.134104,2810.25,6,1089644,-2,0,0,0,0,0
20150105.134105,2809.63,2,1089646,-2,0,0,0,0,0
20150105.134106,2810.25,2,1089648,0,0,0,0,0,0
20150105.134107,2810.25,2,1089650,0,0,0,0,0,0
20150105.134108,2810.25,0,1089650,0,0,0,0,0,0
20150105.134109,2810.25,2,1089652,0,0,0,0,0,0
20150105.13411,2810.25,0,1089652,0,0,0,0,0,0
20150105.134111,2810.25,2,1089654,-2,0,0,0,0,0
20150105.134112,2810.25,2,1089656,0,0,0,0,0,0
20150105.134113,2810.25,10,1089666,-10,0,0,0,0,0
20150105.134114,2810.25,2,1089668,0,0,0,0,0,0
20150105.134115,2810.25,0,1089668,0,0,0,0,0,0
20150105.134116,2810.25,0,1089668,0,0,0,0,0,0
20150105.134117,2810.25,2,1089670,0,0,0,0,0,0
20150105.134118,2810.25,2,1089672,-2,0,0,0,0,0
20150105.134119,2810.25,0,1089672,0,0,0,0,0,0
20150105.13412,2810.25,2,1089674,0,0,0,0,0,0
20150105.134121,2810.25,0,1089674,0,0,0,0,0,0
20150105.134122,2810.25,0,1089674,0,0,0,0,0,0
20150105.134123,2810.25,6,1089680,0,0,0,0,0,0
20150105.134124,2810.25,640,1090320,-184,0,0,0,0,0
20150105.134125,2810.25,2,1090322,0,0,0,0,0,0
20150105.134126,2810.87,2,1090324,2,0,0,0,0,0
20150105.134127,2810.87,0,1090324,0,0,0,0,0,0
20150105.134128,2810.87,60,1090384,0,0,0,0,0,0
20150105.134129,2810.25,4,1090388,0,0,0,0,0,0
20150105.13413,2810.25,4,1090392,0,0,0,0,0,0
20150105.134131,2810.25,2,1090394,0,0,0,0,0,0
20150105.134132,2810.25,48,1090442,4,0,0,0,0,0
20150105.134133,2810.87,74,1090516,0,0,0,0,0,0
20150105.134134,2810.87,0,1090516,0,0,0,0,0,0
20150105.134135,2810.25,2,1090518,-2,0,0,0,0,0
20150105.134136,2810.25,2,1090520,0,0,0,0,0,0
20150105.134137,2810.25,0,1090520,0,0,0,0,0,0
20150105.134138,2810.87,62,1090582,0,0,0,0,0,0
20150105.134139,2810.25,2,1090584,-2,0,0,0,0,0
20150105.13414,2810.25,4,1090588,-4,0,0,0,0,0
20150105.134141,2810.87,12,1090600,10,0,0,0,0,0
20150105.134142,2810.87,0,1090600,0,0,0,0,0,0
20150105.134143,2810.25,2,1090602,0,0,0,0,0,0
20150105.134144,2810.25,4,1090606,-4,0,0,0,0,0
20150105.134145,2810.25,206,1090812,-132,0,0,0,0,0
20150105.134146,2810.25,340,1091152,146,0,0,0,0,0
20150105.134147,2810.25,6,1091158,0,0,0,0,0,0
20150105.134148,2810.25,0,1091158,0,0,0,0,0,0
20150105.134149,2810.25,4,1091162,-4,0,0,0,0,0
20150105.13415,2810.25,10,1091172,-10,0,0,0,0,0
20150105.134151,2810.25,6,1091178,0,0,0,0,0,0
20150105.134152,2810.25,4,1091182,-4,0,0,0,0,0
20150105.134153,2810.25,4,1091186,0,0,0,0,0,0
20150105.134154,2810.25,6,1091192,-2,0,0,0,0,0
20150105.134155,2810.25,2,1091194,-2,0,0,0,0,0
20150105.134156,2810.25,40,1091234,-40,0,0,0,0,0
20150105.134157,2810.25,0,1091234,0,0,0,0,0,0
20150105.134158,2810.25,0,1091234,0,0,0,0,0,0
20150105.134159,2810.25,0,1091234,0,0,0,0,0,0
20150105.1342,2810.25,6,1091240,6,0,0,0,0,0
20150105.134201,2810.25,18,1091258,-12,0,0,0,0,0
20150105.134202,2810.25,16,1091274,-8,0,0,0,0,0
20150105.134203,2810.25,2,1091276,0,0,0,0,0,0
20150105.134204,2810.25,0,1091276,0,0,0,0,0,0
20150105.134205,2810.25,2,1091278,-2,0,0,0,0,0
20150105.134206,2810.25,0,1091278,0,0,0,0,0,0
20150105.134207,2809.63,4,1091282,0,0,0,0,0,0
20150105.134208,2810.25,2,1091284,-2,0,0,0,0,0
20150105.134209,2810.25,2,1091286,0,0,0,0,0,0
20150105.13421,2810.25,0,1091286,0,0,0,0,0,0
20150105.134211,2809.63,4,1091290,0,0,0,0,0,0
20150105.134212,2809.63,0,1091290,0,0,0,0,0,0
20150105.134213,2809.63,0,1091290,0,0,0,0,0,0
20150105.134214,2809.63,0,1091290,0,0,0,0,0,0
20150105.134215,2809.63,0,1091290,0,0,0,0,0,0
20150105.134216,2809.63,60,1091350,-60,0,0,0,0,0
20150105.134217,2810.25,2,1091352,0,0,0,0,0,0
20150105.134218,2810.25,0,1091352,0,0,0,0,0,0
20150105.134219,2810.25,0,1091352,0,0,0,0,0,0
20150105.13422,2809.63,52,1091404,-52,0,0,0,0,0
20150105.134221,2809.63,0,1091404,0,0,0,0,0,0
20150105.134222,2810.25,8,1091412,0,0,0,0,0,0
20150105.134223,2809.63,4,1091416,-4,0,0,0,0,0
20150105.134224,2809.63,2,1091418,0,0,0,0,0,0
20150105.134225,2809.63,2,1091420,0,0,0,0,0,0
20150105.134226,2809.63,6,1091426,0,0,0,0,0,0
20150105.134227,2810.25,30,1091456,0,0,0,0,0,0
20150105.134228,2810.25,32,1091488,-30,0,0,0,0,0
20150105.134229,2809.63,40,1091528,0,0,0,0,0,0
20150105.13423,2810.25,2,1091530,0,0,0,0,0,0
20150105.134231,2810.25,0,1091530,0,0,0,0,0,0
20150105.134232,2809.63,2,1091532,0,0,0,0,0,0
20150105.134233,2809.63,0,1091532,0,0,0,0,0,0
20150105.134234,2809.63,0,1091532,0,0,0,0,0,0
20150105.134235,2809.63,0,1091532,0,0,0,0,0,0
20150105.134236,2809.63,0,1091532,0,0,0,0,0,0
20150105.134237,2809.63,2,1091534,2,0,0,0,0,0
20150105.134238,2809.63,0,1091534,0,0,0,0,0,0
20150105.134239,2809.63,2,1091536,0,0,0,0,0,0
20150105.13424,2809.63,0,1091536,0,0,0,0,0,0
20150105.134241,2810.25,2,1091538,0,0,0,0,0,0
20150105.134242,2809.63,2,1091540,2,0,0,0,0,0
20150105.134243,2809.63,2,1091542,2,0,0,0,0,0
20150105.134244,2809.63,0,1091542,0,0,0,0,0,0
20150105.134245,2810.25,2,1091544,0,0,0,0,0,0
20150105.134246,2810.25,0,1091544,0,0,0,0,0,0
20150105.134247,2810.25,2,1091546,0,0,0,0,0,0
20150105.134248,2810.25,0,1091546,0,0,0,0,0,0
20150105.134249,2810.25,0,1091546,0,0,0,0,0,0
20150105.13425,2810.25,0,1091546,0,0,0,0,0,0
20150105.134251,2810.25,0,1091546,0,0,0,0,0,0
20150105.134252,2810.25,0,1091546,0,0,0,0,0,0
20150105.134253,2810.25,0,1091546,0,0,0,0,0,0
20150105.134254,2810.25,0,1091546,0,0,0,0,0,0
20150105.134255,2810.25,40,1091586,-40,0,0,0,0,0
20150105.134256,2810.25,4,1091590,0,0,0,0,0,0
20150105.134257,2809.63,10,1091600,10,0,0,0,0,0
20150105.134258,2810.25,2,1091602,-2,0,0,0,0,0
20150105.134259,2810.25,0,1091602,0,0,0,0,0,0
20150105.1343,2810.25,0,1091602,0,0,0,0,0,0
20150105.134301,2810.25,0,1091602,0,0,0,0,0,0
20150105.134302,2810.25,0,1091602,0,0,0,0,0,0
20150105.134303,2810.25,0,1091602,0,0,0,0,0,0
20150105.134304,2810.25,0,1091602,0,0,0,0,0,0
20150105.134305,2810.25,0,1091602,0,0,0,0,0,0
20150105.134306,2810.25,0,1091602,0,0,0,0,0,0
20150105.134307,2810.25,0,1091602,0,0,0,0,0,0
20150105.134308,2810.25,0,1091602,0,0,0,0,0,0
20150105.134309,2810.25,0,1091602,0,0,0,0,0,0
20150105.13431,2810.25,12,1091614,-12,0,0,0,0,0
20150105.134311,2810.25,0,1091614,0,0,0,0,0,0
20150105.134312,2810.25,0,1091614,0,0,0,0,0,0
20150105.134313,2810.25,0,1091614,0,0,0,0,0,0
20150105.134314,2810.25,0,1091614,0,0,0,0,0,0
20150105.134315,2810.25,0,1091614,0,0,0,0,0,0
20150105.134316,2810.25,0,1091614,0,0,0,0,0,0
20150105.134317,2810.25,0,1091614,0,0,0,0,0,0
20150105.134318,2810.25,20,1091634,14,0,0,0,0,0
20150105.134319,2810.25,0,1091634,0,0,0,0,0,0
20150105.13432,2810.25,0,1091634,0,0,0,0,0,0
20150105.134321,2810.25,0,1091634,0,0,0,0,0,0
20150105.134322,2810.25,0,1091634,0,0,0,0,0,0
20150105.134323,2810.25,0,1091634,0,0,0,0,0,0
20150105.134324,2810.25,0,1091634,0,0,0,0,0,0
20150105.134325,2810.25,0,1091634,0,0,0,0,0,0
20150105.134326,2810.25,2,1091636,2,0,0,0,0,0
20150105.134327,2810.25,0,1091636,0,0,0,0,0,0
20150105.134328,2810.25,0,1091636,0,0,0,0,0,0
20150105.134329,2810.25,0,1091636,0,0,0,0,0,0
20150105.13433,2810.25,0,1091636,0,0,0,0,0,0
20150105.134331,2809.63,2,1091638,2,0,0,0,0,0
20150105.134332,2809.63,0,1091638,0,0,0,0,0,0
20150105.134333,2809.63,2,1091640,2,0,0,0,0,0
20150105.134334,2810.25,86,1091726,58,0,0,0,0,0
20150105.134335,2810.25,0,1091726,0,0,0,0,0,0
20150105.134336,2810.25,0,1091726,0,0,0,0,0,0
20150105.134337,2810.25,40,1091766,0,0,0,0,0,0
20150105.134338,2810.25,8,1091774,-6,0,0,0,0,0
20150105.134339,2810.25,14,1091788,8,0,0,0,0,0
20150105.13434,2810.25,0,1091788,0,0,0,0,0,0
20150105.134341,2810.25,14,1091802,-14,0,0,0,0,0
20150105.134342,2809.63,32,1091834,0,0,0,0,0,0
20150105.134343,2809.63,0,1091834,0,0,0,0,0,0
20150105.134344,2809.63,12,1091846,0,0,0,0,0,0
20150105.134345,2810.25,10,1091856,-10,0,0,0,0,0
20150105.134346,2810.25,0,1091856,0,0,0,0,0,0
20150105.134347,2810.25,0,1091856,0,0,0,0,0,0
20150105.134348,2810.25,0,1091856,0,0,0,0,0,0
20150105.134349,2810.25,0,1091856,0,0,0,0,0,0
20150105.13435,2809.63,8,1091864,0,0,0,0,0,0
20150105.134351,2810.25,2,1091866,0,0,0,0,0,0
20150105.134352,2809.63,38,1091904,38,0,0,0,0,0
20150105.134353,2809.63,72,1091976,72,0,0,0,0,0
20150105.134354,2809.63,2,1091978,2,0,0,0,0,0
20150105.134355,2809.63,0,1091978,0,0,0,0,0,0
20150105.134356,2809.63,18,1091996,18,0,0,0,0,0
20150105.134357,2809.63,0,1091996,0,0,0,0,0,0
20150105.134358,2809.63,20,1092016,18,0,0,0,0,0
20150105.134359,2809.63,2,1092018,-2,0,0,0,0,0
20150105.1344,2809.63,0,1092018,0,0,0,0,0,0
20150105.134401,2809.63,0,1092018,0,0,0,0,0,0
20150105.134402,2809.63,0,1092018,0,0,0,0,0,0
20150105.134403,2809.63,2,1092020,-2,0,0,0,0,0
20150105.134404,2810.25,40,1092060,0,0,0,0,0,0
20150105.134405,2809.63,8,1092068,-8,0,0,0,0,0
20150105.134406,2810.25,12,1092080,0,0,0,0,0,0
20150105.134407,2810.25,0,1092080,0,0,0,0,0,0
20150105.134408,2810.25,608,1092688,222,0,0,0,0,0
20150105.134409,2810.25,2,1092690,0,0,0,0,0,0
20150105.13441,2809.63,20,1092710,-20,0,0,0,0,0
20150105.134411,2810.25,214,1092924,-200,0,0,0,0,0
20150105.134412,2810.25,20,1092944,0,0,0,0,0,0
20150105.134413,2810.25,10,1092954,0,0,0,0,0,0
20150105.134414,2810.25,12,1092966,0,0,0,0,0,0
20150105.134415,2810.25,12,1092978,0,0,0,0,0,0
20150105.134416,2810.25,2,1092980,0,0,0,0,0,0
20150105.134417,2810.25,4,1092984,0,0,0,0,0,0
20150105.134418,2810.25,102,1093086,8,0,0,0,0,0
20150105.134419,2810.25,110,1093196,42,0,0,0,0,0
20150105.13442,2810.87,2,1093198,2,0,0,0,0,0
20150105.134421,2810.25,2,1093200,0,0,0,0,0,0
20150105.134422,2810.25,50,1093250,50,0,0,0,0,0
20150105.134423,2810.25,120,1093370,2,0,0,0,0,0
20150105.134424,2810.25,0,1093370,0,0,0,0,0,0
20150105.134425,2810.25,0,1093370,0,0,0,0,0,0
20150105.134426,2810.25,0,1093370,0,0,0,0,0,0
20150105.134427,2810.25,0,1093370,0,0,0,0,0,0
20150105.134428,2810.25,2,1093372,0,0,0,0,0,0
20150105.134429,2810.25,2,1093374,0,0,0,0,0,0
20150105.13443,2810.87,2,1093376,0,0,0,0,0,0
20150105.134431,2810.87,0,1093376,0,0,0,0,0,0
20150105.134432,2810.87,0,1093376,0,0,0,0,0,0
20150105.134433,2810.87,10,1093386,10,0,0,0,0,0
20150105.134434,2810.25,6,1093392,4,0,0,0,0,0
20150105.134435,2810.25,98,1093490,-46,0,0,0,0,0
20150105.134436,2810.25,2,1093492,0,0,0,0,0,0
20150105.134437,2810.87,252,1093744,140,0,0,0,0,0
20150105.134438,2810.25,4,1093748,4,0,0,0,0,0
20150105.134439,2810.25,4,1093752,2,0,0,0,0,0
20150105.13444,2810.25,2,1093754,2,0,0,0,0,0
20150105.134441,2810.25,0,1093754,0,0,0,0,0,0
20150105.134442,2810.25,0,1093754,0,0,0,0,0,0
20150105.134443,2810.25,0,1093754,0,0,0,0,0,0
20150105.134444,2810.25,4,1093758,0,0,0,0,0,0
20150105.134445,2810.25,2,1093760,2,0,0,0,0,0
20150105.134446,2810.25,0,1093760,0,0,0,0,0,0
20150105.134447,2810.25,0,1093760,0,0,0,0,0,0
20150105.134448,2810.25,2,1093762,2,0,0,0,0,0
20150105.134449,2810.25,72,1093834,-38,0,0,0,0,0
20150105.13445,2810.25,2,1093836,-2,0,0,0,0,0
20150105.134451,2810.25,16,1093852,-16,0,0,0,0,0
20150105.134452,2810.25,4,1093856,-4,0,0,0,0,0
20150105.134453,2810.25,0,1093856,0,0,0,0,0,0
20150105.134454,2810.25,0,1093856,0,0,0,0,0,0
20150105.134455,2810.25,0,1093856,0,0,0,0,0,0
20150105.134456,2810.25,0,1093856,0,0,0,0,0,0
20150105.134457,2810.25,0,1093856,0,0,0,0,0,0
20150105.134458,2810.25,38,1093894,-38,0,0,0,0,0
20150105.134459,2810.25,0,1093894,0,0,0,0,0,0
20150105.1345,2810.25,0,1093894,0,0,0,0,0,0
20150105.134501,2810.25,2,1093896,-2,0,0,0,0,0
20150105.134502,2810.25,24,1093920,0,0,0,0,0,0
20150105.134503,2810.25,0,1093920,0,0,0,0,0,0
20150105.134504,2809.63,8,1093928,0,0,0,0,0,0
20150105.134505,2809.63,2,1093930,-2,0,0,0,0,0
20150105.134506,2810.25,6,1093936,6,0,0,0,0,0
20150105.134507,2809.63,2,1093938,-2,0,0,0,0,0
20150105.134508,2809.63,4,1093942,0,0,0,0,0,0
20150105.134509,2810.25,2,1093944,2,0,0,0,0,0
20150105.13451,2810.25,0,1093944,0,0,0,0,0,0
20150105.134511,2810.25,4,1093948,4,0,0,0,0,0
20150105.134512,2809.63,26,1093974,-26,0,0,0,0,0
20150105.134513,2809.63,0,1093974,0,0,0,0,0,0
20150105.134514,2810.25,4,1093978,0,0,0,0,0,0
20150105.134515,2810.25,0,1093978,0,0,0,0,0,0
20150105.134516,2810.25,0,1093978,0,0,0,0,0,0
20150105.134517,2810.25,2,1093980,2,0,0,0,0,0
20150105.134518,2810.25,24,1094004,-16,0,0,0,0,0
20150105.134519,2810.25,0,1094004,0,0,0,0,0,0
20150105.13452,2810.25,0,1094004,0,0,0,0,0,0
20150105.134521,2809.63,4,1094008,0,0,0,0,0,0
20150105.134522,2809.63,0,1094008,0,0,0,0,0,0
20150105.134523,2810.25,2,1094010,2,0,0,0,0,0
20150105.134524,2810.25,0,1094010,0,0,0,0,0,0
20150105.134525,2810.25,0,1094010,0,0,0,0,0,0
20150105.134526,2810.25,0,1094010,0,0,0,0,0,0
20150105.134527,2809.63,20,1094030,0,0,0,0,0,0
20150105.134528,2809.63,0,1094030,0,0,0,0,0,0
20150105.134529,2809.63,2,1094032,-2,0,0,0,0,0
20150105.13453,2809.63,4,1094036,0,0,0,0,0,0
20150105.134531,2809.63,0,1094036,0,0,0,0,0,0
20150105.134532,2810.25,14,1094050,0,0,0,0,0,0
20150105.134533,2810.25,0,1094050,0,0,0,0,0,0
20150105.134534,2810.25,0,1094050,0,0,0,0,0,0
20150105.134535,2810.25,0,1094050,0,0,0,0,0,0
20150105.134536,2809.63,4,1094054,-4,0,0,0,0,0
20150105.134537,2809.63,0,1094054,0,0,0,0,0,0
20150105.134538,2809.63,0,1094054,0,0,0,0,0,0
20150105.134539,2809.63,0,1094054,0,0,0,0,0,0
20150105.13454,2809.63,0,1094054,0,0,0,0,0,0
20150105.134541,2810.25,4,1094058,4,0,0,0,0,0
20150105.134542,2809.63,2,1094060,0,0,0,0,0,0
20150105.134543,2810.25,38,1094098,0,0,0,0,0,0
20150105.134544,2810.25,12,1094110,0,0,0,0,0,0
20150105.134545,2810.25,0,1094110,0,0,0,0,0,0
20150105.134546,2810.25,2,1094112,2,0,0,0,0,0
20150105.134547,2810.25,0,1094112,0,0,0,0,0,0
20150105.134548,2810.25,0,1094112,0,0,0,0,0,0
20150105.134549,2810.25,10,1094122,10,0,0,0,0,0
20150105.13455,2809.63,2,1094124,0,0,0,0,0,0
20150105.134551,2809.63,2,1094126,0,0,0,0,0,0
20150105.134552,2810.25,4,1094130,4,0,0,0,0,0
20150105.134553,2810.25,0,1094130,0,0,0,0,0,0
20150105.134554,2810.25,0,1094130,0,0,0,0,0,0
20150105.134555,2810.25,0,1094130,0,0,0,0,0,0
20150105.134556,2810.25,0,1094130,0,0,0,0,0,0
20150105.134557,2809.63,20,1094150,0,0,0,0,0,0
20150105.134558,2809.63,2,1094152,0,0,0,0,0,0
20150105.134559,2809.63,2,1094154,0,0,0,0,0,0
20150105.1346,2809.63,2,1094156,0,0,0,0,0,0
20150105.134601,2809.63,0,1094156,0,0,0,0,0,0
20150105.134602,2810.25,10,1094166,0,0,0,0,0,0
20150105.134603,2810.25,0,1094166,0,0,0,0,0,0
20150105.134604,2809.63,2,1094168,0,0,0,0,0,0
20150105.134605,2810.25,20,1094188,20,0,0,0,0,0
20150105.134606,2810.25,4,1094192,4,0,0,0,0,0
20150105.134607,2810.25,0,1094192,0,0,0,0,0,0
20150105.134608,2810.25,0,1094192,0,0,0,0,0,0
20150105.134609,2810.25,4,1094196,0,0,0,0,0,0
20150105.13461,2810.25,0,1094196,0,0,0,0,0,0
20150105.134611,2809.63,2,1094198,0,0,0,0,0,0
20150105.134612,2809.63,2,1094200,0,0,0,0,0,0
20150105.134613,2810.87,840,1095040,-276,0,0,0,0,0
20150105.134614,2809.63,2,1095042,0,0,0,0,0,0
20150105.134615,2810.87,12,1095054,0,0,0,0,0,0
20150105.134616,2810.87,38,1095092,0,0,0,0,0,0
20150105.134617,2810.25,34,1095126,30,0,0,0,0,0
20150105.134618,2810.25,10,1095136,0,0,0,0,0,0
20150105.134619,2810.25,2,1095138,2,0,0,0,0,0
20150105.13462,2810.25,2,1095140,2,0,0,0,0,0
20150105.134621,2810.25,2,1095142,2,0,0,0,0,0
20150105.134622,2810.87,6,1095148,6,0,0,0,0,0
20150105.134623,2810.25,120,1095268,62,0,0,0,0,0
20150105.134624,2810.87,6,1095274,4,0,0,0,0,0
20150105.134625,2810.87,132,1095406,132,0,0,0,0,0
20150105.134626,2810.25,18,1095424,12,0,0,0,0,0
20150105.134627,2810.25,2,1095426,0,0,0,0,0,0
20150105.134628,2810.87,12,1095438,-10,0,0,0,0,0
20150105.134629,2810.25,2,1095440,0,0,0,0,0,0
20150105.13463,2810.25,0,1095440,0,0,0,0,0,0
20150105.134631,2810.25,6,1095446,-6,0,0,0,0,0
20150105.134632,2810.87,2,1095448,0,0,0,0,0,0
20150105.134633,2810.87,6,1095454,0,0,0,0,0,0
20150105.134634,2810.25,260,1095714,196,0,0,0,0,0
20150105.134635,2809.63,342,1096056,-68,0,0,0,0,0
20150105.134636,2810.25,2,1096058,2,0,0,0,0,0
20150105.134637,2810.25,0,1096058,0,0,0,0,0,0
20150105.134638,2810.25,500,1096558,366,0,0,0,0,0
20150105.134639,2810.25,2,1096560,2,0,0,0,0,0
20150105.13464,2810.25,0,1096560,0,0,0,0,0,0
20150105.134641,2810.25,2,1096562,2,0,0,0,0,0
20150105.134642,2810.87,2,1096564,2,0,0,0,0,0
20150105.134643,2810.87,2,1096566,0,0,0,0,0,0
20150105.134644,2810.87,1160,1097726,-592,0,0,0,0,0
20150105.134645,2810.87,70,1097796,-10,0,0,0,0,0
20150105.134646,2810.87,98,1097894,98,0,0,0,0,0
20150105.134647,2810.87,2,1097896,-2,0,0,0,0,0
20150105.134648,2810.87,4,1097900,-4,0,0,0,0,0
20150105.134649,2810.25,6,1097906,0,0,0,0,0,0
20150105.13465,2810.25,2,1097908,2,0,0,0,0,0
20150105.134651,2810.87,12,1097920,0,0,0,0,0,0
20150105.134652,2810.87,2,1097922,2,0,0,0,0,0
20150105.134653,2810.87,2,1097924,2,0,0,0,0,0
20150105.134654,2810.25,6,1097930,0,0,0,0,0,0
20150105.134655,2810.25,2,1097932,2,0,0,0,0,0
20150105.134656,2810.25,2,1097934,0,0,0,0,0,0
20150105.134657,2810.25,42,1097976,42,0,0,0,0,0
20150105.134658,2810.25,2,1097978,2,0,0,0,0,0
20150105.134659,2810.87,2,1097980,0,0,0,0,0,0
20150105.1347,2810.25,2,1097982,2,0,0,0,0,0
20150105.134701,2810.25,2,1097984,0,0,0,0,0,0
20150105.134702,2810.87,2,1097986,0,0,0,0,0,0
20150105.134703,2810.25,10,1097996,0,0,0,0,0,0
20150105.134704,2810.25,32,1098028,-26,0,0,0,0,0
20150105.134705,2810.25,4,1098032,0,0,0,0,0,0
20150105.134706,2810.25,0,1098032,0,0,0,0,0,0
20150105.134707,2810.25,0,1098032,0,0,0,0,0,0
20150105.134708,2810.25,0,1098032,0,0,0,0,0,0
20150105.134709,2810.25,58,1098090,-54,0,0,0,0,0
20150105.13471,2810.25,102,1098192,46,0,0,0,0,0
20150105.134711,2810.25,104,1098296,30,0,0,0,0,0
20150105.134712,2810.25,92,1098388,58,0,0,0,0,0
20150105.134713,2809.63,2,1098390,0,0,0,0,0,0
20150105.134714,2810.25,18,1098408,-2,0,0,0,0,0
20150105.134715,2810.25,2,1098410,2,0,0,0,0,0
20150105.134716,2810.25,134,1098544,68,0,0,0,0,0
20150105.134717,2810.25,10,1098554,0,0,0,0,0,0
20150105.134718,2810.25,2,1098556,2,0,0,0,0,0
20150105.134719,2810.87,2,1098558,0,0,0,0,0,0
20150105.13472,2810.25,2,1098560,2,0,0,0,0,0
20150105.134721,2810.25,0,1098560,0,0,0,0,0,0
20150105.134722,2810.25,12,1098572,12,0,0,0,0,0
20150105.134723,2810.25,40,1098612,28,0,0,0,0,0
20150105.134724,2810.87,102,1098714,48,0,0,0,0,0
20150105.134725,2810.87,0,1098714,0,0,0,0,0,0
20150105.134726,2810.87,0,1098714,0,0,0,0,0,0
20150105.134727,2810.87,0,1098714,0,0,0,0,0,0
20150105.134728,2810.87,0,1098714,0,0,0,0,0,0
20150105.134729,2810.87,0,1098714,0,0,0,0,0,0
20150105.13473,2810.25,208,1098922,78,0,0,0,0,0
20150105.134731,2810.25,6,1098928,0,0,0,0,0,0
20150105.134732,2810.25,4,1098932,-4,0,0,0,0,0
20150105.134733,2810.87,402,1099334,398,0,0,0,0,0
20150105.134734,2810.25,4,1099338,0,0,0,0,0,0
20150105.134735,2810.87,4,1099342,2,0,0,0,0,0
20150105.134736,2810.87,0,1099342,0,0,0,0,0,0
20150105.134737,2810.87,6,1099348,0,0,0,0,0,0
20150105.134738,2810.25,208,1099556,-128,0,0,0,0,0
20150105.134739,2810.25,0,1099556,0,0,0,0,0,0
20150105.13474,2810.87,2,1099558,0,0,0,0,0,0
20150105.134741,2810.25,104,1099662,0,0,0,0,0,0
20150105.134742,2810.25,52,1099714,-48,0,0,0,0,0
20150105.134743,2809.63,14,1099728,-4,0,0,0,0,0
20150105.134744,2809.63,2,1099730,-2,0,0,0,0,0
20150105.134745,2810.87,72,1099802,0,0,0,0,0,0
20150105.134746,2810.25,10,1099812,-4,0,0,0,0,0
20150105.134747,2810.25,4,1099816,-4,0,0,0,0,0
20150105.134748,2810.25,20,1099836,0,0,0,0,0,0
20150105.134749,2810.87,30,1099866,0,0,0,0,0,0
20150105.13475,2810.25,2,1099868,0,0,0,0,0,0
20150105.134751,2810.25,4,1099872,-4,0,0,0,0,0
20150105.134752,2810.25,20,1099892,0,0,0,0,0,0
20150105.134753,2810.25,16,1099908,-4,0,0,0,0,0
20150105.134754,2810.25,2,1099910,0,0,0,0,0,0
20150105.134755,2810.25,10,1099920,-10,0,0,0,0,0
20150105.134756,2810.25,4,1099924,0,0,0,0,0,0
20150105.134757,2810.87,4,1099928,0,0,0,0,0,0
20150105.134758,2810.25,2,1099930,-2,0,0,0,0,0
20150105.134759,2810.25,148,1100078,24,0,0,0,0,0
20150105.1348,2810.25,110,1100188,8,0,0,0,0,0
20150105.134801,2810.25,2,1100190,0,0,0,0,0,0
20150105.134802,2810.25,4,1100194,2,0,0,0,0,0
20150105.134803,2810.25,102,1100296,102,0,0,0,0,0
20150105.134804,2810.25,2,1100298,2,0,0,0,0,0
20150105.134805,2810.25,50,1100348,42,0,0,0,0,0
20150105.134806,2810.25,2,1100350,0,0,0,0,0,0
20150105.134807,2810.25,4,1100354,2,0,0,0,0,0
20150105.134808,2810.87,402,1100756,314,0,0,0,0,0
20150105.134809,2810.25,2,1100758,2,0,0,0,0,0
20150105.13481,2810.25,10,1100768,10,0,0,0,0,0
20150105.134811,2810.25,0,1100768,0,0,0,0,0,0
20150105.134812,2810.25,2,1100770,0,0,0,0,0,0
20150105.134813,2810.25,40,1100810,26,0,0,0,0,0
20150105.134814,2810.25,2,1100812,0,0,0,0,0,0
20150105.134815,2810.25,40,1100852,0,0,0,0,0,0
20150105.134816,2810.25,2,1100854,0,0,0,0,0,0
20150105.134817,2810.25,0,1100854,0,0,0,0,0,0
20150105.134818,2810.25,2,1100856,0,0,0,0,0,0
20150105.134819,2810.25,2,1100858,-2,0,0,0,0,0
20150105.13482,2810.25,0,1100858,0,0,0,0,0,0
20150105.134821,2810.25,0,1100858,0,0,0,0,0,0
20150105.134822,2810.25,0,1100858,0,0,0,0,0,0
20150105.134823,2810.87,4,1100862,4,0,0,0,0,0
20150105.134824,2810.87,2,1100864,0,0,0,0,0,0
20150105.134825,2810.25,2,1100866,0,0,0,0,0,0
20150105.134826,2810.25,4,1100870,2,0,0,0,0,0
20150105.134827,2810.25,2,1100872,0,0,0,0,0,0
20150105.134828,2810.25,0,1100872,0,0,0,0,0,0
20150105.134829,2810.25,2,1100874,-2,0,0,0,0,0
20150105.13483,2810.25,2,1100876,-2,0,0,0,0,0
20150105.134831,2810.25,2,1100878,0,0,0,0,0,0
20150105.134832,2810.25,46,1100924,0,0,0,0,0,0
20150105.134833,2810.87,28,1100952,0,0,0,0,0,0
20150105.134834,2810.87,0,1100952,0,0,0,0,0,0
20150105.134835,2810.87,0,1100952,0,0,0,0,0,0
20150105.134836,2810.87,0,1100952,0,0,0,0,0,0
20150105.134837,2810.25,2,1100954,0,0,0,0,0,0
20150105.134838,2810.25,0,1100954,0,0,0,0,0,0
20150105.134839,2810.25,0,1100954,0,0,0,0,0,0
20150105.13484,2810.25,200,1101154,38,0,0,0,0,0
20150105.134841,2810.25,0,1101154,0,0,0,0,0,0
20150105.134842,2810.25,46,1101200,0,0,0,0,0,0
20150105.134843,2810.25,2,1101202,0,0,0,0,0,0
20150105.134844,2810.87,2,1101204,2,0,0,0,0,0
20150105.134845,2810.25,2,1101206,0,0,0,0,0,0
20150105.134846,2810.25,0,1101206,0,0,0,0,0,0
20150105.134847,2810.25,30,1101236,0,0,0,0,0,0
20150105.134848,2810.87,2,1101238,2,0,0,0,0,0
20150105.134849,2810.87,8,1101246,8,0,0,0,0,0
20150105.13485,2810.25,2,1101248,0,0,0,0,0,0
20150105.134851,2810.25,10,1101258,0,0,0,0,0,0
20150105.134852,2810.25,6,1101264,-2,0,0,0,0,0
20150105.134853,2810.87,2,1101266,2,0,0,0,0,0
20150105.134854,2810.25,6,1101272,-2,0,0,0,0,0
20150105.134855,2810.25,2,1101274,0,0,0,0,0,0
20150105.134856,2810.25,4,1101278,-2,0,0,0,0,0
20150105.134857,2810.25,2,1101280,0,0,0,0,0,0
20150105.134858,2810.25,6,1101286,0,0,0,0,0,0
20150105.134859,2810.25,0,1101286,0,0,0,0,0,0
20150105.1349,2810.25,0,1101286,0,0,0,0,0,0
20150105.134901,2810.25,0,1101286,0,0,0,0,0,0
20150105.134902,2810.25,2,1101288,0,0,0,0,0,0
20150105.134903,2810.25,0,1101288,0,0,0,0,0,0
20150105.134904,2810.25,0,1101288,0,0,0,0,0,0
20150105.134905,2810.25,0,1101288,0,0,0,0,0,0
20150105.134906,2810.25,0,1101288,0,0,0,0,0,0
20150105.134907,2810.25,2,1101290,0,0,0,0,0,0
20150105.134908,2810.25,0,1101290,0,0,0,0,0,0
20150105.134909,2810.87,2,1101292,2,0,0,0,0,0
20150105.13491,2810.87,0,1101292,0,0,0,0,0,0
20150105.134911,2810.87,8,1101300,0,0,0,0,0,0
20150105.134912,2810.87,0,1101300,0,0,0,0,0,0
20150105.134913,2810.25,2,1101302,0,0,0,0,0,0
20150105.134914,2810.25,14,1101316,0,0,0,0,0,0
20150105.134915,2810.87,38,1101354,0,0,0,0,0,0
20150105.134916,2810.25,2,1101356,-2,0,0,0,0,0
20150105.134917,2810.87,2,1101358,0,0,0,0,0,0
20150105.134918,2810.25,40,1101398,2,0,0,0,0,0
20150105.134919,2810.25,0,1101398,0,0,0,0,0,0
20150105.13492,2810.25,2,1101400,0,0,0,0,0,0
20150105.134921,2810.25,2,1101402,-2,0,0,0,0,0
20150105.134922,2810.25,10,1101412,-10,0,0,0,0,0
20150105.134923,2810.25,2,1101414,0,0,0,0,0,0
20150105.134924,2810.25,0,1101414,0,0,0,0,0,0
20150105.134925,2810.25,2,1101416,0,0,0,0,0,0
20150105.134926,2810.25,2,1101418,-2,0,0,0,0,0
20150105.134927,2810.25,0,1101418,0,0,0,0,0,0
20150105.134928,2810.87,200,1101618,100,0,0,0,0,0
20150105.134929,2810.87,0,1101618,0,0,0,0,0,0
20150105.13493,2810.87,4,1101622,-2,0,0,0,0,0
20150105.134931,2810.87,0,1101622,0,0,0,0,0,0
20150105.134932,2810.87,14,1101636,0,0,0,0,0,0
20150105.134933,2810.87,8,1101644,0,0,0,0,0,0
20150105.134934,2810.87,4,1101648,0,0,0,0,0,0
20150105.134935,2810.25,216,1101864,14,0,0,0,0,0
20150105.134936,2810.87,8,1101872,8,0,0,0,0,0
20150105.134937,2810.87,10,1101882,10,0,0,0,0,0
20150105.134938,2810.87,10,1101892,2,0,0,0,0,0
20150105.134939,2810.87,1280,1103172,88,0,0,0,0,0
20150105.13494,2811.5,8,1103180,0,0,0,0,0,0
20150105.134941,2811.5,8,1103188,0,0,0,0,0,0
20150105.134942,2811.5,8,1103196,0,0,0,0,0,0
20150105.134943,2811.5,10,1103206,4,0,0,0,0,0
20150105.134944,2811.5,208,1103414,138,0,0,0,0,0
20150105.134945,2811.5,268,1103682,-50,0,0,0,0,0
20150105.134946,2811.5,8,1103690,8,0,0,0,0,0
20150105.134947,2811.5,8,1103698,4,0,0,0,0,0
20150105.134948,2811.5,8,1103706,0,0,0,0,0,0
20150105.134949,2811.5,10,1103716,2,0,0,0,0,0
20150105.13495,2811.5,10,1103726,0,0,0,0,0,0
20150105.134951,2811.5,10,1103736,8,0,0,0,0,0
20150105.134952,2811.5,10,1103746,2,0,0,0,0,0
20150105.134953,2811.5,4,1103750,0,0,0,0,0,0
20150105.134954,2811.5,20,1103770,-6,0,0,0,0,0
20150105.134955,2810.87,50,1103820,-8,0,0,0,0,0
20150105.134956,2810.88,518,1104338,366,0,0,0,0,0
20150105.134957,2810.88,10,1104348,-10,0,0,0,0,0
20150105.134958,2810.88,10,1104358,0,0,0,0,0,0
20150105.134959,2810.88,10,1104368,0,0,0,0,0,0
20150105.135,2811.5,16,1104384,-8,0,0,0,0,0
20150105.135001,2811.5,4,1104388,0,0,0,0,0,0
20150105.135002,2810.88,2,1104390,-2,0,0,0,0,0
20150105.135003,2811.5,4,1104394,2,0,0,0,0,0
20150105.135004,2810.88,2,1104396,0,0,0,0,0,0
20150105.135005,2810.88,2,1104398,0,0,0,0,0,0
20150105.135006,2810.88,8,1104406,2,0,0,0,0,0
20150105.135007,2810.88,2,1104408,2,0,0,0,0,0
20150105.135008,2810.88,2,1104410,0,0,0,0,0,0
20150105.135009,2810.88,4,1104414,-2,0,0,0,0,0
20150105.13501,2810.88,110,1104524,-22,0,0,0,0,0
20150105.135011,2810.88,2,1104526,-2,0,0,0,0,0
20150105.135012,2810.88,2,1104528,0,0,0,0,0,0
20150105.135013,2810.25,2,1104530,0,0,0,0,0,0
20150105.135014,2810.88,2,1104532,0,0,0,0,0,0
20150105.135015,2810.88,10,1104542,0,0,0,0,0,0
20150105.135016,2812.12,1736,1106278,944,0,0,0,0,0
20150105.135017,2811.5,116,1106394,80,0,0,0,0,0
20150105.135018,2811.5,4,1106398,0,0,0,0,0,0
20150105.135019,2811.5,8,1106406,2,0,0,0,0,0
20150105.13502,2811.5,2,1106408,-2,0,0,0,0,0
20150105.135021,2811.5,38,1106446,0,0,0,0,0,0
20150105.135022,2812.12,10,1106456,10,0,0,0,0,0
20150105.135023,2811.5,10,1106466,-10,0,0,0,0,0
20150105.135024,2811.5,2,1106468,-2,0,0,0,0,0
20150105.135025,2811.5,168,1106636,-162,0,0,0,0,0
20150105.135026,2811.5,140,1106776,-140,0,0,0,0,0
20150105.135027,2810.88,2,1106778,0,0,0,0,0,0
20150105.135028,2811.5,16,1106794,0,0,0,0,0,0
20150105.135029,2811.5,34,1106828,-22,0,0,0,0,0
20150105.13503,2810.88,8,1106836,-2,0,0,0,0,0
20150105.135031,2810.88,6,1106842,-2,0,0,0,0,0
20150105.135032,2811.5,2,1106844,0,0,0,0,0,0
20150105.135033,2810.88,14,1106858,0,0,0,0,0,0
20150105.135034,2810.88,8,1106866,0,0,0,0,0,0
20150105.135035,2810.88,4,1106870,0,0,0,0,0,0
20150105.135036,2810.88,28,1106898,-16,0,0,0,0,0
20150105.135037,2810.88,8,1106906,0,0,0,0,0,0
20150105.135038,2810.88,12,1106918,-12,0,0,0,0,0
20150105.135039,2810.88,4,1106922,-4,0,0,0,0,0
20150105.13504,2810.88,8,1106930,-8,0,0,0,0,0
20150105.135041,2810.88,14,1106944,-14,0,0,0,0,0
20150105.135042,2810.88,4,1106948,-2,0,0,0,0,0
20150105.135043,2810.88,12,1106960,-10,0,0,0,0,0
20150105.135044,2810.88,4,1106964,0,0,0,0,0,0
20150105.135045,2810.88,8,1106972,0,0,0,0,0,0
20150105.135046,2810.88,32,1107004,0,0,0,0,0,0
20150105.135047,2810.88,4,1107008,0,0,0,0,0,0
20150105.135048,2810.88,12,1107020,-2,0,0,0,0,0
20150105.135049,2810.88,6,1107026,2,0,0,0,0,0
20150105.13505,2810.88,304,1107330,-140,0,0,0,0,0
20150105.135051,2810.25,8,1107338,-8,0,0,0,0,0
20150105.135052,2810.88,14,1107352,-8,0,0,0,0,0
20150105.135053,2810.25,46,1107398,-36,0,0,0,0,0
20150105.135054,2810.25,4,1107402,-4,0,0,0,0,0
20150105.135055,2810.25,12,1107414,-12,0,0,0,0,0
20150105.135056,2810.25,22,1107436,-12,0,0,0,0,0
20150105.135057,2810.25,8,1107444,-8,0,0,0,0,0
20150105.135058,2810.88,16,1107460,-10,0,0,0,0,0
20150105.135059,2810.25,8,1107468,-8,0,0,0,0,0
20150105.1351,2810.25,12,1107480,-8,0,0,0,0,0
20150105.135101,2810.25,8,1107488,-8,0,0,0,0,0
20150105.135102,2810.25,8,1107496,-8,0,0,0,0,0
20150105.135103,2810.25,8,1107504,-6,0,0,0,0,0
20150105.135104,2810.88,10,1107514,-8,0,0,0,0,0
20150105.135105,2810.25,8,1107522,-8,0,0,0,0,0
20150105.135106,2810.25,8,1107530,-2,0,0,0,0,0
20150105.135107,2810.25,18,1107548,0,0,0,0,0,0
20150105.135108,2810.25,4,1107552,0,0,0,0,0,0
20150105.135109,2810.25,20,1107572,0,0,0,0,0,0
20150105.13511,2810.25,4,1107576,0,0,0,0,0,0
20150105.135111,2810.25,14,1107590,0,0,0,0,0,0
20150105.135112,2810.25,4,1107594,0,0,0,0,0,0
20150105.135113,2810.25,24,1107618,-8,0,0,0,0,0
20150105.135114,2810.88,108,1107726,2,0,0,0,0,0
20150105.135115,2810.25,4,1107730,0,0,0,0,0,0
20150105.135116,2810.25,24,1107754,0,0,0,0,0,0
20150105.135117,2810.25,70,1107824,26,0,0,0,0,0
20150105.135118,2810.25,12,1107836,0,0,0,0,0,0
20150105.135119,2810.88,10,1107846,2,0,0,0,0,0
20150105.13512,2810.25,8,1107854,0,0,0,0,0,0
20150105.135121,2810.88,84,1107938,0,0,0,0,0,0
20150105.135122,2810.25,12,1107950,0,0,0,0,0,0
20150105.135123,2810.88,6,1107956,2,0,0,0,0,0
20150105.135124,2810.25,14,1107970,2,0,0,0,0,0
20150105.135125,2810.25,8,1107978,0,0,0,0,0,0
20150105.135126,2810.25,8,1107986,0,0,0,0,0,0
20150105.135127,2810.25,8,1107994,0,0,0,0,0,0
20150105.135128,2810.88,12,1108006,4,0,0,0,0,0
20150105.135129,2810.25,8,1108014,0,0,0,0,0,0
20150105.13513,2810.25,8,1108022,0,0,0,0,0,0
20150105.135131,2810.25,28,1108050,0,0,0,0,0,0
20150105.135132,2810.25,8,1108058,0,0,0,0,0,0
20150105.135133,2810.88,10,1108068,2,0,0,0,0,0
20150105.135134,2810.25,8,1108076,0,0,0,0,0,0
20150105.135135,2810.25,8,1108084,0,0,0,0,0,0
20150105.135136,2810.25,10,1108094,2,0,0,0,0,0
20150105.135137,2810.25,248,1108342,0,0,0,0,0,0
20150105.135138,2810.25,8,1108350,0,0,0,0,0,0
20150105.135139,2810.25,8,1108358,0,0,0,0,0,0
20150105.13514,2810.25,14,1108372,10,0,0,0,0,0
20150105.135141,2810.25,12,1108384,0,0,0,0,0,0
20150105.135142,2810.25,4,1108388,0,0,0,0,0,0
20150105.135143,2810.25,14,1108402,0,0,0,0,0,0
20150105.135144,2810.25,4,1108406,0,0,0,0,0,0
20150105.135145,2810.25,18,1108424,4,0,0,0,0,0
20150105.135146,2810.25,12,1108436,4,0,0,0,0,0
20150105.135147,2810.25,4,1108440,0,0,0,0,0,0
20150105.135148,2810.25,14,1108454,2,0,0,0,0,0
20150105.135149,2810.25,4,1108458,0,0,0,0,0,0
20150105.13515,2810.88,16,1108474,0,0,0,0,0,0
20150105.135151,2810.25,4,1108478,0,0,0,0,0,0
20150105.135152,2810.88,16,1108494,4,0,0,0,0,0
20150105.135153,2810.25,8,1108502,0,0,0,0,0,0
20150105.135154,2810.88,6,1108508,2,0,0,0,0,0
20150105.135155,2810.25,12,1108520,0,0,0,0,0,0
20150105.135156,2810.25,4,1108524,0,0,0,0,0,0
20150105.135157,2810.25,12,1108536,0,0,0,0,0,0
20150105.135158,2810.25,8,1108544,0,0,0,0,0,0
20150105.135159,2810.25,12,1108556,0,0,0,0,0,0
20150105.1352,2810.25,10,1108566,2,0,0,0,0,0
20150105.135201,2810.25,4,1108570,0,0,0,0,0,0
20150105.135202,2810.25,12,1108582,0,0,0,0,0,0
20150105.135203,2810.25,4,1108586,0,0,0,0,0,0
20150105.135204,2810.25,12,1108598,0,0,0,0,0,0
20150105.135205,2810.25,6,1108604,2,0,0,0,0,0
20150105.135206,2810.25,8,1108612,0,0,0,0,0,0
20150105.135207,2810.25,4,1108616,0,0,0,0,0,0
20150105.135208,2810.88,14,1108630,0,0,0,0,0,0
20150105.135209,2810.25,4,1108634,0,0,0,0,0,0
20150105.13521,2810.25,4,1108638,0,0,0,0,0,0
20150105.135211,2810.25,14,1108652,2,0,0,0,0,0
20150105.135212,2810.25,6,1108658,2,0,0,0,0,0
20150105.135213,2810.25,12,1108670,0,0,0,0,0,0
20150105.135214,2810.25,8,1108678,0,0,0,0,0,0
20150105.135215,2810.25,4,1108682,0,0,0,0,0,0
20150105.135216,2810.25,12,1108694,0,0,0,0,0,0
20150105.135217,2810.25,8,1108702,0,0,0,0,0,0
20150105.135218,2810.25,8,1108710,0,0,0,0,0,0
20150105.135219,2810.25,4,1108714,0,0,0,0,0,0
20150105.13522,2810.25,8,1108722,0,0,0,0,0,0
20150105.135221,2810.25,96,1108818,4,0,0,0,0,0
20150105.135222,2810.25,4,1108822,0,0,0,0,0,0
20150105.135223,2810.25,12,1108834,0,0,0,0,0,0
20150105.135224,2810.25,8,1108842,4,0,0,0,0,0
20150105.135225,2810.88,4,1108846,2,0,0,0,0,0
20150105.135226,2810.88,2,1108848,2,0,0,0,0,0
20150105.135227,2810.25,6,1108854,6,0,0,0,0,0
20150105.135228,2810.25,2,1108856,2,0,0,0,0,0
20150105.135229,2810.88,2,1108858,2,0,0,0,0,0
20150105.13523,2810.25,2,1108860,0,0,0,0,0,0
20150105.135231,2810.25,6,1108866,0,0,0,0,0,0
20150105.135232,2810.25,8,1108874,0,0,0,0,0,0
20150105.135233,2810.25,4,1108878,0,0,0,0,0,0
20150105.135234,2810.88,112,1108990,2,0,0,0,0,0
20150105.135235,2810.25,4,1108994,0,0,0,0,0,0
20150105.135236,2810.25,14,1109008,2,0,0,0,0,0
20150105.135237,2810.25,6,1109014,0,0,0,0,0,0
20150105.135238,2810.88,4,1109018,4,0,0,0,0,0
20150105.135239,2810.25,4,1109022,0,0,0,0,0,0
20150105.13524,2810.25,4,1109026,0,0,0,0,0,0
20150105.135241,2810.25,178,1109204,-98,0,0,0,0,0
20150105.135242,2810.25,10,1109214,6,0,0,0,0,0
20150105.135243,2810.25,8,1109222,0,0,0,0,0,0
20150105.135244,2810.88,24,1109246,-24,0,0,0,0,0
20150105.135245,2810.88,30,1109276,2,0,0,0,0,0
20150105.135246,2810.88,40,1109316,-24,0,0,0,0,0
20150105.135247,2810.25,2,1109318,0,0,0,0,0,0
20150105.135248,2810.25,2,1109320,2,0,0,0,0,0
20150105.135249,2810.25,10,1109330,10,0,0,0,0,0
20150105.13525,2810.25,12,1109342,2,0,0,0,0,0
20150105.135251,2810.25,30,1109372,14,0,0,0,0,0
20150105.135252,2810.25,2,1109374,2,0,0,0,0,0
20150105.135253,2810.25,1676,1111050,-804,0,0,0,0,0
20150105.135254,2809.63,2,1111052,0,0,0,0,0,0
20150105.135255,2810.25,86,1111138,-84,0,0,0,0,0
20150105.135256,2810.25,4,1111142,-2,0,0,0,0,0
20150105.135257,2810.25,2,1111144,0,0,0,0,0,0
20150105.135258,2810.25,12,1111156,0,0,0,0,0,0
20150105.135259,2810.25,200,1111356,0,0,0,0,0,0
20150105.1353,2809.63,68,1111424,-8,0,0,0,0,0
20150105.135301,2809.63,2,1111426,0,0,0,0,0,0
20150105.135302,2810.25,10,1111436,6,0,0,0,0,0
20150105.135303,2810.25,10,1111446,10,0,0,0,0,0
20150105.135304,2810.25,2,1111448,0,0,0,0,0,0
20150105.135305,2810.25,4,1111452,4,0,0,0,0,0
20150105.135306,2810.87,42,1111494,2,0,0,0,0,0
20150105.135307,2810.25,2,1111496,2,0,0,0,0,0
20150105.135308,2810.25,104,1111600,-22,0,0,0,0,0
20150105.135309,2810.25,2,1111602,-2,0,0,0,0,0
20150105.13531,2809.63,10,1111612,0,0,0,0,0,0
20150105.135311,2810.25,20,1111632,0,0,0,0,0,0
20150105.135312,2810.25,2,1111634,0,0,0,0,0,0
20150105.135313,2810.25,2,1111636,-2,0,0,0,0,0
20150105.135314,2810.25,2,1111638,0,0,0,0,0,0
20150105.135315,2809.63,20,1111658,0,0,0,0,0,0
20150105.135316,2809.63,2,1111660,0,0,0,0,0,0
20150105.135317,2809.63,20,1111680,20,0,0,0,0,0
20150105.135318,2810.25,2,1111682,0,0,0,0,0,0
20150105.135319,2809.63,6,1111688,6,0,0,0,0,0
20150105.13532,2809.63,44,1111732,2,0,0,0,0,0
20150105.135321,2809.63,106,1111838,26,0,0,0,0,0
20150105.135322,2809.63,2,1111840,2,0,0,0,0,0
20150105.135323,2809.63,2,1111842,2,0,0,0,0,0
20150105.135324,2810.25,6,1111848,0,0,0,0,0,0
20150105.135325,2809.63,2,1111850,2,0,0,0,0,0
20150105.135326,2809.63,2,1111852,2,0,0,0,0,0
20150105.135327,2809.63,40,1111892,40,0,0,0,0,0
20150105.135328,2809.63,2,1111894,0,0,0,0,0,0
20150105.135329,2809.63,22,1111916,22,0,0,0,0,0
20150105.13533,2809.63,10,1111926,2,0,0,0,0,0
20150105.135331,2809.63,4,1111930,4,0,0,0,0,0
20150105.135332,2809.63,8,1111938,0,0,0,0,0,0
20150105.135333,2809.63,4,1111942,0,0,0,0,0,0
20150105.135334,2809.63,130,1112072,24,0,0,0,0,0
20150105.135335,2809.63,152,1112224,46,0,0,0,0,0
20150105.135336,2809.63,408,1112632,-44,0,0,0,0,0
20150105.135337,2809.63,1752,1114384,1298,0,0,0,0,0
20150105.135338,2809.63,4,1114388,2,0,0,0,0,0
20150105.135339,2809.01,2,1114390,2,0,0,0,0,0
20150105.13534,2809.01,42,1114432,0,0,0,0,0,0
20150105.135341,2809.01,98,1114530,8,0,0,0,0,0
20150105.135342,2809.63,2,1114532,2,0,0,0,0,0
20150105.135343,2809.01,2,1114534,2,0,0,0,0,0
20150105.135344,2809.63,48,1114582,46,0,0,0,0,0
20150105.135345,2809.63,8,1114590,8,0,0,0,0,0
20150105.135346,2809.63,22,1114612,2,0,0,0,0,0
20150105.135347,2809.01,4,1114616,4,0,0,0,0,0
20150105.135348,2809.01,4,1114620,4,0,0,0,0,0
20150105.135349,2809.01,12,1114632,12,0,0,0,0,0
20150105.13535,2809.63,2,1114634,0,0,0,0,0,0
20150105.135351,2809.01,16,1114650,2,0,0,0,0,0
20150105.135352,2809.01,10,1114660,2,0,0,0,0,0
20150105.135353,2809.01,8,1114668,0,0,0,0,0,0
20150105.135354,2809.01,236,1114904,146,0,0,0,0,0
20150105.135355,2809.01,32,1114936,2,0,0,0,0,0
20150105.135356,2809.01,24,1114960,10,0,0,0,0,0
20150105.135357,2809.01,10,1114970,0,0,0,0,0,0
20150105.135358,2809.01,134,1115104,110,0,0,0,0,0
20150105.135359,2809.01,18,1115122,2,0,0,0,0,0
20150105.1354,2809.01,22,1115144,6,0,0,0,0,0
20150105.135401,2809.01,20,1115164,0,0,0,0,0,0
20150105.135402,2809.01,36,1115200,0,0,0,0,0,0
20150105.135403,2809.01,42,1115242,24,0,0,0,0,0
20150105.135404,2809.01,440,1115682,142,0,0,0,0,0
20150105.135405,2809.01,122,1115804,122,0,0,0,0,0
20150105.135406,2809.01,4,1115808,0,0,0,0,0,0
20150105.135407,2809.63,20,1115828,14,0,0,0,0,0
20150105.135408,2809.01,2,1115830,2,0,0,0,0,0
20150105.135409,2809.01,4,1115834,2,0,0,0,0,0
20150105.13541,2809.01,52,1115886,50,0,0,0,0,0
20150105.135411,2809.01,204,1116090,150,0,0,0,0,0
20150105.135412,2809.01,4,1116094,4,0,0,0,0,0
20150105.135413,2809.63,2,1116096,2,0,0,0,0,0
20150105.135414,2809.01,6,1116102,6,0,0,0,0,0
20150105.135415,2809.01,2,1116104,2,0,0,0,0,0
20150105.135416,2809.63,2,1116106,2,0,0,0,0,0
20150105.135417,2809.01,2,1116108,2,0,0,0,0,0
20150105.135418,2809.01,20,1116128,20,0,0,0,0,0
20150105.135419,2809.01,2,1116130,2,0,0,0,0,0
20150105.13542,2809.01,2,1116132,2,0,0,0,0,0
20150105.135421,2809.63,2,1116134,2,0,0,0,0,0
20150105.135422,2809.01,2,1116136,2,0,0,0,0,0
20150105.135423,2809.01,20,1116156,0,0,0,0,0,0
20150105.135424,2809.01,4,1116160,4,0,0,0,0,0
20150105.135425,2809.01,4,1116164,2,0,0,0,0,0
20150105.135426,2809.63,26,1116190,20,0,0,0,0,0
20150105.135427,2809.01,20,1116210,20,0,0,0,0,0
20150105.135428,2809.01,200,1116410,200,0,0,0,0,0
20150105.135429,2809.01,24,1116434,24,0,0,0,0,0
20150105.13543,2809.01,6,1116440,6,0,0,0,0,0
20150105.135431,2809.01,18,1116458,16,0,0,0,0,0
20150105.135432,2809.01,240,1116698,240,0,0,0,0,0
20150105.135433,2809.01,4,1116702,4,0,0,0,0,0
20150105.135434,2809.01,8,1116710,8,0,0,0,0,0
20150105.135435,2809.01,226,1116936,112,0,0,0,0,0
20150105.135436,2809.01,4,1116940,2,0,0,0,0,0
20150105.135437,2809.01,4,1116944,4,0,0,0,0,0
20150105.135438,2809.01,2,1116946,2,0,0,0,0,0
20150105.135439,2809.01,60,1117006,60,0,0,0,0,0
20150105.13544,2809.01,12,1117018,12,0,0,0,0,0
20150105.135441,2809.01,6,1117024,4,0,0,0,0,0
20150105.135442,2809.63,6,1117030,6,0,0,0,0,0
20150105.135443,2809.01,22,1117052,22,0,0,0,0,0
20150105.135444,2809.01,4,1117056,4,0,0,0,0,0
20150105.135445,2809.01,4,1117060,0,0,0,0,0,0
20150105.135446,2809.01,4,1117064,2,0,0,0,0,0
20150105.135447,2809.01,2,1117066,0,0,0,0,0,0
20150105.135448,2809.01,2,1117068,0,0,0,0,0,0
20150105.135449,2809.01,24,1117092,22,0,0,0,0,0
20150105.13545,2809.01,4,1117096,0,0,0,0,0,0
20150105.135451,2809.01,2,1117098,0,0,0,0,0,0
20150105.135452,2809.01,16,1117114,14,0,0,0,0,0
20150105.135453,2809.63,10,1117124,10,0,0,0,0,0
20150105.135454,2809.01,2,1117126,2,0,0,0,0,0
20150105.135455,2809.01,2,1117128,2,0,0,0,0,0
20150105.135456,2809.01,2,1117130,0,0,0,0,0,0
20150105.135457,2809.01,12,1117142,2,0,0,0,0,0
20150105.135458,2809.01,42,1117184,30,0,0,0,0,0
20150105.135459,2809.63,16,1117200,0,0,0,0,0,0
20150105.1355,2809.01,4,1117204,0,0,0,0,0,0
20150105.135501,2809.01,6,1117210,2,0,0,0,0,0
20150105.135502,2809.01,14,1117224,0,0,0,0,0,0
20150105.135503,2809.01,10,1117234,2,0,0,0,0,0
20150105.135504,2809.01,24,1117258,20,0,0,0,0,0
20150105.135505,2809.01,6,1117264,0,0,0,0,0,0
20150105.135506,2809.01,2,1117266,0,0,0,0,0,0
20150105.135507,2809.01,8,1117274,0,0,0,0,0,0
20150105.135508,2809.01,6,1117280,0,0,0,0,0,0
20150105.135509,2809.01,8,1117288,4,0,0,0,0,0
20150105.13551,2809.01,10,1117298,4,0,0,0,0,0
20150105.135511,2809.01,6,1117304,2,0,0,0,0,0
20150105.135512,2809.01,6,1117310,2,0,0,0,0,0
20150105.135513,2809.01,6,1117316,2,0,0,0,0,0
20150105.135514,2809.01,8,1117324,2,0,0,0,0,0
20150105.135515,2809.63,4,1117328,2,0,0,0,0,0
20150105.135516,2809.01,48,1117376,40,0,0,0,0,0
20150105.135517,2809.01,4,1117380,0,0,0,0,0,0
20150105.135518,2809.01,4,1117384,0,0,0,0,0,0
20150105.135519,2809.01,8,1117392,2,0,0,0,0,0
20150105.13552,2809.01,6,1117398,0,0,0,0,0,0
20150105.135521,2809.01,4,1117402,0,0,0,0,0,0
20150105.135522,2809.01,4,1117406,0,0,0,0,0,0
20150105.135523,2809.01,4,1117410,0,0,0,0,0,0
20150105.135524,2809.01,4,1117414,0,0,0,0,0,0
20150105.135525,2809.01,4,1117418,0,0,0,0,0,0
20150105.135526,2809.01,26,1117444,22,0,0,0,0,0
20150105.135527,2809.01,124,1117568,120,0,0,0,0,0
20150105.135528,2809.63,16,1117584,2,0,0,0,0,0
20150105.135529,2809.01,4,1117588,0,0,0,0,0,0
20150105.13553,2809.01,8,1117596,2,0,0,0,0,0
20150105.135531,2809.01,8,1117604,8,0,0,0,0,0
20150105.135532,2809.01,6,1117610,4,0,0,0,0,0
20150105.135533,2809.01,4,1117614,4,0,0,0,0,0
20150105.135534,2809.01,4,1117618,2,0,0,0,0,0
20150105.135535,2809.01,4,1117622,4,0,0,0,0,0
20150105.135536,2809.01,102,1117724,102,0,0,0,0,0
20150105.135537,2809.01,4,1117728,4,0,0,0,0,0
20150105.135538,2809.01,6,1117734,4,0,0,0,0,0
20150105.135539,2809.01,36,1117770,4,0,0,0,0,0
20150105.13554,2809.01,16,1117786,2,0,0,0,0,0
20150105.135541,2809.01,8,1117794,4,0,0,0,0,0
20150105.135542,2809.01,6,1117800,6,0,0,0,0,0
20150105.135543,2809.63,10,1117810,8,0,0,0,0,0
20150105.135544,2809.01,4,1117814,4,0,0,0,0,0
20150105.135545,2809.01,60,1117874,58,0,0,0,0,0
20150105.135546,2809.01,22,1117896,12,0,0,0,0,0
20150105.135547,2809.01,10,1117906,0,0,0,0,0,0
20150105.135548,2809.01,18,1117924,0,0,0,0,0,0
20150105.135549,2809.01,16,1117940,6,0,0,0,0,0
20150105.13555,2809.01,20,1117960,10,0,0,0,0,0
20150105.135551,2809.01,4,1117964,0,0,0,0,0,0
20150105.135552,2809.01,10,1117974,0,0,0,0,0,0
20150105.135553,2809.01,8,1117982,0,0,0,0,0,0
20150105.135554,2809.01,12,1117994,0,0,0,0,0,0
20150105.135555,2809.01,8,1118002,0,0,0,0,0,0
20150105.135556,2809.01,10,1118012,0,0,0,0,0,0
20150105.135557,2809.01,4,1118016,0,0,0,0,0,0
20150105.135558,2809.63,8,1118024,8,0,0,0,0,0
20150105.135559,2809.01,2,1118026,0,0,0,0,0,0
20150105.1356,2809.01,14,1118040,6,0,0,0,0,0
20150105.135601,2809.01,4,1118044,2,0,0,0,0,0
20150105.135602,2809.63,12,1118056,12,0,0,0,0,0
20150105.135603,2809.01,2,1118058,0,0,0,0,0,0
20150105.135604,2809.01,22,1118080,2,0,0,0,0,0
20150105.135605,2809.01,4,1118084,2,0,0,0,0,0
20150105.135606,2809.01,202,1118286,200,0,0,0,0,0
20150105.135607,2809.01,122,1118408,120,0,0,0,0,0
20150105.135608,2809.01,14,1118422,2,0,0,0,0,0
20150105.135609,2809.01,22,1118444,22,0,0,0,0,0
20150105.13561,2809.01,12,1118456,10,0,0,0,0,0
20150105.135611,2809.01,14,1118470,4,0,0,0,0,0
20150105.135612,2809.01,4,1118474,2,0,0,0,0,0
20150105.135613,2809.01,6,1118480,2,0,0,0,0,0
20150105.135614,2809.01,2,1118482,0,0,0,0,0,0
20150105.135615,2809.01,12,1118494,0,0,0,0,0,0
20150105.135616,2809.01,4,1118498,2,0,0,0,0,0
20150105.135617,2809.01,10,1118508,10,0,0,0,0,0
20150105.135618,2809.01,2,1118510,0,0,0,0,0,0
20150105.135619,2809.01,10,1118520,0,0,0,0,0,0
20150105.13562,2809.01,6,1118526,4,0,0,0,0,0
20150105.135621,2809.01,6,1118532,0,0,0,0,0,0
20150105.135622,2809.64,2,1118534,2,0,0,0,0,0
20150105.135623,2809.01,10,1118544,2,0,0,0,0,0
20150105.135624,2809.01,10,1118554,0,0,0,0,0,0
20150105.135625,2809.01,4,1118558,2,0,0,0,0,0
20150105.135626,2809.64,10,1118568,10,0,0,0,0,0
20150105.135627,2809.01,16,1118584,14,0,0,0,0,0
20150105.135628,2809.01,2,1118586,0,0,0,0,0,0
20150105.135629,2809.01,4,1118590,2,0,0,0,0,0
20150105.13563,2809.64,2,1118592,0,0,0,0,0,0
20150105.135631,2809.01,204,1118796,202,0,0,0,0,0
20150105.135632,2809.01,6,1118802,4,0,0,0,0,0
20150105.135633,2809.01,14,1118816,12,0,0,0,0,0
20150105.135634,2809.01,44,1118860,2,0,0,0,0,0
20150105.135635,2809.01,10,1118870,4,0,0,0,0,0
20150105.135636,2809.01,26,1118896,26,0,0,0,0,0
20150105.135637,2809.01,28,1118924,26,0,0,0,0,0
20150105.135638,2809.01,2,1118926,0,0,0,0,0,0
20150105.135639,2809.01,2,1118928,0,0,0,0,0,0
20150105.13564,2809.01,2,1118930,2,0,0,0,0,0
20150105.135641,2809.01,4,1118934,2,0,0,0,0,0
20150105.135642,2809.01,2,1118936,0,0,0,0,0,0
20150105.135643,2809.64,2,1118938,2,0,0,0,0,0
20150105.135644,2809.64,10,1118948,8,0,0,0,0,0
20150105.135645,2809.01,76,1119024,42,0,0,0,0,0
20150105.135646,2809.01,4,1119028,4,0,0,0,0,0
20150105.135647,2809.01,4,1119032,2,0,0,0,0,0
20150105.135648,2809.64,12,1119044,6,0,0,0,0,0
20150105.135649,2809.64,6,1119050,2,0,0,0,0,0
20150105.13565,2809.01,22,1119072,0,0,0,0,0,0
20150105.135651,2809.01,4,1119076,2,0,0,0,0,0
20150105.135652,2809.01,2,1119078,2,0,0,0,0,0
20150105.135653,2809.01,4,1119082,2,0,0,0,0,0
20150105.135654,2809.64,20,1119102,0,0,0,0,0,0
20150105.135655,2809.64,4,1119106,0,0,0,0,0,0
20150105.135656,2809.01,6,1119112,4,0,0,0,0,0
20150105.135657,2809.64,2,1119114,2,0,0,0,0,0
20150105.135658,2809.64,4,1119118,2,0,0,0,0,0
20150105.135659,2809.64,2,1119120,0,0,0,0,0,0
20150105.1357,2809.64,2,1119122,0,0,0,0,0,0
20150105.135701,2809.01,4,1119126,2,0,0,0,0,0
20150105.135702,2809.01,2,1119128,0,0,0,0,0,0
20150105.135703,2809.64,4,1119132,4,0,0,0,0,0
20150105.135704,2809.01,2,1119134,0,0,0,0,0,0
20150105.135705,2809.64,2,1119136,0,0,0,0,0,0
20150105.135706,2809.01,4,1119140,2,0,0,0,0,0
20150105.135707,2809.01,16,1119156,16,0,0,0,0,0
20150105.135708,2809.64,20,1119176,18,0,0,0,0,0
20150105.135709,2809.01,4,1119180,0,0,0,0,0,0
20150105.13571,2809.01,2,1119182,0,0,0,0,0,0
20150105.135711,2809.01,4,1119186,4,0,0,0,0,0
20150105.135712,2809.64,4,1119190,2,0,0,0,0,0
20150105.135713,2809.01,4,1119194,2,0,0,0,0,0
20150105.135714,2809.64,14,1119208,2,0,0,0,0,0
20150105.135715,2809.01,2,1119210,0,0,0,0,0,0
20150105.135716,2809.01,2,1119212,0,0,0,0,0,0
20150105.135717,2809.01,10,1119222,10,0,0,0,0,0
20150105.135718,2809.01,4,1119226,4,0,0,0,0,0
20150105.135719,2809.01,2,1119228,0,0,0,0,0,0
20150105.13572,2809.64,2,1119230,0,0,0,0,0,0
20150105.135721,2809.01,4,1119234,2,0,0,0,0,0
20150105.135722,2809.01,62,1119296,62,0,0,0,0,0
20150105.135723,2809.01,2,1119298,0,0,0,0,0,0
20150105.135724,2809.64,6,1119304,0,0,0,0,0,0
20150105.135725,2809.64,202,1119506,200,0,0,0,0,0
20150105.135726,2809.01,2,1119508,0,0,0,0,0,0
20150105.135727,2809.01,2,1119510,0,0,0,0,0,0
20150105.135728,2809.01,4,1119514,2,0,0,0,0,0
20150105.135729,2809.64,6,1119520,2,0,0,0,0,0
20150105.13573,2809.01,2,1119522,2,0,0,0,0,0
20150105.135731,2809.01,1822,1121344,-6,0,0,0,0,0
20150105.135732,2809.01,2,1121346,0,0,0,0,0,0
20150105.135733,2809.01,2012,1123358,624,0,0,0,0,0
20150105.135734,2809.01,656,1124014,122,0,0,0,0,0
20150105.135735,2809.02,336,1124350,306,0,0,0,0,0
20150105.135736,2809.02,320,1124670,130,0,0,0,0,0
20150105.135737,2809.02,12,1124682,0,0,0,0,0,0
20150105.135738,2809.02,406,1125088,224,0,0,0,0,0
20150105.135739,2809.02,44,1125132,-8,0,0,0,0,0
20150105.13574,2809.02,14,1125146,-2,0,0,0,0,0
20150105.135741,2808.39,292,1125438,176,0,0,0,0,0
20150105.135742,2808.39,42,1125480,2,0,0,0,0,0
20150105.135743,2808.39,8,1125488,-8,0,0,0,0,0
20150105.135744,2808.39,18,1125506,-4,0,0,0,0,0
20150105.135745,2808.39,6,1125512,2,0,0,0,0,0
20150105.135746,2809.02,2,1125514,0,0,0,0,0,0
20150105.135747,2809.02,14,1125528,-4,0,0,0,0,0
20150105.135748,2808.39,20,1125548,-20,0,0,0,0,0
20150105.135749,2809.02,12,1125560,0,0,0,0,0,0
20150105.13575,2809.02,14,1125574,-8,0,0,0,0,0
20150105.135751,2809.02,942,1126516,-496,0,0,0,0,0
20150105.135752,2809.02,48,1126564,-14,0,0,0,0,0
20150105.135753,2809.02,10,1126574,-2,0,0,0,0,0
20150105.135754,2809.02,486,1127060,6,0,0,0,0,0
20150105.135755,2809.02,36,1127096,12,0,0,0,0,0
20150105.135756,2809.02,2,1127098,0,0,0,0,0,0
20150105.135757,2809.02,32,1127130,6,0,0,0,0,0
20150105.135758,2809.02,4,1127134,4,0,0,0,0,0
20150105.135759,2809.02,2,1127136,2,0,0,0,0,0
20150105.1358,2809.02,8,1127144,4,0,0,0,0,0
20150105.135801,2809.02,24,1127168,20,0,0,0,0,0
20150105.135802,2809.02,62,1127230,62,0,0,0,0,0
20150105.135803,2809.02,300,1127530,276,0,0,0,0,0
20150105.135804,2809.02,70,1127600,38,0,0,0,0,0
20150105.135805,2809.02,16,1127616,0,0,0,0,0,0
20150105.135806,2809.02,56,1127672,0,0,0,0,0,0
20150105.135807,2809.02,6,1127678,-4,0,0,0,0,0
20150105.135808,2809.02,2,1127680,-2,0,0,0,0,0
20150105.135809,2809.02,348,1128028,-130,0,0,0,0,0
20150105.13581,2809.02,94,1128122,32,0,0,0,0,0
20150105.135811,2809.02,52,1128174,44,0,0,0,0,0
20150105.135812,2809.64,34,1128208,-6,0,0,0,0,0
20150105.135813,2809.02,2,1128210,0,0,0,0,0,0
20150105.135814,2809.02,20,1128230,20,0,0,0,0,0
20150105.135815,2809.02,2,1128232,0,0,0,0,0,0
20150105.135816,2809.02,10,1128242,10,0,0,0,0,0
20150105.135817,2809.02,2,1128244,2,0,0,0,0,0
20150105.135818,2809.02,12,1128256,6,0,0,0,0,0
20150105.135819,2809.02,22,1128278,-18,0,0,0,0,0
20150105.13582,2809.02,4,1128282,2,0,0,0,0,0
20150105.135821,2809.02,2,1128284,0,0,0,0,0,0
20150105.135822,2809.02,4,1128288,0,0,0,0,0,0
20150105.135823,2809.02,326,1128614,34,0,0,0,0,0
20150105.135824,2809.64,2,1128616,0,0,0,0,0,0
20150105.135825,2809.02,104,1128720,102,0,0,0,0,0
20150105.135826,2809.02,12,1128732,12,0,0,0,0,0
20150105.135827,2809.02,4,1128736,4,0,0,0,0,0
20150105.135828,2809.02,32,1128768,-22,0,0,0,0,0
20150105.135829,2809.02,4,1128772,0,0,0,0,0,0
20150105.13583,2809.02,2,1128774,0,0,0,0,0,0
20150105.135831,2809.02,10,1128784,0,0,0,0,0,0
20150105.135832,2809.02,2,1128786,0,0,0,0,0,0
20150105.135833,2809.02,74,1128860,74,0,0,0,0,0
20150105.135834,2809.02,8,1128868,8,0,0,0,0,0
20150105.135835,2809.02,2,1128870,0,0,0,0,0,0
20150105.135836,2809.02,4,1128874,4,0,0,0,0,0
20150105.135837,2809.02,58,1128932,-6,0,0,0,0,0
20150105.135838,2809.02,4,1128936,-2,0,0,0,0,0
20150105.135839,2809.64,2,1128938,-2,0,0,0,0,0
20150105.13584,2809.02,4,1128942,-4,0,0,0,0,0
20150105.135841,2809.02,4,1128946,-2,0,0,0,0,0
20150105.135842,2809.64,2,1128948,-2,0,0,0,0,0
20150105.135843,2809.64,100,1129048,-54,0,0,0,0,0
20150105.135844,2809.64,4,1129052,0,0,0,0,0,0
20150105.135845,2809.64,4,1129056,-4,0,0,0,0,0
20150105.135846,2809.02,2,1129058,0,0,0,0,0,0
20150105.135847,2809.02,20,1129078,0,0,0,0,0,0
20150105.135848,2809.64,2,1129080,-2,0,0,0,0,0
20150105.135849,2809.64,12,1129092,8,0,0,0,0,0
20150105.13585,2809.64,18,1129110,-12,0,0,0,0,0
20150105.135851,2809.02,6,1129116,0,0,0,0,0,0
20150105.135852,2809.64,4,1129120,-4,0,0,0,0,0
20150105.135853,2809.64,4,1129124,-2,0,0,0,0,0
20150105.135854,2809.64,2,1129126,-2,0,0,0,0,0
20150105.135855,2809.02,386,1129512,-218,0,0,0,0,0
20150105.135856,2809.64,38,1129550,-4,0,0,0,0,0
20150105.135857,2809.02,4,1129554,0,0,0,0,0,0
20150105.135858,2809.02,2,1129556,0,0,0,0,0,0
20150105.135859,2809.02,2,1129558,0,0,0,0,0,0
20150105.1359,2809.02,6,1129564,-6,0,0,0,0,0
20150105.135901,2809.02,2,1129566,0,0,0,0,0,0
20150105.135902,2809.64,6,1129572,0,0,0,0,0,0
20150105.135903,2809.02,2,1129574,0,0,0,0,0,0
20150105.135904,2809.02,2,1129576,0,0,0,0,0,0
20150105.135905,2809.64,4,1129580,0,0,0,0,0,0
20150105.135906,2809.02,78,1129658,-78,0,0,0,0,0
20150105.135907,2809.02,2,1129660,0,0,0,0,0,0
20150105.135908,2809.02,2,1129662,0,0,0,0,0,0
20150105.135909,2809.64,6,1129668,-6,0,0,0,0,0
20150105.13591,2809.64,2,1129670,-2,0,0,0,0,0
20150105.135911,2809.02,2,1129672,0,0,0,0,0,0
20150105.135912,2809.64,10,1129682,-10,0,0,0,0,0
20150105.135913,2809.02,2,1129684,0,0,0,0,0,0
20150105.135914,2809.64,2,1129686,-2,0,0,0,0,0
20150105.135915,2809.64,4,1129690,-2,0,0,0,0,0
20150105.135916,2809.02,32,1129722,-16,0,0,0,0,0
20150105.135917,2809.64,2,1129724,0,0,0,0,0,0
20150105.135918,2809.64,2,1129726,-2,0,0,0,0,0
20150105.135919,2809.02,4,1129730,0,0,0,0,0,0
20150105.13592,2809.02,2,1129732,0,0,0,0,0,0
20150105.135921,2809.64,26,1129758,-26,0,0,0,0,0
20150105.135922,2809.64,2,1129760,0,0,0,0,0,0
20150105.135923,2809.02,4,1129764,-2,0,0,0,0,0
20150105.135924,2809.64,2,1129766,-2,0,0,0,0,0
20150105.135925,2809.02,2,1129768,0,0,0,0,0,0
20150105.135926,2809.64,2,1129770,-2,0,0,0,0,0
20150105.135927,2809.64,480,1130250,-310,0,0,0,0,0
20150105.135928,2809.64,624,1130874,-238,0,0,0,0,0
20150105.135929,2809.64,10,1130884,0,0,0,0,0,0
20150105.13593,2810.26,6,1130890,-4,0,0,0,0,0
20150105.135931,2809.64,102,1130992,0,0,0,0,0,0
20150105.135932,2809.64,2,1130994,-2,0,0,0,0,0
20150105.135933,2809.64,2,1130996,0,0,0,0,0,0
20150105.135934,2809.64,400,1131396,-246,0,0,0,0,0
20150105.135935,2810.26,10,1131406,6,0,0,0,0,0
20150105.135936,2810.26,4,1131410,0,0,0,0,0,0
20150105.135937,2809.64,4,1131414,2,0,0,0,0,0
20150105.135938,2810.26,36,1131450,24,0,0,0,0,0
20150105.135939,2810.26,306,1131756,150,0,0,0,0,0
20150105.13594,2810.26,466,1132222,160,0,0,0,0,0
20150105.135941,2810.88,1316,1133538,-634,0,0,0,0,0
20150105.135942,2810.88,24,1133562,-24,0,0,0,0,0
20150105.135943,2811.51,6,1133568,-2,0,0,0,0,0
20150105.135944,2810.88,10,1133578,-6,0,0,0,0,0
20150105.135945,2811.51,4,1133582,0,0,0,0,0,0
20150105.135946,2811.51,4,1133586,2,0,0,0,0,0
20150105.135947,2811.51,8,1133594,0,0,0,0,0,0
20150105.135948,2810.88,404,1133998,-158,0,0,0,0,0
20150105.135949,2811.51,34,1134032,0,0,0,0,0,0
20150105.13595,2811.51,14,1134046,0,0,0,0,0,0
20150105.135951,2811.51,2,1134048,2,0,0,0,0,0
20150105.135952,2811.51,2,1134050,0,0,0,0,0,0
20150105.135953,2811.51,6,1134056,0,0,0,0,0,0
20150105.135954,2811.51,24,1134080,0,0,0,0,0,0
20150105.135955,2810.88,124,1134204,-84,0,0,0,0,0
20150105.135956,2810.88,10,1134214,0,0,0,0,0,0
20150105.135957,2810.88,36,1134250,-28,0,0,0,0,0
20150105.135958,2811.51,6,1134256,2,0,0,0,0,0
20150105.135959,2810.88,2,1134258,-2,0,0,0,0,0
20150105.14,2810.88,8,1134266,-4,0,0,0,0,0
20150105.140001,2811.51,2,1134268,2,0,0,0,0,0
20150105.140002,2810.88,4,1134272,-2,0,0,0,0,0
20150105.140003,2810.88,400,1134672,-146,0,0,0,0,0
20150105.140004,2810.88,2,1134674,2,0,0,0,0,0
20150105.140005,2810.88,100,1134774,-100,0,0,0,0,0
20150105.140006,2810.26,14,1134788,10,0,0,0,0,0
20150105.140007,2810.88,106,1134894,-92,0,0,0,0,0
20150105.140008,2810.88,12,1134906,-10,0,0,0,0,0
20150105.140009,2810.88,4,1134910,0,0,0,0,0,0
20150105.14001,2810.88,264,1135174,-218,0,0,0,0,0
20150105.140011,2810.88,4,1135178,-2,0,0,0,0,0
20150105.140012,2811.51,2,1135180,2,0,0,0,0,0
20150105.140013,2810.88,2,1135182,-2,0,0,0,0,0
20150105.140014,2810.88,2,1135184,0,0,0,0,0,0
20150105.140015,2810.88,4,1135188,0,0,0,0,0,0
20150105.140016,2810.88,16,1135204,4,0,0,0,0,0
20150105.140017,2810.88,10,1135214,10,0,0,0,0,0
20150105.140018,2810.88,10,1135224,0,0,0,0,0,0
20150105.140019,2810.88,2,1135226,2,0,0,0,0,0
20150105.14002,2810.88,402,1135628,2,0,0,0,0,0
20150105.140021,2810.88,12,1135640,0,0,0,0,0,0
20150105.140022,2810.88,38,1135678,-22,0,0,0,0,0
20150105.140023,2810.88,2,1135680,0,0,0,0,0,0
20150105.140024,2810.88,6,1135686,2,0,0,0,0,0
20150105.140025,2810.88,10,1135696,0,0,0,0,0,0
20150105.140026,2810.88,56,1135752,8,0,0,0,0,0
20150105.140027,2810.88,2,1135754,2,0,0,0,0,0
20150105.140028,2810.88,56,1135810,0,0,0,0,0,0
20150105.140029,2810.26,204,1136014,2,0,0,0,0,0
20150105.14003,2810.88,12,1136026,-2,0,0,0,0,0
20150105.140031,2810.26,400,1136426,-328,0,0,0,0,0
20150105.140032,2810.88,36,1136462,-36,0,0,0,0,0
20150105.140033,2810.88,16,1136478,-14,0,0,0,0,0
20150105.140034,2810.26,2,1136480,0,0,0,0,0,0
20150105.140035,2810.88,30,1136510,-30,0,0,0,0,0
20150105.140036,2810.88,6,1136516,-6,0,0,0,0,0
20150105.140037,2810.26,12,1136528,0,0,0,0,0,0
20150105.140038,2810.88,2,1136530,-2,0,0,0,0,0
20150105.140039,2810.88,386,1136916,-284,0,0,0,0,0
20150105.14004,2810.88,2,1136918,2,0,0,0,0,0
20150105.140041,2811.5,104,1137022,78,0,0,0,0,0
20150105.140042,2810.88,396,1137418,136,0,0,0,0,0
20150105.140043,2811.51,150,1137568,44,0,0,0,0,0
20150105.140044,2810.88,6,1137574,2,0,0,0,0,0
20150105.140045,2810.88,60,1137634,-60,0,0,0,0,0
20150105.140046,2810.88,2,1137636,0,0,0,0,0,0
20150105.140047,2810.88,14,1137650,-2,0,0,0,0,0
20150105.140048,2811.51,100,1137750,100,0,0,0,0,0
20150105.140049,2810.88,6,1137756,4,0,0,0,0,0
20150105.14005,2811.51,100,1137856,100,0,0,0,0,0
20150105.140051,2810.88,2,1137858,-2,0,0,0,0,0
20150105.140052,2811.51,12,1137870,10,0,0,0,0,0
20150105.140053,2811.51,100,1137970,100,0,0,0,0,0
20150105.140054,2810.88,2,1137972,0,0,0,0,0,0
20150105.140055,2810.88,16,1137988,-2,0,0,0,0,0
20150105.140056,2811.51,112,1138100,98,0,0,0,0,0
20150105.140057,2810.88,12,1138112,10,0,0,0,0,0
20150105.140058,2810.88,114,1138226,102,0,0,0,0,0
20150105.140059,2810.88,2,1138228,2,0,0,0,0,0
20150105.1401,2810.88,2,1138230,2,0,0,0,0,0
20150105.140101,2810.88,104,1138334,40,0,0,0,0,0
20150105.140102,2811.51,100,1138434,12,0,0,0,0,0
20150105.140103,2810.88,2,1138436,0,0,0,0,0,0
20150105.140104,2811.51,580,1139016,-220,0,0,0,0,0
20150105.140105,2811.51,136,1139152,-36,0,0,0,0,0
20150105.140106,2811.51,114,1139266,-6,0,0,0,0,0
20150105.140107,2810.88,4,1139270,0,0,0,0,0,0
20150105.140108,2811.51,14,1139284,-12,0,0,0,0,0
20150105.140109,2811.51,10,1139294,-10,0,0,0,0,0
20150105.14011,2812.13,20,1139314,18,0,0,0,0,0
20150105.140111,2812.13,6,1139320,-2,0,0,0,0,0
20150105.140112,2812.13,148,1139468,-50,0,0,0,0,0
20150105.140113,2812.13,20,1139488,0,0,0,0,0,0
20150105.140114,2811.51,2,1139490,-2,0,0,0,0,0
20150105.140115,2811.51,6,1139496,-2,0,0,0,0,0
20150105.140116,2812.13,8,1139504,0,0,0,0,0,0
20150105.140117,2811.51,4,1139508,-2,0,0,0,0,0
20150105.140118,2811.51,50,1139558,-8,0,0,0,0,0
20150105.140119,2811.51,116,1139674,-112,0,0,0,0,0
20150105.14012,2811.51,544,1140218,-26,0,0,0,0,0
20150105.140121,2812.13,118,1140336,-92,0,0,0,0,0
20150105.140122,2810.88,4,1140340,2,0,0,0,0,0
20150105.140123,2811.51,2,1140342,0,0,0,0,0,0
20150105.140124,2811.51,26,1140368,-24,0,0,0,0,0
20150105.140125,2811.51,182,1140550,2,0,0,0,0,0
20150105.140126,2811.51,4,1140554,4,0,0,0,0,0
20150105.140127,2811.51,2,1140556,2,0,0,0,0,0
20150105.140128,2811.51,10,1140566,0,0,0,0,0,0
20150105.140129,2811.51,2,1140568,2,0,0,0,0,0
20150105.14013,2810.88,2,1140570,0,0,0,0,0,0
20150105.140131,2811.51,6,1140576,4,0,0,0,0,0
20150105.140132,2811.51,2,1140578,0,0,0,0,0,0
20150105.140133,2810.88,2,1140580,0,0,0,0,0,0
20150105.140134,2811.51,6,1140586,6,0,0,0,0,0
20150105.140135,2811.51,10,1140596,2,0,0,0,0,0
20150105.140136,2811.5,130,1140726,-50,0,0,0,0,0
20150105.140137,2810.88,2,1140728,0,0,0,0,0,0
20150105.140138,2810.88,2,1140730,2,0,0,0,0,0
20150105.140139,2811.51,170,1140900,170,0,0,0,0,0
20150105.14014,2811.51,204,1141104,0,0,0,0,0,0
20150105.140141,2811.51,2,1141106,2,0,0,0,0,0
20150105.140142,2811.51,60,1141166,0,0,0,0,0,0
20150105.140143,2811.51,50,1141216,-6,0,0,0,0,0
20150105.140144,2811.51,2,1141218,2,0,0,0,0,0
20150105.140145,2811.51,4,1141222,0,0,0,0,0,0
20150105.140146,2811.51,50,1141272,0,0,0,0,0,0
20150105.140147,2810.88,4,1141276,4,0,0,0,0,0
20150105.140148,2811.51,310,1141586,2,0,0,0,0,0
20150105.140149,2811.51,468,1142054,234,0,0,0,0,0
20150105.14015,2811.51,58,1142112,0,0,0,0,0,0
20150105.140151,2811.51,40,1142152,-20,0,0,0,0,0
20150105.140152,2811.51,80,1142232,0,0,0,0,0,0
20150105.140153,2812.13,4,1142236,4,0,0,0,0,0
20150105.140154,2811.51,34,1142270,-8,0,0,0,0,0
20150105.140155,2811.51,2002,1144272,328,0,0,0,0,0
20150105.140156,2811.51,52,1144324,-38,0,0,0,0,0
20150105.140157,2812.13,4,1144328,0,0,0,0,0,0
20150105.140158,2812.13,20,1144348,0,0,0,0,0,0
20150105.140159,2812.13,858,1145206,322,0,0,0,0,0
20150105.1402,2812.13,162,1145368,18,0,0,0,0,0
20150105.140201,2812.13,156,1145524,-16,0,0,0,0,0
20150105.140202,2812.13,32,1145556,32,0,0,0,0,0
20150105.140203,2812.13,52,1145608,-6,0,0,0,0,0
20150105.140204,2812.13,84,1145692,2,0,0,0,0,0
20150105.140205,2812.13,268,1145960,-10,0,0,0,0,0
20150105.140206,2812.75,2,1145962,0,0,0,0,0,0
20150105.140207,2812.13,334,1146296,72,0,0,0,0,0
20150105.140208,2812.75,36,1146332,0,0,0,0,0,0
20150105.140209,2812.75,2,1146334,0,0,0,0,0,0
20150105.14021,2812.75,254,1146588,40,0,0,0,0,0
20150105.140211,2812.75,14,1146602,10,0,0,0,0,0
20150105.140212,2812.76,2082,1148684,694,0,0,0,0,0
20150105.140213,2812.76,50,1148734,-4,0,0,0,0,0
20150105.140214,2813.38,44,1148778,-26,0,0,0,0,0
20150105.140215,2813.38,54,1148832,-2,0,0,0,0,0
20150105.140216,2813.38,156,1148988,2,0,0,0,0,0
20150105.140217,2813.38,4,1148992,2,0,0,0,0,0
20150105.140218,2813.38,372,1149364,360,0,0,0,0,0
20150105.140219,2813.38,4,1149368,4,0,0,0,0,0
20150105.14022,2813.38,18,1149386,6,0,0,0,0,0
20150105.140221,2812.76,268,1149654,194,0,0,0,0,0
20150105.140222,2812.76,24,1149678,8,0,0,0,0,0
20150105.140223,2813.38,6,1149684,4,0,0,0,0,0
20150105.140224,2813.38,214,1149898,200,0,0,0,0,0
20150105.140225,2813.38,16,1149914,16,0,0,0,0,0
20150105.140226,2813.38,202,1150116,198,0,0,0,0,0
20150105.140227,2812.76,6,1150122,-4,0,0,0,0,0
20150105.140228,2813.38,18,1150140,18,0,0,0,0,0
20150105.140229,2813.38,210,1150350,204,0,0,0,0,0
20150105.14023,2812.76,22,1150372,6,0,0,0,0,0
20150105.140231,2812.76,4,1150376,0,0,0,0,0,0
20150105.140232,2813.38,10,1150386,6,0,0,0,0,0
20150105.140233,2813.38,12,1150398,10,0,0,0,0,0
20150105.140234,2813.38,4,1150402,4,0,0,0,0,0
20150105.140235,2812.76,16,1150418,-2,0,0,0,0,0
20150105.140236,2813.38,4,1150422,4,0,0,0,0,0
20150105.140237,2812.76,448,1150870,382,0,0,0,0,0
20150105.140238,2812.76,912,1151782,96,0,0,0,0,0
20150105.140239,2813.38,228,1152010,52,0,0,0,0,0
20150105.14024,2812.76,48,1152058,36,0,0,0,0,0
20150105.140241,2812.76,22,1152080,22,0,0,0,0,0
20150105.140242,2812.76,2,1152082,0,0,0,0,0,0
20150105.140243,2812.14,118,1152200,100,0,0,0,0,0
20150105.140244,2812.76,22,1152222,0,0,0,0,0,0
20150105.140245,2812.76,2,1152224,0,0,0,0,0,0
20150105.140246,2812.76,8,1152232,0,0,0,0,0,0
20150105.140247,2812.76,8,1152240,-4,0,0,0,0,0
20150105.140248,2812.76,6,1152246,-6,0,0,0,0,0
20150105.140249,2812.76,2,1152248,-2,0,0,0,0,0
20150105.14025,2812.76,44,1152292,-38,0,0,0,0,0
20150105.140251,2812.76,6,1152298,-2,0,0,0,0,0
20150105.140252,2812.76,22,1152320,0,0,0,0,0,0
20150105.140253,2813.38,30,1152350,4,0,0,0,0,0
20150105.140254,2812.76,8,1152358,4,0,0,0,0,0
20150105.140255,2812.76,26,1152384,4,0,0,0,0,0
20150105.140256,2813.38,20,1152404,-2,0,0,0,0,0
20150105.140257,2812.76,6,1152410,0,0,0,0,0,0
20150105.140258,2813.38,10,1152420,-2,0,0,0,0,0
20150105.140259,2812.76,802,1153222,-770,0,0,0,0,0
20150105.1403,2813.38,8,1153230,0,0,0,0,0,0
20150105.140301,2813.38,18,1153248,0,0,0,0,0,0
20150105.140302,2813.38,114,1153362,-84,0,0,0,0,0
20150105.140303,2813.38,382,1153744,-316,0,0,0,0,0
20150105.140304,2813.38,16,1153760,-10,0,0,0,0,0
20150105.140305,2813.38,4,1153764,-4,0,0,0,0,0
20150105.140306,2813.38,62,1153826,8,0,0,0,0,0
20150105.140307,2813.38,36,1153862,-6,0,0,0,0,0
20150105.140308,2813.38,6,1153868,0,0,0,0,0,0
20150105.140309,2813.38,28,1153896,-6,0,0,0,0,0
20150105.14031,2813.38,12,1153908,0,0,0,0,0,0
20150105.140311,2812.76,36,1153944,14,0,0,0,0,0
20150105.140312,2813.38,34,1153978,-30,0,0,0,0,0
20150105.140313,2813.38,2,1153980,0,0,0,0,0,0
20150105.140314,2812.76,8,1153988,-4,0,0,0,0,0
20150105.140315,2813.38,8,1153996,-8,0,0,0,0,0
20150105.140316,2813.38,20,1154016,0,0,0,0,0,0
20150105.140317,2813.38,4,1154020,0,0,0,0,0,0
20150105.140318,2813.38,84,1154104,-6,0,0,0,0,0
20150105.140319,2813.38,2,1154106,-2,0,0,0,0,0
20150105.14032,2813.38,2,1154108,0,0,0,0,0,0
20150105.140321,2813.38,236,1154344,36,0,0,0,0,0
20150105.140322,2812.76,12,1154356,2,0,0,0,0,0
20150105.140323,2813.38,12,1154368,-6,0,0,0,0,0
20150105.140324,2813.38,200,1154568,40,0,0,0,0,0
20150105.140325,2813.38,6,1154574,-2,0,0,0,0,0
20150105.140326,2813.38,4,1154578,-4,0,0,0,0,0
20150105.140327,2812.76,32,1154610,10,0,0,0,0,0
20150105.140328,2812.76,2,1154612,0,0,0,0,0,0
20150105.140329,2813.38,2,1154614,-2,0,0,0,0,0
20150105.14033,2813.38,16,1154630,-8,0,0,0,0,0
20150105.140331,2812.76,2,1154632,0,0,0,0,0,0
20150105.140332,2813.38,4,1154636,0,0,0,0,0,0
20150105.140333,2813.38,4,1154640,0,0,0,0,0,0
20150105.140334,2812.76,12,1154652,-8,0,0,0,0,0
20150105.140335,2812.76,10,1154662,-10,0,0,0,0,0
20150105.140336,2812.76,4,1154666,-2,0,0,0,0,0
20150105.140337,2813.38,20,1154686,0,0,0,0,0,0
20150105.140338,2813.38,6,1154692,-2,0,0,0,0,0
20150105.140339,2813.38,2,1154694,0,0,0,0,0,0
20150105.14034,2813.38,10,1154704,4,0,0,0,0,0
20150105.140341,2813.38,18,1154722,0,0,0,0,0,0
20150105.140342,2813.38,24,1154746,-6,0,0,0,0,0
20150105.140343,2813.38,18,1154764,-12,0,0,0,0,0
20150105.140344,2812.76,42,1154806,0,0,0,0,0,0
20150105.140345,2813.38,26,1154832,2,0,0,0,0,0
20150105.140346,2813.38,78,1154910,-8,0,0,0,0,0
20150105.140347,2813.38,8,1154918,0,0,0,0,0,0
20150105.140348,2813.38,16,1154934,2,0,0,0,0,0
20150105.140349,2812.76,2,1154936,0,0,0,0,0,0
20150105.14035,2812.76,4,1154940,-2,0,0,0,0,0
20150105.140351,2812.76,12,1154952,8,0,0,0,0,0
20150105.140352,2812.76,14,1154966,8,0,0,0,0,0
20150105.140353,2813.38,6,1154972,0,0,0,0,0,0
20150105.140354,2812.76,92,1155064,-26,0,0,0,0,0
20150105.140355,2812.76,42,1155106,-8,0,0,0,0,0
20150105.140356,2812.76,1010,1156116,-338,0,0,0,0,0
20150105.140357,2812.76,48,1156164,0,0,0,0,0,0
20150105.140358,2812.13,12,1156176,10,0,0,0,0,0
20150105.140359,2812.13,2,1156178,0,0,0,0,0,0
20150105.1404,2812.13,28,1156206,-6,0,0,0,0,0
20150105.140401,2812.13,12,1156218,6,0,0,0,0,0
20150105.140402,2812.13,24,1156242,-4,0,0,0,0,0
20150105.140403,2812.13,6,1156248,-2,0,0,0,0,0
20150105.140404,2812.13,2,1156250,-2,0,0,0,0,0
20150105.140405,2812.13,40,1156290,-6,0,0,0,0,0
20150105.140406,2812.76,4,1156294,-2,0,0,0,0,0
20150105.140407,2812.13,6,1156300,-6,0,0,0,0,0
20150105.140408,2812.76,20,1156320,0,0,0,0,0,0
20150105.140409,2812.13,2,1156322,-2,0,0,0,0,0
20150105.14041,2812.13,4,1156326,0,0,0,0,0,0
20150105.140411,2812.13,2,1156328,-2,0,0,0,0,0
20150105.140412,2812.13,58,1156386,32,0,0,0,0,0
20150105.140413,2812.13,400,1156786,216,0,0,0,0,0
20150105.140414,2812.13,228,1157014,60,0,0,0,0,0
20150105.140415,2811.51,24,1157038,20,0,0,0,0,0
20150105.140416,2811.51,14,1157052,-2,0,0,0,0,0
20150105.140417,2812.13,6,1157058,0,0,0,0,0,0
20150105.140418,2812.13,454,1157512,24,0,0,0,0,0
20150105.140419,2811.51,20,1157532,0,0,0,0,0,0
20150105.14042,2812.13,50,1157582,0,0,0,0,0,0
20150105.140421,2812.13,376,1157958,36,0,0,0,0,0
20150105.140422,2812.13,24,1157982,-20,0,0,0,0,0
20150105.140423,2811.51,402,1158384,114,0,0,0,0,0
20150105.140424,2811.51,2,1158386,-2,0,0,0,0,0
20150105.140425,2812.14,516,1158902,426,0,0,0,0,0
20150105.140426,2811.51,14,1158916,12,0,0,0,0,0
20150105.140427,2812.14,26,1158942,-6,0,0,0,0,0
20150105.140428,2812.14,18,1158960,-2,0,0,0,0,0
20150105.140429,2812.14,12,1158972,2,0,0,0,0,0
20150105.14043,2812.14,10,1158982,0,0,0,0,0,0
20150105.140431,2812.14,70,1159052,8,0,0,0,0,0
20150105.140432,2812.14,538,1159590,336,0,0,0,0,0
20150105.140433,2812.14,8,1159598,4,0,0,0,0,0
20150105.140434,2812.76,2,1159600,2,0,0,0,0,0
20150105.140435,2812.14,168,1159768,2,0,0,0,0,0
20150105.140436,2812.76,428,1160196,402,0,0,0,0,0
20150105.140437,2812.14,28,1160224,24,0,0,0,0,0
20150105.140438,2812.14,4,1160228,2,0,0,0,0,0
20150105.140439,2812.14,194,1160422,32,0,0,0,0,0
20150105.14044,2812.14,2,1160424,0,0,0,0,0,0
20150105.140441,2812.14,2,1160426,2,0,0,0,0,0
20150105.140442,2812.14,218,1160644,212,0,0,0,0,0
20150105.140443,2812.14,4,1160648,4,0,0,0,0,0
20150105.140444,2812.14,10,1160658,0,0,0,0,0,0
20150105.140445,2812.14,2,1160660,0,0,0,0,0,0
20150105.140446,2812.14,4,1160664,4,0,0,0,0,0
20150105.140447,2812.14,2,1160666,2,0,0,0,0,0
20150105.140448,2812.14,4,1160670,4,0,0,0,0,0
20150105.140449,2811.51,2,1160672,0,0,0,0,0,0
20150105.14045,2812.14,18,1160690,10,0,0,0,0,0
20150105.140451,2812.14,4,1160694,0,0,0,0,0,0
20150105.140452,2811.51,2,1160696,-2,0,0,0,0,0
20150105.140453,2812.14,2,1160698,2,0,0,0,0,0
20150105.140454,2811.51,402,1161100,218,0,0,0,0,0
20150105.140455,2811.51,2,1161102,-2,0,0,0,0,0
20150105.140456,2812.14,6,1161108,6,0,0,0,0,0
20150105.140457,2811.51,8,1161116,6,0,0,0,0,0
20150105.140458,2812.14,6,1161122,6,0,0,0,0,0
20150105.140459,2812.14,6,1161128,-4,0,0,0,0,0
20150105.1405,2812.14,4,1161132,0,0,0,0,0,0
20150105.140501,2811.51,2,1161134,0,0,0,0,0,0
20150105.140502,2812.14,6,1161140,4,0,0,0,0,0
20150105.140503,2812.14,16,1161156,16,0,0,0,0,0
20150105.140504,2811.51,2,1161158,2,0,0,0,0,0
20150105.140505,2812.14,22,1161180,22,0,0,0,0,0
20150105.140506,2812.14,612,1161792,366,0,0,0,0,0
20150105.140507,2812.14,226,1162018,-64,0,0,0,0,0
20150105.140508,2812.76,136,1162154,-8,0,0,0,0,0
20150105.140509,2812.14,2,1162156,0,0,0,0,0,0
20150105.14051,2812.14,12,1162168,-10,0,0,0,0,0
20150105.140511,2812.76,2,1162170,-2,0,0,0,0,0
20150105.140512,2812.14,2,1162172,0,0,0,0,0,0
20150105.140513,2812.14,4,1162176,0,0,0,0,0,0
20150105.140514,2812.14,12,1162188,0,0,0,0,0,0
20150105.140515,2812.14,244,1162432,-214,0,0,0,0,0
20150105.140516,2812.14,4,1162436,0,0,0,0,0,0
20150105.140517,2812.14,2,1162438,0,0,0,0,0,0
20150105.140518,2812.76,420,1162858,252,0,0,0,0,0
20150105.140519,2811.52,2000,1164858,-6,0,0,0,0,0
20150105.14052,2812.14,32,1164890,30,0,0,0,0,0
20150105.140521,2812.14,356,1165246,-12,0,0,0,0,0
20150105.140522,2812.14,16,1165262,-12,0,0,0,0,0
20150105.140523,2812.14,10,1165272,-2,0,0,0,0,0
20150105.140524,2811.52,4,1165276,-2,0,0,0,0,0
20150105.140525,2812.14,32,1165308,0,0,0,0,0,0
20150105.140526,2812.14,14,1165322,2,0,0,0,0,0
20150105.140527,2812.14,12,1165334,0,0,0,0,0,0
20150105.140528,2811.52,2,1165336,0,0,0,0,0,0
20150105.140529,2812.14,30,1165366,-24,0,0,0,0,0
20150105.14053,2812.14,18,1165384,-4,0,0,0,0,0
20150105.140531,2812.14,24,1165408,0,0,0,0,0,0
20150105.140532,2811.52,4,1165412,2,0,0,0,0,0
20150105.140533,2811.52,2,1165414,0,0,0,0,0,0
20150105.140534,2812.14,18,1165432,-12,0,0,0,0,0
20150105.140535,2812.14,8,1165440,0,0,0,0,0,0
20150105.140536,2811.52,402,1165842,100,0,0,0,0,0
20150105.140537,2811.52,14,1165856,-4,0,0,0,0,0
20150105.140538,2811.52,2,1165858,2,0,0,0,0,0
20150105.140539,2811.52,4,1165862,0,0,0,0,0,0
20150105.14054,2811.52,2,1165864,0,0,0,0,0,0
20150105.140541,2811.52,4,1165868,0,0,0,0,0,0
20150105.140542,2811.52,4,1165872,4,0,0,0,0,0
20150105.140543,2811.52,6,1165878,2,0,0,0,0,0
20150105.140544,2812.14,4,1165882,-4,0,0,0,0,0
20150105.140545,2812.14,14,1165896,12,0,0,0,0,0
20150105.140546,2811.52,6,1165902,4,0,0,0,0,0
20150105.140547,2811.52,2,1165904,2,0,0,0,0,0
20150105.140548,2812.14,2,1165906,0,0,0,0,0,0
20150105.140549,2812.14,22,1165928,0,0,0,0,0,0
20150105.14055,2811.52,10,1165938,0,0,0,0,0,0
20150105.140551,2811.52,2,1165940,0,0,0,0,0,0
20150105.140552,2812.14,2,1165942,0,0,0,0,0,0
20150105.140553,2812.14,2,1165944,0,0,0,0,0,0
20150105.140554,2812.14,2,1165946,0,0,0,0,0,0
20150105.140555,2811.52,2,1165948,2,0,0,0,0,0
20150105.140556,2812.14,28,1165976,-10,0,0,0,0,0
20150105.140557,2811.52,4,1165980,0,0,0,0,0,0
20150105.140558,2812.14,4,1165984,0,0,0,0,0,0
20150105.140559,2812.14,8,1165992,-8,0,0,0,0,0
20150105.1406,2812.14,2,1165994,-2,0,0,0,0,0
20150105.140601,2812.14,6,1166000,-2,0,0,0,0,0
20150105.140602,2812.14,2,1166002,-2,0,0,0,0,0
20150105.140603,2812.14,8,1166010,0,0,0,0,0,0
20150105.140604,2812.14,4,1166014,-2,0,0,0,0,0
20150105.140605,2811.52,4,1166018,4,0,0,0,0,0
20150105.140606,2812.14,12,1166030,-6,0,0,0,0,0
20150105.140607,2811.52,4,1166034,2,0,0,0,0,0
20150105.140608,2812.14,2,1166036,0,0,0,0,0,0
20150105.140609,2811.52,2,1166038,2,0,0,0,0,0
20150105.14061,2811.52,2,1166040,2,0,0,0,0,0
20150105.140611,2811.52,2,1166042,2,0,0,0,0,0
20150105.140612,2811.52,2,1166044,2,0,0,0,0,0
20150105.140613,2811.52,2,1166046,0,0,0,0,0,0
20150105.140614,2811.52,2,1166048,0,0,0,0,0,0
20150105.140615,2811.52,2,1166050,0,0,0,0,0,0
20150105.140616,2812.14,6,1166056,0,0,0,0,0,0
20150105.140617,2811.52,2,1166058,2,0,0,0,0,0
20150105.140618,2811.52,2,1166060,0,0,0,0,0,0
20150105.140619,2811.52,554,1166614,-52,0,0,0,0,0
20150105.14062,2811.51,352,1166966,-84,0,0,0,0,0
20150105.140621,2811.52,250,1167216,50,0,0,0,0,0
20150105.140622,2811.52,136,1167352,-4,0,0,0,0,0
20150105.140623,2811.52,2,1167354,-2,0,0,0,0,0
20150105.140624,2811.51,40,1167394,-32,0,0,0,0,0
20150105.140625,2811.52,108,1167502,-2,0,0,0,0,0
20150105.140626,2811.52,16,1167518,0,0,0,0,0,0
20150105.140627,2812.14,2,1167520,0,0,0,0,0,0
20150105.140628,2810.89,6,1167526,0,0,0,0,0,0
20150105.140629,2810.89,8,1167534,4,0,0,0,0,0
20150105.14063,2811.52,4,1167538,4,0,0,0,0,0
20150105.140631,2811.52,20,1167558,16,0,0,0,0,0
20150105.140632,2811.52,12,1167570,10,0,0,0,0,0
20150105.140633,2811.52,8,1167578,6,0,0,0,0,0
20150105.140634,2811.52,18,1167596,6,0,0,0,0,0
20150105.140635,2811.52,8,1167604,0,0,0,0,0,0
20150105.140636,2811.52,14,1167618,0,0,0,0,0,0
20150105.140637,2810.89,10,1167628,2,0,0,0,0,0
20150105.140638,2811.52,4,1167632,0,0,0,0,0,0
20150105.140639,2811.52,22,1167654,-18,0,0,0,0,0
20150105.14064,2810.89,2,1167656,2,0,0,0,0,0
20150105.140641,2811.52,2,1167658,0,0,0,0,0,0
20150105.140642,2811.52,6,1167664,-4,0,0,0,0,0
20150105.140643,2811.52,2,1167666,-2,0,0,0,0,0
20150105.140644,2811.52,2,1167668,0,0,0,0,0,0
20150105.140645,2811.52,10,1167678,0,0,0,0,0,0
20150105.140646,2810.89,12,1167690,0,0,0,0,0,0
20150105.140647,2810.89,12,1167702,2,0,0,0,0,0
20150105.140648,2810.89,6,1167708,0,0,0,0,0,0
20150105.140649,2811.52,2,1167710,0,0,0,0,0,0
20150105.14065,2811.52,6,1167716,0,0,0,0,0,0
20150105.140651,2810.89,2,1167718,0,0,0,0,0,0
20150105.140652,2811.52,10,1167728,-10,0,0,0,0,0
20150105.140653,2810.89,2,1167730,2,0,0,0,0,0
20150105.140654,2810.89,4,1167734,0,0,0,0,0,0
20150105.140655,2810.89,4,1167738,4,0,0,0,0,0
20150105.140656,2810.89,26,1167764,18,0,0,0,0,0
20150105.140657,2810.89,672,1168436,236,0,0,0,0,0
20150105.140658,2811.52,2,1168438,0,0,0,0,0,0
20150105.140659,2811.52,44,1168482,0,0,0,0,0,0
20150105.1407,2811.52,448,1168930,4,0,0,0,0,0
20150105.140701,2811.52,84,1169014,0,0,0,0,0,0
20150105.140702,2812.14,1000,1170014,-430,0,0,0,0,0
20150105.140703,2811.51,2,1170016,0,0,0,0,0,0
20150105.140704,2811.51,20,1170036,0,0,0,0,0,0
20150105.140705,2811.52,720,1170756,230,0,0,0,0,0
20150105.140706,2812.14,830,1171586,72,0,0,0,0,0
20150105.140707,2812.14,4,1171590,4,0,0,0,0,0
20150105.140708,2812.14,130,1171720,-122,0,0,0,0,0
20150105.140709,2812.14,6,1171726,0,0,0,0,0,0
20150105.14071,2812.14,584,1172310,-420,0,0,0,0,0
20150105.140711,2812.14,442,1172752,-280,0,0,0,0,0
20150105.140712,2812.14,4,1172756,2,0,0,0,0,0
20150105.140713,2812.14,672,1173428,104,0,0,0,0,0
20150105.140714,2812.76,1498,1174926,974,0,0,0,0,0
20150105.140715,2812.76,30,1174956,0,0,0,0,0,0
20150105.140716,2812.76,52,1175008,-30,0,0,0,0,0
20150105.140717,2812.76,6,1175014,-4,0,0,0,0,0
20150105.140718,2812.76,2,1175016,-2,0,0,0,0,0
20150105.140719,2812.76,264,1175280,66,0,0,0,0,0
20150105.14072,2812.76,2,1175282,0,0,0,0,0,0
20150105.140721,2812.76,16,1175298,16,0,0,0,0,0
20150105.140722,2812.76,74,1175372,74,0,0,0,0,0
20150105.140723,2812.76,8,1175380,-2,0,0,0,0,0
20150105.140724,2812.76,2,1175382,-2,0,0,0,0,0
20150105.140725,2812.76,10,1175392,8,0,0,0,0,0
20150105.140726,2812.76,120,1175512,106,0,0,0,0,0
20150105.140727,2812.76,4,1175516,4,0,0,0,0,0
20150105.140728,2812.76,104,1175620,2,0,0,0,0,0
20150105.140729,2812.76,26,1175646,-20,0,0,0,0,0
20150105.14073,2812.77,230,1175876,198,0,0,0,0,0
20150105.140731,2812.77,4,1175880,0,0,0,0,0,0
20150105.140732,2812.77,6,1175886,4,0,0,0,0,0
20150105.140733,2812.77,2,1175888,0,0,0,0,0,0
20150105.140734,2812.77,2,1175890,2,0,0,0,0,0
20150105.140735,2812.14,2,1175892,2,0,0,0,0,0
20150105.140736,2812.77,236,1176128,102,0,0,0,0,0
20150105.140737,2812.77,2,1176130,0,0,0,0,0,0
20150105.140738,2812.77,2,1176132,0,0,0,0,0,0
20150105.140739,2812.77,62,1176194,-10,0,0,0,0,0
20150105.14074,2812.14,2,1176196,2,0,0,0,0,0
20150105.140741,2812.77,112,1176308,-4,0,0,0,0,0
20150105.140742,2812.77,158,1176466,102,0,0,0,0,0
20150105.140743,2812.77,342,1176808,58,0,0,0,0,0
20150105.140744,2812.77,10,1176818,10,0,0,0,0,0
20150105.140745,2812.77,2,1176820,0,0,0,0,0,0
20150105.140746,2812.77,8,1176828,8,0,0,0,0,0
20150105.140747,2812.77,24,1176852,4,0,0,0,0,0
20150105.140748,2812.77,28,1176880,0,0,0,0,0,0
20150105.140749,2812.77,26,1176906,24,0,0,0,0,0
20150105.14075,2812.77,8,1176914,8,0,0,0,0,0
20150105.140751,2812.77,6,1176920,6,0,0,0,0,0
20150105.140752,2812.77,418,1177338,382,0,0,0,0,0
20150105.140753,2812.77,16,1177354,-14,0,0,0,0,0
20150105.140754,2812.14,966,1178320,-650,0,0,0,0,0
20150105.140755,2812.14,4,1178324,4,0,0,0,0,0
20150105.140756,2812.14,6,1178330,2,0,0,0,0,0
20150105.140757,2812.14,126,1178456,102,0,0,0,0,0
20150105.140758,2812.14,278,1178734,-168,0,0,0,0,0
20150105.140759,2812.14,214,1178948,100,0,0,0,0,0
20150105.1408,2812.14,112,1179060,14,0,0,0,0,0
20150105.140801,2812.14,4,1179064,4,0,0,0,0,0
20150105.140802,2812.14,16,1179080,2,0,0,0,0,0
20150105.140803,2812.14,260,1179340,0,0,0,0,0,0
20150105.140804,2811.52,2,1179342,0,0,0,0,0,0
20150105.140805,2812.14,104,1179446,-74,0,0,0,0,0
20150105.140806,2812.14,412,1179858,-404,0,0,0,0,0
20150105.140807,2812.76,2,1179860,0,0,0,0,0,0
20150105.140808,2812.14,224,1180084,-28,0,0,0,0,0
20150105.140809,2812.14,4,1180088,0,0,0,0,0,0
20150105.14081,2811.52,102,1180190,-100,0,0,0,0,0
20150105.140811,2812.14,10,1180200,0,0,0,0,0,0
20150105.140812,2812.14,12,1180212,-6,0,0,0,0,0
20150105.140813,2812.14,6,1180218,0,0,0,0,0,0
20150105.140814,2812.14,4,1180222,0,0,0,0,0,0
20150105.140815,2812.14,2,1180224,0,0,0,0,0,0
20150105.140816,2812.14,286,1180510,16,0,0,0,0,0
20150105.140817,2811.52,154,1180664,100,0,0,0,0,0
20150105.140818,2811.52,174,1180838,0,0,0,0,0,0
20150105.140819,2812.14,10,1180848,-10,0,0,0,0,0
20150105.14082,2811.52,2,1180850,0,0,0,0,0,0
20150105.140821,2812.14,2,1180852,0,0,0,0,0,0
20150105.140822,2812.14,2,1180854,0,0,0,0,0,0
20150105.140823,2811.52,6,1180860,-2,0,0,0,0,0
20150105.140824,2812.14,184,1181044,-106,0,0,0,0,0
20150105.140825,2812.14,2,1181046,0,0,0,0,0,0
20150105.140826,2811.52,4,1181050,2,0,0,0,0,0
20150105.140827,2812.14,6,1181056,6,0,0,0,0,0
20150105.140828,2812.14,40,1181096,-34,0,0,0,0,0
20150105.140829,2812.14,2,1181098,-2,0,0,0,0,0
20150105.14083,2812.14,50,1181148,0,0,0,0,0,0
20150105.140831,2811.52,2,1181150,0,0,0,0,0,0
20150105.140832,2812.14,2,1181152,-2,0,0,0,0,0
20150105.140833,2812.14,8,1181160,0,0,0,0,0,0
20150105.140834,2812.14,162,1181322,-88,0,0,0,0,0
20150105.140835,2812.14,104,1181426,92,0,0,0,0,0
20150105.140836,2811.52,104,1181530,98,0,0,0,0,0
20150105.140837,2812.14,4,1181534,0,0,0,0,0,0
20150105.140838,2812.14,12,1181546,2,0,0,0,0,0
20150105.140839,2812.14,130,1181676,10,0,0,0,0,0
20150105.14084,2812.14,2,1181678,-2,0,0,0,0,0
20150105.140841,2812.14,2,1181680,0,0,0,0,0,0
20150105.140842,2812.14,112,1181792,74,0,0,0,0,0
20150105.140843,2811.52,36,1181828,0,0,0,0,0,0
20150105.140844,2812.14,140,1181968,-110,0,0,0,0,0
20150105.140845,2812.14,44,1182012,44,0,0,0,0,0
20150105.140846,2812.14,38,1182050,18,0,0,0,0,0
20150105.140847,2812.14,32,1182082,0,0,0,0,0,0
20150105.140848,2812.14,2,1182084,-2,0,0,0,0,0
20150105.140849,2812.14,2,1182086,0,0,0,0,0,0
20150105.14085,2811.52,2,1182088,2,0,0,0,0,0
20150105.140851,2812.14,80,1182168,10,0,0,0,0,0
20150105.140852,2812.14,50,1182218,44,0,0,0,0,0
20150105.140853,2811.52,112,1182330,56,0,0,0,0,0
20150105.140854,2812.14,236,1182566,4,0,0,0,0,0
20150105.140855,2812.14,6,1182572,-6,0,0,0,0,0
20150105.140856,2812.14,2,1182574,-2,0,0,0,0,0
20150105.140857,2811.52,106,1182680,0,0,0,0,0,0
20150105.140858,2811.52,102,1182782,-40,0,0,0,0,0
20150105.140859,2812.14,2,1182784,2,0,0,0,0,0
20150105.1409,2812.14,432,1183216,84,0,0,0,0,0
20150105.140901,2812.14,4,1183220,0,0,0,0,0,0
20150105.140902,2812.14,116,1183336,-16,0,0,0,0,0
20150105.140903,2812.14,12,1183348,-8,0,0,0,0,0
20150105.140904,2812.76,12,1183360,0,0,0,0,0,0
20150105.140905,2812.14,2,1183362,0,0,0,0,0,0
20150105.140906,2812.14,44,1183406,0,0,0,0,0,0
20150105.140907,2812.14,64,1183470,-50,0,0,0,0,0
20150105.140908,2812.14,74,1183544,-58,0,0,0,0,0
20150105.140909,2811.52,10,1183554,-6,0,0,0,0,0
20150105.14091,2811.52,2,1183556,0,0,0,0,0,0
20150105.140911,2812.14,164,1183720,100,0,0,0,0,0
20150105.140912,2812.14,2,1183722,0,0,0,0,0,0
20150105.140913,2812.14,80,1183802,0,0,0,0,0,0
20150105.140914,2812.14,2,1183804,-2,0,0,0,0,0
20150105.140915,2812.14,4,1183808,-2,0,0,0,0,0
20150105.140916,2812.76,160,1183968,-12,0,0,0,0,0
20150105.140917,2811.52,42,1184010,-36,0,0,0,0,0
20150105.140918,2812.14,2,1184012,2,0,0,0,0,0
20150105.140919,2812.14,2,1184014,2,0,0,0,0,0
20150105.14092,2812.14,232,1184246,-134,0,0,0,0,0
20150105.140921,2811.52,12,1184258,0,0,0,0,0,0
20150105.140922,2812.14,204,1184462,190,0,0,0,0,0
20150105.140923,2812.14,6,1184468,0,0,0,0,0,0
20150105.140924,2812.14,106,1184574,0,0,0,0,0,0
20150105.140925,2812.14,54,1184628,14,0,0,0,0,0
20150105.140926,2811.52,2,1184630,0,0,0,0,0,0
20150105.140927,2812.14,6,1184636,4,0,0,0,0,0
20150105.140928,2812.14,40,1184676,-38,0,0,0,0,0
20150105.140929,2812.14,20,1184696,4,0,0,0,0,0
20150105.14093,2811.52,2,1184698,0,0,0,0,0,0
20150105.140931,2811.52,2,1184700,-2,0,0,0,0,0
20150105.140932,2812.14,4,1184704,-2,0,0,0,0,0
20150105.140933,2812.14,2,1184706,-2,0,0,0,0,0
20150105.140934,2812.14,4,1184710,-2,0,0,0,0,0
20150105.140935,2812.14,2,1184712,-2,0,0,0,0,0
20150105.140936,2812.14,40,1184752,0,0,0,0,0,0
20150105.140937,2812.14,2,1184754,0,0,0,0,0,0
20150105.140938,2811.52,2,1184756,2,0,0,0,0,0
20150105.140939,2811.52,2,1184758,0,0,0,0,0,0
20150105.14094,2812.14,6,1184764,-4,0,0,0,0,0
20150105.140941,2811.52,16,1184780,-16,0,0,0,0,0
20150105.140942,2811.52,2,1184782,0,0,0,0,0,0
20150105.140943,2811.52,4,1184786,-4,0,0,0,0,0
20150105.140944,2811.52,2,1184788,0,0,0,0,0,0
20150105.140945,2811.52,20,1184808,0,0,0,0,0,0
20150105.140946,2811.51,1124,1185932,-696,0,0,0,0,0
20150105.140947,2811.51,10,1185942,-10,0,0,0,0,0
20150105.140948,2810.89,2,1185944,0,0,0,0,0,0
20150105.140949,2810.89,2,1185946,-2,0,0,0,0,0
20150105.14095,2811.51,2,1185948,0,0,0,0,0,0
20150105.140951,2811.51,2,1185950,0,0,0,0,0,0
20150105.140952,2810.89,2,1185952,0,0,0,0,0,0
20150105.140953,2810.89,8,1185960,0,0,0,0,0,0
20150105.140954,2811.51,2,1185962,0,0,0,0,0,0
20150105.140955,2810.89,2,1185964,0,0,0,0,0,0
20150105.140956,2810.89,2,1185966,0,0,0,0,0,0
20150105.140957,2811.51,482,1186448,-196,0,0,0,0,0
20150105.140958,2811.51,4,1186452,0,0,0,0,0,0
20150105.140959,2811.51,78,1186530,-78,0,0,0,0,0
20150105.141,2811.51,2,1186532,0,0,0,0,0,0
20150105.141001,2811.51,4,1186536,0,0,0,0,0,0
20150105.141002,2811.51,2,1186538,0,0,0,0,0,0
20150105.141003,2811.51,2,1186540,-2,0,0,0,0,0
20150105.141004,2811.51,2,1186542,0,0,0,0,0,0
20150105.141005,2812.14,18,1186560,-18,0,0,0,0,0
20150105.141006,2811.51,20,1186580,0,0,0,0,0,0
20150105.141007,2811.51,2,1186582,0,0,0,0,0,0
20150105.141008,2811.51,8,1186590,-8,0,0,0,0,0
20150105.141009,2811.51,2,1186592,0,0,0,0,0,0
20150105.14101,2812.14,2,1186594,-2,0,0,0,0,0
20150105.141011,2812.14,200,1186794,-156,0,0,0,0,0
20150105.141012,2812.14,100,1186894,84,0,0,0,0,0
20150105.141013,2812.14,20,1186914,0,0,0,0,0,0
20150105.141014,2811.51,4,1186918,2,0,0,0,0,0
20150105.141015,2812.14,6,1186924,4,0,0,0,0,0
20150105.141016,2812.14,12,1186936,8,0,0,0,0,0
20150105.141017,2812.14,2,1186938,0,0,0,0,0,0
20150105.141018,2811.51,6,1186944,-2,0,0,0,0,0
20150105.141019,2812.14,20,1186964,-12,0,0,0,0,0
20150105.14102,2811.51,2,1186966,0,0,0,0,0,0
20150105.141021,2812.14,2,1186968,0,0,0,0,0,0
20150105.141022,2811.51,4,1186972,-2,0,0,0,0,0
20150105.141023,2812.14,238,1187210,-60,0,0,0,0,0
20150105.141024,2812.14,128,1187338,-126,0,0,0,0,0
20150105.141025,2812.14,34,1187372,-28,0,0,0,0,0
20150105.141026,2812.14,2,1187374,2,0,0,0,0,0
20150105.141027,2812.14,142,1187516,132,0,0,0,0,0
20150105.141028,2811.51,120,1187636,0,0,0,0,0,0
20150105.141029,2812.14,2,1187638,0,0,0,0,0,0
20150105.14103,2812.14,4,1187642,-4,0,0,0,0,0
20150105.141031,2811.51,400,1188042,124,0,0,0,0,0
20150105.141032,2812.14,2,1188044,0,0,0,0,0,0
20150105.141033,2810.89,402,1188446,80,0,0,0,0,0
20150105.141034,2811.51,22,1188468,0,0,0,0,0,0
20150105.141035,2811.51,410,1188878,10,0,0,0,0,0
20150105.141036,2811.51,54,1188932,-52,0,0,0,0,0
20150105.141037,2810.89,408,1189340,162,0,0,0,0,0
20150105.141038,2810.89,200,1189540,148,0,0,0,0,0
20150105.141039,2811.51,40,1189580,0,0,0,0,0,0
20150105.14104,2811.52,402,1189982,350,0,0,0,0,0
20150105.141041,2812.14,2,1189984,-2,0,0,0,0,0
20150105.141042,2810.89,400,1190384,130,0,0,0,0,0
20150105.141043,2810.89,4,1190388,-2,0,0,0,0,0
20150105.141044,2810.27,400,1190788,150,0,0,0,0,0
20150105.141045,2810.27,34,1190822,-34,0,0,0,0,0
20150105.141046,2810.89,718,1191540,-86,0,0,0,0,0
20150105.141047,2810.89,104,1191644,68,0,0,0,0,0
20150105.141048,2810.27,350,1191994,48,0,0,0,0,0
20150105.141049,2810.27,352,1192346,-68,0,0,0,0,0
20150105.14105,2810.27,400,1192746,348,0,0,0,0,0
20150105.141051,2809.64,4,1192750,-2,0,0,0,0,0
20150105.141052,2810.27,78,1192828,46,0,0,0,0,0
20150105.141053,2810.27,28,1192856,-24,0,0,0,0,0
20150105.141054,2810.27,2,1192858,-2,0,0,0,0,0
20150105.141055,2810.27,6,1192864,0,0,0,0,0,0
20150105.141056,2810.27,2,1192866,-2,0,0,0,0,0
20150105.141057,2810.27,218,1193084,-66,0,0,0,0,0
20150105.141058,2810.27,6,1193090,0,0,0,0,0,0
20150105.141059,2810.89,2,1193092,-2,0,0,0,0,0
20150105.1411,2810.27,20,1193112,16,0,0,0,0,0
20150105.141101,2810.27,22,1193134,-22,0,0,0,0,0
20150105.141102,2810.89,4,1193138,-2,0,0,0,0,0
20150105.141103,2810.89,4,1193142,-2,0,0,0,0,0
20150105.141104,2810.27,2,1193144,0,0,0,0,0,0
20150105.141105,2810.27,2,1193146,-2,0,0,0,0,0
20150105.141106,2810.89,4,1193150,0,0,0,0,0,0
20150105.141107,2810.27,464,1193614,-84,0,0,0,0,0
20150105.141108,2810.27,10,1193624,-10,0,0,0,0,0
20150105.141109,2810.27,12,1193636,4,0,0,0,0,0
20150105.14111,2810.27,2,1193638,0,0,0,0,0,0
20150105.141111,2810.27,2,1193640,0,0,0,0,0,0
20150105.141112,2810.27,300,1193940,292,0,0,0,0,0
20150105.141113,2810.27,114,1194054,-44,0,0,0,0,0
20150105.141114,2810.27,40,1194094,0,0,0,0,0,0
20150105.141115,2810.27,2,1194096,0,0,0,0,0,0
20150105.141116,2810.27,10,1194106,0,0,0,0,0,0
20150105.141117,2809.64,10,1194116,-8,0,0,0,0,0
20150105.141118,2810.27,2,1194118,-2,0,0,0,0,0
20150105.141119,2809.64,30,1194148,-26,0,0,0,0,0
20150105.14112,2810.27,6,1194154,4,0,0,0,0,0
20150105.141121,2809.64,2,1194156,2,0,0,0,0,0
20150105.141122,2809.64,4,1194160,4,0,0,0,0,0
20150105.141123,2809.64,14,1194174,0,0,0,0,0,0
20150105.141124,2809.64,40,1194214,2,0,0,0,0,0
20150105.141125,2809.64,6,1194220,-2,0,0,0,0,0
20150105.141126,2810.27,6,1194226,0,0,0,0,0,0
20150105.141127,2810.27,2,1194228,0,0,0,0,0,0
20150105.141128,2810.27,2,1194230,0,0,0,0,0,0
20150105.141129,2809.64,6,1194236,-2,0,0,0,0,0
20150105.14113,2809.64,60,1194296,-22,0,0,0,0,0
20150105.141131,2809.64,8,1194304,-6,0,0,0,0,0
20150105.141132,2809.64,2,1194306,2,0,0,0,0,0
20150105.141133,2809.64,2,1194308,0,0,0,0,0,0
20150105.141134,2810.27,2,1194310,2,0,0,0,0,0
20150105.141135,2810.27,100,1194410,100,0,0,0,0,0
20150105.141136,2810.27,2,1194412,2,0,0,0,0,0
20150105.141137,2809.64,40,1194452,-40,0,0,0,0,0
20150105.141138,2810.27,2,1194454,2,0,0,0,0,0
20150105.141139,2809.64,20,1194474,18,0,0,0,0,0
20150105.14114,2810.27,4,1194478,4,0,0,0,0,0
20150105.141141,2809.64,2,1194480,0,0,0,0,0,0
20150105.141142,2809.64,10,1194490,-4,0,0,0,0,0
20150105.141143,2810.27,2,1194492,0,0,0,0,0,0
20150105.141144,2810.27,6,1194498,0,0,0,0,0,0
20150105.141145,2810.27,8,1194506,2,0,0,0,0,0
20150105.141146,2810.27,6,1194512,4,0,0,0,0,0
20150105.141147,2810.27,2,1194514,0,0,0,0,0,0
20150105.141148,2810.27,2,1194516,2,0,0,0,0,0
20150105.141149,2810.27,2,1194518,0,0,0,0,0,0
20150105.14115,2810.27,4,1194522,4,0,0,0,0,0
20150105.141151,2810.27,20,1194542,0,0,0,0,0,0
20150105.141152,2809.64,10,1194552,0,0,0,0,0,0
20150105.141153,2810.27,2,1194554,2,0,0,0,0,0
20150105.141154,2810.27,14,1194568,10,0,0,0,0,0
20150105.141155,2810.27,28,1194596,0,0,0,0,0,0
20150105.141156,2810.27,10,1194606,10,0,0,0,0,0
20150105.141157,2809.64,22,1194628,18,0,0,0,0,0
20150105.141158,2810.27,6,1194634,0,0,0,0,0,0
20150105.141159,2810.27,4,1194638,4,0,0,0,0,0
20150105.1412,2809.64,10,1194648,0,0,0,0,0,0
20150105.141201,2810.27,2,1194650,0,0,0,0,0,0
20150105.141202,2809.64,2,1194652,0,0,0,0,0,0
20150105.141203,2809.65,102,1194754,98,0,0,0,0,0
20150105.141204,2809.65,42,1194796,38,0,0,0,0,0
20150105.141205,2809.65,8,1194804,0,0,0,0,0,0
20150105.141206,2809.65,26,1194830,2,0,0,0,0,0
20150105.141207,2810.27,50,1194880,20,0,0,0,0,0
20150105.141208,2810.27,52,1194932,-44,0,0,0,0,0
20150105.141209,2810.27,14,1194946,0,0,0,0,0,0
20150105.14121,2810.27,2,1194948,-2,0,0,0,0,0
20150105.141211,2810.27,752,1195700,-46,0,0,0,0,0
20150105.141212,2810.27,320,1196020,134,0,0,0,0,0
20150105.141213,2810.27,406,1196426,-2,0,0,0,0,0
20150105.141214,2809.65,142,1196568,-90,0,0,0,0,0
20150105.141215,2809.65,8,1196576,8,0,0,0,0,0
20150105.141216,2810.27,28,1196604,0,0,0,0,0,0
20150105.141217,2810.27,2,1196606,-2,0,0,0,0,0
20150105.141218,2810.27,540,1197146,-72,0,0,0,0,0
20150105.141219,2810.27,8,1197154,8,0,0,0,0,0
20150105.14122,2810.27,452,1197606,358,0,0,0,0,0
20150105.141221,2810.27,52,1197658,2,0,0,0,0,0
20150105.141222,2810.27,400,1198058,128,0,0,0,0,0
20150105.141223,2810.27,6,1198064,-6,0,0,0,0,0
20150105.141224,2810.27,304,1198368,6,0,0,0,0,0
20150105.141225,2810.27,10,1198378,10,0,0,0,0,0
20150105.141226,2810.27,20,1198398,18,0,0,0,0,0
20150105.141227,2810.27,6,1198404,6,0,0,0,0,0
20150105.141228,2810.27,10,1198414,10,0,0,0,0,0
20150105.141229,2810.27,2,1198416,0,0,0,0,0,0
20150105.14123,2810.27,20,1198436,-2,0,0,0,0,0
20150105.141231,2809.65,16,1198452,4,0,0,0,0,0
20150105.141232,2810.27,4,1198456,0,0,0,0,0,0
20150105.141233,2810.27,4,1198460,4,0,0,0,0,0
20150105.141234,2810.27,4,1198464,4,0,0,0,0,0
20150105.141235,2810.27,4,1198468,0,0,0,0,0,0
20150105.141236,2810.27,2,1198470,0,0,0,0,0,0
20150105.141237,2810.27,2,1198472,0,0,0,0,0,0
20150105.141238,2810.27,4,1198476,4,0,0,0,0,0
20150105.141239,2809.65,2,1198478,0,0,0,0,0,0
20150105.14124,2810.27,2,1198480,2,0,0,0,0,0
20150105.141241,2810.27,42,1198522,-20,0,0,0,0,0
20150105.141242,2810.27,2,1198524,-2,0,0,0,0,0
20150105.141243,2810.27,4,1198528,-2,0,0,0,0,0
20150105.141244,2810.27,8,1198536,0,0,0,0,0,0
20150105.141245,2810.27,50,1198586,-14,0,0,0,0,0
20150105.141246,2810.27,102,1198688,2,0,0,0,0,0
20150105.141247,2810.27,34,1198722,6,0,0,0,0,0
20150105.141248,2810.27,368,1199090,-72,0,0,0,0,0
20150105.141249,2810.27,14,1199104,2,0,0,0,0,0
20150105.14125,2810.27,2,1199106,2,0,0,0,0,0
20150105.141251,2810.27,2,1199108,0,0,0,0,0,0
20150105.141252,2810.27,22,1199130,0,0,0,0,0,0
20150105.141253,2810.27,2,1199132,0,0,0,0,0,0
20150105.141254,2810.27,4,1199136,2,0,0,0,0,0
20150105.141255,2810.27,4,1199140,4,0,0,0,0,0
20150105.141256,2810.27,82,1199222,42,0,0,0,0,0
20150105.141257,2810.27,22,1199244,22,0,0,0,0,0
20150105.141258,2809.65,4,1199248,2,0,0,0,0,0
20150105.141259,2810.27,2,1199250,2,0,0,0,0,0
20150105.1413,2810.27,58,1199308,58,0,0,0,0,0
20150105.141301,2809.65,4,1199312,0,0,0,0,0,0
20150105.141302,2810.27,42,1199354,42,0,0,0,0,0
20150105.141303,2810.27,2,1199356,0,0,0,0,0,0
20150105.141304,2810.27,2,1199358,0,0,0,0,0,0
20150105.141305,2809.65,2,1199360,0,0,0,0,0,0
20150105.141306,2810.27,172,1199532,-16,0,0,0,0,0
20150105.141307,2810.27,2,1199534,0,0,0,0,0,0
20150105.141308,2810.27,144,1199678,-4,0,0,0,0,0
20150105.141309,2810.27,20,1199698,0,0,0,0,0,0
20150105.14131,2810.27,4,1199702,4,0,0,0,0,0
20150105.141311,2810.27,54,1199756,30,0,0,0,0,0
20150105.141312,2809.65,4,1199760,0,0,0,0,0,0
20150105.141313,2810.27,4,1199764,2,0,0,0,0,0
20150105.141314,2810.27,10,1199774,6,0,0,0,0,0
20150105.141315,2810.27,4,1199778,4,0,0,0,0,0
20150105.141316,2810.27,2,1199780,2,0,0,0,0,0
20150105.141317,2809.65,2,1199782,-2,0,0,0,0,0
20150105.141318,2809.65,8,1199790,6,0,0,0,0,0
20150105.141319,2810.27,2,1199792,0,0,0,0,0,0
20150105.14132,2810.27,12,1199804,10,0,0,0,0,0
20150105.141321,2810.27,4,1199808,0,0,0,0,0,0
20150105.141322,2810.27,2,1199810,2,0,0,0,0,0
20150105.141323,2810.27,14,1199824,4,0,0,0,0,0
20150105.141324,2810.27,50,1199874,48,0,0,0,0,0
20150105.141325,2809.65,402,1200276,-396,0,0,0,0,0
20150105.141326,2810.27,2,1200278,2,0,0,0,0,0
20150105.141327,2809.65,400,1200678,-152,0,0,0,0,0
20150105.141328,2810.27,36,1200714,36,0,0,0,0,0
20150105.141329,2809.64,400,1201114,-200,0,0,0,0,0
20150105.14133,2809.64,1210,1202324,-554,0,0,0,0,0
20150105.141331,2809.64,212,1202536,-46,0,0,0,0,0
20150105.141332,2809.64,22,1202558,-20,0,0,0,0,0
20150105.141333,2809.64,2,1202560,-2,0,0,0,0,0
20150105.141334,2809.02,10,1202570,-2,0,0,0,0,0
20150105.141335,2809.02,2,1202572,-2,0,0,0,0,0
20150105.141336,2809.02,18,1202590,-18,0,0,0,0,0
20150105.141337,2809.64,2,1202592,0,0,0,0,0,0
20150105.141338,2809.64,14,1202606,-2,0,0,0,0,0
20150105.141339,2809.02,40,1202646,-2,0,0,0,0,0
20150105.14134,2809.64,2,1202648,0,0,0,0,0,0
20150105.141341,2809.64,368,1203016,12,0,0,0,0,0
20150105.141342,2809.02,2,1203018,2,0,0,0,0,0
20150105.141343,2809.02,2,1203020,2,0,0,0,0,0
20150105.141344,2809.64,2,1203022,0,0,0,0,0,0
20150105.141345,2809.64,4,1203026,0,0,0,0,0,0
20150105.141346,2809.64,2,1203028,0,0,0,0,0,0
20150105.141347,2809.64,2,1203030,0,0,0,0,0,0
20150105.141348,2809.02,10,1203040,4,0,0,0,0,0
20150105.141349,2809.64,80,1203120,0,0,0,0,0,0
20150105.14135,2809.02,2,1203122,2,0,0,0,0,0
20150105.141351,2809.02,2,1203124,2,0,0,0,0,0
20150105.141352,2809.64,2,1203126,0,0,0,0,0,0
20150105.141353,2809.64,100,1203226,0,0,0,0,0,0
20150105.141354,2809.02,2,1203228,0,0,0,0,0,0
20150105.141355,2809.64,110,1203338,-100,0,0,0,0,0
20150105.141356,2809.64,24,1203362,0,0,0,0,0,0
20150105.141357,2809.64,404,1203766,-372,0,0,0,0,0
20150105.141358,2809.64,328,1204094,-174,0,0,0,0,0
20150105.141359,2809.02,16,1204110,0,0,0,0,0,0
20150105.1414,2809.02,16,1204126,4,0,0,0,0,0
20150105.141401,2809.02,2,1204128,0,0,0,0,0,0
20150105.141402,2809.64,12,1204140,-10,0,0,0,0,0
20150105.141403,2809.02,72,1204212,10,0,0,0,0,0
20150105.141404,2809.64,8,1204220,0,0,0,0,0,0
20150105.141405,2809.64,6,1204226,-4,0,0,0,0,0
20150105.141406,2809.64,2,1204228,0,0,0,0,0,0
20150105.141407,2809.64,20,1204248,0,0,0,0,0,0
20150105.141408,2809.64,8,1204256,-6,0,0,0,0,0
20150105.141409,2809.02,6,1204262,-6,0,0,0,0,0
20150105.14141,2809.64,12,1204274,-2,0,0,0,0,0
20150105.141411,2809.02,2,1204276,0,0,0,0,0,0
20150105.141412,2809.02,2,1204278,-2,0,0,0,0,0
20150105.141413,2809.64,468,1204746,-424,0,0,0,0,0
20150105.141414,2809.64,420,1205166,54,0,0,0,0,0
20150105.141415,2809.64,400,1205566,-300,0,0,0,0,0
20150105.141416,2809.64,312,1205878,-206,0,0,0,0,0
20150105.141417,2809.64,84,1205962,0,0,0,0,0,0
20150105.141418,2809.64,316,1206278,0,0,0,0,0,0
20150105.141419,2809.64,12,1206290,-10,0,0,0,0,0
20150105.14142,2809.64,2,1206292,0,0,0,0,0,0
20150105.141421,2809.64,124,1206416,-4,0,0,0,0,0
20150105.141422,2809.64,30,1206446,0,0,0,0,0,0
20150105.141423,2809.02,10,1206456,-6,0,0,0,0,0
20150105.141424,2809.02,2000,1208456,524,0,0,0,0,0
20150105.141425,2809.02,482,1208938,-2,0,0,0,0,0
20150105.141426,2809.02,66,1209004,2,0,0,0,0,0
20150105.141427,2808.39,40,1209044,-36,0,0,0,0,0
20150105.141428,2808.39,26,1209070,-20,0,0,0,0,0
20150105.141429,2809.02,60,1209130,-38,0,0,0,0,0
20150105.14143,2808.39,2000,1211130,-1342,0,0,0,0,0
20150105.141431,2808.39,2250,1213380,-1058,0,0,0,0,0
20150105.141432,2808.39,132,1213512,-104,0,0,0,0,0
20150105.141433,2807.77,2,1213514,0,0,0,0,0,0
20150105.141434,2808.39,36,1213550,-16,0,0,0,0,0
20150105.141435,2807.77,42,1213592,-22,0,0,0,0,0
20150105.141436,2808.39,108,1213700,-102,0,0,0,0,0
20150105.141437,2808.39,1064,1214764,-388,0,0,0,0,0
20150105.141438,2808.39,56,1214820,-34,0,0,0,0,0
20150105.141439,2808.39,14,1214834,-6,0,0,0,0,0
20150105.14144,2808.39,12,1214846,-4,0,0,0,0,0
20150105.141441,2808.39,14,1214860,4,0,0,0,0,0
20150105.141442,2808.39,14,1214874,2,0,0,0,0,0
20150105.141443,2808.39,2,1214876,2,0,0,0,0,0
20150105.141444,2808.39,8,1214884,4,0,0,0,0,0
20150105.141445,2808.39,632,1215516,358,0,0,0,0,0
20150105.141446,2808.39,4,1215520,2,0,0,0,0,0
20150105.141447,2809.01,694,1216214,-300,0,0,0,0,0
20150105.141448,2809.01,422,1216636,-192,0,0,0,0,0
20150105.141449,2808.39,4,1216640,0,0,0,0,0,0
20150105.14145,2809.01,2,1216642,0,0,0,0,0,0
20150105.141451,2808.39,8,1216650,-2,0,0,0,0,0
20150105.141452,2809.01,22,1216672,0,0,0,0,0,0
20150105.141453,2808.39,908,1217580,-786,0,0,0,0,0
20150105.141454,2808.39,110,1217690,18,0,0,0,0,0
20150105.141455,2808.39,458,1218148,-234,0,0,0,0,0
20150105.141456,2808.39,298,1218446,260,0,0,0,0,0
20150105.141457,2807.76,172,1218618,92,0,0,0,0,0
20150105.141458,2808.39,108,1218726,20,0,0,0,0,0
20150105.141459,2808.39,2,1218728,0,0,0,0,0,0
20150105.1415,2809.01,636,1219364,-168,0,0,0,0,0
20150105.141501,2809.01,448,1219812,-400,0,0,0,0,0
20150105.141502,2809.01,2,1219814,0,0,0,0,0,0
20150105.141503,2808.39,442,1220256,-6,0,0,0,0,0
20150105.141504,2808.39,8,1220264,0,0,0,0,0,0
20150105.141505,2808.39,2,1220266,-2,0,0,0,0,0
20150105.141506,2809.01,284,1220550,-154,0,0,0,0,0
20150105.141507,2809.01,42,1220592,-40,0,0,0,0,0
20150105.141508,2809.01,2,1220594,-2,0,0,0,0,0
20150105.141509,2809.01,686,1221280,-676,0,0,0,0,0
20150105.14151,2809.01,2,1221282,0,0,0,0,0,0
20150105.141511,2809.01,2,1221284,2,0,0,0,0,0
20150105.141512,2808.39,24,1221308,0,0,0,0,0,0
20150105.141513,2809.01,4,1221312,2,0,0,0,0,0
20150105.141514,2809.01,48,1221360,-6,0,0,0,0,0
20150105.141515,2809.01,4,1221364,0,0,0,0,0,0
20150105.141516,2809.01,20,1221384,0,0,0,0,0,0
20150105.141517,2809.01,84,1221468,-8,0,0,0,0,0
20150105.141518,2809.01,12,1221480,8,0,0,0,0,0
20150105.141519,2809.01,12,1221492,10,0,0,0,0,0
20150105.14152,2809.01,8,1221500,8,0,0,0,0,0
20150105.141521,2809.01,270,1221770,-122,0,0,0,0,0
20150105.141522,2809.01,2,1221772,0,0,0,0,0,0
20150105.141523,2809.01,1734,1223506,-1728,0,0,0,0,0
20150105.141524,2809.01,2,1223508,0,0,0,0,0,0
20150105.141525,2809.01,4,1223512,2,0,0,0,0,0
20150105.141526,2809.01,6,1223518,-2,0,0,0,0,0
20150105.141527,2809.01,6,1223524,0,0,0,0,0,0
20150105.141528,2809.01,130,1223654,0,0,0,0,0,0
20150105.141529,2809.01,2,1223656,0,0,0,0,0,0
20150105.14153,2809.01,2,1223658,-2,0,0,0,0,0
20150105.141531,2809.01,8,1223666,-6,0,0,0,0,0
20150105.141532,2809.01,4,1223670,-2,0,0,0,0,0
20150105.141533,2809.01,10,1223680,0,0,0,0,0,0
20150105.141534,2809.01,6,1223686,-6,0,0,0,0,0
20150105.141535,2809.63,26,1223712,2,0,0,0,0,0
20150105.141536,2809.01,2,1223714,-2,0,0,0,0,0
20150105.141537,2809.63,30,1223744,-8,0,0,0,0,0
20150105.141538,2809.01,2,1223746,0,0,0,0,0,0
20150105.141539,2809.01,2,1223748,0,0,0,0,0,0
20150105.14154,2809.63,20,1223768,-10,0,0,0,0,0
20150105.141541,2809.63,2,1223770,0,0,0,0,0,0
20150105.141542,2809.01,2,1223772,0,0,0,0,0,0
20150105.141543,2809.63,6,1223778,-2,0,0,0,0,0
20150105.141544,2809.63,20,1223798,-20,0,0,0,0,0
20150105.141545,2809.63,22,1223820,-20,0,0,0,0,0
20150105.141546,2809.63,2,1223822,-2,0,0,0,0,0
20150105.141547,2809.01,4,1223826,-2,0,0,0,0,0
20150105.141548,2809.63,100,1223926,34,0,0,0,0,0
20150105.141549,2809.63,20,1223946,0,0,0,0,0,0
20150105.14155,2809.63,2,1223948,0,0,0,0,0,0
20150105.141551,2809.63,16,1223964,-12,0,0,0,0,0
20150105.141552,2809.01,6,1223970,-6,0,0,0,0,0
20150105.141553,2809.01,2,1223972,0,0,0,0,0,0
20150105.141554,2809.63,8,1223980,0,0,0,0,0,0
20150105.141555,2809.01,2,1223982,0,0,0,0,0,0
20150105.141556,2809.63,10,1223992,0,0,0,0,0,0
20150105.141557,2809.63,2,1223994,0,0,0,0,0,0
20150105.141558,2809.01,2,1223996,0,0,0,0,0,0
20150105.141559,2809.63,412,1224408,196,0,0,0,0,0
20150105.1416,2809.63,36,1224444,-2,0,0,0,0,0
20150105.141601,2809.63,2,1224446,0,0,0,0,0,0
20150105.141602,2810.25,12,1224458,0,0,0,0,0,0
20150105.141603,2810.25,4,1224462,4,0,0,0,0,0
20150105.141604,2810.25,104,1224566,-40,0,0,0,0,0
20150105.141605,2809.63,324,1224890,-116,0,0,0,0,0
20150105.141606,2809.63,100,1224990,-2,0,0,0,0,0
20150105.141607,2810.25,10,1225000,8,0,0,0,0,0
20150105.141608,2810.25,8,1225008,6,0,0,0,0,0
20150105.141609,2809.63,360,1225368,-8,0,0,0,0,0
20150105.14161,2809.63,60,1225428,-32,0,0,0,0,0
20150105.141611,2809.63,50,1225478,50,0,0,0,0,0
20150105.141612,2809.63,120,1225598,0,0,0,0,0,0
20150105.141613,2809,292,1225890,-232,0,0,0,0,0
20150105.141614,2809.63,12,1225902,-8,0,0,0,0,0
20150105.141615,2809.63,4,1225906,0,0,0,0,0,0
20150105.141616,2809.63,8,1225914,-4,0,0,0,0,0
20150105.141617,2809.63,8,1225922,0,0,0,0,0,0
20150105.141618,2809.63,10,1225932,0,0,0,0,0,0
20150105.141619,2809.63,4,1225936,0,0,0,0,0,0
20150105.14162,2809.63,10,1225946,0,0,0,0,0,0
20150105.141621,2809.63,12,1225958,-2,0,0,0,0,0
20150105.141622,2809.63,10,1225968,0,0,0,0,0,0
20150105.141623,2809.63,8,1225976,-2,0,0,0,0,0
20150105.141624,2809.63,72,1226048,-66,0,0,0,0,0
20150105.141625,2809.63,66,1226114,0,0,0,0,0,0
20150105.141626,2809.63,192,1226306,0,0,0,0,0,0
20150105.141627,2809.63,2,1226308,2,0,0,0,0,0
20150105.141628,2809.63,112,1226420,0,0,0,0,0,0
20150105.141629,2809.63,4,1226424,2,0,0,0,0,0
20150105.14163,2810.25,12,1226436,10,0,0,0,0,0
20150105.141631,2809.63,86,1226522,86,0,0,0,0,0
20150105.141632,2809.63,160,1226682,-60,0,0,0,0,0
20150105.141633,2810.25,2,1226684,-2,0,0,0,0,0
20150105.141634,2809.63,8,1226692,0,0,0,0,0,0
20150105.141635,2809,2,1226694,0,0,0,0,0,0
20150105.141636,2809.63,32,1226726,-28,0,0,0,0,0
20150105.141637,2809.63,12,1226738,0,0,0,0,0,0
20150105.141638,2809.63,2,1226740,0,0,0,0,0,0
20150105.141639,2809.63,2,1226742,0,0,0,0,0,0
20150105.14164,2809.63,414,1227156,8,0,0,0,0,0
20150105.141641,2809.63,2,1227158,-2,0,0,0,0,0
20150105.141642,2809.63,130,1227288,0,0,0,0,0,0
20150105.141643,2809.63,2,1227290,0,0,0,0,0,0
20150105.141644,2809.63,4,1227294,0,0,0,0,0,0
20150105.141645,2809.63,300,1227594,-298,0,0,0,0,0
20150105.141646,2809.63,38,1227632,-2,0,0,0,0,0
20150105.141647,2809.63,6,1227638,0,0,0,0,0,0
20150105.141648,2809.63,4,1227642,0,0,0,0,0,0
20150105.141649,2809.63,70,1227712,-2,0,0,0,0,0
20150105.14165,2809.63,184,1227896,2,0,0,0,0,0
20150105.141651,2809.63,100,1227996,-100,0,0,0,0,0
20150105.141652,2809.63,14,1228010,0,0,0,0,0,0
20150105.141653,2809.63,2,1228012,0,0,0,0,0,0
20150105.141654,2809.63,4,1228016,-4,0,0,0,0,0
20150105.141655,2809.63,10,1228026,0,0,0,0,0,0
20150105.141656,2809.63,6,1228032,-2,0,0,0,0,0
20150105.141657,2809.63,6,1228038,0,0,0,0,0,0
20150105.141658,2809.63,2,1228040,0,0,0,0,0,0
20150105.141659,2809.63,2,1228042,0,0,0,0,0,0
20150105.1417,2809.63,2,1228044,0,0,0,0,0,0
20150105.141701,2809.63,2,1228046,-2,0,0,0,0,0
20150105.141702,2809.63,20,1228066,0,0,0,0,0,0
20150105.141703,2809.63,2,1228068,0,0,0,0,0,0
20150105.141704,2809.63,20,1228088,0,0,0,0,0,0
20150105.141705,2809.63,62,1228150,0,0,0,0,0,0
20150105.141706,2809.63,6,1228156,0,0,0,0,0,0
20150105.141707,2809.63,2,1228158,-2,0,0,0,0,0
20150105.141708,2809.63,12,1228170,-2,0,0,0,0,0
20150105.141709,2809.63,2,1228172,-2,0,0,0,0,0
20150105.14171,2809.63,2,1228174,0,0,0,0,0,0
20150105.141711,2809.63,4,1228178,-4,0,0,0,0,0
20150105.141712,2809.63,64,1228242,-64,0,0,0,0,0
20150105.141713,2809.63,4,1228246,-2,0,0,0,0,0
20150105.141714,2809.63,4,1228250,-4,0,0,0,0,0
20150105.141715,2809.63,2,1228252,0,0,0,0,0,0
20150105.141716,2809.63,4,1228256,0,0,0,0,0,0
20150105.141717,2809.63,196,1228452,8,0,0,0,0,0
20150105.141718,2810.25,2,1228454,-2,0,0,0,0,0
20150105.141719,2809,116,1228570,-8,0,0,0,0,0
20150105.14172,2809.63,182,1228752,-22,0,0,0,0,0
20150105.141721,2809,4,1228756,0,0,0,0,0,0
20150105.141722,2809.63,66,1228822,66,0,0,0,0,0
20150105.141723,2809.63,2,1228824,0,0,0,0,0,0
20150105.141724,2809.63,6,1228830,-2,0,0,0,0,0
20150105.141725,2809.63,2,1228832,0,0,0,0,0,0
20150105.141726,2809,10,1228842,-10,0,0,0,0,0
20150105.141727,2809.63,2,1228844,0,0,0,0,0,0
20150105.141728,2809.63,204,1229048,-92,0,0,0,0,0
20150105.141729,2809.63,4,1229052,4,0,0,0,0,0
20150105.14173,2809.63,212,1229264,202,0,0,0,0,0
20150105.141731,2809.63,4,1229268,0,0,0,0,0,0
20150105.141732,2809.63,4,1229272,0,0,0,0,0,0
20150105.141733,2809,140,1229412,-14,0,0,0,0,0
20150105.141734,2809,76,1229488,0,0,0,0,0,0
20150105.141735,2809.63,6,1229494,-6,0,0,0,0,0
20150105.141736,2809.63,102,1229596,-100,0,0,0,0,0
20150105.141737,2809.63,4,1229600,0,0,0,0,0,0
20150105.141738,2809.63,60,1229660,0,0,0,0,0,0
20150105.141739,2809,26,1229686,0,0,0,0,0,0
20150105.14174,2810.25,2,1229688,-2,0,0,0,0,0
20150105.141741,2809.63,32,1229720,26,0,0,0,0,0
20150105.141742,2809,154,1229874,-18,0,0,0,0,0
20150105.141743,2809,272,1230146,48,0,0,0,0,0
20150105.141744,2809,52,1230198,-22,0,0,0,0,0
20150105.141745,2809.63,10,1230208,0,0,0,0,0,0
20150105.141746,2809.63,2,1230210,-2,0,0,0,0,0
20150105.141747,2809.63,2,1230212,0,0,0,0,0,0
20150105.141748,2809.63,2,1230214,0,0,0,0,0,0
20150105.141749,2809.63,20,1230234,0,0,0,0,0,0
20150105.14175,2809.63,2,1230236,0,0,0,0,0,0
20150105.141751,2809.63,2,1230238,0,0,0,0,0,0
20150105.141752,2809,2,1230240,-2,0,0,0,0,0
20150105.141753,2809,2,1230242,-2,0,0,0,0,0
20150105.141754,2809.63,192,1230434,-114,0,0,0,0,0
20150105.141755,2809.63,64,1230498,-10,0,0,0,0,0
20150105.141756,2809.63,126,1230624,0,0,0,0,0,0
20150105.141757,2809,224,1230848,20,0,0,0,0,0
20150105.141758,2809,6,1230854,-6,0,0,0,0,0
20150105.141759,2809,4,1230858,-4,0,0,0,0,0
20150105.1418,2809,16,1230874,-8,0,0,0,0,0
20150105.141801,2809,10,1230884,0,0,0,0,0,0
20150105.141802,2809,16,1230900,0,0,0,0,0,0
20150105.141803,2809,30,1230930,-20,0,0,0,0,0
20150105.141804,2809.63,8,1230938,-2,0,0,0,0,0
20150105.141805,2809.63,4,1230942,0,0,0,0,0,0
20150105.141806,2809,4,1230946,0,0,0,0,0,0
20150105.141807,2809.63,8,1230954,8,0,0,0,0,0
20150105.141808,2809.63,24,1230978,24,0,0,0,0,0
20150105.141809,2809,6,1230984,0,0,0,0,0,0
20150105.14181,2809,4,1230988,2,0,0,0,0,0
20150105.141811,2810.25,10,1230998,0,0,0,0,0,0
20150105.141812,2809.63,10,1231008,10,0,0,0,0,0
20150105.141813,2809.63,8,1231016,0,0,0,0,0,0
20150105.141814,2809.63,126,1231142,116,0,0,0,0,0
20150105.141815,2809.63,2,1231144,2,0,0,0,0,0
20150105.141816,2809.63,6,1231150,0,0,0,0,0,0
20150105.141817,2809.63,28,1231178,2,0,0,0,0,0
20150105.141818,2809.63,20,1231198,-20,0,0,0,0,0
20150105.141819,2810.25,4,1231202,0,0,0,0,0,0
20150105.14182,2809.63,12,1231214,8,0,0,0,0,0
20150105.141821,2809.63,2,1231216,2,0,0,0,0,0
20150105.141822,2809.63,2,1231218,0,0,0,0,0,0
20150105.141823,2810.25,4,1231222,2,0,0,0,0,0
20150105.141824,2809.63,2,1231224,2,0,0,0,0,0
20150105.141825,2810.25,2,1231226,-2,0,0,0,0,0
20150105.141826,2810.25,14,1231240,8,0,0,0,0,0
20150105.141827,2809.63,6,1231246,2,0,0,0,0,0
20150105.141828,2810.25,2,1231248,2,0,0,0,0,0
20150105.141829,2810.25,6,1231254,0,0,0,0,0,0
20150105.14183,2809.63,30,1231284,28,0,0,0,0,0
20150105.141831,2809.63,12,1231296,-2,0,0,0,0,0
20150105.141832,2809.63,6,1231302,2,0,0,0,0,0
20150105.141833,2809.63,2,1231304,2,0,0,0,0,0
20150105.141834,2809.63,12,1231316,12,0,0,0,0,0
20150105.141835,2810.25,2,1231318,0,0,0,0,0,0
20150105.141836,2810.25,2,1231320,2,0,0,0,0,0
20150105.141837,2809.63,2,1231322,2,0,0,0,0,0
20150105.141838,2810.25,2,1231324,0,0,0,0,0,0
20150105.141839,2809.63,400,1231724,-64,0,0,0,0,0
20150105.14184,2809.63,4,1231728,-2,0,0,0,0,0
20150105.141841,2809.63,4,1231732,0,0,0,0,0,0
20150105.141842,2809.63,8,1231740,4,0,0,0,0,0
20150105.141843,2809.63,2,1231742,-2,0,0,0,0,0
20150105.141844,2809.63,2,1231744,-2,0,0,0,0,0
20150105.141845,2810.25,2,1231746,0,0,0,0,0,0
20150105.141846,2809.63,2,1231748,0,0,0,0,0,0
20150105.141847,2809.63,8,1231756,0,0,0,0,0,0
20150105.141848,2809.63,28,1231784,-20,0,0,0,0,0
20150105.141849,2810.25,20,1231804,20,0,0,0,0,0
20150105.14185,2810.25,240,1232044,-180,0,0,0,0,0
20150105.141851,2809.63,2,1232046,0,0,0,0,0,0
20150105.141852,2810.25,12,1232058,-12,0,0,0,0,0
20150105.141853,2809.63,2,1232060,0,0,0,0,0,0
20150105.141854,2810.25,2,1232062,0,0,0,0,0,0
20150105.141855,2810.25,4,1232066,-4,0,0,0,0,0
20150105.141856,2810.25,2,1232068,0,0,0,0,0,0
20150105.141857,2810.25,2,1232070,0,0,0,0,0,0
20150105.141858,2809.63,2,1232072,-2,0,0,0,0,0
20150105.141859,2810.25,2,1232074,0,0,0,0,0,0
20150105.1419,2809.63,400,1232474,136,0,0,0,0,0
20150105.141901,2810.25,2,1232476,0,0,0,0,0,0
20150105.141902,2810.25,2,1232478,0,0,0,0,0,0
20150105.141903,2809.63,18,1232496,16,0,0,0,0,0
20150105.141904,2809.63,2,1232498,0,0,0,0,0,0
20150105.141905,2809.63,16,1232514,-14,0,0,0,0,0
20150105.141906,2809.63,206,1232720,-192,0,0,0,0,0
20150105.141907,2809.63,232,1232952,-222,0,0,0,0,0
20150105.141908,2809.63,4,1232956,0,0,0,0,0,0
20150105.141909,2809.63,8,1232964,-4,0,0,0,0,0
20150105.14191,2809.63,2,1232966,0,0,0,0,0,0
20150105.141911,2809.63,108,1233074,-98,0,0,0,0,0
20150105.141912,2809.63,104,1233178,0,0,0,0,0,0
20150105.141913,2809.63,60,1233238,4,0,0,0,0,0
20150105.141914,2809.63,44,1233282,0,0,0,0,0,0
20150105.141915,2809.63,2,1233284,-2,0,0,0,0,0
20150105.141916,2810.25,2,1233286,0,0,0,0,0,0
20150105.141917,2809.63,4,1233290,4,0,0,0,0,0
20150105.141918,2809.63,2,1233292,2,0,0,0,0,0
20150105.141919,2810.25,10,1233302,0,0,0,0,0,0
20150105.14192,2809.63,6,1233308,6,0,0,0,0,0
20150105.141921,2809.63,32,1233340,20,0,0,0,0,0
20150105.141922,2809.63,2,1233342,0,0,0,0,0,0
20150105.141923,2809.63,2,1233344,0,0,0,0,0,0
20150105.141924,2809.63,2,1233346,0,0,0,0,0,0
20150105.141925,2810.25,2,1233348,-2,0,0,0,0,0
20150105.141926,2809.63,6,1233354,0,0,0,0,0,0
20150105.141927,2810.25,4,1233358,0,0,0,0,0,0
20150105.141928,2809.63,2,1233360,0,0,0,0,0,0
20150105.141929,2809.63,4,1233364,2,0,0,0,0,0
20150105.14193,2809.63,4,1233368,0,0,0,0,0,0
20150105.141931,2809.63,12,1233380,6,0,0,0,0,0
20150105.141932,2810.25,2,1233382,-2,0,0,0,0,0
20150105.141933,2809.63,4,1233386,4,0,0,0,0,0
20150105.141934,2809.63,26,1233412,0,0,0,0,0,0
20150105.141935,2810.25,2,1233414,0,0,0,0,0,0
20150105.141936,2810.25,10,1233424,0,0,0,0,0,0
20150105.141937,2809.63,202,1233626,38,0,0,0,0,0
20150105.141938,2810.25,6,1233632,2,0,0,0,0,0
20150105.141939,2809.63,226,1233858,176,0,0,0,0,0
20150105.14194,2809.63,4,1233862,2,0,0,0,0,0
20150105.141941,2809.63,6,1233868,0,0,0,0,0,0
20150105.141942,2809.63,2,1233870,0,0,0,0,0,0
20150105.141943,2809.63,2,1233872,0,0,0,0,0,0
20150105.141944,2809.63,466,1234338,224,0,0,0,0,0
20150105.141945,2809.63,8,1234346,-8,0,0,0,0,0
20150105.141946,2809,36,1234382,-34,0,0,0,0,0
20150105.141947,2809,400,1234782,-92,0,0,0,0,0
20150105.141948,2809.63,496,1235278,-264,0,0,0,0,0
20150105.141949,2809,106,1235384,-42,0,0,0,0,0
20150105.14195,2809.63,4,1235388,0,0,0,0,0,0
20150105.141951,2809,400,1235788,-224,0,0,0,0,0
20150105.141952,2809.63,2,1235790,2,0,0,0,0,0
20150105.141953,2809,420,1236210,-2,0,0,0,0,0
20150105.141954,2809,10,1236220,10,0,0,0,0,0
20150105.141955,2809.63,252,1236472,-162,0,0,0,0,0
20150105.141956,2809,102,1236574,12,0,0,0,0,0
20150105.141957,2809,6,1236580,0,0,0,0,0,0
20150105.141958,2809,36,1236616,-32,0,0,0,0,0
20150105.141959,2809,2,1236618,0,0,0,0,0,0
20150105.142,2809,2,1236620,0,0,0,0,0,0
20150105.142001,2809,18,1236638,0,0,0,0,0,0
20150105.142002,2809,10,1236648,-10,0,0,0,0,0
20150105.142003,2809,2,1236650,0,0,0,0,0,0
20150105.142004,2809,2,1236652,0,0,0,0,0,0
20150105.142005,2809,4,1236656,-2,0,0,0,0,0
20150105.142006,2809,2,1236658,0,0,0,0,0,0
20150105.142007,2809,6,1236664,-2,0,0,0,0,0
20150105.142008,2809,252,1236916,184,0,0,0,0,0
20150105.142009,2809,6,1236922,0,0,0,0,0,0
20150105.14201,2809,2,1236924,2,0,0,0,0,0
20150105.142011,2809,2,1236926,2,0,0,0,0,0
20150105.142012,2807.76,1620,1238546,-626,0,0,0,0,0
20150105.142013,2808.38,86,1238632,-56,0,0,0,0,0
20150105.142014,2808.38,34,1238666,-4,0,0,0,0,0
20150105.142015,2808.38,116,1238782,40,0,0,0,0,0
20150105.142016,2808.38,8,1238790,8,0,0,0,0,0
20150105.142017,2807.76,4,1238794,-4,0,0,0,0,0
20150105.142018,2807.76,2,1238796,-2,0,0,0,0,0
20150105.142019,2807.76,12,1238808,-4,0,0,0,0,0
20150105.14202,2807.76,12,1238820,-8,0,0,0,0,0
20150105.142021,2808.38,6,1238826,6,0,0,0,0,0
20150105.142022,2808.38,4,1238830,4,0,0,0,0,0
20150105.142023,2808.38,4,1238834,4,0,0,0,0,0
20150105.142024,2807.76,4,1238838,-4,0,0,0,0,0
20150105.142025,2808.38,8,1238846,6,0,0,0,0,0
20150105.142026,2808.38,14,1238860,6,0,0,0,0,0
20150105.142027,2808.38,4,1238864,0,0,0,0,0,0
20150105.142028,2808.38,50,1238914,50,0,0,0,0,0
20150105.142029,2808.38,4,1238918,2,0,0,0,0,0
20150105.14203,2807.75,2488,1241406,-670,0,0,0,0,0
20150105.142031,2808.38,804,1242210,-134,0,0,0,0,0
20150105.142032,2808.38,104,1242314,-4,0,0,0,0,0
20150105.142033,2808.38,30,1242344,-30,0,0,0,0,0
20150105.142034,2808.38,1440,1243784,0,0,0,0,0,0
20150105.142035,2808.38,2,1243786,2,0,0,0,0,0
20150105.142036,2807.75,530,1244316,242,0,0,0,0,0
20150105.142037,2807.75,28,1244344,4,0,0,0,0,0
20150105.142038,2808.38,4,1244348,-2,0,0,0,0,0
20150105.142039,2807.75,2,1244350,-2,0,0,0,0,0
20150105.14204,2807.75,24,1244374,-12,0,0,0,0,0
20150105.142041,2807.75,16,1244390,4,0,0,0,0,0
20150105.142042,2807.75,2,1244392,2,0,0,0,0,0
20150105.142043,2807.75,6,1244398,4,0,0,0,0,0
20150105.142044,2807.75,88,1244486,-64,0,0,0,0,0
20150105.142045,2807.75,4,1244490,4,0,0,0,0,0
20150105.142046,2807.75,4,1244494,2,0,0,0,0,0
20150105.142047,2807.75,2,1244496,2,0,0,0,0,0
20150105.142048,2807.75,20,1244516,0,0,0,0,0,0
20150105.142049,2808.38,4,1244520,0,0,0,0,0,0
20150105.14205,2808.38,12,1244532,2,0,0,0,0,0
20150105.142051,2808.38,2,1244534,0,0,0,0,0,0
20150105.142052,2807.75,8,1244542,4,0,0,0,0,0
20150105.142053,2807.75,78,1244620,60,0,0,0,0,0
20150105.142054,2808.38,2,1244622,-2,0,0,0,0,0
20150105.142055,2807.76,618,1245240,304,0,0,0,0,0
20150105.142056,2807.76,2,1245242,2,0,0,0,0,0
20150105.142057,2807.76,2,1245244,2,0,0,0,0,0
20150105.142058,2807.76,124,1245368,74,0,0,0,0,0
20150105.142059,2807.13,124,1245492,86,0,0,0,0,0
20150105.1421,2807.13,42,1245534,14,0,0,0,0,0
20150105.142101,2807.76,334,1245868,212,0,0,0,0,0
20150105.142102,2807.13,6,1245874,-2,0,0,0,0,0
20150105.142103,2807.13,10,1245884,-6,0,0,0,0,0
20150105.142104,2807.76,8,1245892,2,0,0,0,0,0
20150105.142105,2807.76,6,1245898,4,0,0,0,0,0
20150105.142106,2807.13,10,1245908,6,0,0,0,0,0
20150105.142107,2807.76,46,1245954,-6,0,0,0,0,0
20150105.142108,2807.76,6,1245960,6,0,0,0,0,0
20150105.142109,2807.76,2,1245962,0,0,0,0,0,0
20150105.14211,2807.76,2,1245964,2,0,0,0,0,0
20150105.142111,2807.76,4,1245968,2,0,0,0,0,0
20150105.142112,2807.76,4,1245972,4,0,0,0,0,0
20150105.142113,2807.76,194,1246166,190,0,0,0,0,0
20150105.142114,2807.13,126,1246292,122,0,0,0,0,0
20150105.142115,2807.76,34,1246326,10,0,0,0,0,0
20150105.142116,2807.13,2,1246328,0,0,0,0,0,0
20150105.142117,2807.13,2,1246330,0,0,0,0,0,0
20150105.142118,2807.13,8,1246338,4,0,0,0,0,0
20150105.142119,2807.13,40,1246378,0,0,0,0,0,0
20150105.14212,2807.76,16,1246394,14,0,0,0,0,0
20150105.142121,2807.13,104,1246498,12,0,0,0,0,0
20150105.142122,2807.76,54,1246552,-30,0,0,0,0,0
20150105.142123,2807.76,6,1246558,0,0,0,0,0,0
20150105.142124,2807.76,4,1246562,4,0,0,0,0,0
20150105.142125,2807.76,20,1246582,20,0,0,0,0,0
20150105.142126,2807.76,20,1246602,8,0,0,0,0,0
20150105.142127,2807.13,36,1246638,-32,0,0,0,0,0
20150105.142128,2807.76,10,1246648,10,0,0,0,0,0
20150105.142129,2807.76,106,1246754,98,0,0,0,0,0
20150105.14213,2807.76,16,1246770,0,0,0,0,0,0
20150105.142131,2807.76,4,1246774,0,0,0,0,0,0
20150105.142132,2807.76,6,1246780,6,0,0,0,0,0
20150105.142133,2807.76,4,1246784,-2,0,0,0,0,0
20150105.142134,2807.76,6,1246790,2,0,0,0,0,0
20150105.142135,2807.13,410,1247200,-384,0,0,0,0,0
20150105.142136,2807.76,1060,1248260,924,0,0,0,0,0
20150105.142137,2807.76,458,1248718,180,0,0,0,0,0
20150105.142138,2807.76,404,1249122,218,0,0,0,0,0
20150105.142139,2807.76,14,1249136,12,0,0,0,0,0
20150105.14214,2807.76,112,1249248,78,0,0,0,0,0
20150105.142141,2807.76,202,1249450,200,0,0,0,0,0
20150105.142142,2807.76,304,1249754,-60,0,0,0,0,0
20150105.142143,2807.76,262,1250016,260,0,0,0,0,0
20150105.142144,2807.76,146,1250162,74,0,0,0,0,0
20150105.142145,2807.76,244,1250406,228,0,0,0,0,0
20150105.142146,2807.76,140,1250546,16,0,0,0,0,0
20150105.142147,2807.76,176,1250722,162,0,0,0,0,0
20150105.142148,2807.76,144,1250866,8,0,0,0,0,0
20150105.142149,2807.76,24,1250890,4,0,0,0,0,0
20150105.14215,2807.76,14,1250904,12,0,0,0,0,0
20150105.142151,2807.76,2,1250906,2,0,0,0,0,0
20150105.142152,2807.76,4,1250910,0,0,0,0,0,0
20150105.142153,2807.76,4,1250914,4,0,0,0,0,0
20150105.142154,2807.76,8,1250922,6,0,0,0,0,0
20150105.142155,2807.76,8,1250930,8,0,0,0,0,0
20150105.142156,2807.76,10,1250940,6,0,0,0,0,0
20150105.142157,2807.76,2,1250942,2,0,0,0,0,0
20150105.142158,2807.76,12,1250954,12,0,0,0,0,0
20150105.142159,2807.76,4,1250958,4,0,0,0,0,0
20150105.1422,2807.14,6,1250964,6,0,0,0,0,0
20150105.142201,2807.76,12,1250976,2,0,0,0,0,0
20150105.142202,2807.76,4,1250980,4,0,0,0,0,0
20150105.142203,2807.76,66,1251046,14,0,0,0,0,0
20150105.142204,2807.14,366,1251412,182,0,0,0,0,0
20150105.142205,2807.76,286,1251698,4,0,0,0,0,0
20150105.142206,2807.76,602,1252300,490,0,0,0,0,0
20150105.142207,2807.76,14,1252314,-4,0,0,0,0,0
20150105.142208,2807.76,204,1252518,-192,0,0,0,0,0
20150105.142209,2807.76,130,1252648,-64,0,0,0,0,0
20150105.14221,2807.76,8,1252656,2,0,0,0,0,0
20150105.142211,2807.76,24,1252680,24,0,0,0,0,0
20150105.142212,2807.76,22,1252702,2,0,0,0,0,0
20150105.142213,2807.76,4,1252706,2,0,0,0,0,0
20150105.142214,2807.76,4,1252710,4,0,0,0,0,0
20150105.142215,2807.76,34,1252744,34,0,0,0,0,0
20150105.142216,2807.76,22,1252766,8,0,0,0,0,0
20150105.142217,2807.76,30,1252796,4,0,0,0,0,0
20150105.142218,2807.76,10,1252806,8,0,0,0,0,0
20150105.142219,2807.76,6,1252812,6,0,0,0,0,0
20150105.14222,2807.76,18,1252830,18,0,0,0,0,0
20150105.142221,2807.76,18,1252848,6,0,0,0,0,0
20150105.142222,2807.76,2,1252850,2,0,0,0,0,0
20150105.142223,2807.76,4,1252854,2,0,0,0,0,0
20150105.142224,2807.76,6,1252860,4,0,0,0,0,0
20150105.142225,2807.76,46,1252906,46,0,0,0,0,0
20150105.142226,2807.76,8,1252914,0,0,0,0,0,0
20150105.142227,2807.76,4,1252918,2,0,0,0,0,0
20150105.142228,2807.76,2,1252920,2,0,0,0,0,0
20150105.142229,2807.76,2,1252922,2,0,0,0,0,0
20150105.14223,2807.76,8,1252930,6,0,0,0,0,0
20150105.142231,2807.76,2,1252932,2,0,0,0,0,0
20150105.142232,2807.76,6,1252938,6,0,0,0,0,0
20150105.142233,2807.76,2,1252940,2,0,0,0,0,0
20150105.142234,2807.76,8,1252948,8,0,0,0,0,0
20150105.142235,2807.76,80,1253028,80,0,0,0,0,0
20150105.142236,2807.76,2,1253030,2,0,0,0,0,0
20150105.142237,2807.76,12,1253042,2,0,0,0,0,0
20150105.142238,2807.76,32,1253074,32,0,0,0,0,0
20150105.142239,2807.76,4,1253078,4,0,0,0,0,0
20150105.14224,2807.76,4,1253082,0,0,0,0,0,0
20150105.142241,2807.76,12,1253094,4,0,0,0,0,0
20150105.142242,2807.76,2,1253096,0,0,0,0,0,0
20150105.142243,2807.76,20,1253116,0,0,0,0,0,0
20150105.142244,2807.76,6,1253122,4,0,0,0,0,0
20150105.142245,2807.76,18,1253140,18,0,0,0,0,0
20150105.142246,2807.76,4,1253144,2,0,0,0,0,0
20150105.142247,2807.76,166,1253310,166,0,0,0,0,0
20150105.142248,2807.14,110,1253420,100,0,0,0,0,0
20150105.142249,2807.76,2,1253422,2,0,0,0,0,0
20150105.14225,2807.76,4,1253426,4,0,0,0,0,0
20150105.142251,2807.14,2,1253428,2,0,0,0,0,0
20150105.142252,2807.76,2,1253430,2,0,0,0,0,0
20150105.142253,2807.76,92,1253522,2,0,0,0,0,0
20150105.142254,2807.76,4,1253526,2,0,0,0,0,0
20150105.142255,2807.76,42,1253568,42,0,0,0,0,0
20150105.142256,2807.76,10,1253578,10,0,0,0,0,0
20150105.142257,2807.76,126,1253704,50,0,0,0,0,0
20150105.142258,2807.76,6,1253710,6,0,0,0,0,0
20150105.142259,2807.76,20,1253730,0,0,0,0,0,0
20150105.1423,2807.76,18,1253748,12,0,0,0,0,0
20150105.142301,2807.76,426,1254174,-20,0,0,0,0,0
20150105.142302,2807.76,2,1254176,-2,0,0,0,0,0
20150105.142303,2808.38,2,1254178,-2,0,0,0,0,0
20150105.142304,2807.76,266,1254444,24,0,0,0,0,0
20150105.142305,2807.76,16,1254460,-2,0,0,0,0,0
20150105.142306,2807.76,16,1254476,0,0,0,0,0,0
20150105.142307,2807.76,102,1254578,0,0,0,0,0,0
20150105.142308,2807.76,18,1254596,0,0,0,0,0,0
20150105.142309,2807.76,46,1254642,24,0,0,0,0,0
20150105.14231,2807.76,10,1254652,10,0,0,0,0,0
20150105.142311,2808.38,2,1254654,-2,0,0,0,0,0
20150105.142312,2808.38,2,1254656,0,0,0,0,0,0
20150105.142313,2807.76,286,1254942,270,0,0,0,0,0
20150105.142314,2807.76,16,1254958,16,0,0,0,0,0
20150105.142315,2807.76,4,1254962,2,0,0,0,0,0
20150105.142316,2807.76,8,1254970,6,0,0,0,0,0
20150105.142317,2807.76,2,1254972,2,0,0,0,0,0
20150105.142318,2807.76,6,1254978,6,0,0,0,0,0
20150105.142319,2807.76,44,1255022,14,0,0,0,0,0
20150105.14232,2807.76,2,1255024,2,0,0,0,0,0
20150105.142321,2807.76,10,1255034,10,0,0,0,0,0
20150105.142322,2807.76,14,1255048,12,0,0,0,0,0
20150105.142323,2807.76,2,1255050,2,0,0,0,0,0
20150105.142324,2807.76,2,1255052,0,0,0,0,0,0
20150105.142325,2807.76,6,1255058,6,0,0,0,0,0
20150105.142326,2807.76,20,1255078,0,0,0,0,0,0
20150105.142327,2807.14,4,1255082,4,0,0,0,0,0
20150105.142328,2807.76,150,1255232,104,0,0,0,0,0
20150105.142329,2807.14,10,1255242,0,0,0,0,0,0
20150105.14233,2807.76,24,1255266,20,0,0,0,0,0
20150105.142331,2807.76,6,1255272,4,0,0,0,0,0
20150105.142332,2807.76,6,1255278,6,0,0,0,0,0
20150105.142333,2807.76,26,1255304,6,0,0,0,0,0
20150105.142334,2807.76,22,1255326,22,0,0,0,0,0
20150105.142335,2807.14,12,1255338,8,0,0,0,0,0
20150105.142336,2807.14,6,1255344,4,0,0,0,0,0
20150105.142337,2807.76,2,1255346,0,0,0,0,0,0
20150105.142338,2807.76,2,1255348,2,0,0,0,0,0
20150105.142339,2807.76,2,1255350,2,0,0,0,0,0
20150105.14234,2807.76,4,1255354,4,0,0,0,0,0
20150105.142341,2807.76,120,1255474,20,0,0,0,0,0
20150105.142342,2807.76,12,1255486,12,0,0,0,0,0
20150105.142343,2807.76,12,1255498,0,0,0,0,0,0
20150105.142344,2807.76,18,1255516,18,0,0,0,0,0
20150105.142345,2807.76,22,1255538,22,0,0,0,0,0
20150105.142346,2807.76,4,1255542,2,0,0,0,0,0
20150105.142347,2807.14,4,1255546,2,0,0,0,0,0
20150105.142348,2807.14,2,1255548,2,0,0,0,0,0
20150105.142349,2807.14,40,1255588,40,0,0,0,0,0
20150105.14235,2807.76,4,1255592,0,0,0,0,0,0
20150105.142351,2807.76,18,1255610,18,0,0,0,0,0
20150105.142352,2807.76,22,1255632,20,0,0,0,0,0
20150105.142353,2807.76,2,1255634,2,0,0,0,0,0
20150105.142354,2807.76,2,1255636,2,0,0,0,0,0
20150105.142355,2807.14,32,1255668,28,0,0,0,0,0
20150105.142356,2807.76,10,1255678,10,0,0,0,0,0
20150105.142357,2807.14,20,1255698,20,0,0,0,0,0
20150105.142358,2807.14,2,1255700,2,0,0,0,0,0
20150105.142359,2807.76,18,1255718,2,0,0,0,0,0
20150105.1424,2807.76,4,1255722,2,0,0,0,0,0
20150105.142401,2807.76,2,1255724,2,0,0,0,0,0
20150105.142402,2807.14,2,1255726,0,0,0,0,0,0
20150105.142403,2807.76,64,1255790,4,0,0,0,0,0
20150105.142404,2807.76,16,1255806,12,0,0,0,0,0
20150105.142405,2807.76,34,1255840,10,0,0,0,0,0
20150105.142406,2807.76,2,1255842,2,0,0,0,0,0
20150105.142407,2807.76,2,1255844,0,0,0,0,0,0
20150105.142408,2807.76,10,1255854,10,0,0,0,0,0
20150105.142409,2807.76,6,1255860,6,0,0,0,0,0
20150105.14241,2807.14,2,1255862,0,0,0,0,0,0
20150105.142411,2807.14,40,1255902,40,0,0,0,0,0
20150105.142412,2807.76,4,1255906,2,0,0,0,0,0
20150105.142413,2807.76,2,1255908,2,0,0,0,0,0
20150105.142414,2807.76,6,1255914,6,0,0,0,0,0
20150105.142415,2807.76,80,1255994,20,0,0,0,0,0
20150105.142416,2807.14,76,1256070,74,0,0,0,0,0
20150105.142417,2807.14,2,1256072,2,0,0,0,0,0
20150105.142418,2807.76,10,1256082,10,0,0,0,0,0
20150105.142419,2807.76,10,1256092,10,0,0,0,0,0
20150105.14242,2807.76,4,1256096,4,0,0,0,0,0
20150105.142421,2807.76,12,1256108,2,0,0,0,0,0
20150105.142422,2807.76,54,1256162,44,0,0,0,0,0
20150105.142423,2807.76,8,1256170,8,0,0,0,0,0
20150105.142424,2807.76,6,1256176,6,0,0,0,0,0
20150105.142425,2807.76,12,1256188,12,0,0,0,0,0
20150105.142426,2807.76,946,1257134,-158,0,0,0,0,0
20150105.142427,2808.39,4,1257138,0,0,0,0,0,0
20150105.142428,2808.39,2,1257140,0,0,0,0,0,0
20150105.142429,2807.76,2,1257142,2,0,0,0,0,0
20150105.14243,2807.76,90,1257232,90,0,0,0,0,0
20150105.142431,2807.76,26,1257258,20,0,0,0,0,0
20150105.142432,2807.76,4,1257262,0,0,0,0,0,0
20150105.142433,2807.14,404,1257666,-398,0,0,0,0,0
20150105.142434,2807.14,2,1257668,2,0,0,0,0,0
20150105.142435,2807.76,14,1257682,-12,0,0,0,0,0
20150105.142436,2807.76,4,1257686,-2,0,0,0,0,0
20150105.142437,2807.76,4,1257690,-2,0,0,0,0,0
20150105.142438,2807.76,2,1257692,0,0,0,0,0,0
20150105.142439,2807.76,18,1257710,6,0,0,0,0,0
20150105.14244,2807.14,6,1257716,4,0,0,0,0,0
20150105.142441,2807.76,6,1257722,0,0,0,0,0,0
20150105.142442,2807.76,2,1257724,-2,0,0,0,0,0
20150105.142443,2807.76,6,1257730,-4,0,0,0,0,0
20150105.142444,2807.14,8,1257738,-6,0,0,0,0,0
20150105.142445,2807.76,84,1257822,-4,0,0,0,0,0
20150105.142446,2807.76,2,1257824,2,0,0,0,0,0
20150105.142447,2807.76,10,1257834,10,0,0,0,0,0
20150105.142448,2807.76,8,1257842,6,0,0,0,0,0
20150105.142449,2807.76,14,1257856,14,0,0,0,0,0
20150105.14245,2807.76,2,1257858,0,0,0,0,0,0
20150105.142451,2807.76,4,1257862,2,0,0,0,0,0
20150105.142452,2807.76,18,1257880,14,0,0,0,0,0
20150105.142453,2807.14,2,1257882,2,0,0,0,0,0
20150105.142454,2807.76,28,1257910,8,0,0,0,0,0
20150105.142455,2807.14,4,1257914,4,0,0,0,0,0
20150105.142456,2807.76,22,1257936,20,0,0,0,0,0
20150105.142457,2807.76,4,1257940,-2,0,0,0,0,0
20150105.142458,2807.76,4,1257944,0,0,0,0,0,0
20150105.142459,2807.14,2,1257946,2,0,0,0,0,0
20150105.1425,2807.76,22,1257968,-20,0,0,0,0,0
20150105.142501,2807.76,172,1258140,-90,0,0,0,0,0
20150105.142502,2807.76,48,1258188,0,0,0,0,0,0
20150105.142503,2807.76,12,1258200,0,0,0,0,0,0
20150105.142504,2807.76,2,1258202,0,0,0,0,0,0
20150105.142505,2807.76,40,1258242,26,0,0,0,0,0
20150105.142506,2807.76,212,1258454,146,0,0,0,0,0
20150105.142507,2807.76,144,1258598,140,0,0,0,0,0
20150105.142508,2807.76,90,1258688,30,0,0,0,0,0
20150105.142509,2807.76,160,1258848,-160,0,0,0,0,0
20150105.14251,2807.76,74,1258922,-70,0,0,0,0,0
20150105.142511,2807.76,10,1258932,0,0,0,0,0,0
20150105.142512,2807.76,2,1258934,2,0,0,0,0,0
20150105.142513,2807.76,4,1258938,0,0,0,0,0,0
20150105.142514,2807.14,30,1258968,0,0,0,0,0,0
20150105.142515,2807.76,2,1258970,2,0,0,0,0,0
20150105.142516,2808.39,24,1258994,-2,0,0,0,0,0
20150105.142517,2807.76,42,1259036,0,0,0,0,0,0
20150105.142518,2807.76,2,1259038,0,0,0,0,0,0
20150105.142519,2807.14,424,1259462,-20,0,0,0,0,0
20150105.14252,2807.76,16,1259478,-4,0,0,0,0,0
20150105.142521,2807.76,88,1259566,2,0,0,0,0,0
20150105.142522,2808.39,30,1259596,-30,0,0,0,0,0
20150105.142523,2807.76,4,1259600,-2,0,0,0,0,0
20150105.142524,2807.76,4,1259604,-2,0,0,0,0,0
20150105.142525,2808.39,2,1259606,-2,0,0,0,0,0
20150105.142526,2807.76,2,1259608,0,0,0,0,0,0
20150105.142527,2807.76,8,1259616,-8,0,0,0,0,0
20150105.142528,2807.76,4,1259620,0,0,0,0,0,0
20150105.142529,2807.76,2,1259622,-2,0,0,0,0,0
20150105.14253,2807.76,2,1259624,2,0,0,0,0,0
20150105.142531,2807.76,12,1259636,10,0,0,0,0,0
20150105.142532,2807.76,22,1259658,22,0,0,0,0,0
20150105.142533,2807.76,2,1259660,2,0,0,0,0,0
20150105.142534,2808.39,2,1259662,0,0,0,0,0,0
20150105.142535,2808.39,2,1259664,0,0,0,0,0,0
20150105.142536,2807.76,14,1259678,14,0,0,0,0,0
20150105.142537,2807.76,8,1259686,8,0,0,0,0,0
20150105.142538,2807.76,2,1259688,2,0,0,0,0,0
20150105.142539,2808.39,2,1259690,0,0,0,0,0,0
20150105.14254,2807.76,2,1259692,2,0,0,0,0,0
20150105.142541,2807.76,2,1259694,2,0,0,0,0,0
20150105.142542,2807.76,6,1259700,6,0,0,0,0,0
20150105.142543,2808.39,766,1260466,-272,0,0,0,0,0
20150105.142544,2808.39,102,1260568,0,0,0,0,0,0
20150105.142545,2808.39,90,1260658,-60,0,0,0,0,0
20150105.142546,2808.39,20,1260678,0,0,0,0,0,0
20150105.142547,2808.39,28,1260706,24,0,0,0,0,0
20150105.142548,2808.39,2,1260708,0,0,0,0,0,0
20150105.142549,2808.39,2,1260710,0,0,0,0,0,0
20150105.14255,2808.39,10,1260720,0,0,0,0,0,0
20150105.142551,2808.39,180,1260900,180,0,0,0,0,0
20150105.142552,2808.39,202,1261102,144,0,0,0,0,0
20150105.142553,2807.76,6,1261108,0,0,0,0,0,0
20150105.142554,2808.39,2,1261110,-2,0,0,0,0,0
20150105.142555,2808.39,8,1261118,6,0,0,0,0,0
20150105.142556,2807.76,6,1261124,6,0,0,0,0,0
20150105.142557,2807.76,12,1261136,2,0,0,0,0,0
20150105.142558,2807.76,72,1261208,72,0,0,0,0,0
20150105.142559,2807.76,2,1261210,2,0,0,0,0,0
20150105.1426,2808.39,4,1261214,4,0,0,0,0,0
20150105.142601,2808.39,6,1261220,0,0,0,0,0,0
20150105.142602,2807.76,2,1261222,2,0,0,0,0,0
20150105.142603,2807.76,10,1261232,10,0,0,0,0,0
20150105.142604,2807.76,200,1261432,196,0,0,0,0,0
20150105.142605,2807.76,2,1261434,2,0,0,0,0,0
20150105.142606,2807.76,584,1262018,302,0,0,0,0,0
20150105.142607,2807.76,4,1262022,2,0,0,0,0,0
20150105.142608,2807.76,132,1262154,22,0,0,0,0,0
20150105.142609,2807.76,44,1262198,4,0,0,0,0,0
20150105.14261,2807.76,322,1262520,318,0,0,0,0,0
20150105.142611,2807.76,20,1262540,10,0,0,0,0,0
20150105.142612,2807.76,4,1262544,2,0,0,0,0,0
20150105.142613,2807.76,200,1262744,120,0,0,0,0,0
20150105.142614,2807.76,82,1262826,0,0,0,0,0,0
20150105.142615,2808.39,2,1262828,0,0,0,0,0,0
20150105.142616,2807.76,2,1262830,0,0,0,0,0,0
20150105.142617,2807.76,80,1262910,70,0,0,0,0,0
20150105.142618,2807.76,6,1262916,6,0,0,0,0,0
20150105.142619,2807.76,26,1262942,24,0,0,0,0,0
20150105.14262,2807.76,12,1262954,4,0,0,0,0,0
20150105.142621,2808.39,4,1262958,4,0,0,0,0,0
20150105.142622,2807.76,16,1262974,10,0,0,0,0,0
20150105.142623,2807.76,2,1262976,0,0,0,0,0,0
20150105.142624,2807.76,14,1262990,14,0,0,0,0,0
20150105.142625,2807.76,4,1262994,4,0,0,0,0,0
20150105.142626,2807.14,2,1262996,2,0,0,0,0,0
20150105.142627,2807.76,14,1263010,10,0,0,0,0,0
20150105.142628,2807.76,6,1263016,6,0,0,0,0,0
20150105.142629,2807.76,400,1263416,0,0,0,0,0,0
20150105.14263,2807.76,80,1263496,2,0,0,0,0,0
20150105.142631,2807.76,8,1263504,8,0,0,0,0,0
20150105.142632,2807.76,6,1263510,6,0,0,0,0,0
20150105.142633,2807.76,16,1263526,6,0,0,0,0,0
20150105.142634,2807.76,6,1263532,4,0,0,0,0,0
20150105.142635,2807.76,4,1263536,4,0,0,0,0,0
20150105.142636,2807.76,202,1263738,0,0,0,0,0,0
20150105.142637,2807.14,22,1263760,22,0,0,0,0,0
20150105.142638,2807.76,2,1263762,2,0,0,0,0,0
20150105.142639,2807.76,2,1263764,2,0,0,0,0,0
20150105.14264,2807.76,2,1263766,2,0,0,0,0,0
20150105.142641,2807.76,34,1263800,34,0,0,0,0,0
20150105.142642,2807.76,16,1263816,0,0,0,0,0,0
20150105.142643,2807.76,6,1263822,6,0,0,0,0,0
20150105.142644,2807.76,6,1263828,0,0,0,0,0,0
20150105.142645,2807.76,12,1263840,12,0,0,0,0,0
20150105.142646,2807.14,8,1263848,6,0,0,0,0,0
20150105.142647,2807.76,4,1263852,4,0,0,0,0,0
20150105.142648,2807.14,2,1263854,2,0,0,0,0,0
20150105.142649,2807.14,40,1263894,0,0,0,0,0,0
20150105.14265,2807.14,2,1263896,0,0,0,0,0,0
20150105.142651,2807.76,2,1263898,2,0,0,0,0,0
20150105.142652,2807.14,2,1263900,2,0,0,0,0,0
20150105.142653,2807.76,20,1263920,20,0,0,0,0,0
20150105.142654,2807.76,10,1263930,0,0,0,0,0,0
20150105.142655,2807.76,2,1263932,2,0,0,0,0,0
20150105.142656,2807.76,10,1263942,10,0,0,0,0,0
20150105.142657,2807.76,2,1263944,2,0,0,0,0,0
20150105.142658,2807.76,2,1263946,2,0,0,0,0,0
20150105.142659,2807.76,2,1263948,0,0,0,0,0,0
20150105.1427,2807.76,6,1263954,4,0,0,0,0,0
20150105.142701,2807.76,2,1263956,0,0,0,0,0,0
20150105.142702,2807.76,8,1263964,8,0,0,0,0,0
20150105.142703,2807.76,2,1263966,2,0,0,0,0,0
20150105.142704,2807.76,10,1263976,0,0,0,0,0,0
20150105.142705,2807.76,2,1263978,2,0,0,0,0,0
20150105.142706,2807.76,2,1263980,2,0,0,0,0,0
20150105.142707,2807.76,110,1264090,10,0,0,0,0,0
20150105.142708,2807.14,22,1264112,22,0,0,0,0,0
20150105.142709,2807.76,2,1264114,2,0,0,0,0,0
20150105.14271,2807.76,4,1264118,4,0,0,0,0,0
20150105.142711,2807.76,120,1264238,20,0,0,0,0,0
20150105.142712,2807.76,20,1264258,20,0,0,0,0,0
20150105.142713,2807.76,4,1264262,0,0,0,0,0,0
20150105.142714,2807.76,2,1264264,0,0,0,0,0,0
20150105.142715,2807.76,202,1264466,2,0,0,0,0,0
20150105.142716,2807.76,16,1264482,16,0,0,0,0,0
20150105.142717,2807.76,4,1264486,4,0,0,0,0,0
20150105.142718,2807.76,76,1264562,0,0,0,0,0,0
20150105.142719,2807.76,700,1265262,-66,0,0,0,0,0
20150105.14272,2807.76,2,1265264,0,0,0,0,0,0
20150105.142721,2807.76,6,1265270,6,0,0,0,0,0
20150105.142722,2807.76,2,1265272,2,0,0,0,0,0
20150105.142723,2807.77,16,1265288,14,0,0,0,0,0
20150105.142724,2807.77,2,1265290,0,0,0,0,0,0
20150105.142725,2807.76,10,1265300,10,0,0,0,0,0
20150105.142726,2807.76,40,1265340,0,0,0,0,0,0
20150105.142727,2807.77,10,1265350,-2,0,0,0,0,0
20150105.142728,2807.77,6,1265356,0,0,0,0,0,0
20150105.142729,2807.76,22,1265378,6,0,0,0,0,0
20150105.14273,2807.76,2,1265380,2,0,0,0,0,0
20150105.142731,2807.76,2,1265382,0,0,0,0,0,0
20150105.142732,2807.76,10,1265392,0,0,0,0,0,0
20150105.142733,2807.76,2,1265394,2,0,0,0,0,0
20150105.142734,2807.76,2,1265396,2,0,0,0,0,0
20150105.142735,2807.14,20,1265416,0,0,0,0,0,0
20150105.142736,2807.14,18,1265434,0,0,0,0,0,0
20150105.142737,2807.76,4,1265438,0,0,0,0,0,0
20150105.142738,2807.14,6,1265444,0,0,0,0,0,0
20150105.142739,2807.76,20,1265464,20,0,0,0,0,0
20150105.14274,2807.14,2,1265466,0,0,0,0,0,0
20150105.142741,2807.76,6,1265472,6,0,0,0,0,0
20150105.142742,2807.77,20,1265492,20,0,0,0,0,0
20150105.142743,2807.76,2,1265494,2,0,0,0,0,0
20150105.142744,2807.76,4,1265498,0,0,0,0,0,0
20150105.142745,2807.14,14,1265512,4,0,0,0,0,0
20150105.142746,2807.76,2,1265514,0,0,0,0,0,0
20150105.142747,2807.77,10,1265524,10,0,0,0,0,0
20150105.142748,2807.77,12,1265536,12,0,0,0,0,0
20150105.142749,2807.77,4,1265540,0,0,0,0,0,0
20150105.14275,2807.14,10,1265550,0,0,0,0,0,0
20150105.142751,2807.77,4,1265554,4,0,0,0,0,0
20150105.142752,2807.77,4,1265558,4,0,0,0,0,0
20150105.142753,2807.77,20,1265578,0,0,0,0,0,0
20150105.142754,2807.76,2,1265580,2,0,0,0,0,0
20150105.142755,2807.14,10,1265590,0,0,0,0,0,0
20150105.142756,2807.77,2,1265592,2,0,0,0,0,0
20150105.142757,2807.76,2,1265594,2,0,0,0,0,0
20150105.142758,2807.76,4,1265598,4,0,0,0,0,0
20150105.142759,2807.76,2,1265600,0,0,0,0,0,0
20150105.1428,2807.76,12,1265612,0,0,0,0,0,0
20150105.142801,2807.77,16,1265628,16,0,0,0,0,0
20150105.142802,2807.77,4,1265632,0,0,0,0,0,0
20150105.142803,2807.77,2,1265634,2,0,0,0,0,0
20150105.142804,2807.77,2,1265636,2,0,0,0,0,0
20150105.142805,2807.77,4,1265640,4,0,0,0,0,0
20150105.142806,2807.77,2,1265642,2,0,0,0,0,0
20150105.142807,2807.14,8,1265650,8,0,0,0,0,0
20150105.142808,2807.77,2,1265652,2,0,0,0,0,0
20150105.142809,2807.77,4,1265656,4,0,0,0,0,0
20150105.14281,2807.14,202,1265858,196,0,0,0,0,0
20150105.142811,2807.77,8,1265866,2,0,0,0,0,0
20150105.142812,2807.77,100,1265966,0,0,0,0,0,0
20150105.142813,2807.77,12,1265978,0,0,0,0,0,0
20150105.142814,2807.77,20,1265998,0,0,0,0,0,0
20150105.142815,2807.77,2,1266000,2,0,0,0,0,0
20150105.142816,2807.77,4,1266004,4,0,0,0,0,0
20150105.142817,2807.14,124,1266128,112,0,0,0,0,0
20150105.142818,2807.77,108,1266236,108,0,0,0,0,0
20150105.142819,2807.14,2,1266238,2,0,0,0,0,0
20150105.14282,2807.77,4,1266242,4,0,0,0,0,0
20150105.142821,2807.14,4,1266246,0,0,0,0,0,0
20150105.142822,2807.77,82,1266328,82,0,0,0,0,0
20150105.142823,2807.77,16,1266344,2,0,0,0,0,0
20150105.142824,2807.14,2,1266346,0,0,0,0,0,0
20150105.142825,2807.14,30,1266376,0,0,0,0,0,0
20150105.142826,2807.77,2,1266378,2,0,0,0,0,0
20150105.142827,2807.14,2,1266380,0,0,0,0,0,0
20150105.142828,2807.14,12,1266392,12,0,0,0,0,0
20150105.142829,2807.14,4,1266396,4,0,0,0,0,0
20150105.14283,2807.14,2,1266398,2,0,0,0,0,0
20150105.142831,2807.77,2,1266400,0,0,0,0,0,0
20150105.142832,2807.77,2,1266402,2,0,0,0,0,0
20150105.142833,2807.14,80,1266482,80,0,0,0,0,0
20150105.142834,2807.14,2,1266484,0,0,0,0,0,0
20150105.142835,2807.77,2,1266486,0,0,0,0,0,0
20150105.142836,2807.77,10,1266496,10,0,0,0,0,0
20150105.142837,2807.14,2,1266498,2,0,0,0,0,0
20150105.142838,2807.77,12,1266510,8,0,0,0,0,0
20150105.142839,2807.77,10,1266520,10,0,0,0,0,0
20150105.14284,2807.77,2,1266522,0,0,0,0,0,0
20150105.142841,2807.14,240,1266762,236,0,0,0,0,0
20150105.142842,2807.14,2,1266764,0,0,0,0,0,0
20150105.142843,2807.77,4,1266768,4,0,0,0,0,0
20150105.142844,2807.14,2,1266770,2,0,0,0,0,0
20150105.142845,2807.77,2,1266772,0,0,0,0,0,0
20150105.142846,2807.77,2,1266774,2,0,0,0,0,0
20150105.142847,2807.77,2,1266776,2,0,0,0,0,0
20150105.142848,2807.14,900,1267676,852,0,0,0,0,0
20150105.142849,2807.77,6,1267682,-2,0,0,0,0,0
20150105.14285,2807.77,2,1267684,0,0,0,0,0,0
20150105.142851,2807.14,28,1267712,28,0,0,0,0,0
20150105.142852,2807.15,2080,1269792,1636,0,0,0,0,0
20150105.142853,2807.15,64,1269856,62,0,0,0,0,0
20150105.142854,2807.15,118,1269974,96,0,0,0,0,0
20150105.142855,2807.77,62,1270036,6,0,0,0,0,0
20150105.142856,2807.15,6,1270042,2,0,0,0,0,0
20150105.142857,2807.15,8,1270050,2,0,0,0,0,0
20150105.142858,2807.15,2,1270052,0,0,0,0,0,0
20150105.142859,2807.15,72,1270124,64,0,0,0,0,0
20150105.1429,2807.15,2,1270126,2,0,0,0,0,0
20150105.142901,2807.15,206,1270332,202,0,0,0,0,0
20150105.142902,2807.15,100,1270432,98,0,0,0,0,0
20150105.142903,2807.15,2,1270434,0,0,0,0,0,0
20150105.142904,2807.15,2,1270436,0,0,0,0,0,0
20150105.142905,2807.77,6,1270442,4,0,0,0,0,0
20150105.142906,2807.77,4,1270446,0,0,0,0,0,0
20150105.142907,2807.15,28,1270474,18,0,0,0,0,0
20150105.142908,2807.15,4,1270478,-2,0,0,0,0,0
20150105.142909,2807.15,2,1270480,-2,0,0,0,0,0
20150105.14291,2807.15,2,1270482,0,0,0,0,0,0
20150105.142911,2807.15,4,1270486,-4,0,0,0,0,0
20150105.142912,2807.15,2,1270488,0,0,0,0,0,0
20150105.142913,2807.15,804,1271292,724,0,0,0,0,0
20150105.142914,2807.15,20,1271312,16,0,0,0,0,0
20150105.142915,2807.15,12,1271324,12,0,0,0,0,0
20150105.142916,2807.15,202,1271526,202,0,0,0,0,0
20150105.142917,2807.15,60,1271586,20,0,0,0,0,0
20150105.142918,2807.15,10,1271596,0,0,0,0,0,0
20150105.142919,2807.15,2,1271598,0,0,0,0,0,0
20150105.14292,2807.77,2,1271600,2,0,0,0,0,0
20150105.142921,2807.15,6,1271606,-2,0,0,0,0,0
20150105.142922,2807.15,20,1271626,-2,0,0,0,0,0
20150105.142923,2807.15,112,1271738,12,0,0,0,0,0
20150105.142924,2807.15,2,1271740,2,0,0,0,0,0
20150105.142925,2807.15,66,1271806,0,0,0,0,0,0
20150105.142926,2807.77,20,1271826,20,0,0,0,0,0
20150105.142927,2807.15,2,1271828,2,0,0,0,0,0
20150105.142928,2807.15,52,1271880,50,0,0,0,0,0
20150105.142929,2807.15,124,1272004,122,0,0,0,0,0
20150105.14293,2807.15,50,1272054,0,0,0,0,0,0
20150105.142931,2807.15,162,1272216,162,0,0,0,0,0
20150105.142932,2807.15,14,1272230,4,0,0,0,0,0
20150105.142933,2807.15,4,1272234,0,0,0,0,0,0
20150105.142934,2807.15,10,1272244,8,0,0,0,0,0
20150105.142935,2807.15,8,1272252,6,0,0,0,0,0
20150105.142936,2807.15,4,1272256,2,0,0,0,0,0
20150105.142937,2807.15,2,1272258,0,0,0,0,0,0
20150105.142938,2807.15,328,1272586,322,0,0,0,0,0
20150105.142939,2807.15,6,1272592,0,0,0,0,0,0
20150105.14294,2807.15,52,1272644,2,0,0,0,0,0
20150105.142941,2807.15,4,1272648,4,0,0,0,0,0
20150105.142942,2807.15,2000,1274648,1898,0,0,0,0,0
20150105.142943,2807.15,6,1274654,6,0,0,0,0,0
20150105.142944,2807.15,6,1274660,6,0,0,0,0,0
20150105.142945,2807.15,2,1274662,2,0,0,0,0,0
20150105.142946,2807.15,2,1274664,0,0,0,0,0,0
20150105.142947,2807.15,14,1274678,12,0,0,0,0,0
20150105.142948,2807.15,40,1274718,4,0,0,0,0,0
20150105.142949,2807.15,22,1274740,22,0,0,0,0,0
20150105.14295,2807.15,2,1274742,2,0,0,0,0,0
20150105.142951,2807.15,2,1274744,2,0,0,0,0,0
20150105.142952,2807.15,38,1274782,38,0,0,0,0,0
20150105.142953,2807.15,24,1274806,4,0,0,0,0,0
20150105.142954,2807.15,138,1274944,108,0,0,0,0,0
20150105.142955,2807.15,8,1274952,4,0,0,0,0,0
20150105.142956,2807.15,8,1274960,8,0,0,0,0,0
20150105.142957,2807.15,4,1274964,4,0,0,0,0,0
20150105.142958,2807.15,22,1274986,-2,0,0,0,0,0
20150105.142959,2807.15,8,1274994,8,0,0,0,0,0
20150105.143,2807.15,24,1275018,2,0,0,0,0,0
20150105.143001,2807.15,10,1275028,10,0,0,0,0,0
20150105.143002,2807.15,4,1275032,4,0,0,0,0,0
20150105.143003,2807.15,4,1275036,4,0,0,0,0,0
20150105.143004,2807.15,6,1275042,4,0,0,0,0,0
20150105.143005,2807.15,2,1275044,2,0,0,0,0,0
20150105.143006,2807.15,4,1275048,2,0,0,0,0,0
20150105.143007,2807.15,4,1275052,4,0,0,0,0,0
20150105.143008,2807.15,100,1275152,100,0,0,0,0,0
20150105.143009,2807.15,2,1275154,2,0,0,0,0,0
20150105.14301,2807.15,2,1275156,2,0,0,0,0,0
20150105.143011,2807.15,12,1275168,2,0,0,0,0,0
20150105.143012,2807.15,202,1275370,-200,0,0,0,0,0
20150105.143013,2807.15,52,1275422,0,0,0,0,0,0
20150105.143014,2807.15,242,1275664,48,0,0,0,0,0
20150105.143015,2806.53,134,1275798,86,0,0,0,0,0
20150105.143016,2807.15,18,1275816,0,0,0,0,0,0
20150105.143017,2807.15,16,1275832,-14,0,0,0,0,0
20150105.143018,2807.15,32,1275864,-12,0,0,0,0,0
20150105.143019,2807.15,60,1275924,58,0,0,0,0,0
20150105.14302,2807.15,4,1275928,0,0,0,0,0,0
20150105.143021,2807.15,4,1275932,4,0,0,0,0,0
20150105.143022,2807.15,10,1275942,10,0,0,0,0,0
20150105.143023,2807.15,48,1275990,48,0,0,0,0,0
20150105.143024,2807.15,30,1276020,30,0,0,0,0,0
20150105.143025,2807.15,22,1276042,20,0,0,0,0,0
20150105.143026,2807.15,32,1276074,32,0,0,0,0,0
20150105.143027,2807.78,18,1276092,0,0,0,0,0,0
20150105.143028,2807.78,100,1276192,98,0,0,0,0,0
20150105.143029,2807.15,40,1276232,0,0,0,0,0,0
20150105.14303,2807.78,2,1276234,0,0,0,0,0,0
20150105.143031,2807.78,10,1276244,0,0,0,0,0,0
20150105.143032,2807.78,22,1276266,22,0,0,0,0,0
20150105.143033,2807.78,2,1276268,0,0,0,0,0,0
20150105.143034,2807.78,10,1276278,10,0,0,0,0,0
20150105.143035,2807.78,2,1276280,0,0,0,0,0,0
20150105.143036,2807.78,12,1276292,12,0,0,0,0,0
20150105.143037,2807.78,2,1276294,2,0,0,0,0,0
20150105.143038,2807.15,10,1276304,6,0,0,0,0,0
20150105.143039,2807.78,2,1276306,2,0,0,0,0,0
20150105.14304,2807.78,4,1276310,4,0,0,0,0,0
20150105.143041,2807.78,20,1276330,10,0,0,0,0,0
20150105.143042,2807.15,988,1277318,494,0,0,0,0,0
20150105.143043,2807.15,24,1277342,0,0,0,0,0,0
20150105.143044,2807.15,4,1277346,2,0,0,0,0,0
20150105.143045,2806.53,2000,1279346,1480,0,0,0,0,0
20150105.143046,2806.53,24,1279370,4,0,0,0,0,0
20150105.143047,2806.53,32,1279402,2,0,0,0,0,0
20150105.143048,2806.53,632,1280034,630,0,0,0,0,0
20150105.143049,2806.53,142,1280176,140,0,0,0,0,0
20150105.14305,2806.53,30,1280206,18,0,0,0,0,0
20150105.143051,2805.91,2,1280208,0,0,0,0,0,0
20150105.143052,2805.91,546,1280754,218,0,0,0,0,0
20150105.143053,2805.91,326,1281080,-112,0,0,0,0,0
20150105.143054,2806.53,50,1281130,10,0,0,0,0,0
20150105.143055,2806.53,58,1281188,24,0,0,0,0,0
20150105.143056,2805.91,274,1281462,-68,0,0,0,0,0
20150105.143057,2805.91,36,1281498,34,0,0,0,0,0
20150105.143058,2806.53,4,1281502,2,0,0,0,0,0
20150105.143059,2805.91,2,1281504,2,0,0,0,0,0
20150105.1431,2805.91,4,1281508,0,0,0,0,0,0
20150105.143101,2805.91,40,1281548,40,0,0,0,0,0
20150105.143102,2805.91,6,1281554,2,0,0,0,0,0
20150105.143103,2805.91,4,1281558,-2,0,0,0,0,0
20150105.143104,2805.91,4,1281562,4,0,0,0,0,0
20150105.143105,2805.91,62,1281624,-12,0,0,0,0,0
20150105.143106,2806.53,32,1281656,-2,0,0,0,0,0
20150105.143107,2805.91,58,1281714,-46,0,0,0,0,0
20150105.143108,2805.91,2,1281716,0,0,0,0,0,0
20150105.143109,2805.91,16,1281732,-16,0,0,0,0,0
20150105.14311,2806.53,2,1281734,0,0,0,0,0,0
20150105.143111,2806.53,356,1282090,32,0,0,0,0,0
20150105.143112,2805.91,28,1282118,-6,0,0,0,0,0
20150105.143113,2806.53,22,1282140,0,0,0,0,0,0
20150105.143114,2805.91,2,1282142,0,0,0,0,0,0
20150105.143115,2805.91,4,1282146,0,0,0,0,0,0
20150105.143116,2806.53,12,1282158,0,0,0,0,0,0
20150105.143117,2805.91,26,1282184,0,0,0,0,0,0
20150105.143118,2805.91,4,1282188,0,0,0,0,0,0
20150105.143119,2806.53,6,1282194,0,0,0,0,0,0
20150105.14312,2805.91,6,1282200,-6,0,0,0,0,0
20150105.143121,2806.53,2,1282202,0,0,0,0,0,0
20150105.143122,2805.91,90,1282292,20,0,0,0,0,0
20150105.143123,2805.91,24,1282316,-16,0,0,0,0,0
20150105.143124,2806.53,140,1282456,-140,0,0,0,0,0
20150105.143125,2806.53,22,1282478,16,0,0,0,0,0
20150105.143126,2805.91,20,1282498,20,0,0,0,0,0
20150105.143127,2806.53,64,1282562,2,0,0,0,0,0
20150105.143128,2805.91,22,1282584,20,0,0,0,0,0
20150105.143129,2806.53,4,1282588,-2,0,0,0,0,0
20150105.14313,2806.53,6,1282594,2,0,0,0,0,0
20150105.143131,2806.53,4,1282598,0,0,0,0,0,0
20150105.143132,2806.53,4,1282602,0,0,0,0,0,0
20150105.143133,2805.91,32,1282634,30,0,0,0,0,0
20150105.143134,2805.91,6,1282640,4,0,0,0,0,0
20150105.143135,2805.91,26,1282666,0,0,0,0,0,0
20150105.143136,2805.91,4,1282670,0,0,0,0,0,0
20150105.143137,2805.91,30,1282700,0,0,0,0,0,0
20150105.143138,2805.91,4,1282704,2,0,0,0,0,0
20150105.143139,2806.53,10,1282714,10,0,0,0,0,0
20150105.14314,2806.53,6,1282720,4,0,0,0,0,0
20150105.143141,2805.91,2000,1284720,1326,0,0,0,0,0
20150105.143142,2805.91,1200,1285920,394,0,0,0,0,0
20150105.143143,2805.29,1106,1287026,680,0,0,0,0,0
20150105.143144,2805.29,452,1287478,186,0,0,0,0,0
20150105.143145,2805.29,586,1288064,-262,0,0,0,0,0
20150105.143146,2805.29,196,1288260,-30,0,0,0,0,0
20150105.143147,2805.29,8,1288268,2,0,0,0,0,0
20150105.143148,2805.29,18,1288286,0,0,0,0,0,0
20150105.143149,2805.29,14,1288300,4,0,0,0,0,0
20150105.14315,2805.29,32,1288332,0,0,0,0,0,0
20150105.143151,2805.29,30,1288362,12,0,0,0,0,0
20150105.143152,2805.29,22,1288384,-2,0,0,0,0,0
20150105.143153,2805.29,42,1288426,-42,0,0,0,0,0
20150105.143154,2805.91,18,1288444,6,0,0,0,0,0
20150105.143155,2805.29,2,1288446,-2,0,0,0,0,0
20150105.143156,2805.91,34,1288480,-10,0,0,0,0,0
20150105.143157,2805.29,70,1288550,8,0,0,0,0,0
20150105.143158,2805.29,36,1288586,14,0,0,0,0,0
20150105.143159,2805.29,108,1288694,-2,0,0,0,0,0
20150105.1432,2805.29,10,1288704,-2,0,0,0,0,0
20150105.143201,2805.29,14,1288718,8,0,0,0,0,0
20150105.143202,2805.29,10,1288728,-2,0,0,0,0,0
20150105.143203,2805.29,14,1288742,-2,0,0,0,0,0
20150105.143204,2805.91,14,1288756,0,0,0,0,0,0
20150105.143205,2805.91,4,1288760,0,0,0,0,0,0
20150105.143206,2805.29,8,1288768,0,0,0,0,0,0
20150105.143207,2805.29,48,1288816,-32,0,0,0,0,0
20150105.143208,2805.29,4,1288820,4,0,0,0,0,0
20150105.143209,2805.29,12,1288832,2,0,0,0,0,0
20150105.14321,2805.29,20,1288852,18,0,0,0,0,0
20150105.143211,2805.29,72,1288924,64,0,0,0,0,0
20150105.143212,2805.91,20,1288944,20,0,0,0,0,0
20150105.143213,2805.91,1132,1290076,-70,0,0,0,0,0
20150105.143214,2805.91,612,1290688,-142,0,0,0,0,0
20150105.143215,2805.91,4,1290692,-2,0,0,0,0,0
20150105.143216,2805.91,212,1290904,-202,0,0,0,0,0
20150105.143217,2806.54,22,1290926,0,0,0,0,0,0
20150105.143218,2805.91,124,1291050,-18,0,0,0,0,0
20150105.143219,2805.91,6,1291056,2,0,0,0,0,0
20150105.14322,2806.54,26,1291082,4,0,0,0,0,0
20150105.143221,2805.91,4,1291086,2,0,0,0,0,0
20150105.143222,2805.91,666,1291752,132,0,0,0,0,0
20150105.143223,2805.91,30,1291782,0,0,0,0,0,0
20150105.143224,2805.91,2,1291784,0,0,0,0,0,0
20150105.143225,2805.91,296,1292080,-50,0,0,0,0,0
20150105.143226,2806.54,14,1292094,0,0,0,0,0,0
20150105.143227,2805.91,22,1292116,20,0,0,0,0,0
20150105.143228,2805.91,2,1292118,0,0,0,0,0,0
20150105.143229,2805.91,18,1292136,14,0,0,0,0,0
20150105.14323,2805.91,24,1292160,22,0,0,0,0,0
20150105.143231,2805.91,22,1292182,20,0,0,0,0,0
20150105.143232,2805.91,4,1292186,4,0,0,0,0,0
20150105.143233,2805.91,4,1292190,2,0,0,0,0,0
20150105.143234,2805.91,38,1292228,20,0,0,0,0,0
20150105.143235,2806.54,210,1292438,210,0,0,0,0,0
20150105.143236,2805.91,2,1292440,2,0,0,0,0,0
20150105.143237,2805.91,2,1292442,0,0,0,0,0,0
20150105.143238,2805.91,8,1292450,8,0,0,0,0,0
20150105.143239,2805.91,10,1292460,8,0,0,0,0,0
20150105.14324,2805.91,44,1292504,42,0,0,0,0,0
20150105.143241,2806.54,2,1292506,0,0,0,0,0,0
20150105.143242,2805.91,28,1292534,0,0,0,0,0,0
20150105.143243,2805.91,8,1292542,8,0,0,0,0,0
20150105.143244,2805.91,520,1293062,-152,0,0,0,0,0
20150105.143245,2805.91,12,1293074,0,0,0,0,0,0
20150105.143246,2805.91,2,1293076,-2,0,0,0,0,0
20150105.143247,2805.91,1166,1294242,-938,0,0,0,0,0
20150105.143248,2806.53,406,1294648,6,0,0,0,0,0
20150105.143249,2805.91,2,1294650,0,0,0,0,0,0
20150105.14325,2805.91,106,1294756,0,0,0,0,0,0
20150105.143251,2806.53,102,1294858,84,0,0,0,0,0
20150105.143252,2805.91,180,1295038,0,0,0,0,0,0
20150105.143253,2805.91,4,1295042,0,0,0,0,0,0
20150105.143254,2805.91,10,1295052,-10,0,0,0,0,0
20150105.143255,2805.91,466,1295518,-228,0,0,0,0,0
20150105.143256,2805.28,14,1295532,-4,0,0,0,0,0
20150105.143257,2805.91,44,1295576,0,0,0,0,0,0
20150105.143258,2805.91,14,1295590,0,0,0,0,0,0
20150105.143259,2805.91,100,1295690,-2,0,0,0,0,0
20150105.1433,2805.91,458,1296148,-354,0,0,0,0,0
20150105.143301,2805.91,10,1296158,0,0,0,0,0,0
20150105.143302,2806.53,6,1296164,-2,0,0,0,0,0
20150105.143303,2805.91,22,1296186,16,0,0,0,0,0
20150105.143304,2805.91,130,1296316,130,0,0,0,0,0
20150105.143305,2805.91,8,1296324,6,0,0,0,0,0
20150105.143306,2805.91,6,1296330,4,0,0,0,0,0
20150105.143307,2805.91,14,1296344,10,0,0,0,0,0
20150105.143308,2805.91,276,1296620,248,0,0,0,0,0
20150105.143309,2805.91,4,1296624,0,0,0,0,0,0
20150105.14331,2805.91,10,1296634,-2,0,0,0,0,0
20150105.143311,2805.91,98,1296732,-98,0,0,0,0,0
20150105.143312,2805.91,1922,1298654,-1682,0,0,0,0,0
20150105.143313,2805.91,2,1298656,0,0,0,0,0,0
20150105.143314,2805.91,32,1298688,-32,0,0,0,0,0
20150105.143315,2805.91,24,1298712,-10,0,0,0,0,0
20150105.143316,2805.28,24,1298736,-20,0,0,0,0,0
20150105.143317,2805.28,6,1298742,0,0,0,0,0,0
20150105.143318,2805.28,40,1298782,-24,0,0,0,0,0
20150105.143319,2805.91,60,1298842,0,0,0,0,0,0
20150105.14332,2805.91,42,1298884,-16,0,0,0,0,0
20150105.143321,2805.28,2,1298886,0,0,0,0,0,0
20150105.143322,2805.28,40,1298926,-34,0,0,0,0,0
20150105.143323,2805.91,4,1298930,0,0,0,0,0,0
20150105.143324,2805.91,16,1298946,-2,0,0,0,0,0
20150105.143325,2805.91,16,1298962,-4,0,0,0,0,0
20150105.143326,2805.28,2,1298964,-2,0,0,0,0,0
20150105.143327,2805.91,36,1299000,-32,0,0,0,0,0
20150105.143328,2805.91,396,1299396,-238,0,0,0,0,0
20150105.143329,2805.91,94,1299490,82,0,0,0,0,0
20150105.14333,2805.91,2,1299492,2,0,0,0,0,0
20150105.143331,2805.91,38,1299530,-4,0,0,0,0,0
20150105.143332,2805.91,20,1299550,0,0,0,0,0,0
20150105.143333,2805.91,20,1299570,20,0,0,0,0,0
20150105.143334,2806.53,2,1299572,0,0,0,0,0,0
20150105.143335,2806.53,2,1299574,2,0,0,0,0,0
20150105.143336,2805.91,2,1299576,2,0,0,0,0,0
20150105.143337,2805.91,12,1299588,2,0,0,0,0,0
20150105.143338,2805.91,2,1299590,2,0,0,0,0,0
20150105.143339,2805.91,10,1299600,10,0,0,0,0,0
20150105.14334,2805.91,14,1299614,14,0,0,0,0,0
20150105.143341,2805.91,220,1299834,78,0,0,0,0,0
20150105.143342,2806.53,4,1299838,2,0,0,0,0,0
20150105.143343,2806.53,4,1299842,-2,0,0,0,0,0
20150105.143344,2805.91,2,1299844,0,0,0,0,0,0
20150105.143345,2805.91,46,1299890,0,0,0,0,0,0
20150105.143346,2806.53,8,1299898,0,0,0,0,0,0
20150105.143347,2805.91,6,1299904,0,0,0,0,0,0
20150105.143348,2805.91,2,1299906,0,0,0,0,0,0
20150105.143349,2805.91,806,1300712,170,0,0,0,0,0
20150105.14335,2805.91,6,1300718,0,0,0,0,0,0
20150105.143351,2805.91,30,1300748,6,0,0,0,0,0
20150105.143352,2805.91,28,1300776,-2,0,0,0,0,0
20150105.143353,2805.91,14,1300790,0,0,0,0,0,0
20150105.143354,2805.91,2,1300792,0,0,0,0,0,0
20150105.143355,2806.53,4,1300796,4,0,0,0,0,0
20150105.143356,2805.91,14,1300810,10,0,0,0,0,0
20150105.143357,2805.91,6,1300816,6,0,0,0,0,0
20150105.143358,2805.91,14,1300830,14,0,0,0,0,0
20150105.143359,2805.91,4,1300834,2,0,0,0,0,0
20150105.1434,2805.91,18,1300852,4,0,0,0,0,0
20150105.143401,2806.53,2,1300854,2,0,0,0,0,0
20150105.143402,2805.91,24,1300878,2,0,0,0,0,0
20150105.143403,2805.91,2,1300880,2,0,0,0,0,0
20150105.143404,2805.91,2,1300882,2,0,0,0,0,0
20150105.143405,2806.53,14,1300896,8,0,0,0,0,0
20150105.143406,2806.53,10,1300906,10,0,0,0,0,0
20150105.143407,2806.53,612,1301518,314,0,0,0,0,0
20150105.143408,2805.91,34,1301552,30,0,0,0,0,0
20150105.143409,2805.91,8,1301560,8,0,0,0,0,0
20150105.14341,2806.53,8,1301568,6,0,0,0,0,0
20150105.143411,2806.53,4,1301572,4,0,0,0,0,0
20150105.143412,2805.91,12,1301584,12,0,0,0,0,0
20150105.143413,2806.53,8,1301592,8,0,0,0,0,0
20150105.143414,2806.53,8,1301600,8,0,0,0,0,0
20150105.143415,2806.53,32,1301632,10,0,0,0,0,0
20150105.143416,2805.91,6,1301638,4,0,0,0,0,0
20150105.143417,2806.53,10,1301648,0,0,0,0,0,0
20150105.143418,2805.91,4,1301652,4,0,0,0,0,0
20150105.143419,2806.53,2,1301654,0,0,0,0,0,0
20150105.14342,2806.53,18,1301672,2,0,0,0,0,0
20150105.143421,2806.53,10,1301682,0,0,0,0,0,0
20150105.143422,2806.53,4,1301686,2,0,0,0,0,0
20150105.143423,2805.91,200,1301886,150,0,0,0,0,0
20150105.143424,2806.53,358,1302244,196,0,0,0,0,0
20150105.143425,2805.91,6,1302250,0,0,0,0,0,0
20150105.143426,2805.91,12,1302262,4,0,0,0,0,0
20150105.143427,2805.91,4,1302266,4,0,0,0,0,0
20150105.143428,2805.91,22,1302288,12,0,0,0,0,0
20150105.143429,2805.91,14,1302302,0,0,0,0,0,0
20150105.14343,2805.91,4,1302306,4,0,0,0,0,0
20150105.143431,2805.91,12,1302318,0,0,0,0,0,0
20150105.143432,2805.91,18,1302336,-10,0,0,0,0,0
20150105.143433,2805.91,126,1302462,-10,0,0,0,0,0
20150105.143434,2805.91,2,1302464,0,0,0,0,0,0
20150105.143435,2805.91,16,1302480,0,0,0,0,0,0
20150105.143436,2805.28,40,1302520,10,0,0,0,0,0
20150105.143437,2805.28,6,1302526,6,0,0,0,0,0
20150105.143438,2805.91,6,1302532,0,0,0,0,0,0
20150105.143439,2805.28,200,1302732,200,0,0,0,0,0
20150105.14344,2805.91,2,1302734,0,0,0,0,0,0
20150105.143441,2805.91,2,1302736,-2,0,0,0,0,0
20150105.143442,2805.91,4,1302740,0,0,0,0,0,0
20150105.143443,2805.91,4,1302744,0,0,0,0,0,0
20150105.143444,2805.91,2,1302746,0,0,0,0,0,0
20150105.143445,2805.28,2,1302748,2,0,0,0,0,0
20150105.143446,2805.91,2,1302750,0,0,0,0,0,0
20150105.143447,2805.91,80,1302830,-60,0,0,0,0,0
20150105.143448,2805.91,104,1302934,-2,0,0,0,0,0
20150105.143449,2806.53,566,1303500,-462,0,0,0,0,0
20150105.14345,2805.91,4,1303504,2,0,0,0,0,0
20150105.143451,2805.91,440,1303944,-262,0,0,0,0,0
20150105.143452,2805.91,490,1304434,32,0,0,0,0,0
20150105.143453,2806.53,12,1304446,-12,0,0,0,0,0
20150105.143454,2805.91,22,1304468,-10,0,0,0,0,0
20150105.143455,2805.91,2,1304470,0,0,0,0,0,0
20150105.143456,2805.91,210,1304680,200,0,0,0,0,0
20150105.143457,2805.91,110,1304790,110,0,0,0,0,0
20150105.143458,2806.53,22,1304812,0,0,0,0,0,0
20150105.143459,2805.91,2,1304814,0,0,0,0,0,0
20150105.1435,2806.53,2,1304816,-2,0,0,0,0,0
20150105.143501,2806.53,2,1304818,0,0,0,0,0,0
20150105.143502,2806.53,2,1304820,0,0,0,0,0,0
20150105.143503,2805.91,2,1304822,0,0,0,0,0,0
20150105.143504,2805.91,10,1304832,0,0,0,0,0,0
20150105.143505,2806.53,2,1304834,0,0,0,0,0,0
20150105.143506,2806.53,2,1304836,0,0,0,0,0,0
20150105.143507,2806.53,2,1304838,0,0,0,0,0,0
20150105.143508,2806.53,112,1304950,0,0,0,0,0,0
20150105.143509,2806.53,584,1305534,-270,0,0,0,0,0
20150105.14351,2806.53,4,1305538,-4,0,0,0,0,0
20150105.143511,2806.53,6,1305544,-4,0,0,0,0,0
20150105.143512,2806.53,2,1305546,-2,0,0,0,0,0
20150105.143513,2807.16,368,1305914,-206,0,0,0,0,0
20150105.143514,2807.16,342,1306256,78,0,0,0,0,0
20150105.143515,2806.53,4,1306260,-2,0,0,0,0,0
20150105.143516,2806.53,32,1306292,-18,0,0,0,0,0
20150105.143517,2805.91,10,1306302,-4,0,0,0,0,0
20150105.143518,2806.53,532,1306834,104,0,0,0,0,0
20150105.143519,2806.53,4,1306838,0,0,0,0,0,0
20150105.14352,2807.16,6,1306844,0,0,0,0,0,0
20150105.143521,2807.16,4,1306848,0,0,0,0,0,0
20150105.143522,2806.53,2,1306850,0,0,0,0,0,0
20150105.143523,2807.16,2,1306852,0,0,0,0,0,0
20150105.143524,2806.53,4,1306856,-4,0,0,0,0,0
20150105.143525,2807.16,20,1306876,-20,0,0,0,0,0
20150105.143526,2807.16,2,1306878,0,0,0,0,0,0
20150105.143527,2806.53,4,1306882,0,0,0,0,0,0
20150105.143528,2807.16,30,1306912,2,0,0,0,0,0
20150105.143529,2807.16,2,1306914,2,0,0,0,0,0
20150105.14353,2807.16,6,1306920,2,0,0,0,0,0
20150105.143531,2807.16,4,1306924,0,0,0,0,0,0
20150105.143532,2807.16,522,1307446,-398,0,0,0,0,0
20150105.143533,2806.53,22,1307468,-16,0,0,0,0,0
20150105.143534,2807.16,2,1307470,-2,0,0,0,0,0
20150105.143535,2807.16,2,1307472,0,0,0,0,0,0
20150105.143536,2807.16,10,1307482,10,0,0,0,0,0
20150105.143537,2806.53,30,1307512,8,0,0,0,0,0
20150105.143538,2807.16,22,1307534,2,0,0,0,0,0
20150105.143539,2807.16,2,1307536,0,0,0,0,0,0
20150105.14354,2807.16,4,1307540,0,0,0,0,0,0
20150105.143541,2807.16,10,1307550,10,0,0,0,0,0
20150105.143542,2807.16,6,1307556,2,0,0,0,0,0
20150105.143543,2807.16,16,1307572,0,0,0,0,0,0
20150105.143544,2806.53,4,1307576,4,0,0,0,0,0
20150105.143545,2807.16,4,1307580,2,0,0,0,0,0
20150105.143546,2807.16,2,1307582,2,0,0,0,0,0
20150105.143547,2807.16,34,1307616,10,0,0,0,0,0
20150105.143548,2807.16,6,1307622,2,0,0,0,0,0
20150105.143549,2807.16,40,1307662,0,0,0,0,0,0
20150105.14355,2807.16,2,1307664,2,0,0,0,0,0
20150105.143551,2807.16,6,1307670,2,0,0,0,0,0
20150105.143552,2806.53,10,1307680,10,0,0,0,0,0
20150105.143553,2807.16,4,1307684,0,0,0,0,0,0
20150105.143554,2807.16,2,1307686,2,0,0,0,0,0
20150105.143555,2807.16,444,1308130,-32,0,0,0,0,0
20150105.143556,2807.16,98,1308228,-72,0,0,0,0,0
20150105.143557,2807.16,364,1308592,-12,0,0,0,0,0
20150105.143558,2807.16,192,1308784,10,0,0,0,0,0
20150105.143559,2807.16,32,1308816,-32,0,0,0,0,0
20150105.1436,2807.16,12,1308828,-12,0,0,0,0,0
20150105.143601,2807.16,108,1308936,8,0,0,0,0,0
20150105.143602,2807.78,466,1309402,-10,0,0,0,0,0
20150105.143603,2807.78,76,1309478,0,0,0,0,0,0
20150105.143604,2807.16,8,1309486,-8,0,0,0,0,0
20150105.143605,2807.78,10,1309496,-6,0,0,0,0,0
20150105.143606,2807.78,112,1309608,-12,0,0,0,0,0
20150105.143607,2807.16,8,1309616,-8,0,0,0,0,0
20150105.143608,2807.78,28,1309644,-8,0,0,0,0,0
20150105.143609,2807.78,6,1309650,-2,0,0,0,0,0
20150105.14361,2807.16,2,1309652,-2,0,0,0,0,0
20150105.143611,2807.78,4,1309656,-2,0,0,0,0,0
20150105.143612,2807.16,40,1309696,0,0,0,0,0,0
20150105.143613,2807.78,2,1309698,2,0,0,0,0,0
20150105.143614,2807.78,4,1309702,4,0,0,0,0,0
20150105.143615,2807.78,2,1309704,0,0,0,0,0,0
20150105.143616,2807.78,6,1309710,0,0,0,0,0,0
20150105.143617,2807.16,6,1309716,-2,0,0,0,0,0
20150105.143618,2807.78,2,1309718,2,0,0,0,0,0
20150105.143619,2807.16,4,1309722,-4,0,0,0,0,0
20150105.14362,2807.78,112,1309834,-50,0,0,0,0,0
20150105.143621,2807.78,800,1310634,-458,0,0,0,0,0
20150105.143622,2808.4,4,1310638,2,0,0,0,0,0
20150105.143623,2808.4,138,1310776,-72,0,0,0,0,0
20150105.143624,2808.4,16,1310792,-2,0,0,0,0,0
20150105.143625,2807.78,8,1310800,0,0,0,0,0,0
20150105.143626,2808.4,6,1310806,0,0,0,0,0,0
20150105.143627,2807.78,6,1310812,-2,0,0,0,0,0
20150105.143628,2808.4,20,1310832,-14,0,0,0,0,0
20150105.143629,2807.78,26,1310858,-26,0,0,0,0,0
20150105.14363,2807.78,26,1310884,16,0,0,0,0,0
20150105.143631,2807.78,26,1310910,-8,0,0,0,0,0
20150105.143632,2807.78,8,1310918,-8,0,0,0,0,0
20150105.143633,2807.78,4,1310922,-4,0,0,0,0,0
20150105.143634,2808.4,8,1310930,-2,0,0,0,0,0
20150105.143635,2807.78,4,1310934,-4,0,0,0,0,0
20150105.143636,2807.78,4,1310938,-4,0,0,0,0,0
20150105.143637,2807.78,314,1311252,32,0,0,0,0,0
20150105.143638,2807.78,2,1311254,-2,0,0,0,0,0
20150105.143639,2807.16,8,1311262,0,0,0,0,0,0
20150105.14364,2807.78,44,1311306,-34,0,0,0,0,0
20150105.143641,2807.78,120,1311426,6,0,0,0,0,0
20150105.143642,2808.4,8,1311434,0,0,0,0,0,0
20150105.143643,2807.78,12,1311446,2,0,0,0,0,0
20150105.143644,2807.78,14,1311460,0,0,0,0,0,0
20150105.143645,2807.78,2,1311462,2,0,0,0,0,0
20150105.143646,2807.78,8,1311470,0,0,0,0,0,0
20150105.143647,2807.78,334,1311804,2,0,0,0,0,0
20150105.143648,2807.78,4,1311808,4,0,0,0,0,0
20150105.143649,2807.78,28,1311836,-22,0,0,0,0,0
20150105.14365,2807.78,16,1311852,0,0,0,0,0,0
20150105.143651,2807.16,28,1311880,20,0,0,0,0,0
20150105.143652,2807.78,2,1311882,0,0,0,0,0,0
20150105.143653,2808.4,4,1311886,0,0,0,0,0,0
20150105.143654,2807.78,2,1311888,0,0,0,0,0,0
20150105.143655,2808.4,2,1311890,0,0,0,0,0,0
20150105.143656,2807.78,10,1311900,0,0,0,0,0,0
20150105.143657,2808.4,46,1311946,-20,0,0,0,0,0
20150105.143658,2808.4,6,1311952,6,0,0,0,0,0
20150105.143659,2808.4,8,1311960,0,0,0,0,0,0
20150105.1437,2808.4,6,1311966,6,0,0,0,0,0
20150105.143701,2808.4,12,1311978,2,0,0,0,0,0
20150105.143702,2807.78,26,1312004,14,0,0,0,0,0
20150105.143703,2808.4,2,1312006,0,0,0,0,0,0
20150105.143704,2807.78,2,1312008,2,0,0,0,0,0
20150105.143705,2808.4,20,1312028,0,0,0,0,0,0
20150105.143706,2807.78,54,1312082,14,0,0,0,0,0
20150105.143707,2807.78,18,1312100,0,0,0,0,0,0
20150105.143708,2808.4,2,1312102,0,0,0,0,0,0
20150105.143709,2808.4,4,1312106,-2,0,0,0,0,0
20150105.14371,2808.4,2,1312108,-2,0,0,0,0,0
20150105.143711,2808.4,2,1312110,0,0,0,0,0,0
20150105.143712,2807.78,36,1312146,22,0,0,0,0,0
20150105.143713,2808.4,8,1312154,-6,0,0,0,0,0
20150105.143714,2808.4,30,1312184,-18,0,0,0,0,0
20150105.143715,2808.4,4,1312188,-4,0,0,0,0,0
20150105.143716,2807.78,8,1312196,4,0,0,0,0,0
20150105.143717,2808.4,100,1312296,-66,0,0,0,0,0
20150105.143718,2808.4,2,1312298,0,0,0,0,0,0
20150105.143719,2808.4,10,1312308,0,0,0,0,0,0
20150105.14372,2808.4,2,1312310,-2,0,0,0,0,0
20150105.143721,2808.4,2,1312312,-2,0,0,0,0,0
20150105.143722,2808.4,8,1312320,0,0,0,0,0,0
20150105.143723,2808.4,4,1312324,-4,0,0,0,0,0
20150105.143724,2807.78,4,1312328,-4,0,0,0,0,0
20150105.143725,2808.4,2,1312330,-2,0,0,0,0,0
20150105.143726,2807.78,4,1312334,2,0,0,0,0,0
20150105.143727,2807.78,12,1312346,-10,0,0,0,0,0
20150105.143728,2807.78,2,1312348,-2,0,0,0,0,0
20150105.143729,2807.78,16,1312364,-6,0,0,0,0,0
20150105.14373,2808.4,2,1312366,0,0,0,0,0,0
20150105.143731,2807.78,30,1312396,-30,0,0,0,0,0
20150105.143732,2808.4,10,1312406,-8,0,0,0,0,0
20150105.143733,2807.78,8,1312414,-6,0,0,0,0,0
20150105.143734,2808.4,8,1312422,-8,0,0,0,0,0
20150105.143735,2808.4,10,1312432,-10,0,0,0,0,0
20150105.143736,2808.4,4,1312436,-2,0,0,0,0,0
20150105.143737,2807.78,20,1312456,0,0,0,0,0,0
20150105.143738,2807.78,4,1312460,4,0,0,0,0,0
20150105.143739,2808.4,12,1312472,6,0,0,0,0,0
20150105.14374,2807.16,408,1312880,94,0,0,0,0,0
20150105.143741,2807.78,26,1312906,-24,0,0,0,0,0
20150105.143742,2807.78,74,1312980,0,0,0,0,0,0
20150105.143743,2807.78,400,1313380,0,0,0,0,0,0
20150105.143744,2807.78,2,1313382,0,0,0,0,0,0
20150105.143745,2808.4,402,1313784,2,0,0,0,0,0
20150105.143746,2807.78,4,1313788,-2,0,0,0,0,0
20150105.143747,2807.78,6,1313794,-4,0,0,0,0,0
20150105.143748,2807.16,400,1314194,144,0,0,0,0,0
20150105.143749,2807.78,2,1314196,0,0,0,0,0,0
20150105.14375,2807.16,30,1314226,-26,0,0,0,0,0
20150105.143751,2807.16,164,1314390,88,0,0,0,0,0
20150105.143752,2807.16,88,1314478,-2,0,0,0,0,0
20150105.143753,2807.16,20,1314498,0,0,0,0,0,0
20150105.143754,2807.16,4,1314502,2,0,0,0,0,0
20150105.143755,2806.53,406,1314908,234,0,0,0,0,0
20150105.143756,2806.53,38,1314946,-16,0,0,0,0,0
20150105.143757,2806.53,32,1314978,-28,0,0,0,0,0
20150105.143758,2806.53,6,1314984,0,0,0,0,0,0
20150105.143759,2806.53,52,1315036,0,0,0,0,0,0
20150105.1438,2806.53,4,1315040,2,0,0,0,0,0
20150105.143801,2806.53,2,1315042,0,0,0,0,0,0
20150105.143802,2806.53,104,1315146,104,0,0,0,0,0
20150105.143803,2806.53,4,1315150,0,0,0,0,0,0
20150105.143804,2805.91,2,1315152,0,0,0,0,0,0
20150105.143805,2806.53,4,1315156,2,0,0,0,0,0
20150105.143806,2805.91,6,1315162,4,0,0,0,0,0
20150105.143807,2806.53,32,1315194,0,0,0,0,0,0
20150105.143808,2805.91,6,1315200,0,0,0,0,0,0
20150105.143809,2806.53,86,1315286,0,0,0,0,0,0
20150105.14381,2807.16,18,1315304,-2,0,0,0,0,0
20150105.143811,2807.16,340,1315644,182,0,0,0,0,0
20150105.143812,2807.16,112,1315756,2,0,0,0,0,0
20150105.143813,2807.16,404,1316160,400,0,0,0,0,0
20150105.143814,2807.16,10,1316170,0,0,0,0,0,0
20150105.143815,2807.16,2,1316172,0,0,0,0,0,0
20150105.143816,2807.16,274,1316446,212,0,0,0,0,0
20150105.143817,2806.53,4,1316450,-4,0,0,0,0,0
20150105.143818,2807.16,10,1316460,10,0,0,0,0,0
20150105.143819,2807.16,2,1316462,0,0,0,0,0,0
20150105.14382,2807.16,24,1316486,22,0,0,0,0,0
20150105.143821,2807.16,278,1316764,218,0,0,0,0,0
20150105.143822,2807.16,408,1317172,400,0,0,0,0,0
20150105.143823,2807.16,4,1317176,0,0,0,0,0,0
20150105.143824,2807.16,8,1317184,8,0,0,0,0,0
20150105.143825,2807.16,400,1317584,374,0,0,0,0,0
20150105.143826,2807.16,4,1317588,2,0,0,0,0,0
20150105.143827,2807.16,10,1317598,0,0,0,0,0,0
20150105.143828,2806.53,2,1317600,0,0,0,0,0,0
20150105.143829,2807.16,10,1317610,0,0,0,0,0,0
20150105.14383,2807.16,464,1318074,458,0,0,0,0,0
20150105.143831,2807.16,4,1318078,0,0,0,0,0,0
20150105.143832,2807.16,2,1318080,0,0,0,0,0,0
20150105.143833,2807.16,14,1318094,0,0,0,0,0,0
20150105.143834,2807.16,8,1318102,0,0,0,0,0,0
20150105.143835,2807.16,34,1318136,30,0,0,0,0,0
20150105.143836,2807.16,4,1318140,0,0,0,0,0,0
20150105.143837,2807.16,518,1318658,486,0,0,0,0,0
20150105.143838,2807.16,38,1318696,-32,0,0,0,0,0
20150105.143839,2807.16,4,1318700,-4,0,0,0,0,0
20150105.14384,2807.16,12,1318712,-10,0,0,0,0,0
20150105.143841,2807.16,4,1318716,-4,0,0,0,0,0
20150105.143842,2807.16,18,1318734,-4,0,0,0,0,0
20150105.143843,2807.16,2,1318736,0,0,0,0,0,0
20150105.143844,2807.16,2,1318738,-2,0,0,0,0,0
20150105.143845,2807.16,22,1318760,-2,0,0,0,0,0
20150105.143846,2807.16,2,1318762,-2,0,0,0,0,0
20150105.143847,2807.16,32,1318794,0,0,0,0,0,0
20150105.143848,2807.16,12,1318806,0,0,0,0,0,0
20150105.143849,2807.16,414,1319220,402,0,0,0,0,0
20150105.14385,2807.79,206,1319426,184,0,0,0,0,0
20150105.143851,2807.79,6,1319432,-4,0,0,0,0,0
20150105.143852,2807.16,2,1319434,2,0,0,0,0,0
20150105.143853,2807.79,62,1319496,48,0,0,0,0,0
20150105.143854,2807.16,4,1319500,4,0,0,0,0,0
20150105.143855,2807.16,2,1319502,2,0,0,0,0,0
20150105.143856,2807.16,60,1319562,10,0,0,0,0,0
20150105.143857,2807.16,42,1319604,40,0,0,0,0,0
20150105.143858,2807.16,16,1319620,4,0,0,0,0,0
20150105.143859,2807.16,8,1319628,0,0,0,0,0,0
20150105.1439,2807.16,8,1319636,2,0,0,0,0,0
20150105.143901,2807.16,10,1319646,10,0,0,0,0,0
20150105.143902,2807.16,30,1319676,-2,0,0,0,0,0
20150105.143903,2807.16,38,1319714,0,0,0,0,0,0
20150105.143904,2807.16,346,1320060,138,0,0,0,0,0
20150105.143905,2807.16,128,1320188,2,0,0,0,0,0
20150105.143906,2806.54,4,1320192,-4,0,0,0,0,0
20150105.143907,2807.16,2,1320194,0,0,0,0,0,0
20150105.143908,2807.16,4,1320198,4,0,0,0,0,0
20150105.143909,2807.16,2,1320200,2,0,0,0,0,0
20150105.14391,2807.16,2,1320202,0,0,0,0,0,0
20150105.143911,2807.16,40,1320242,36,0,0,0,0,0
20150105.143912,2806.54,6,1320248,-2,0,0,0,0,0
20150105.143913,2806.54,2,1320250,0,0,0,0,0,0
20150105.143914,2807.16,4,1320254,0,0,0,0,0,0
20150105.143915,2806.54,2,1320256,0,0,0,0,0,0
20150105.143916,2806.54,4,1320260,-2,0,0,0,0,0
20150105.143917,2806.54,120,1320380,-98,0,0,0,0,0
20150105.143918,2806.54,16,1320396,4,0,0,0,0,0
20150105.143919,2807.16,4,1320400,0,0,0,0,0,0
20150105.14392,2806.54,2,1320402,2,0,0,0,0,0
20150105.143921,2806.54,2,1320404,2,0,0,0,0,0
20150105.143922,2807.16,302,1320706,2,0,0,0,0,0
20150105.143923,2806.54,2,1320708,2,0,0,0,0,0
20150105.143924,2806.54,12,1320720,12,0,0,0,0,0
20150105.143925,2806.54,596,1321316,314,0,0,0,0,0
20150105.143926,2805.91,4,1321320,4,0,0,0,0,0
20150105.143927,2806.54,4,1321324,0,0,0,0,0,0
20150105.143928,2805.91,2,1321326,2,0,0,0,0,0
20150105.143929,2805.91,2,1321328,2,0,0,0,0,0
20150105.14393,2806.54,2,1321330,0,0,0,0,0,0
20150105.143931,2805.91,10,1321340,10,0,0,0,0,0
20150105.143932,2806.54,8,1321348,8,0,0,0,0,0
20150105.143933,2805.91,508,1321856,108,0,0,0,0,0
20150105.143934,2805.91,244,1322100,224,0,0,0,0,0
20150105.143935,2806.54,410,1322510,-146,0,0,0,0,0
20150105.143936,2805.91,28,1322538,6,0,0,0,0,0
20150105.143937,2806.54,2,1322540,-2,0,0,0,0,0
20150105.143938,2806.54,6,1322546,2,0,0,0,0,0
20150105.143939,2805.91,8,1322554,-8,0,0,0,0,0
20150105.14394,2806.54,2,1322556,-2,0,0,0,0,0
20150105.143941,2806.54,246,1322802,-132,0,0,0,0,0
20150105.143942,2807.16,142,1322944,2,0,0,0,0,0
20150105.143943,2806.54,224,1323168,30,0,0,0,0,0
20150105.143944,2805.91,40,1323208,-16,0,0,0,0,0
20150105.143945,2805.91,8,1323216,-8,0,0,0,0,0
20150105.143946,2805.91,8,1323224,-8,0,0,0,0,0
20150105.143947,2805.91,10,1323234,-10,0,0,0,0,0
20150105.143948,2805.91,8,1323242,-8,0,0,0,0,0
20150105.143949,2805.91,4,1323246,-4,0,0,0,0,0
20150105.14395,2805.91,54,1323300,-44,0,0,0,0,0
20150105.143951,2805.91,40,1323340,-38,0,0,0,0,0
20150105.143952,2805.91,86,1323426,-38,0,0,0,0,0
20150105.143953,2805.91,28,1323454,-8,0,0,0,0,0
20150105.143954,2805.91,20,1323474,-14,0,0,0,0,0
20150105.143955,2805.91,34,1323508,-12,0,0,0,0,0
20150105.143956,2805.91,34,1323542,-8,0,0,0,0,0
20150105.143957,2805.91,14,1323556,-4,0,0,0,0,0
20150105.143958,2805.91,34,1323590,-12,0,0,0,0,0
20150105.143959,2805.91,14,1323604,-4,0,0,0,0,0
20150105.144,2805.91,122,1323726,0,0,0,0,0,0
20150105.144001,2805.91,82,1323808,14,0,0,0,0,0
20150105.144002,2805.91,2,1323810,-2,0,0,0,0,0
20150105.144003,2806.54,142,1323952,-82,0,0,0,0,0
20150105.144004,2805.91,28,1323980,-10,0,0,0,0,0
20150105.144005,2805.91,172,1324152,104,0,0,0,0,0
20150105.144006,2805.91,10,1324162,10,0,0,0,0,0
20150105.144007,2805.91,66,1324228,56,0,0,0,0,0
20150105.144008,2805.91,2,1324230,0,0,0,0,0,0
20150105.144009,2805.91,6,1324236,6,0,0,0,0,0
20150105.14401,2805.91,4,1324240,0,0,0,0,0,0
20150105.144011,2805.91,2,1324242,2,0,0,0,0,0
20150105.144012,2805.91,2,1324244,2,0,0,0,0,0
20150105.144013,2805.91,12,1324256,2,0,0,0,0,0
20150105.144014,2805.91,14,1324270,10,0,0,0,0,0
20150105.144015,2805.91,32,1324302,30,0,0,0,0,0
20150105.144016,2806.54,200,1324502,-6,0,0,0,0,0
20150105.144017,2806.54,286,1324788,68,0,0,0,0,0
20150105.144018,2806.54,286,1325074,16,0,0,0,0,0
20150105.144019,2806.54,136,1325210,8,0,0,0,0,0
20150105.14402,2807.16,6,1325216,0,0,0,0,0,0
20150105.144021,2807.16,80,1325296,0,0,0,0,0,0
20150105.144022,2807.16,108,1325404,-46,0,0,0,0,0
20150105.144023,2806.54,6,1325410,0,0,0,0,0,0
20150105.144024,2806.54,4,1325414,0,0,0,0,0,0
20150105.144025,2806.54,34,1325448,-22,0,0,0,0,0
20150105.144026,2806.54,4,1325452,0,0,0,0,0,0
20150105.144027,2806.54,126,1325578,64,0,0,0,0,0
20150105.144028,2806.54,22,1325600,20,0,0,0,0,0
20150105.144029,2805.91,2,1325602,0,0,0,0,0,0
20150105.14403,2805.91,6,1325608,2,0,0,0,0,0
20150105.144031,2806.54,26,1325634,26,0,0,0,0,0
20150105.144032,2806.54,6,1325640,6,0,0,0,0,0
20150105.144033,2806.54,2,1325642,2,0,0,0,0,0
20150105.144034,2806.54,306,1325948,300,0,0,0,0,0
20150105.144035,2806.54,2,1325950,0,0,0,0,0,0
20150105.144036,2805.91,46,1325996,20,0,0,0,0,0
20150105.144037,2806.54,2,1325998,0,0,0,0,0,0
20150105.144038,2806.54,120,1326118,120,0,0,0,0,0
20150105.144039,2805.91,4,1326122,4,0,0,0,0,0
20150105.14404,2805.91,10,1326132,10,0,0,0,0,0
20150105.144041,2805.91,10,1326142,2,0,0,0,0,0
20150105.144042,2805.91,2,1326144,2,0,0,0,0,0
20150105.144043,2806.54,4,1326148,4,0,0,0,0,0
20150105.144044,2806.54,2,1326150,2,0,0,0,0,0
20150105.144045,2805.91,12,1326162,12,0,0,0,0,0
20150105.144046,2805.91,6,1326168,2,0,0,0,0,0
20150105.144047,2805.91,12,1326180,8,0,0,0,0,0
20150105.144048,2805.91,6,1326186,6,0,0,0,0,0
20150105.144049,2806.54,4,1326190,2,0,0,0,0,0
20150105.14405,2805.91,4,1326194,2,0,0,0,0,0
20150105.144051,2806.54,2,1326196,2,0,0,0,0,0
20150105.144052,2806.54,2,1326198,0,0,0,0,0,0
20150105.144053,2806.54,2,1326200,2,0,0,0,0,0
20150105.144054,2805.91,2,1326202,2,0,0,0,0,0
20150105.144055,2805.91,160,1326362,92,0,0,0,0,0
20150105.144056,2806.54,26,1326388,8,0,0,0,0,0
20150105.144057,2805.91,4,1326392,4,0,0,0,0,0
20150105.144058,2806.54,60,1326452,2,0,0,0,0,0
20150105.144059,2806.54,6,1326458,0,0,0,0,0,0
20150105.1441,2806.54,200,1326658,200,0,0,0,0,0
20150105.144101,2806.54,394,1327052,78,0,0,0,0,0
20150105.144102,2807.16,2,1327054,-2,0,0,0,0,0
20150105.144103,2806.54,2,1327056,0,0,0,0,0,0
20150105.144104,2807.16,208,1327264,154,0,0,0,0,0
20150105.144105,2807.16,654,1327918,6,0,0,0,0,0
20150105.144106,2807.16,400,1328318,164,0,0,0,0,0
20150105.144107,2807.16,4,1328322,4,0,0,0,0,0
20150105.144108,2807.79,2,1328324,0,0,0,0,0,0
20150105.144109,2807.16,404,1328728,148,0,0,0,0,0
20150105.14411,2807.79,94,1328822,-70,0,0,0,0,0
20150105.144111,2807.16,190,1329012,30,0,0,0,0,0
20150105.144112,2807.16,8,1329020,8,0,0,0,0,0
20150105.144113,2807.16,8,1329028,4,0,0,0,0,0
20150105.144114,2807.16,18,1329046,10,0,0,0,0,0
20150105.144115,2807.16,4,1329050,4,0,0,0,0,0
20150105.144116,2807.16,12,1329062,4,0,0,0,0,0
20150105.144117,2807.16,24,1329086,24,0,0,0,0,0
20150105.144118,2807.16,28,1329114,28,0,0,0,0,0
20150105.144119,2807.16,8,1329122,8,0,0,0,0,0
20150105.14412,2806.54,14,1329136,-6,0,0,0,0,0
20150105.144121,2807.16,12,1329148,6,0,0,0,0,0
20150105.144122,2807.16,12,1329160,12,0,0,0,0,0
20150105.144123,2807.16,2,1329162,0,0,0,0,0,0
20150105.144124,2807.16,2,1329164,0,0,0,0,0,0
20150105.144125,2807.16,8,1329172,0,0,0,0,0,0
20150105.144126,2807.16,2,1329174,0,0,0,0,0,0
20150105.144127,2807.16,2,1329176,0,0,0,0,0,0
20150105.144128,2807.16,64,1329240,52,0,0,0,0,0
20150105.144129,2807.16,50,1329290,-12,0,0,0,0,0
20150105.14413,2807.16,12,1329302,0,0,0,0,0,0
20150105.144131,2806.54,2,1329304,2,0,0,0,0,0
20150105.144132,2807.16,26,1329330,10,0,0,0,0,0
20150105.144133,2806.54,6,1329336,6,0,0,0,0,0
20150105.144134,2807.16,12,1329348,0,0,0,0,0,0
20150105.144135,2807.16,2,1329350,0,0,0,0,0,0
20150105.144136,2806.54,36,1329386,0,0,0,0,0,0
20150105.144137,2807.16,2,1329388,0,0,0,0,0,0
20150105.144138,2807.16,8,1329396,0,0,0,0,0,0
20150105.144139,2807.16,2,1329398,0,0,0,0,0,0
20150105.14414,2807.16,206,1329604,-48,0,0,0,0,0
20150105.144141,2807.16,18,1329622,18,0,0,0,0,0
20150105.144142,2806.54,562,1330184,144,0,0,0,0,0
20150105.144143,2806.54,2,1330186,2,0,0,0,0,0
20150105.144144,2806.54,6,1330192,-6,0,0,0,0,0
20150105.144145,2805.91,38,1330230,36,0,0,0,0,0
20150105.144146,2806.54,2,1330232,-2,0,0,0,0,0
20150105.144147,2805.91,24,1330256,0,0,0,0,0,0
20150105.144148,2806.54,2,1330258,-2,0,0,0,0,0
20150105.144149,2806.54,2,1330260,0,0,0,0,0,0
20150105.14415,2806.54,8,1330268,-2,0,0,0,0,0
20150105.144151,2805.91,1000,1331268,-716,0,0,0,0,0
20150105.144152,2805.91,2,1331270,0,0,0,0,0,0
20150105.144153,2805.91,2,1331272,0,0,0,0,0,0
20150105.144154,2806.54,442,1331714,-382,0,0,0,0,0
20150105.144155,2805.91,34,1331748,0,0,0,0,0,0
20150105.144156,2805.91,2,1331750,0,0,0,0,0,0
20150105.144157,2806.54,6,1331756,6,0,0,0,0,0
20150105.144158,2806.54,2,1331758,0,0,0,0,0,0
20150105.144159,2806.54,6,1331764,4,0,0,0,0,0
20150105.1442,2806.54,26,1331790,26,0,0,0,0,0
20150105.144201,2806.54,268,1332058,-162,0,0,0,0,0
20150105.144202,2806.54,20,1332078,0,0,0,0,0,0
20150105.144203,2806.54,60,1332138,0,0,0,0,0,0
20150105.144204,2806.54,4,1332142,-4,0,0,0,0,0
20150105.144205,2806.54,2,1332144,-2,0,0,0,0,0
20150105.144206,2806.54,6,1332150,-4,0,0,0,0,0
20150105.144207,2807.16,6,1332156,0,0,0,0,0,0
20150105.144208,2807.16,2,1332158,2,0,0,0,0,0
20150105.144209,2807.16,2,1332160,0,0,0,0,0,0
20150105.14421,2806.54,12,1332172,-10,0,0,0,0,0
20150105.144211,2806.54,10,1332182,10,0,0,0,0,0
20150105.144212,2807.16,40,1332222,0,0,0,0,0,0
20150105.144213,2806.54,2,1332224,2,0,0,0,0,0
20150105.144214,2807.16,400,1332624,-26,0,0,0,0,0
20150105.144215,2806.54,2,1332626,2,0,0,0,0,0
20150105.144216,2807.16,10,1332636,-10,0,0,0,0,0
20150105.144217,2806.54,8,1332644,0,0,0,0,0,0
20150105.144218,2807.16,2,1332646,-2,0,0,0,0,0
20150105.144219,2806.54,2,1332648,0,0,0,0,0,0
20150105.14422,2806.54,2,1332650,2,0,0,0,0,0
20150105.144221,2806.54,66,1332716,-14,0,0,0,0,0
20150105.144222,2807.16,260,1332976,2,0,0,0,0,0
20150105.144223,2807.16,2,1332978,0,0,0,0,0,0
20150105.144224,2806.54,438,1333416,410,0,0,0,0,0
20150105.144225,2806.54,8,1333424,8,0,0,0,0,0
20150105.144226,2807.16,2,1333426,0,0,0,0,0,0
20150105.144227,2806.54,24,1333450,24,0,0,0,0,0
20150105.144228,2806.54,436,1333886,82,0,0,0,0,0
20150105.144229,2806.54,6,1333892,6,0,0,0,0,0
20150105.14423,2806.54,16,1333908,-16,0,0,0,0,0
20150105.144231,2807.16,4,1333912,4,0,0,0,0,0
20150105.144232,2807.16,20,1333932,0,0,0,0,0,0
20150105.144233,2806.54,2,1333934,0,0,0,0,0,0
20150105.144234,2805.91,6,1333940,0,0,0,0,0,0
20150105.144235,2806.54,2,1333942,0,0,0,0,0,0
20150105.144236,2807.16,2,1333944,2,0,0,0,0,0
20150105.144237,2806.54,24,1333968,18,0,0,0,0,0
20150105.144238,2806.54,8,1333976,2,0,0,0,0,0
20150105.144239,2806.54,4,1333980,0,0,0,0,0,0
20150105.14424,2805.91,4,1333984,-2,0,0,0,0,0
20150105.144241,2806.54,2,1333986,0,0,0,0,0,0
20150105.144242,2806.54,2,1333988,0,0,0,0,0,0
20150105.144243,2806.54,36,1334024,0,0,0,0,0,0
20150105.144244,2805.91,66,1334090,-60,0,0,0,0,0
20150105.144245,2806.54,14,1334104,-12,0,0,0,0,0
20150105.144246,2806.54,4,1334108,-4,0,0,0,0,0
20150105.144247,2806.54,2,1334110,0,0,0,0,0,0
20150105.144248,2806.54,46,1334156,-44,0,0,0,0,0
20150105.144249,2806.54,6,1334162,0,0,0,0,0,0
20150105.14425,2806.54,42,1334204,-30,0,0,0,0,0
20150105.144251,2806.54,16,1334220,-12,0,0,0,0,0
20150105.144252,2806.54,34,1334254,-4,0,0,0,0,0
20150105.144253,2806.54,4,1334258,2,0,0,0,0,0
20150105.144254,2806.54,54,1334312,54,0,0,0,0,0
20150105.144255,2806.54,2,1334314,0,0,0,0,0,0
20150105.144256,2806.54,20,1334334,0,0,0,0,0,0
20150105.144257,2806.54,12,1334346,8,0,0,0,0,0
20150105.144258,2806.54,8,1334354,0,0,0,0,0,0
20150105.144259,2806.54,6,1334360,6,0,0,0,0,0
20150105.1443,2806.54,2,1334362,2,0,0,0,0,0
20150105.144301,2806.54,6,1334368,-6,0,0,0,0,0
20150105.144302,2806.54,2,1334370,0,0,0,0,0,0
20150105.144303,2807.16,26,1334396,0,0,0,0,0,0
20150105.144304,2807.16,10,1334406,10,0,0,0,0,0
20150105.144305,2807.16,4,1334410,4,0,0,0,0,0
20150105.144306,2806.54,4,1334414,0,0,0,0,0,0
20150105.144307,2806.54,2,1334416,0,0,0,0,0,0
20150105.144308,2807.16,2,1334418,2,0,0,0,0,0
20150105.144309,2807.16,2,1334420,2,0,0,0,0,0
20150105.14431,2806.54,4,1334424,0,0,0,0,0,0
20150105.144311,2807.16,2,1334426,2,0,0,0,0,0
20150105.144312,2806.54,2,1334428,0,0,0,0,0,0
20150105.144313,2806.54,2,1334430,-2,0,0,0,0,0
20150105.144314,2806.54,10,1334440,-10,0,0,0,0,0
20150105.144315,2807.16,2,1334442,2,0,0,0,0,0
20150105.144316,2806.54,8,1334450,-8,0,0,0,0,0
20150105.144317,2806.54,2,1334452,0,0,0,0,0,0
20150105.144318,2806.54,30,1334482,-14,0,0,0,0,0
20150105.144319,2807.16,198,1334680,80,0,0,0,0,0
20150105.14432,2807.16,6,1334686,6,0,0,0,0,0
20150105.144321,2807.16,8,1334694,8,0,0,0,0,0
20150105.144322,2807.16,8,1334702,8,0,0,0,0,0
20150105.144323,2807.16,8,1334710,6,0,0,0,0,0
20150105.144324,2807.16,8,1334718,8,0,0,0,0,0
20150105.144325,2807.16,48,1334766,48,0,0,0,0,0
20150105.144326,2806.54,6,1334772,4,0,0,0,0,0
20150105.144327,2807.16,8,1334780,8,0,0,0,0,0
20150105.144328,2807.16,4,1334784,4,0,0,0,0,0
20150105.144329,2807.16,8,1334792,8,0,0,0,0,0
20150105.14433,2807.16,8,1334800,8,0,0,0,0,0
20150105.144331,2807.16,1372,1336172,-456,0,0,0,0,0
20150105.144332,2807.16,2,1336174,0,0,0,0,0,0
20150105.144333,2807.16,20,1336194,6,0,0,0,0,0
20150105.144334,2807.79,180,1336374,-124,0,0,0,0,0
20150105.144335,2807.16,4,1336378,-4,0,0,0,0,0
20150105.144336,2807.79,746,1337124,-92,0,0,0,0,0
20150105.144337,2807.16,18,1337142,4,0,0,0,0,0
20150105.144338,2807.16,2,1337144,0,0,0,0,0,0
20150105.144339,2807.16,84,1337228,2,0,0,0,0,0
20150105.14434,2807.16,328,1337556,224,0,0,0,0,0
20150105.144341,2807.16,4,1337560,0,0,0,0,0,0
20150105.144342,2807.16,216,1337776,144,0,0,0,0,0
20150105.144343,2807.16,4,1337780,2,0,0,0,0,0
20150105.144344,2807.16,22,1337802,22,0,0,0,0,0
20150105.144345,2807.16,2,1337804,0,0,0,0,0,0
20150105.144346,2807.16,22,1337826,2,0,0,0,0,0
20150105.144347,2807.16,200,1338026,0,0,0,0,0,0
20150105.144348,2806.54,4,1338030,0,0,0,0,0,0
20150105.144349,2807.16,2,1338032,0,0,0,0,0,0
20150105.14435,2806.54,2,1338034,2,0,0,0,0,0
20150105.144351,2807.16,8,1338042,8,0,0,0,0,0
20150105.144352,2807.16,6,1338048,2,0,0,0,0,0
20150105.144353,2807.16,2,1338050,2,0,0,0,0,0
20150105.144354,2806.54,4,1338054,4,0,0,0,0,0
20150105.144355,2806.54,8,1338062,0,0,0,0,0,0
20150105.144356,2806.54,100,1338162,-98,0,0,0,0,0
20150105.144357,2807.16,10,1338172,10,0,0,0,0,0
20150105.144358,2806.54,12,1338184,-10,0,0,0,0,0
20150105.144359,2806.54,10,1338194,0,0,0,0,0,0
20150105.1444,2806.54,194,1338388,108,0,0,0,0,0
20150105.144401,2806.54,200,1338588,-10,0,0,0,0,0
20150105.144402,2806.54,252,1338840,54,0,0,0,0,0
20150105.144403,2806.54,2,1338842,-2,0,0,0,0,0
20150105.144404,2806.54,4,1338846,0,0,0,0,0,0
20150105.144405,2806.54,20,1338866,0,0,0,0,0,0
20150105.144406,2807.16,2,1338868,2,0,0,0,0,0
20150105.144407,2806.54,2178,1341046,548,0,0,0,0,0
20150105.144408,2806.54,426,1341472,-248,0,0,0,0,0
20150105.144409,2806.54,2,1341474,0,0,0,0,0,0
20150105.14441,2805.91,120,1341594,104,0,0,0,0,0
20150105.144411,2805.91,140,1341734,122,0,0,0,0,0
20150105.144412,2806.54,4,1341738,-4,0,0,0,0,0
20150105.144413,2805.91,356,1342094,142,0,0,0,0,0
20150105.144414,2806.54,4,1342098,0,0,0,0,0,0
20150105.144415,2805.91,12,1342110,4,0,0,0,0,0
20150105.144416,2805.91,36,1342146,4,0,0,0,0,0
20150105.144417,2805.91,58,1342204,-28,0,0,0,0,0
20150105.144418,2805.29,2,1342206,2,0,0,0,0,0
20150105.144419,2805.29,42,1342248,-8,0,0,0,0,0
20150105.14442,2805.29,58,1342306,-6,0,0,0,0,0
20150105.144421,2805.91,26,1342332,24,0,0,0,0,0
20150105.144422,2805.91,4,1342336,4,0,0,0,0,0
20150105.144423,2805.91,290,1342626,50,0,0,0,0,0
20150105.144424,2805.91,8,1342634,8,0,0,0,0,0
20150105.144425,2805.91,4,1342638,0,0,0,0,0,0
20150105.144426,2805.91,40,1342678,30,0,0,0,0,0
20150105.144427,2805.91,2,1342680,2,0,0,0,0,0
20150105.144428,2805.29,52,1342732,52,0,0,0,0,0
20150105.144429,2805.91,24,1342756,6,0,0,0,0,0
20150105.14443,2805.91,6,1342762,4,0,0,0,0,0
20150105.144431,2805.29,10,1342772,4,0,0,0,0,0
20150105.144432,2805.91,12,1342784,12,0,0,0,0,0
20150105.144433,2805.91,2,1342786,2,0,0,0,0,0
20150105.144434,2805.91,180,1342966,80,0,0,0,0,0
20150105.144435,2805.91,10,1342976,10,0,0,0,0,0
20150105.144436,2805.29,60,1343036,22,0,0,0,0,0
20150105.144437,2805.29,2,1343038,-2,0,0,0,0,0
20150105.144438,2805.29,10,1343048,0,0,0,0,0,0
20150105.144439,2805.91,32,1343080,-16,0,0,0,0,0
20150105.14444,2805.91,2,1343082,0,0,0,0,0,0
20150105.144441,2805.91,2,1343084,0,0,0,0,0,0
20150105.144442,2805.91,62,1343146,-58,0,0,0,0,0
20150105.144443,2805.91,6,1343152,0,0,0,0,0,0
20150105.144444,2805.29,194,1343346,86,0,0,0,0,0
20150105.144445,2805.91,2,1343348,2,0,0,0,0,0
20150105.144446,2805.91,4,1343352,4,0,0,0,0,0
20150105.144447,2805.91,8,1343360,8,0,0,0,0,0
20150105.144448,2805.91,150,1343510,50,0,0,0,0,0
20150105.144449,2805.29,2,1343512,0,0,0,0,0,0
20150105.14445,2805.91,6,1343518,6,0,0,0,0,0
20150105.144451,2805.29,178,1343696,6,0,0,0,0,0
20150105.144452,2805.91,8,1343704,8,0,0,0,0,0
20150105.144453,2805.29,10,1343714,10,0,0,0,0,0
20150105.144454,2805.91,8,1343722,8,0,0,0,0,0
20150105.144455,2805.29,6,1343728,4,0,0,0,0,0
20150105.144456,2805.29,8,1343736,8,0,0,0,0,0
20150105.144457,2805.91,8,1343744,8,0,0,0,0,0
20150105.144458,2805.29,6,1343750,4,0,0,0,0,0
20150105.144459,2805.91,8,1343758,8,0,0,0,0,0
20150105.1445,2805.29,6,1343764,4,0,0,0,0,0
20150105.144501,2805.91,758,1344522,-530,0,0,0,0,0
20150105.144502,2806.54,548,1345070,-456,0,0,0,0,0
20150105.144503,2806.54,8,1345078,-8,0,0,0,0,0
20150105.144504,2806.54,8,1345086,0,0,0,0,0,0
20150105.144505,2806.54,66,1345152,-18,0,0,0,0,0
20150105.144506,2805.91,80,1345232,0,0,0,0,0,0
20150105.144507,2806.54,86,1345318,2,0,0,0,0,0
20150105.144508,2806.54,2,1345320,0,0,0,0,0,0
20150105.144509,2806.54,2,1345322,0,0,0,0,0,0
20150105.14451,2806.54,2,1345324,-2,0,0,0,0,0
20150105.144511,2806.54,8,1345332,0,0,0,0,0,0
20150105.144512,2806.54,60,1345392,-56,0,0,0,0,0
20150105.144513,2805.91,50,1345442,-34,0,0,0,0,0
20150105.144514,2806.54,30,1345472,0,0,0,0,0,0
20150105.144515,2806.54,4,1345476,4,0,0,0,0,0
20150105.144516,2805.91,2,1345478,0,0,0,0,0,0
20150105.144517,2805.91,6,1345484,6,0,0,0,0,0
20150105.144518,2806.54,12,1345496,12,0,0,0,0,0
20150105.144519,2806.54,8,1345504,2,0,0,0,0,0
20150105.14452,2805.91,42,1345546,-16,0,0,0,0,0
20150105.144521,2806.54,12,1345558,-4,0,0,0,0,0
20150105.144522,2806.54,10,1345568,6,0,0,0,0,0
20150105.144523,2806.54,10,1345578,0,0,0,0,0,0
20150105.144524,2805.91,40,1345618,40,0,0,0,0,0
20150105.144525,2806.54,2,1345620,0,0,0,0,0,0
20150105.144526,2805.91,4,1345624,0,0,0,0,0,0
20150105.144527,2806.54,2,1345626,0,0,0,0,0,0
20150105.144528,2805.91,16,1345642,0,0,0,0,0,0
20150105.144529,2805.91,16,1345658,16,0,0,0,0,0
20150105.14453,2805.91,10,1345668,10,0,0,0,0,0
20150105.144531,2806.54,2,1345670,-2,0,0,0,0,0
20150105.144532,2805.91,180,1345850,96,0,0,0,0,0
20150105.144533,2805.91,4,1345854,0,0,0,0,0,0
20150105.144534,2805.91,2,1345856,0,0,0,0,0,0
20150105.144535,2806.54,500,1346356,-226,0,0,0,0,0
20150105.144536,2806.54,2,1346358,0,0,0,0,0,0
20150105.144537,2806.54,6,1346364,-4,0,0,0,0,0
20150105.144538,2806.54,6,1346370,2,0,0,0,0,0
20150105.144539,2806.54,4,1346374,0,0,0,0,0,0
20150105.14454,2805.91,4,1346378,-4,0,0,0,0,0
20150105.144541,2806.54,2,1346380,-2,0,0,0,0,0
20150105.144542,2805.91,86,1346466,48,0,0,0,0,0
20150105.144543,2805.91,116,1346582,78,0,0,0,0,0
20150105.144544,2806.54,6,1346588,0,0,0,0,0,0
20150105.144545,2806.54,2,1346590,0,0,0,0,0,0
20150105.144546,2806.54,20,1346610,-20,0,0,0,0,0
20150105.144547,2806.54,4,1346614,0,0,0,0,0,0
20150105.144548,2806.54,2,1346616,-2,0,0,0,0,0
20150105.144549,2805.91,2,1346618,2,0,0,0,0,0
20150105.14455,2806.54,2,1346620,-2,0,0,0,0,0
20150105.144551,2805.91,196,1346816,44,0,0,0,0,0
20150105.144552,2805.91,62,1346878,-14,0,0,0,0,0
20150105.144553,2805.91,394,1347272,-98,0,0,0,0,0
20150105.144554,2805.91,42,1347314,-36,0,0,0,0,0
20150105.144555,2805.91,2,1347316,0,0,0,0,0,0
20150105.144556,2805.91,20,1347336,-20,0,0,0,0,0
20150105.144557,2805.91,22,1347358,22,0,0,0,0,0
20150105.144558,2805.91,78,1347436,0,0,0,0,0,0
20150105.144559,2805.29,2,1347438,0,0,0,0,0,0
20150105.1446,2805.91,4,1347442,0,0,0,0,0,0
20150105.144601,2805.91,4,1347446,0,0,0,0,0,0
20150105.144602,2805.91,2,1347448,0,0,0,0,0,0
20150105.144603,2805.91,12,1347460,-2,0,0,0,0,0
20150105.144604,2805.91,138,1347598,6,0,0,0,0,0
20150105.144605,2805.91,20,1347618,20,0,0,0,0,0
20150105.144606,2805.91,6,1347624,4,0,0,0,0,0
20150105.144607,2806.54,4,1347628,-2,0,0,0,0,0
20150105.144608,2806.54,2,1347630,2,0,0,0,0,0
20150105.144609,2805.91,2,1347632,2,0,0,0,0,0
20150105.14461,2806.54,2,1347634,2,0,0,0,0,0
20150105.144611,2805.91,2,1347636,2,0,0,0,0,0
20150105.144612,2805.91,4,1347640,0,0,0,0,0,0
20150105.144613,2805.91,4,1347644,4,0,0,0,0,0
20150105.144614,2805.91,10,1347654,10,0,0,0,0,0
20150105.144615,2806.54,8,1347662,0,0,0,0,0,0
20150105.144616,2805.91,2,1347664,0,0,0,0,0,0
20150105.144617,2805.91,20,1347684,0,0,0,0,0,0
20150105.144618,2805.91,4,1347688,2,0,0,0,0,0
20150105.144619,2805.91,10,1347698,10,0,0,0,0,0
20150105.14462,2806.54,30,1347728,4,0,0,0,0,0
20150105.144621,2806.54,2,1347730,-2,0,0,0,0,0
20150105.144622,2805.91,10,1347740,0,0,0,0,0,0
20150105.144623,2805.91,10,1347750,10,0,0,0,0,0
20150105.144624,2806.54,2,1347752,0,0,0,0,0,0
20150105.144625,2805.91,20,1347772,0,0,0,0,0,0
20150105.144626,2805.91,8,1347780,2,0,0,0,0,0
20150105.144627,2805.91,2,1347782,0,0,0,0,0,0
20150105.144628,2806.54,102,1347884,22,0,0,0,0,0
20150105.144629,2806.54,2,1347886,2,0,0,0,0,0
20150105.14463,2805.91,2,1347888,2,0,0,0,0,0
20150105.144631,2805.91,492,1348380,66,0,0,0,0,0
20150105.144632,2805.91,2,1348382,-2,0,0,0,0,0
20150105.144633,2806.54,6,1348388,0,0,0,0,0,0
20150105.144634,2805.91,2,1348390,-2,0,0,0,0,0
20150105.144635,2805.91,6,1348396,-6,0,0,0,0,0
20150105.144636,2805.91,6,1348402,0,0,0,0,0,0
20150105.144637,2805.91,6,1348408,0,0,0,0,0,0
20150105.144638,2805.91,400,1348808,-388,0,0,0,0,0
20150105.144639,2805.91,4,1348812,-4,0,0,0,0,0
20150105.14464,2805.91,2,1348814,0,0,0,0,0,0
20150105.144641,2805.91,184,1348998,88,0,0,0,0,0
20150105.144642,2805.91,16,1349014,16,0,0,0,0,0
20150105.144643,2805.91,4,1349018,4,0,0,0,0,0
20150105.144644,2805.91,2,1349020,0,0,0,0,0,0
20150105.144645,2805.91,496,1349516,-126,0,0,0,0,0
20150105.144646,2805.91,4,1349520,-4,0,0,0,0,0
20150105.144647,2805.91,128,1349648,-28,0,0,0,0,0
20150105.144648,2805.91,242,1349890,0,0,0,0,0,0
20150105.144649,2805.91,10,1349900,0,0,0,0,0,0
20150105.14465,2805.91,210,1350110,-210,0,0,0,0,0
20150105.144651,2805.91,278,1350388,-188,0,0,0,0,0
20150105.144652,2805.91,30,1350418,-30,0,0,0,0,0
20150105.144653,2805.91,336,1350754,2,0,0,0,0,0
20150105.144654,2805.91,400,1351154,-296,0,0,0,0,0
20150105.144655,2805.29,516,1351670,-310,0,0,0,0,0
20150105.144656,2805.91,2,1351672,-2,0,0,0,0,0
20150105.144657,2805.29,2,1351674,0,0,0,0,0,0
20150105.144658,2805.91,108,1351782,-108,0,0,0,0,0
20150105.144659,2805.91,2,1351784,0,0,0,0,0,0
20150105.1447,2805.91,2,1351786,0,0,0,0,0,0
20150105.144701,2805.91,2,1351788,0,0,0,0,0,0
20150105.144702,2805.91,10,1351798,0,0,0,0,0,0
20150105.144703,2805.91,2,1351800,0,0,0,0,0,0
20150105.144704,2805.91,12,1351812,0,0,0,0,0,0
20150105.144705,2805.91,2,1351814,0,0,0,0,0,0
20150105.144706,2805.91,2,1351816,0,0,0,0,0,0
20150105.144707,2805.29,10,1351826,0,0,0,0,0,0
20150105.144708,2805.29,2,1351828,0,0,0,0,0,0
20150105.144709,2805.91,8,1351836,-8,0,0,0,0,0
20150105.14471,2805.91,2,1351838,0,0,0,0,0,0
20150105.144711,2805.91,2,1351840,0,0,0,0,0,0
20150105.144712,2805.91,4,1351844,0,0,0,0,0,0
20150105.144713,2805.91,2,1351846,0,0,0,0,0,0
20150105.144714,2805.91,2,1351848,-2,0,0,0,0,0
20150105.144715,2805.91,2,1351850,-2,0,0,0,0,0
20150105.144716,2805.91,4,1351854,0,0,0,0,0,0
20150105.144717,2805.91,4,1351858,0,0,0,0,0,0
20150105.144718,2805.91,8,1351866,4,0,0,0,0,0
20150105.144719,2805.29,66,1351932,66,0,0,0,0,0
20150105.14472,2805.91,14,1351946,0,0,0,0,0,0
20150105.144721,2805.91,140,1352086,-138,0,0,0,0,0
20150105.144722,2805.91,2,1352088,2,0,0,0,0,0
20150105.144723,2805.91,6,1352094,6,0,0,0,0,0
20150105.144724,2805.91,6,1352100,6,0,0,0,0,0
20150105.144725,2805.91,20,1352120,0,0,0,0,0,0
20150105.144726,2805.29,202,1352322,202,0,0,0,0,0
20150105.144727,2805.91,2,1352324,2,0,0,0,0,0
20150105.144728,2805.91,2,1352326,2,0,0,0,0,0
20150105.144729,2805.91,4,1352330,4,0,0,0,0,0
20150105.14473,2805.91,4,1352334,4,0,0,0,0,0
20150105.144731,2805.91,100,1352434,96,0,0,0,0,0
20150105.144732,2805.91,12,1352446,12,0,0,0,0,0
20150105.144733,2805.91,108,1352554,108,0,0,0,0,0
20150105.144734,2805.29,194,1352748,194,0,0,0,0,0
20150105.144735,2805.29,2,1352750,0,0,0,0,0,0
20150105.144736,2805.29,18,1352768,18,0,0,0,0,0
20150105.144737,2805.91,6,1352774,6,0,0,0,0,0
20150105.144738,2805.91,6,1352780,6,0,0,0,0,0
20150105.144739,2805.91,24,1352804,22,0,0,0,0,0
20150105.14474,2805.91,102,1352906,2,0,0,0,0,0
20150105.144741,2805.91,2,1352908,2,0,0,0,0,0
20150105.144742,2805.91,42,1352950,2,0,0,0,0,0
20150105.144743,2805.91,2,1352952,2,0,0,0,0,0
20150105.144744,2805.91,20,1352972,20,0,0,0,0,0
20150105.144745,2805.91,4,1352976,2,0,0,0,0,0
20150105.144746,2805.91,2,1352978,0,0,0,0,0,0
20150105.144747,2805.91,2,1352980,2,0,0,0,0,0
20150105.144748,2805.29,2,1352982,0,0,0,0,0,0
20150105.144749,2805.91,20,1353002,20,0,0,0,0,0
20150105.14475,2805.91,2,1353004,2,0,0,0,0,0
20150105.144751,2805.91,2,1353006,0,0,0,0,0,0
20150105.144752,2805.91,2,1353008,0,0,0,0,0,0
20150105.144753,2805.29,2,1353010,0,0,0,0,0,0
20150105.144754,2805.29,22,1353032,22,0,0,0,0,0
20150105.144755,2805.29,216,1353248,212,0,0,0,0,0
20150105.144756,2805.29,1000,1354248,494,0,0,0,0,0
20150105.144757,2805.29,2,1354250,-2,0,0,0,0,0
20150105.144758,2805.29,298,1354548,20,0,0,0,0,0
20150105.144759,2805.29,32,1354580,2,0,0,0,0,0
20150105.1448,2805.29,2,1354582,0,0,0,0,0,0
20150105.144801,2805.29,2,1354584,-2,0,0,0,0,0
20150105.144802,2805.29,204,1354788,-4,0,0,0,0,0
20150105.144803,2805.29,2,1354790,-2,0,0,0,0,0
20150105.144804,2805.29,2,1354792,-2,0,0,0,0,0
20150105.144805,2805.29,8,1354800,-4,0,0,0,0,0
20150105.144806,2805.91,384,1355184,-324,0,0,0,0,0
20150105.144807,2805.91,12,1355196,4,0,0,0,0,0
20150105.144808,2805.29,2,1355198,-2,0,0,0,0,0
20150105.144809,2805.91,20,1355218,20,0,0,0,0,0
20150105.14481,2805.29,66,1355284,-66,0,0,0,0,0
20150105.144811,2805.29,6,1355290,2,0,0,0,0,0
20150105.144812,2805.29,624,1355914,-524,0,0,0,0,0
20150105.144813,2805.91,2,1355916,2,0,0,0,0,0
20150105.144814,2805.29,20,1355936,2,0,0,0,0,0
20150105.144815,2805.29,2,1355938,-2,0,0,0,0,0
20150105.144816,2805.29,18,1355956,0,0,0,0,0,0
20150105.144817,2805.29,2,1355958,0,0,0,0,0,0
20150105.144818,2805.29,16,1355974,-16,0,0,0,0,0
20150105.144819,2805.29,4,1355978,0,0,0,0,0,0
20150105.14482,2805.29,12,1355990,-2,0,0,0,0,0
20150105.144821,2805.29,52,1356042,20,0,0,0,0,0
20150105.144822,2805.29,296,1356338,178,0,0,0,0,0
20150105.144823,2805.29,18,1356356,8,0,0,0,0,0
20150105.144824,2805.29,68,1356424,-30,0,0,0,0,0
20150105.144825,2805.29,42,1356466,0,0,0,0,0,0
20150105.144826,2805.29,12,1356478,-2,0,0,0,0,0
20150105.144827,2805.29,92,1356570,-70,0,0,0,0,0
20150105.144828,2805.29,440,1357010,-234,0,0,0,0,0
20150105.144829,2805.29,32,1357042,32,0,0,0,0,0
20150105.14483,2805.29,112,1357154,60,0,0,0,0,0
20150105.144831,2805.29,566,1357720,160,0,0,0,0,0
20150105.144832,2805.29,2,1357722,-2,0,0,0,0,0
20150105.144833,2805.91,1000,1358722,662,0,0,0,0,0
20150105.144834,2805.29,10,1358732,0,0,0,0,0,0
20150105.144835,2805.29,2,1358734,0,0,0,0,0,0
20150105.144836,2805.29,22,1358756,16,0,0,0,0,0
20150105.144837,2805.29,2,1358758,2,0,0,0,0,0
20150105.144838,2805.91,2,1358760,0,0,0,0,0,0
20150105.144839,2805.29,14,1358774,-12,0,0,0,0,0
20150105.14484,2805.29,190,1358964,-188,0,0,0,0,0
20150105.144841,2805.29,2,1358966,-2,0,0,0,0,0
20150105.144842,2805.29,32,1358998,-32,0,0,0,0,0
20150105.144843,2805.91,16,1359014,-6,0,0,0,0,0
20150105.144844,2805.29,62,1359076,-2,0,0,0,0,0
20150105.144845,2805.29,12,1359088,0,0,0,0,0,0
20150105.144846,2805.29,2,1359090,0,0,0,0,0,0
20150105.144847,2805.29,2,1359092,0,0,0,0,0,0
20150105.144848,2805.91,18,1359110,0,0,0,0,0,0
20150105.144849,2805.91,2,1359112,-2,0,0,0,0,0
20150105.14485,2805.29,2,1359114,-2,0,0,0,0,0
20150105.144851,2805.29,140,1359254,-130,0,0,0,0,0
20150105.144852,2805.29,12,1359266,-2,0,0,0,0,0
20150105.144853,2805.91,10,1359276,-10,0,0,0,0,0
20150105.144854,2805.29,22,1359298,-10,0,0,0,0,0
20150105.144855,2805.29,2,1359300,0,0,0,0,0,0
20150105.144856,2805.29,2,1359302,0,0,0,0,0,0
20150105.144857,2805.29,14,1359316,-12,0,0,0,0,0
20150105.144858,2805.29,2,1359318,-2,0,0,0,0,0
20150105.144859,2805.29,2,1359320,0,0,0,0,0,0
20150105.1449,2805.91,40,1359360,-40,0,0,0,0,0
20150105.144901,2805.29,10,1359370,0,0,0,0,0,0
20150105.144902,2805.29,10,1359380,-10,0,0,0,0,0
20150105.144903,2805.29,12,1359392,-12,0,0,0,0,0
20150105.144904,2805.29,2,1359394,0,0,0,0,0,0
20150105.144905,2805.91,8,1359402,-2,0,0,0,0,0
20150105.144906,2805.91,4,1359406,0,0,0,0,0,0
20150105.144907,2805.29,8,1359414,0,0,0,0,0,0
20150105.144908,2805.29,14,1359428,-12,0,0,0,0,0
20150105.144909,2805.29,2,1359430,-2,0,0,0,0,0
20150105.14491,2805.91,400,1359830,-152,0,0,0,0,0
20150105.144911,2805.29,2,1359832,-2,0,0,0,0,0
20150105.144912,2805.91,2,1359834,0,0,0,0,0,0
20150105.144913,2805.91,20,1359854,20,0,0,0,0,0
20150105.144914,2805.29,16,1359870,-16,0,0,0,0,0
20150105.144915,2805.29,2,1359872,-2,0,0,0,0,0
20150105.144916,2805.29,4,1359876,-2,0,0,0,0,0
20150105.144917,2805.29,2,1359878,-2,0,0,0,0,0
20150105.144918,2805.91,42,1359920,-34,0,0,0,0,0
20150105.144919,2805.91,22,1359942,0,0,0,0,0,0
20150105.14492,2805.91,6,1359948,0,0,0,0,0,0
20150105.144921,2805.29,4,1359952,0,0,0,0,0,0
20150105.144922,2805.29,12,1359964,-12,0,0,0,0,0
20150105.144923,2805.91,16,1359980,0,0,0,0,0,0
20150105.144924,2805.91,4,1359984,4,0,0,0,0,0
20150105.144925,2805.91,2,1359986,0,0,0,0,0,0
20150105.144926,2805.91,2,1359988,0,0,0,0,0,0
20150105.144927,2805.29,28,1360016,-28,0,0,0,0,0
20150105.144928,2805.91,400,1360416,-296,0,0,0,0,0
20150105.144929,2805.91,6,1360422,-6,0,0,0,0,0
20150105.14493,2805.91,2,1360424,-2,0,0,0,0,0
20150105.144931,2805.91,26,1360450,-16,0,0,0,0,0
20150105.144932,2805.91,14,1360464,-10,0,0,0,0,0
20150105.144933,2805.91,2,1360466,2,0,0,0,0,0
20150105.144934,2805.91,2,1360468,0,0,0,0,0,0
20150105.144935,2805.91,88,1360556,16,0,0,0,0,0
20150105.144936,2805.91,20,1360576,-18,0,0,0,0,0
20150105.144937,2805.91,10,1360586,0,0,0,0,0,0
20150105.144938,2805.91,26,1360612,-24,0,0,0,0,0
20150105.144939,2805.29,220,1360832,-108,0,0,0,0,0
20150105.14494,2805.91,10,1360842,-10,0,0,0,0,0
20150105.144941,2805.29,26,1360868,24,0,0,0,0,0
20150105.144942,2805.91,202,1361070,-198,0,0,0,0,0
20150105.144943,2805.91,2,1361072,0,0,0,0,0,0
20150105.144944,2805.29,46,1361118,0,0,0,0,0,0
20150105.144945,2805.91,8,1361126,0,0,0,0,0,0
20150105.144946,2805.29,160,1361286,84,0,0,0,0,0
20150105.144947,2805.91,2,1361288,-2,0,0,0,0,0
20150105.144948,2805.29,60,1361348,-4,0,0,0,0,0
20150105.144949,2805.91,4,1361352,-2,0,0,0,0,0
20150105.14495,2805.91,484,1361836,104,0,0,0,0,0
20150105.144951,2805.91,90,1361926,0,0,0,0,0,0
20150105.144952,2805.91,42,1361968,-28,0,0,0,0,0
20150105.144953,2805.91,14,1361982,-14,0,0,0,0,0
20150105.144954,2805.91,22,1362004,0,0,0,0,0,0
20150105.144955,2805.29,38,1362042,0,0,0,0,0,0
20150105.144956,2805.29,400,1362442,-74,0,0,0,0,0
20150105.144957,2805.29,14,1362456,-4,0,0,0,0,0
20150105.144958,2805.29,4,1362460,-4,0,0,0,0,0
20150105.144959,2805.29,4,1362464,-4,0,0,0,0,0
20150105.145,2805.91,2,1362466,-2,0,0,0,0,0
20150105.145001,2805.91,6,1362472,0,0,0,0,0,0
20150105.145002,2805.29,64,1362536,-62,0,0,0,0,0
20150105.145003,2805.91,2,1362538,-2,0,0,0,0,0
20150105.145004,2805.91,2,1362540,-2,0,0,0,0,0
20150105.145005,2805.91,128,1362668,0,0,0,0,0,0
20150105.145006,2805.29,16,1362684,-4,0,0,0,0,0
20150105.145007,2805.91,2,1362686,0,0,0,0,0,0
20150105.145008,2805.91,2,1362688,-2,0,0,0,0,0
20150105.145009,2805.29,600,1363288,188,0,0,0,0,0
20150105.14501,2805.29,136,1363424,76,0,0,0,0,0
20150105.145011,2805.29,2,1363426,0,0,0,0,0,0
20150105.145012,2805.29,20,1363446,2,0,0,0,0,0
20150105.145013,2804.66,22,1363468,-18,0,0,0,0,0
20150105.145014,2804.66,298,1363766,66,0,0,0,0,0
20150105.145015,2804.66,234,1364000,-124,0,0,0,0,0
20150105.145016,2804.66,4,1364004,-4,0,0,0,0,0
20150105.145017,2805.29,4,1364008,0,0,0,0,0,0
20150105.145018,2805.29,2,1364010,2,0,0,0,0,0
20150105.145019,2805.29,2,1364012,2,0,0,0,0,0
20150105.14502,2805.29,8,1364020,8,0,0,0,0,0
20150105.145021,2805.29,20,1364040,6,0,0,0,0,0
20150105.145022,2805.29,2,1364042,2,0,0,0,0,0
20150105.145023,2805.91,90,1364132,-86,0,0,0,0,0
20150105.145024,2805.29,110,1364242,98,0,0,0,0,0
20150105.145025,2805.29,66,1364308,0,0,0,0,0,0
20150105.145026,2804.66,102,1364410,-18,0,0,0,0,0
20150105.145027,2805.29,12,1364422,0,0,0,0,0,0
20150105.145028,2805.29,40,1364462,12,0,0,0,0,0
20150105.145029,2805.29,6,1364468,2,0,0,0,0,0
20150105.14503,2805.29,6,1364474,4,0,0,0,0,0
20150105.145031,2805.29,8,1364482,2,0,0,0,0,0
20150105.145032,2805.29,4,1364486,4,0,0,0,0,0
20150105.145033,2805.29,2,1364488,2,0,0,0,0,0
20150105.145034,2805.29,12,1364500,12,0,0,0,0,0
20150105.145035,2805.29,12,1364512,0,0,0,0,0,0
20150105.145036,2805.91,200,1364712,-98,0,0,0,0,0
20150105.145037,2805.29,2,1364714,0,0,0,0,0,0
20150105.145038,2805.91,2,1364716,2,0,0,0,0,0
20150105.145039,2805.91,2,1364718,0,0,0,0,0,0
20150105.14504,2805.91,6,1364724,2,0,0,0,0,0
20150105.145041,2805.91,2,1364726,2,0,0,0,0,0
20150105.145042,2805.29,2,1364728,0,0,0,0,0,0
20150105.145043,2805.29,2,1364730,2,0,0,0,0,0
20150105.145044,2805.91,10,1364740,0,0,0,0,0,0
20150105.145045,2805.29,20,1364760,0,0,0,0,0,0
20150105.145046,2805.29,6,1364766,4,0,0,0,0,0
20150105.145047,2805.29,4,1364770,4,0,0,0,0,0
20150105.145048,2805.29,176,1364946,-106,0,0,0,0,0
20150105.145049,2805.29,2,1364948,0,0,0,0,0,0
20150105.14505,2805.91,216,1365164,64,0,0,0,0,0
20150105.145051,2805.29,2,1365166,0,0,0,0,0,0
20150105.145052,2805.91,2,1365168,2,0,0,0,0,0
20150105.145053,2805.29,2,1365170,0,0,0,0,0,0
20150105.145054,2805.91,2,1365172,2,0,0,0,0,0
20150105.145055,2805.29,2,1365174,-2,0,0,0,0,0
20150105.145056,2805.29,10,1365184,-8,0,0,0,0,0
20150105.145057,2805.29,4,1365188,-4,0,0,0,0,0
20150105.145058,2805.29,40,1365228,28,0,0,0,0,0
20150105.145059,2805.29,94,1365322,48,0,0,0,0,0
20150105.1451,2805.29,978,1366300,610,0,0,0,0,0
20150105.145101,2805.29,492,1366792,324,0,0,0,0,0
20150105.145102,2805.29,40,1366832,30,0,0,0,0,0
20150105.145103,2805.29,64,1366896,-52,0,0,0,0,0
20150105.145104,2805.91,4,1366900,4,0,0,0,0,0
20150105.145105,2805.29,102,1367002,-72,0,0,0,0,0
20150105.145106,2805.91,2,1367004,0,0,0,0,0,0
20150105.145107,2805.29,26,1367030,-14,0,0,0,0,0
20150105.145108,2805.29,14,1367044,-12,0,0,0,0,0
20150105.145109,2805.29,178,1367222,22,0,0,0,0,0
20150105.14511,2805.29,28,1367250,-8,0,0,0,0,0
20150105.145111,2805.29,4,1367254,-2,0,0,0,0,0
20150105.145112,2805.91,10,1367264,-10,0,0,0,0,0
20150105.145113,2805.29,78,1367342,-12,0,0,0,0,0
20150105.145114,2805.29,4,1367346,4,0,0,0,0,0
20150105.145115,2805.29,6,1367352,-2,0,0,0,0,0
20150105.145116,2805.91,2,1367354,-2,0,0,0,0,0
20150105.145117,2805.29,64,1367418,32,0,0,0,0,0
20150105.145118,2805.29,12,1367430,-12,0,0,0,0,0
20150105.145119,2805.91,352,1367782,-276,0,0,0,0,0
20150105.14512,2805.29,2,1367784,-2,0,0,0,0,0
20150105.145121,2805.29,32,1367816,-32,0,0,0,0,0
20150105.145122,2805.29,2,1367818,-2,0,0,0,0,0
20150105.145123,2805.29,2,1367820,0,0,0,0,0,0
20150105.145124,2805.91,10,1367830,2,0,0,0,0,0
20150105.145125,2805.29,10,1367840,8,0,0,0,0,0
20150105.145126,2805.91,4,1367844,0,0,0,0,0,0
20150105.145127,2805.29,4,1367848,-2,0,0,0,0,0
20150105.145128,2805.29,4,1367852,4,0,0,0,0,0
20150105.145129,2805.91,4,1367856,0,0,0,0,0,0
20150105.14513,2805.91,16,1367872,-16,0,0,0,0,0
20150105.145131,2805.29,28,1367900,0,0,0,0,0,0
20150105.145132,2805.91,16,1367916,0,0,0,0,0,0
20150105.145133,2805.91,4,1367920,0,0,0,0,0,0
20150105.145134,2805.91,2,1367922,-2,0,0,0,0,0
20150105.145135,2805.91,10,1367932,-10,0,0,0,0,0
20150105.145136,2805.91,20,1367952,0,0,0,0,0,0
20150105.145137,2805.29,102,1368054,98,0,0,0,0,0
20150105.145138,2805.29,12,1368066,0,0,0,0,0,0
20150105.145139,2805.91,32,1368098,-12,0,0,0,0,0
20150105.14514,2805.91,2,1368100,0,0,0,0,0,0
20150105.145141,2805.91,30,1368130,0,0,0,0,0,0
20150105.145142,2805.91,2,1368132,0,0,0,0,0,0
20150105.145143,2805.29,438,1368570,214,0,0,0,0,0
20150105.145144,2805.29,752,1369322,280,0,0,0,0,0
20150105.145145,2805.91,2,1369324,-2,0,0,0,0,0
20150105.145146,2805.91,2,1369326,-2,0,0,0,0,0
20150105.145147,2805.29,2,1369328,0,0,0,0,0,0
20150105.145148,2805.29,60,1369388,0,0,0,0,0,0
20150105.145149,2805.29,8,1369396,-4,0,0,0,0,0
20150105.14515,2805.91,4,1369400,0,0,0,0,0,0
20150105.145151,2805.91,6,1369406,-6,0,0,0,0,0
20150105.145152,2805.91,4,1369410,-4,0,0,0,0,0
20150105.145153,2805.91,4,1369414,0,0,0,0,0,0
20150105.145154,2805.91,16,1369430,-16,0,0,0,0,0
20150105.145155,2805.91,910,1370340,-420,0,0,0,0,0
20150105.145156,2805.91,166,1370506,-66,0,0,0,0,0
20150105.145157,2805.91,10,1370516,-10,0,0,0,0,0
20150105.145158,2805.91,16,1370532,-16,0,0,0,0,0
20150105.145159,2805.91,8,1370540,-8,0,0,0,0,0
20150105.1452,2805.91,54,1370594,-54,0,0,0,0,0
20150105.145201,2805.91,212,1370806,-50,0,0,0,0,0
20150105.145202,2805.91,2,1370808,2,0,0,0,0,0
20150105.145203,2805.91,4,1370812,0,0,0,0,0,0
20150105.145204,2805.91,134,1370946,2,0,0,0,0,0
20150105.145205,2805.91,2,1370948,0,0,0,0,0,0
20150105.145206,2805.91,10,1370958,0,0,0,0,0,0
20150105.145207,2805.91,2,1370960,0,0,0,0,0,0
20150105.145208,2805.91,2,1370962,-2,0,0,0,0,0
20150105.145209,2805.91,210,1371172,-178,0,0,0,0,0
20150105.14521,2805.91,2,1371174,0,0,0,0,0,0
20150105.145211,2805.91,4,1371178,4,0,0,0,0,0
20150105.145212,2805.91,98,1371276,98,0,0,0,0,0
20150105.145213,2805.91,2,1371278,2,0,0,0,0,0
20150105.145214,2805.91,18,1371296,2,0,0,0,0,0
20150105.145215,2805.91,2,1371298,2,0,0,0,0,0
20150105.145216,2805.91,2,1371300,2,0,0,0,0,0
20150105.145217,2805.91,2,1371302,0,0,0,0,0,0
20150105.145218,2805.91,202,1371504,-98,0,0,0,0,0
20150105.145219,2805.91,26,1371530,6,0,0,0,0,0
20150105.14522,2805.91,8,1371538,0,0,0,0,0,0
20150105.145221,2805.91,28,1371566,4,0,0,0,0,0
20150105.145222,2805.91,4,1371570,2,0,0,0,0,0
20150105.145223,2805.91,606,1372176,-250,0,0,0,0,0
20150105.145224,2805.91,14,1372190,4,0,0,0,0,0
20150105.145225,2805.91,10,1372200,-4,0,0,0,0,0
20150105.145226,2805.91,2,1372202,-2,0,0,0,0,0
20150105.145227,2805.91,2,1372204,-2,0,0,0,0,0
20150105.145228,2805.29,2,1372206,0,0,0,0,0,0
20150105.145229,2805.91,2,1372208,0,0,0,0,0,0
20150105.14523,2805.91,24,1372232,-22,0,0,0,0,0
20150105.145231,2805.91,2,1372234,-2,0,0,0,0,0
20150105.145232,2805.91,2,1372236,-2,0,0,0,0,0
20150105.145233,2805.91,2,1372238,0,0,0,0,0,0
20150105.145234,2805.29,62,1372300,8,0,0,0,0,0
20150105.145235,2805.91,128,1372428,114,0,0,0,0,0
20150105.145236,2805.91,10,1372438,10,0,0,0,0,0
20150105.145237,2805.91,18,1372456,-14,0,0,0,0,0
20150105.145238,2805.91,8,1372464,-2,0,0,0,0,0
20150105.145239,2805.91,4,1372468,0,0,0,0,0,0
20150105.14524,2805.29,16,1372484,-16,0,0,0,0,0
20150105.145241,2805.91,44,1372528,-4,0,0,0,0,0
20150105.145242,2805.91,2,1372530,-2,0,0,0,0,0
20150105.145243,2805.91,2,1372532,0,0,0,0,0,0
20150105.145244,2805.91,106,1372638,-100,0,0,0,0,0
20150105.145245,2805.91,4,1372642,-2,0,0,0,0,0
20150105.145246,2805.91,2,1372644,0,0,0,0,0,0
20150105.145247,2805.91,10,1372654,0,0,0,0,0,0
20150105.145248,2805.91,2,1372656,0,0,0,0,0,0
20150105.145249,2805.91,10,1372666,-6,0,0,0,0,0
20150105.14525,2805.91,2,1372668,0,0,0,0,0,0
20150105.145251,2805.91,4,1372672,0,0,0,0,0,0
20150105.145252,2805.91,40,1372712,0,0,0,0,0,0
20150105.145253,2805.91,2,1372714,0,0,0,0,0,0
20150105.145254,2805.91,2,1372716,-2,0,0,0,0,0
20150105.145255,2805.91,48,1372764,0,0,0,0,0,0
20150105.145256,2805.91,10,1372774,-10,0,0,0,0,0
20150105.145257,2805.91,2,1372776,-2,0,0,0,0,0
20150105.145258,2805.91,12,1372788,-12,0,0,0,0,0
20150105.145259,2805.91,8,1372796,-6,0,0,0,0,0
20150105.1453,2805.91,34,1372830,-34,0,0,0,0,0
20150105.145301,2805.91,18,1372848,-18,0,0,0,0,0
20150105.145302,2805.91,2,1372850,0,0,0,0,0,0
20150105.145303,2805.91,6,1372856,0,0,0,0,0,0
20150105.145304,2805.91,100,1372956,-100,0,0,0,0,0
20150105.145305,2805.91,20,1372976,-20,0,0,0,0,0
20150105.145306,2805.91,2,1372978,0,0,0,0,0,0
20150105.145307,2805.91,20,1372998,0,0,0,0,0,0
20150105.145308,2805.91,10,1373008,0,0,0,0,0,0
20150105.145309,2805.91,10,1373018,-10,0,0,0,0,0
20150105.14531,2805.91,8,1373026,-8,0,0,0,0,0
20150105.145311,2805.91,2,1373028,-2,0,0,0,0,0
20150105.145312,2805.91,40,1373068,0,0,0,0,0,0
20150105.145313,2805.91,82,1373150,-76,0,0,0,0,0
20150105.145314,2805.91,80,1373230,24,0,0,0,0,0
20150105.145315,2806.54,2,1373232,-2,0,0,0,0,0
20150105.145316,2806.54,16,1373248,-16,0,0,0,0,0
20150105.145317,2806.54,2,1373250,-2,0,0,0,0,0
20150105.145318,2806.54,2,1373252,-2,0,0,0,0,0
20150105.145319,2805.91,2,1373254,0,0,0,0,0,0
20150105.14532,2805.91,108,1373362,-24,0,0,0,0,0
20150105.145321,2805.91,2,1373364,0,0,0,0,0,0
20150105.145322,2805.91,4,1373368,-2,0,0,0,0,0
20150105.145323,2805.91,2,1373370,-2,0,0,0,0,0
20150105.145324,2805.91,2,1373372,-2,0,0,0,0,0
20150105.145325,2805.91,2,1373374,0,0,0,0,0,0
20150105.145326,2805.29,4,1373378,-4,0,0,0,0,0
20150105.145327,2805.91,20,1373398,0,0,0,0,0,0
20150105.145328,2805.91,2,1373400,-2,0,0,0,0,0
20150105.145329,2805.91,4,1373404,0,0,0,0,0,0
20150105.14533,2805.91,12,1373416,-10,0,0,0,0,0
20150105.145331,2805.91,12,1373428,-2,0,0,0,0,0
20150105.145332,2805.91,4,1373432,-2,0,0,0,0,0
20150105.145333,2805.91,4,1373436,-4,0,0,0,0,0
20150105.145334,2805.29,2,1373438,0,0,0,0,0,0
20150105.145335,2805.91,14,1373452,-10,0,0,0,0,0
20150105.145336,2805.91,228,1373680,-184,0,0,0,0,0
20150105.145337,2805.29,180,1373860,78,0,0,0,0,0
20150105.145338,2805.91,10,1373870,0,0,0,0,0,0
20150105.145339,2805.91,42,1373912,-42,0,0,0,0,0
20150105.14534,2805.91,2,1373914,-2,0,0,0,0,0
20150105.145341,2805.91,20,1373934,-20,0,0,0,0,0
20150105.145342,2805.91,2,1373936,0,0,0,0,0,0
20150105.145343,2805.91,20,1373956,-20,0,0,0,0,0
20150105.145344,2805.91,2,1373958,0,0,0,0,0,0
20150105.145345,2805.91,4,1373962,-4,0,0,0,0,0
20150105.145346,2805.29,1050,1375012,1024,0,0,0,0,0
20150105.145347,2805.91,2,1375014,0,0,0,0,0,0
20150105.145348,2805.91,4,1375018,0,0,0,0,0,0
20150105.145349,2805.29,10,1375028,2,0,0,0,0,0
20150105.14535,2805.29,10,1375038,0,0,0,0,0,0
20150105.145351,2805.29,1050,1376088,404,0,0,0,0,0
20150105.145352,2804.66,2,1376090,-2,0,0,0,0,0
20150105.145353,2805.29,20,1376110,-6,0,0,0,0,0
20150105.145354,2805.29,10,1376120,0,0,0,0,0,0
20150105.145355,2805.29,38,1376158,-26,0,0,0,0,0
20150105.145356,2805.91,334,1376492,-6,0,0,0,0,0
20150105.145357,2805.29,12,1376504,0,0,0,0,0,0
20150105.145358,2805.29,18,1376522,0,0,0,0,0,0
20150105.145359,2805.29,14,1376536,4,0,0,0,0,0
20150105.1454,2805.29,2,1376538,2,0,0,0,0,0
20150105.145401,2805.29,4,1376542,4,0,0,0,0,0
20150105.145402,2805.29,22,1376564,2,0,0,0,0,0
20150105.145403,2805.29,4,1376568,2,0,0,0,0,0
20150105.145404,2805.29,4,1376572,2,0,0,0,0,0
20150105.145405,2805.29,4,1376576,-2,0,0,0,0,0
20150105.145406,2805.29,2,1376578,2,0,0,0,0,0
20150105.145407,2805.29,22,1376600,22,0,0,0,0,0
20150105.145408,2805.29,2,1376602,0,0,0,0,0,0
20150105.145409,2805.29,6,1376608,4,0,0,0,0,0
20150105.14541,2805.91,18,1376626,-18,0,0,0,0,0
20150105.145411,2805.29,2,1376628,0,0,0,0,0,0
20150105.145412,2805.91,172,1376800,-172,0,0,0,0,0
20150105.145413,2805.29,30,1376830,30,0,0,0,0,0
20150105.145414,2805.29,2,1376832,0,0,0,0,0,0
20150105.145415,2805.91,4,1376836,-4,0,0,0,0,0
20150105.145416,2805.29,2,1376838,2,0,0,0,0,0
20150105.145417,2805.91,2,1376840,0,0,0,0,0,0
20150105.145418,2805.91,2,1376842,0,0,0,0,0,0
20150105.145419,2805.29,10,1376852,0,0,0,0,0,0
20150105.14542,2805.29,10,1376862,0,0,0,0,0,0
20150105.145421,2805.29,200,1377062,86,0,0,0,0,0
20150105.145422,2805.91,74,1377136,-30,0,0,0,0,0
20150105.145423,2805.29,2,1377138,0,0,0,0,0,0
20150105.145424,2805.91,10,1377148,-10,0,0,0,0,0
20150105.145425,2805.91,2,1377150,-2,0,0,0,0,0
20150105.145426,2805.29,14,1377164,-8,0,0,0,0,0
20150105.145427,2805.29,4,1377168,-4,0,0,0,0,0
20150105.145428,2805.91,2,1377170,0,0,0,0,0,0
20150105.145429,2805.29,300,1377470,-64,0,0,0,0,0
20150105.14543,2805.29,2,1377472,2,0,0,0,0,0
20150105.145431,2805.91,2,1377474,0,0,0,0,0,0
20150105.145432,2805.29,8,1377482,4,0,0,0,0,0
20150105.145433,2805.29,6,1377488,6,0,0,0,0,0
20150105.145434,2805.91,1498,1378986,1170,0,0,0,0,0
20150105.145435,2805.29,20,1379006,12,0,0,0,0,0
20150105.145436,2805.29,2,1379008,0,0,0,0,0,0
20150105.145437,2805.91,2,1379010,0,0,0,0,0,0
20150105.145438,2805.29,4,1379014,0,0,0,0,0,0
20150105.145439,2805.91,14,1379028,4,0,0,0,0,0
20150105.14544,2805.91,40,1379068,-40,0,0,0,0,0
20150105.145441,2805.29,10,1379078,4,0,0,0,0,0
20150105.145442,2805.91,6,1379084,2,0,0,0,0,0
20150105.145443,2805.91,8,1379092,0,0,0,0,0,0
20150105.145444,2805.29,204,1379296,0,0,0,0,0,0
20150105.145445,2805.91,2,1379298,2,0,0,0,0,0
20150105.145446,2805.29,164,1379462,154,0,0,0,0,0
20150105.145447,2805.29,30,1379492,0,0,0,0,0,0
20150105.145448,2805.29,4,1379496,0,0,0,0,0,0
20150105.145449,2805.91,2,1379498,0,0,0,0,0,0
20150105.14545,2805.91,200,1379698,38,0,0,0,0,0
20150105.145451,2804.66,10,1379708,6,0,0,0,0,0
20150105.145452,2804.66,4,1379712,-2,0,0,0,0,0
20150105.145453,2805.91,24,1379736,-4,0,0,0,0,0
20150105.145454,2805.91,196,1379932,68,0,0,0,0,0
20150105.145455,2805.29,40,1379972,6,0,0,0,0,0
20150105.145456,2805.29,4,1379976,-2,0,0,0,0,0
20150105.145457,2805.29,2,1379978,2,0,0,0,0,0
20150105.145458,2805.91,2,1379980,2,0,0,0,0,0
20150105.145459,2805.91,2,1379982,0,0,0,0,0,0
20150105.1455,2805.91,2,1379984,0,0,0,0,0,0
20150105.145501,2805.29,2,1379986,2,0,0,0,0,0
20150105.145502,2805.29,18,1380004,8,0,0,0,0,0
20150105.145503,2805.91,8,1380012,-4,0,0,0,0,0
20150105.145504,2805.91,2,1380014,0,0,0,0,0,0
20150105.145505,2805.91,2,1380016,0,0,0,0,0,0
20150105.145506,2805.91,6,1380022,-2,0,0,0,0,0
20150105.145507,2805.91,24,1380046,2,0,0,0,0,0
20150105.145508,2805.91,2,1380048,0,0,0,0,0,0
20150105.145509,2805.91,20,1380068,0,0,0,0,0,0
20150105.14551,2805.29,10,1380078,0,0,0,0,0,0
20150105.145511,2805.29,6,1380084,0,0,0,0,0,0
20150105.145512,2805.91,6,1380090,6,0,0,0,0,0
20150105.145513,2805.91,2,1380092,2,0,0,0,0,0
20150105.145514,2805.29,54,1380146,-32,0,0,0,0,0
20150105.145515,2805.91,10,1380156,10,0,0,0,0,0
20150105.145516,2805.29,12,1380168,2,0,0,0,0,0
20150105.145517,2805.91,2,1380170,0,0,0,0,0,0
20150105.145518,2805.91,202,1380372,186,0,0,0,0,0
20150105.145519,2805.91,212,1380584,208,0,0,0,0,0
20150105.14552,2805.91,130,1380714,-106,0,0,0,0,0
20150105.145521,2805.91,424,1381138,-192,0,0,0,0,0
20150105.145522,2805.91,428,1381566,38,0,0,0,0,0
20150105.145523,2805.91,22,1381588,-22,0,0,0,0,0
20150105.145524,2805.91,10,1381598,0,0,0,0,0,0
20150105.145525,2805.91,2,1381600,-2,0,0,0,0,0
20150105.145526,2805.29,8,1381608,-8,0,0,0,0,0
20150105.145527,2805.91,1320,1382928,-1310,0,0,0,0,0
20150105.145528,2805.91,2,1382930,0,0,0,0,0,0
20150105.145529,2805.91,42,1382972,-2,0,0,0,0,0
20150105.14553,2805.91,8,1382980,-2,0,0,0,0,0
20150105.145531,2805.91,10,1382990,0,0,0,0,0,0
20150105.145532,2805.91,8,1382998,-6,0,0,0,0,0
20150105.145533,2805.91,102,1383100,-100,0,0,0,0,0
20150105.145534,2805.91,108,1383208,-102,0,0,0,0,0
20150105.145535,2805.91,4,1383212,-4,0,0,0,0,0
20150105.145536,2805.29,22,1383234,-20,0,0,0,0,0
20150105.145537,2805.91,30,1383264,-8,0,0,0,0,0
20150105.145538,2805.91,24,1383288,-20,0,0,0,0,0
20150105.145539,2805.29,10,1383298,-10,0,0,0,0,0
20150105.14554,2805.91,2,1383300,-2,0,0,0,0,0
20150105.145541,2805.91,70,1383370,-56,0,0,0,0,0
20150105.145542,2805.91,80,1383450,68,0,0,0,0,0
20150105.145543,2805.91,8,1383458,0,0,0,0,0,0
20150105.145544,2805.91,2,1383460,-2,0,0,0,0,0
20150105.145545,2805.91,12,1383472,-8,0,0,0,0,0
20150105.145546,2805.91,10,1383482,-10,0,0,0,0,0
20150105.145547,2805.91,2,1383484,0,0,0,0,0,0
20150105.145548,2805.91,202,1383686,-192,0,0,0,0,0
20150105.145549,2805.29,2,1383688,0,0,0,0,0,0
20150105.14555,2805.91,4,1383692,0,0,0,0,0,0
20150105.145551,2805.91,2,1383694,0,0,0,0,0,0
20150105.145552,2805.91,24,1383718,-24,0,0,0,0,0
20150105.145553,2805.29,2,1383720,0,0,0,0,0,0
20150105.145554,2805.91,4,1383724,-4,0,0,0,0,0
20150105.145555,2805.91,2,1383726,0,0,0,0,0,0
20150105.145556,2805.91,2,1383728,2,0,0,0,0,0
20150105.145557,2805.91,2,1383730,0,0,0,0,0,0
20150105.145558,2805.91,2,1383732,-2,0,0,0,0,0
20150105.145559,2805.91,40,1383772,-40,0,0,0,0,0
20150105.1456,2805.91,4,1383776,-2,0,0,0,0,0
20150105.145601,2805.91,4,1383780,0,0,0,0,0,0
20150105.145602,2805.91,4,1383784,-4,0,0,0,0,0
20150105.145603,2805.91,4,1383788,0,0,0,0,0,0
20150105.145604,2805.91,2,1383790,0,0,0,0,0,0
20150105.145605,2805.91,2,1383792,-2,0,0,0,0,0
20150105.145606,2805.91,60,1383852,0,0,0,0,0,0
20150105.145607,2805.91,2,1383854,0,0,0,0,0,0
20150105.145608,2805.91,2,1383856,0,0,0,0,0,0
20150105.145609,2805.91,280,1384136,-256,0,0,0,0,0
20150105.14561,2805.91,20,1384156,-20,0,0,0,0,0
20150105.145611,2805.91,4,1384160,-4,0,0,0,0,0
20150105.145612,2805.91,22,1384182,0,0,0,0,0,0
20150105.145613,2805.91,20,1384202,-18,0,0,0,0,0
20150105.145614,2805.91,8,1384210,-4,0,0,0,0,0
20150105.145615,2805.91,362,1384572,-122,0,0,0,0,0
20150105.145616,2805.91,2,1384574,0,0,0,0,0,0
20150105.145617,2805.29,4,1384578,-2,0,0,0,0,0
20150105.145618,2805.91,40,1384618,-36,0,0,0,0,0
20150105.145619,2805.29,14,1384632,-12,0,0,0,0,0
20150105.14562,2805.91,4,1384636,0,0,0,0,0,0
20150105.145621,2805.91,8,1384644,-6,0,0,0,0,0
20150105.145622,2805.91,382,1385026,-338,0,0,0,0,0
20150105.145623,2805.91,230,1385256,140,0,0,0,0,0
20150105.145624,2805.91,26,1385282,-26,0,0,0,0,0
20150105.145625,2805.91,6,1385288,-2,0,0,0,0,0
20150105.145626,2805.91,12,1385300,-4,0,0,0,0,0
20150105.145627,2805.91,358,1385658,-178,0,0,0,0,0
20150105.145628,2806.53,2,1385660,0,0,0,0,0,0
20150105.145629,2806.53,2,1385662,-2,0,0,0,0,0
20150105.14563,2806.53,18,1385680,-18,0,0,0,0,0
20150105.145631,2806.53,4,1385684,-4,0,0,0,0,0
20150105.145632,2805.91,62,1385746,50,0,0,0,0,0
20150105.145633,2806.53,14,1385760,-2,0,0,0,0,0
20150105.145634,2805.91,142,1385902,-26,0,0,0,0,0
20150105.145635,2805.91,4,1385906,-2,0,0,0,0,0
20150105.145636,2805.91,2,1385908,-2,0,0,0,0,0
20150105.145637,2805.91,18,1385926,2,0,0,0,0,0
20150105.145638,2805.91,400,1386326,-390,0,0,0,0,0
20150105.145639,2805.91,200,1386526,-200,0,0,0,0,0
20150105.14564,2805.91,400,1386926,-390,0,0,0,0,0
20150105.145641,2805.91,516,1387442,-446,0,0,0,0,0
20150105.145642,2805.91,66,1387508,-4,0,0,0,0,0
20150105.145643,2805.91,14,1387522,-8,0,0,0,0,0
20150105.145644,2805.91,204,1387726,0,0,0,0,0,0
20150105.145645,2805.91,2,1387728,0,0,0,0,0,0
20150105.145646,2805.91,58,1387786,-2,0,0,0,0,0
20150105.145647,2805.91,10,1387796,-10,0,0,0,0,0
20150105.145648,2805.91,24,1387820,-22,0,0,0,0,0
20150105.145649,2805.91,8,1387828,-8,0,0,0,0,0
20150105.14565,2805.91,266,1388094,-180,0,0,0,0,0
20150105.145651,2805.91,24,1388118,-22,0,0,0,0,0
20150105.145652,2805.91,2,1388120,0,0,0,0,0,0
20150105.145653,2805.91,20,1388140,-18,0,0,0,0,0
20150105.145654,2805.91,2,1388142,0,0,0,0,0,0
20150105.145655,2805.91,2,1388144,0,0,0,0,0,0
20150105.145656,2805.91,212,1388356,108,0,0,0,0,0
20150105.145657,2805.91,18,1388374,-18,0,0,0,0,0
20150105.145658,2805.91,4,1388378,0,0,0,0,0,0
20150105.145659,2805.91,12,1388390,0,0,0,0,0,0
20150105.1457,2805.91,6,1388396,-2,0,0,0,0,0
20150105.145701,2805.91,6,1388402,-6,0,0,0,0,0
20150105.145702,2805.91,466,1388868,24,0,0,0,0,0
20150105.145703,2805.91,100,1388968,-50,0,0,0,0,0
20150105.145704,2805.91,6,1388974,0,0,0,0,0,0
20150105.145705,2805.91,12,1388986,0,0,0,0,0,0
20150105.145706,2805.91,36,1389022,-36,0,0,0,0,0
20150105.145707,2805.91,2,1389024,0,0,0,0,0,0
20150105.145708,2805.91,6,1389030,-4,0,0,0,0,0
20150105.145709,2805.91,4,1389034,-4,0,0,0,0,0
20150105.14571,2805.91,2,1389036,0,0,0,0,0,0
20150105.145711,2805.91,2,1389038,0,0,0,0,0,0
20150105.145712,2805.91,2,1389040,0,0,0,0,0,0
20150105.145713,2805.91,64,1389104,0,0,0,0,0,0
20150105.145714,2805.91,4,1389108,0,0,0,0,0,0
20150105.145715,2805.91,2,1389110,0,0,0,0,0,0
20150105.145716,2805.91,8,1389118,-2,0,0,0,0,0
20150105.145717,2805.28,2,1389120,-2,0,0,0,0,0
20150105.145718,2805.91,6,1389126,0,0,0,0,0,0
20150105.145719,2805.28,2,1389128,0,0,0,0,0,0
20150105.14572,2805.91,6,1389134,0,0,0,0,0,0
20150105.145721,2805.91,10,1389144,0,0,0,0,0,0
20150105.145722,2805.28,2,1389146,0,0,0,0,0,0
20150105.145723,2805.91,4,1389150,0,0,0,0,0,0
20150105.145724,2805.91,300,1389450,-300,0,0,0,0,0
20150105.145725,2805.28,100,1389550,68,0,0,0,0,0
20150105.145726,2805.91,8,1389558,0,0,0,0,0,0
20150105.145727,2805.91,2,1389560,-2,0,0,0,0,0
20150105.145728,2805.91,2,1389562,-2,0,0,0,0,0
20150105.145729,2805.91,24,1389586,-20,0,0,0,0,0
20150105.14573,2805.91,2,1389588,0,0,0,0,0,0
20150105.145731,2805.91,18,1389606,-18,0,0,0,0,0
20150105.145732,2805.91,2,1389608,-2,0,0,0,0,0
20150105.145733,2805.91,6,1389614,-6,0,0,0,0,0
20150105.145734,2805.91,2,1389616,-2,0,0,0,0,0
20150105.145735,2805.91,28,1389644,-20,0,0,0,0,0
20150105.145736,2805.91,18,1389662,0,0,0,0,0,0
20150105.145737,2805.91,8,1389670,0,0,0,0,0,0
20150105.145738,2805.91,12,1389682,-4,0,0,0,0,0
20150105.145739,2805.91,6,1389688,0,0,0,0,0,0
20150105.14574,2805.91,6,1389694,0,0,0,0,0,0
20150105.145741,2805.91,12,1389706,0,0,0,0,0,0
20150105.145742,2805.91,12,1389718,0,0,0,0,0,0
20150105.145743,2805.91,6,1389724,-2,0,0,0,0,0
20150105.145744,2805.91,4,1389728,0,0,0,0,0,0
20150105.145745,2805.91,64,1389792,-60,0,0,0,0,0
20150105.145746,2805.91,10,1389802,0,0,0,0,0,0
20150105.145747,2805.91,20,1389822,2,0,0,0,0,0
20150105.145748,2805.91,38,1389860,-22,0,0,0,0,0
20150105.145749,2805.91,2,1389862,0,0,0,0,0,0
20150105.14575,2805.91,4,1389866,4,0,0,0,0,0
20150105.145751,2805.91,24,1389890,20,0,0,0,0,0
20150105.145752,2805.91,22,1389912,2,0,0,0,0,0
20150105.145753,2805.91,2,1389914,0,0,0,0,0,0
20150105.145754,2805.91,16,1389930,0,0,0,0,0,0
20150105.145755,2805.91,10,1389940,0,0,0,0,0,0
20150105.145756,2805.91,4,1389944,0,0,0,0,0,0
20150105.145757,2805.91,2,1389946,2,0,0,0,0,0
20150105.145758,2805.91,12,1389958,4,0,0,0,0,0
20150105.145759,2805.91,2,1389960,0,0,0,0,0,0
20150105.1458,2805.91,30,1389990,0,0,0,0,0,0
20150105.145801,2805.91,6,1389996,6,0,0,0,0,0
20150105.145802,2805.91,30,1390026,0,0,0,0,0,0
20150105.145803,2805.91,2,1390028,2,0,0,0,0,0
20150105.145804,2805.91,20,1390048,0,0,0,0,0,0
20150105.145805,2805.91,26,1390074,-12,0,0,0,0,0
20150105.145806,2805.91,2,1390076,-2,0,0,0,0,0
20150105.145807,2805.91,6,1390082,-6,0,0,0,0,0
20150105.145808,2805.28,402,1390484,0,0,0,0,0,0
20150105.145809,2805.91,14,1390498,0,0,0,0,0,0
20150105.14581,2805.28,4,1390502,0,0,0,0,0,0
20150105.145811,2805.91,100,1390602,-100,0,0,0,0,0
20150105.145812,2805.91,2,1390604,0,0,0,0,0,0
20150105.145813,2805.91,20,1390624,-20,0,0,0,0,0
20150105.145814,2805.91,2,1390626,0,0,0,0,0,0
20150105.145815,2805.91,2,1390628,-2,0,0,0,0,0
20150105.145816,2805.91,4,1390632,0,0,0,0,0,0
20150105.145817,2805.91,2,1390634,0,0,0,0,0,0
20150105.145818,2805.91,196,1390830,194,0,0,0,0,0
20150105.145819,2805.91,42,1390872,-20,0,0,0,0,0
20150105.14582,2805.91,98,1390970,-44,0,0,0,0,0
20150105.145821,2805.91,12,1390982,0,0,0,0,0,0
20150105.145822,2805.91,12,1390994,-2,0,0,0,0,0
20150105.145823,2805.28,4,1390998,0,0,0,0,0,0
20150105.145824,2805.91,2,1391000,0,0,0,0,0,0
20150105.145825,2805.91,4,1391004,-2,0,0,0,0,0
20150105.145826,2805.28,16,1391020,16,0,0,0,0,0
20150105.145827,2805.91,8,1391028,-2,0,0,0,0,0
20150105.145828,2805.91,2,1391030,0,0,0,0,0,0
20150105.145829,2805.91,2,1391032,0,0,0,0,0,0
20150105.14583,2805.91,14,1391046,8,0,0,0,0,0
20150105.145831,2805.28,14,1391060,0,0,0,0,0,0
20150105.145832,2805.91,16,1391076,-16,0,0,0,0,0
20150105.145833,2805.91,200,1391276,0,0,0,0,0,0
20150105.145834,2805.91,6,1391282,-2,0,0,0,0,0
20150105.145835,2805.91,8,1391290,0,0,0,0,0,0
20150105.145836,2805.91,6,1391296,0,0,0,0,0,0
20150105.145837,2805.28,240,1391536,0,0,0,0,0,0
20150105.145838,2805.28,230,1391766,-138,0,0,0,0,0
20150105.145839,2805.91,14,1391780,-14,0,0,0,0,0
20150105.14584,2805.28,2,1391782,0,0,0,0,0,0
20150105.145841,2805.91,400,1392182,82,0,0,0,0,0
20150105.145842,2805.91,2,1392184,0,0,0,0,0,0
20150105.145843,2805.28,2,1392186,2,0,0,0,0,0
20150105.145844,2805.91,2,1392188,0,0,0,0,0,0
20150105.145845,2805.28,2,1392190,2,0,0,0,0,0
20150105.145846,2805.28,6,1392196,0,0,0,0,0,0
20150105.145847,2805.91,6,1392202,0,0,0,0,0,0
20150105.145848,2805.91,2,1392204,0,0,0,0,0,0
20150105.145849,2805.91,20,1392224,-20,0,0,0,0,0
20150105.14585,2805.91,4,1392228,-2,0,0,0,0,0
20150105.145851,2805.91,2,1392230,0,0,0,0,0,0
20150105.145852,2805.91,18,1392248,-18,0,0,0,0,0
20150105.145853,2805.91,46,1392294,-46,0,0,0,0,0
20150105.145854,2805.91,2,1392296,0,0,0,0,0,0
20150105.145855,2805.91,2,1392298,0,0,0,0,0,0
20150105.145856,2805.91,4,1392302,-4,0,0,0,0,0
20150105.145857,2805.28,2,1392304,-2,0,0,0,0,0
20150105.145858,2805.28,6,1392310,-4,0,0,0,0,0
20150105.145859,2805.28,2,1392312,2,0,0,0,0,0
20150105.1459,2805.91,2,1392314,0,0,0,0,0,0
20150105.145901,2805.91,12,1392326,-12,0,0,0,0,0
20150105.145902,2805.91,12,1392338,-12,0,0,0,0,0
20150105.145903,2805.91,42,1392380,0,0,0,0,0,0
20150105.145904,2805.28,400,1392780,-146,0,0,0,0,0
20150105.145905,2805.91,4,1392784,-2,0,0,0,0,0
20150105.145906,2805.91,6,1392790,0,0,0,0,0,0
20150105.145907,2805.28,40,1392830,-40,0,0,0,0,0
20150105.145908,2805.91,4,1392834,0,0,0,0,0,0
20150105.145909,2805.91,28,1392862,-26,0,0,0,0,0
20150105.14591,2805.91,16,1392878,-14,0,0,0,0,0
20150105.145911,2805.91,8,1392886,8,0,0,0,0,0
20150105.145912,2805.91,18,1392904,0,0,0,0,0,0
20150105.145913,2805.91,2,1392906,2,0,0,0,0,0
20150105.145914,2805.28,6,1392912,0,0,0,0,0,0
20150105.145915,2805.91,2,1392914,2,0,0,0,0,0
20150105.145916,2805.28,2,1392916,-2,0,0,0,0,0
20150105.145917,2805.91,30,1392946,0,0,0,0,0,0
20150105.145918,2805.91,2,1392948,2,0,0,0,0,0
20150105.145919,2805.91,30,1392978,20,0,0,0,0,0
20150105.14592,2805.91,8,1392986,4,0,0,0,0,0
20150105.145921,2805.28,42,1393028,-30,0,0,0,0,0
20150105.145922,2805.28,6,1393034,0,0,0,0,0,0
20150105.145923,2805.28,4,1393038,2,0,0,0,0,0
20150105.145924,2805.91,10,1393048,-2,0,0,0,0,0
20150105.145925,2805.28,2,1393050,-2,0,0,0,0,0
20150105.145926,2805.28,2,1393052,0,0,0,0,0,0
20150105.145927,2805.91,2,1393054,2,0,0,0,0,0
20150105.145928,2805.28,6,1393060,4,0,0,0,0,0
20150105.145929,2805.28,4,1393064,2,0,0,0,0,0
20150105.14593,2805.91,2,1393066,0,0,0,0,0,0
20150105.145931,2805.91,2,1393068,0,0,0,0,0,0
20150105.145932,2805.28,40,1393108,-40,0,0,0,0,0
20150105.145933,2805.28,4,1393112,-2,0,0,0,0,0
20150105.145934,2805.91,2,1393114,2,0,0,0,0,0
20150105.145935,2805.91,2,1393116,0,0,0,0,0,0
20150105.145936,2805.91,20,1393136,0,0,0,0,0,0
20150105.145937,2805.28,2,1393138,0,0,0,0,0,0
20150105.145938,2805.28,12,1393150,6,0,0,0,0,0
20150105.145939,2805.28,2,1393152,0,0,0,0,0,0
20150105.14594,2805.91,2,1393154,2,0,0,0,0,0
20150105.145941,2805.91,100,1393254,100,0,0,0,0,0
20150105.145942,2805.28,10,1393264,10,0,0,0,0,0
20150105.145943,2805.28,20,1393284,0,0,0,0,0,0
20150105.145944,2805.91,2,1393286,0,0,0,0,0,0
20150105.145945,2805.91,6,1393292,-4,0,0,0,0,0
20150105.145946,2805.91,2,1393294,0,0,0,0,0,0
20150105.145947,2805.91,4,1393298,0,0,0,0,0,0
20150105.145948,2805.91,28,1393326,-28,0,0,0,0,0
20150105.145949,2805.91,6,1393332,0,0,0,0,0,0
20150105.14595,2805.28,2,1393334,2,0,0,0,0,0
20150105.145951,2805.91,2,1393336,-2,0,0,0,0,0
20150105.145952,2805.91,2,1393338,-2,0,0,0,0,0
20150105.145953,2805.28,2,1393340,2,0,0,0,0,0
20150105.145954,2805.28,4,1393344,2,0,0,0,0,0
20150105.145955,2805.91,6,1393350,-2,0,0,0,0,0
20150105.145956,2805.91,22,1393372,-22,0,0,0,0,0
20150105.145957,2805.28,2,1393374,2,0,0,0,0,0
20150105.145958,2805.91,2,1393376,0,0,0,0,0,0
20150105.145959,2805.28,20,1393396,-8,0,0,0,0,0
